id,date,price,bedrooms,bathrooms,sqft_living,sqft_lot,floors,waterfront,view,condition,grade,sqft_above,sqft_basement,yr_built,yr_renovated,zipcode,lat,long,sqft_living15,sqft_lot15,date_month,date_day,date_year,renovated_status,sqft_living15_diff,sqft_lot15_diff
7129300520,10/13/2014,221900.0,3,1.0,1180,5650,1.0,0.0,0.0,3,7,1180,0,1955,0,98178,47.5112,-122.257,1340,5650,10,13,2014,UNK,-160,0
6414100192,12/9/2014,538000.0,3,2.25,2570,7242,2.0,0.0,0.0,3,7,2170,400,1951,1991,98125,47.721000000000004,-122.319,1690,7639,12,9,2014,Y,880,-397
5631500400,2/25/2015,180000.0,2,1.0,770,10000,1.0,0.0,0.0,3,6,770,0,1933,0,98028,47.7379,-122.23299999999999,2720,8062,2,25,2015,UNK,-1950,1938
2487200875,12/9/2014,604000.0,4,3.0,1960,5000,1.0,0.0,0.0,5,7,1050,910,1965,0,98136,47.5208,-122.39299999999999,1360,5000,12,9,2014,UNK,600,0
1954400510,2/18/2015,510000.0,3,2.0,1680,8080,1.0,0.0,0.0,3,8,1680,0,1987,0,98074,47.6168,-122.045,1800,7503,2,18,2015,UNK,-120,577
7237550310,5/12/2014,1230000.0,4,4.5,5420,101930,1.0,0.0,0.0,3,11,3890,1530,2001,0,98053,47.6561,-122.005,4760,101930,5,12,2014,UNK,660,0
1321400060,6/27/2014,257500.0,3,2.25,1715,6819,2.0,0.0,0.0,3,7,1715,0,1995,0,98003,47.3097,-122.32700000000001,2238,6819,6,27,2014,UNK,-523,0
2008000270,1/15/2015,291850.0,3,1.5,1060,9711,1.0,0.0,0.0,3,7,1060,0,1963,0,98198,47.4095,-122.315,1650,9711,1,15,2015,UNK,-590,0
2414600126,4/15/2015,229500.0,3,1.0,1780,7470,1.0,0.0,0.0,3,7,1050,730,1960,0,98146,47.5123,-122.337,1780,8113,4,15,2015,UNK,0,-643
3793500160,3/12/2015,323000.0,3,2.5,1890,6560,2.0,0.0,0.0,3,7,1890,0,2003,0,98038,47.3684,-122.031,2390,7570,3,12,2015,UNK,-500,-1010
1736800520,4/3/2015,662500.0,3,2.5,3560,9796,1.0,0.0,0.0,3,8,1860,1700,1965,0,98007,47.6007,-122.145,2210,8925,4,3,2015,UNK,1350,871
9212900260,5/27/2014,468000.0,2,1.0,1160,6000,1.0,0.0,0.0,4,7,860,300,1942,0,98115,47.69,-122.292,1330,6000,5,27,2014,UNK,-170,0
114101516,5/28/2014,310000.0,3,1.0,1430,19901,1.5,0.0,0.0,4,7,1430,0,1927,0,98028,47.7558,-122.229,1780,12697,5,28,2014,UNK,-350,7204
6054650070,10/7/2014,400000.0,3,1.75,1370,9680,1.0,0.0,0.0,4,7,1370,0,1977,0,98074,47.6127,-122.045,1370,10208,10,7,2014,UNK,0,-528
1175000570,3/12/2015,530000.0,5,2.0,1810,4850,1.5,0.0,0.0,3,7,1810,0,1900,0,98107,47.67,-122.39399999999999,1360,4850,3,12,2015,UNK,450,0
9297300055,1/24/2015,650000.0,4,3.0,2950,5000,2.0,0.0,3.0,3,9,1980,970,1979,0,98126,47.5714,-122.375,2140,4000,1,24,2015,UNK,810,1000
1875500060,7/31/2014,395000.0,3,2.0,1890,14040,2.0,0.0,0.0,3,7,1890,0,1994,0,98019,47.7277,-121.962,1890,14018,7,31,2014,UNK,0,22
6865200140,5/29/2014,485000.0,4,1.0,1600,4300,1.5,0.0,0.0,4,7,1600,0,1916,0,98103,47.6648,-122.34299999999999,1610,4300,5,29,2014,UNK,-10,0
16000397,12/5/2014,189000.0,2,1.0,1200,9850,1.0,0.0,0.0,4,7,1200,0,1921,0,98002,47.3089,-122.21,1060,5095,12,5,2014,UNK,140,4755
7983200060,4/24/2015,230000.0,3,1.0,1250,9774,1.0,0.0,0.0,4,7,1250,0,1969,0,98003,47.3343,-122.306,1280,8850,4,24,2015,UNK,-30,924
6300500875,5/14/2014,385000.0,4,1.75,1620,4980,1.0,0.0,0.0,4,7,860,760,1947,0,98133,47.7025,-122.34100000000001,1400,4980,5,14,2014,UNK,220,0
2524049179,8/26/2014,2000000.0,3,2.75,3050,44867,1.0,0.0,4.0,3,9,2330,720,1968,0,98040,47.5316,-122.23299999999999,4110,20336,8,26,2014,UNK,-1060,24531
7137970340,7/3/2014,285000.0,5,2.5,2270,6300,2.0,0.0,0.0,3,8,2270,0,1995,0,98092,47.3266,-122.169,2240,7005,7,3,2014,UNK,30,-705
8091400200,5/16/2014,252700.0,2,1.5,1070,9643,1.0,0.0,0.0,3,7,1070,0,1985,0,98030,47.3533,-122.166,1220,8386,5,16,2014,UNK,-150,1257
3814700200,11/20/2014,329000.0,3,2.25,2450,6500,2.0,0.0,0.0,4,8,2450,0,1985,0,98030,47.3739,-122.17200000000001,2200,6865,11,20,2014,UNK,250,-365
1202000200,11/3/2014,233000.0,3,2.0,1710,4697,1.5,0.0,0.0,5,6,1710,0,1941,0,98002,47.3048,-122.21799999999999,1030,4705,11,3,2014,UNK,680,-8
1794500383,6/26/2014,937000.0,3,1.75,2450,2691,2.0,0.0,0.0,3,8,1750,700,1915,0,98119,47.6386,-122.36,1760,3573,6,26,2014,UNK,690,-882
3303700376,12/1/2014,667000.0,3,1.0,1400,1581,1.5,0.0,0.0,5,8,1400,0,1909,0,98112,47.6221,-122.314,1860,3861,12,1,2014,UNK,-460,-2280
5101402488,6/24/2014,438000.0,3,1.75,1520,6380,1.0,0.0,0.0,3,7,790,730,1948,0,98115,47.695,-122.304,1520,6235,6,24,2014,UNK,0,145
1873100390,3/2/2015,719000.0,4,2.5,2570,7173,2.0,0.0,0.0,3,8,2570,0,2005,0,98052,47.7073,-122.11,2630,6026,3,2,2015,N,-60,1147
8562750320,11/10/2014,580500.0,3,2.5,2320,3980,2.0,0.0,0.0,3,8,2320,0,2003,0,98027,47.5391,-122.07,2580,3980,11,10,2014,UNK,-260,0
2426039314,12/1/2014,280000.0,2,1.5,1190,1265,3.0,0.0,0.0,3,7,1190,0,2005,0,98133,47.7274,-122.35700000000001,1390,1756,12,1,2014,N,-200,-491
461000390,6/24/2014,687500.0,4,1.75,2330,5000,1.5,0.0,0.0,4,7,1510,820,1929,0,98117,47.6823,-122.368,1460,5000,6,24,2014,UNK,870,0
7589200193,11/10/2014,535000.0,3,1.0,1090,3000,1.5,0.0,0.0,4,8,1090,0,1929,0,98117,47.6889,-122.375,1570,5080,11,10,2014,UNK,-480,-2080
7955080270,12/3/2014,322500.0,4,2.75,2060,6659,1.0,0.0,0.0,3,7,1280,780,1981,0,98058,47.4276,-122.15700000000001,2020,8720,12,3,2014,UNK,40,-2061
9547205180,6/13/2014,696000.0,3,2.5,2300,3060,1.5,0.0,0.0,3,8,1510,790,1930,2002,98115,47.6827,-122.31,1590,3264,6,13,2014,Y,710,-204
9435300030,5/28/2014,550000.0,4,1.0,1660,34848,1.0,0.0,0.0,1,5,930,730,1933,0,98052,47.6621,-122.132,2160,11467,5,28,2014,UNK,-500,23381
2768000400,12/30/2014,640000.0,4,2.0,2360,6000,2.0,0.0,0.0,4,8,2360,0,1904,0,98107,47.6702,-122.36200000000001,1730,4700,12,30,2014,UNK,630,1300
7895500070,2/13/2015,240000.0,4,1.0,1220,8075,1.0,0.0,0.0,2,7,890,330,1969,0,98001,47.3341,-122.28200000000001,1290,7800,2,13,2015,UNK,-70,275
2078500320,6/20/2014,605000.0,4,2.5,2620,7553,2.0,0.0,0.0,3,8,2620,0,1996,0,98056,47.5301,-122.18,2620,11884,6,20,2014,UNK,0,-4331
5547700270,7/15/2014,625000.0,4,2.5,2570,5520,2.0,0.0,0.0,3,9,2570,0,2000,0,98074,47.6145,-122.027,2470,5669,7,15,2014,UNK,100,-149
7766200013,8/11/2014,775000.0,4,2.25,4220,24186,1.0,0.0,0.0,3,8,2600,1620,1984,0,98166,47.445,-122.34700000000001,2410,30617,8,11,2014,UNK,1810,-6431
7203220400,7/7/2014,861990.0,5,2.75,3595,5639,2.0,0.0,0.0,3,9,3595,0,2014,0,98053,47.6848,-122.016,3625,5639,7,7,2014,N,-30,0
9270200160,10/28/2014,685000.0,3,1.0,1570,2280,2.0,0.0,0.0,3,7,1570,0,1922,0,98119,47.6413,-122.36399999999999,1580,2640,10,28,2014,UNK,-10,-360
1432701230,7/29/2014,309000.0,3,1.0,1280,9656,1.0,0.0,0.0,4,6,920,360,1959,0,98058,47.4485,-122.175,1340,8808,7,29,2014,UNK,-60,848
8035350320,7/18/2014,488000.0,3,2.5,3160,13603,2.0,0.0,0.0,3,8,3160,0,2003,0,98019,47.7443,-121.977,3050,9232,7,18,2014,UNK,110,4371
8945200830,3/25/2015,210490.0,3,1.0,990,8528,1.0,0.0,0.0,3,6,990,0,1966,0,98023,47.3066,-122.37100000000001,1228,8840,3,25,2015,UNK,-238,-312
4178300310,7/16/2014,785000.0,4,2.5,2290,13416,2.0,0.0,0.0,4,9,2290,0,1981,0,98007,47.6194,-122.15100000000001,2680,13685,7,16,2014,UNK,-390,-269
9215400105,4/28/2015,450000.0,3,1.75,1250,5963,1.0,0.0,0.0,4,7,1250,0,1953,0,98115,47.6796,-122.301,970,5100,4,28,2015,UNK,280,863
822039084,3/11/2015,1350000.0,3,2.5,2753,65005,1.0,1.0,2.0,5,9,2165,588,1953,0,98070,47.4041,-122.45100000000001,2680,72513,3,11,2015,UNK,73,-7508
5245600105,9/16/2014,228000.0,3,1.0,1190,9199,1.0,0.0,0.0,3,7,1190,0,1955,0,98148,47.4258,-122.322,1190,9364,9,16,2014,UNK,0,-165
7231300125,2/17/2015,345000.0,5,2.5,3150,9134,1.0,0.0,0.0,4,8,1640,1510,1966,0,98056,47.4934,-122.189,1990,9133,2,17,2015,UNK,1160,1
7518505990,12/31/2014,600000.0,3,1.75,1410,4080,1.0,0.0,0.0,4,7,1000,410,1950,0,98117,47.6808,-122.384,1410,4080,12,31,2014,UNK,0,0
3626039271,2/5/2015,585000.0,2,1.75,1980,8550,1.0,0.0,0.0,3,7,990,990,1981,0,98117,47.6989,-122.369,1480,6738,2,5,2015,UNK,500,1812
4217401195,3/3/2015,920000.0,5,2.25,2730,6000,1.5,0.0,0.0,3,8,2130,600,1927,0,98105,47.6571,-122.281,2730,6000,3,3,2015,UNK,0,0
9822700295,5/12/2014,885000.0,4,2.5,2830,5000,2.0,0.0,0.0,3,9,2830,0,1995,0,98105,47.6597,-122.29,1950,5000,5,12,2014,UNK,880,0
9478500640,8/19/2014,292500.0,4,2.5,2250,4495,2.0,0.0,0.0,3,7,2250,0,2008,0,98042,47.3663,-122.11399999999999,2250,4500,8,19,2014,N,0,-5
2799800710,4/7/2015,301000.0,3,2.5,2420,4750,2.0,0.0,0.0,3,8,2420,0,2003,0,98042,47.3663,-122.12200000000001,2690,4750,4,7,2015,UNK,-270,0
7922800400,8/27/2014,951000.0,5,3.25,3250,14342,2.0,0.0,4.0,4,8,3250,0,1968,0,98008,47.588,-122.116,2960,11044,8,27,2014,UNK,290,3298
8079040320,2/23/2015,430000.0,4,3.0,1850,9976,2.0,0.0,0.0,3,8,1850,0,1991,0,98059,47.5059,-122.149,2270,8542,2,23,2015,UNK,-420,1434
1516000055,12/10/2014,650000.0,3,2.25,2150,21235,1.0,0.0,3.0,4,8,1590,560,1959,0,98166,47.4336,-122.339,2570,18900,12,10,2014,UNK,-420,2335
9558200045,8/28/2014,289000.0,3,1.75,1260,8400,1.0,0.0,0.0,3,7,1260,0,1954,0,98148,47.4366,-122.335,1290,8750,8,28,2014,UNK,-30,-350
5072410070,10/21/2014,505000.0,3,1.75,2519,8690,2.0,0.0,0.0,5,8,2519,0,1973,0,98166,47.4428,-122.344,2500,9500,10,21,2014,UNK,19,-810
9528102996,12/7/2014,549000.0,3,1.75,1540,1044,3.0,0.0,0.0,3,8,1540,0,2014,0,98115,47.6765,-122.32,1580,3090,12,7,2014,N,-40,-2046
1189001180,6/3/2014,425000.0,3,2.25,1660,6000,1.0,0.0,0.0,3,7,1110,550,1979,0,98122,47.6113,-122.29700000000001,1440,4080,6,3,2014,UNK,220,1920
3253500160,11/20/2014,317625.0,3,2.75,2770,3809,1.5,0.0,0.0,5,7,1770,1000,1925,0,98144,47.5747,-122.304,1440,4000,11,20,2014,UNK,1330,-191
3394100030,9/9/2014,975000.0,4,2.5,2720,11049,2.0,0.0,0.0,3,10,2720,0,1989,0,98004,47.5815,-122.19200000000001,2750,11049,9,9,2014,UNK,-30,0
3717000160,10/9/2014,287000.0,4,2.5,2240,4648,2.0,0.0,0.0,3,7,2240,0,2005,0,98001,47.3378,-122.257,2221,4557,10,9,2014,N,19,91
1274500060,8/25/2014,204000.0,3,1.0,1000,12070,1.0,0.0,0.0,4,7,1000,0,1968,0,98042,47.3621,-122.11,1010,12635,8,25,2014,UNK,-10,-565
1802000060,6/12/2014,1330000.0,5,2.25,3200,20158,1.0,0.0,0.0,3,8,1600,1600,1965,0,98004,47.6303,-122.215,3390,20158,6,12,2014,UNK,-190,0
1525059190,9/12/2014,1040000.0,5,3.25,4770,50094,1.0,0.0,0.0,4,11,3070,1700,1973,0,98005,47.6525,-122.16,3530,38917,9,12,2014,UNK,1240,11177
1049000060,1/5/2015,325000.0,3,2.0,1260,5612,1.0,0.0,0.0,4,7,1260,0,1972,0,98034,47.7362,-122.179,1640,4745,1,5,2015,UNK,-380,867
8820901275,6/10/2014,571000.0,4,2.0,2750,7807,1.5,0.0,0.0,5,7,2250,500,1916,0,98125,47.7168,-122.287,1510,7807,6,10,2014,UNK,1240,0
5416510140,7/10/2014,360000.0,4,2.5,2380,5000,2.0,0.0,0.0,3,8,2380,0,2005,0,98038,47.3608,-122.036,2420,5000,7,10,2014,N,-40,0
3444100400,3/16/2015,349000.0,3,1.75,1790,50529,1.0,0.0,0.0,5,7,1090,700,1965,0,98042,47.3511,-122.073,1940,50529,3,16,2015,UNK,-150,0
3276920270,11/5/2014,832500.0,4,4.0,3430,35102,2.0,0.0,0.0,4,10,2390,1040,1986,0,98075,47.5822,-121.98700000000001,3240,35020,11,5,2014,UNK,190,82
4036801170,10/13/2014,380000.0,4,1.75,1760,7300,1.0,0.0,0.0,3,7,880,880,1956,0,98008,47.6034,-122.125,1680,7500,10,13,2014,UNK,80,-200
2391600320,4/20/2015,480000.0,3,1.0,1040,5060,1.0,0.0,0.0,3,7,1040,0,1941,0,98116,47.5636,-122.39399999999999,890,5060,4,20,2015,UNK,150,0
6300000287,6/9/2014,410000.0,3,1.0,1410,5060,1.0,0.0,0.0,4,7,910,500,1956,0,98133,47.7073,-122.34,1130,5693,6,9,2014,UNK,280,-633
1531000030,3/23/2015,720000.0,4,2.5,3450,39683,2.0,0.0,0.0,3,10,3450,0,2002,0,98010,47.342,-122.025,3350,39750,3,23,2015,UNK,100,-67
5104520400,12/2/2014,390000.0,3,2.5,2350,5100,2.0,0.0,0.0,3,8,2350,0,2003,0,98038,47.3512,-122.008,2350,5363,12,2,2014,UNK,0,-263
7437100340,12/22/2014,360000.0,4,2.5,1900,5889,2.0,0.0,0.0,3,7,1900,0,1992,0,98038,47.349,-122.031,1870,6405,12,22,2014,UNK,30,-516
9418400240,10/28/2014,355000.0,2,1.0,2020,6720,1.0,0.0,0.0,3,7,1010,1010,1948,0,98118,47.5474,-122.291,1720,6720,10,28,2014,UNK,300,0
1523059105,1/28/2015,356000.0,3,1.5,1680,8712,1.0,0.0,0.0,3,8,1680,0,1964,0,98059,47.4811,-122.149,1850,8797,1,28,2015,UNK,-170,-85
1133000671,6/2/2014,315000.0,3,1.0,960,6634,1.0,0.0,0.0,3,6,960,0,1952,0,98125,47.7264,-122.31,1570,7203,6,2,2014,UNK,-610,-569
4232902595,11/14/2014,940000.0,3,1.5,2140,3600,2.0,0.0,0.0,3,9,1900,240,1925,0,98119,47.6337,-122.365,2020,4800,11,14,2014,UNK,120,-1200
2599001200,11/3/2014,305000.0,5,2.25,2660,8400,1.5,0.0,0.0,5,7,2660,0,1961,0,98092,47.2909,-122.189,1590,8165,11,3,2014,UNK,1070,235
3342103156,6/18/2014,461000.0,3,3.25,2770,6278,2.0,0.0,0.0,3,9,1980,790,2006,0,98056,47.5228,-122.199,1900,7349,6,18,2014,N,870,-1071
1332700270,5/19/2014,215000.0,2,2.25,1610,2040,2.0,0.0,0.0,4,7,1610,0,1979,0,98056,47.518,-122.194,1950,2025,5,19,2014,UNK,-340,15
3869900162,9/4/2014,335000.0,2,1.75,1030,1066,2.0,0.0,0.0,3,7,765,265,2006,0,98136,47.5394,-122.387,1030,1106,9,4,2014,N,0,-40
2791500270,5/22/2014,243500.0,4,2.5,1980,7403,2.0,0.0,0.0,3,7,1980,0,1988,0,98023,47.2897,-122.37200000000001,1980,7510,5,22,2014,UNK,0,-107
5036300431,3/11/2015,1100000.0,5,2.75,3520,6353,2.0,0.0,0.0,4,10,3520,0,2001,0,98199,47.6506,-122.391,2520,6250,3,11,2015,UNK,1000,103
4168000060,2/26/2015,153000.0,3,1.0,1200,10500,1.0,0.0,0.0,3,7,1200,0,1962,0,98023,47.321999999999996,-122.351,1350,10500,2,26,2015,UNK,-150,0
6021501535,7/25/2014,430000.0,3,1.5,1580,5000,1.0,0.0,0.0,3,8,1290,290,1939,0,98117,47.687,-122.38600000000001,1570,4500,7,25,2014,UNK,10,500
6021501535,12/23/2014,700000.0,3,1.5,1580,5000,1.0,0.0,0.0,3,8,1290,290,1939,0,98117,47.687,-122.38600000000001,1570,4500,12,23,2014,UNK,10,500
1483300570,9/8/2014,905000.0,4,2.5,3300,10250,1.0,0.0,0.0,3,7,2390,910,1946,1991,98040,47.5873,-122.249,1950,6045,9,8,2014,Y,1350,4205
3422049190,3/30/2015,247500.0,3,1.75,1960,15681,1.0,0.0,0.0,3,7,1960,0,1967,0,98032,47.3576,-122.277,1750,15616,3,30,2015,UNK,210,65
1099611230,9/12/2014,199000.0,4,1.5,1160,6400,1.0,0.0,0.0,4,7,1160,0,1975,0,98023,47.3036,-122.37799999999999,1160,6400,9,12,2014,UNK,0,0
722079104,7/11/2014,314000.0,3,1.75,1810,41800,1.0,0.0,0.0,5,7,1210,600,1980,0,98038,47.4109,-121.958,1650,135036,7,11,2014,UNK,160,-93236
7338200240,5/16/2014,437500.0,3,2.5,2320,36847,2.0,0.0,2.0,3,9,2320,0,1992,0,98045,47.4838,-121.714,2550,35065,5,16,2014,UNK,-230,1782
1952200240,6/11/2014,850830.0,3,2.5,2070,13241,1.5,0.0,0.0,5,9,1270,800,1910,0,98102,47.6415,-122.315,2200,4500,6,11,2014,UNK,-130,8741
5200100125,10/27/2014,555000.0,3,2.0,1980,3478,1.5,0.0,0.0,4,7,1440,540,1929,0,98117,47.6775,-122.37200000000001,1610,3478,10,27,2014,UNK,370,0
7214720075,12/12/2014,699950.0,3,2.25,2190,107593,2.0,0.0,0.0,4,8,2190,0,1983,0,98077,47.7731,-122.08,2570,47777,12,12,2014,UNK,-380,59816
2450000295,10/7/2014,1090000.0,3,2.5,2920,8113,2.0,0.0,0.0,3,8,2920,0,1950,2010,98004,47.5814,-122.196,2370,8113,10,7,2014,Y,550,0
6197800045,9/24/2014,290000.0,3,1.0,1210,33919,1.0,0.0,0.0,3,7,1210,0,1954,0,98058,47.4375,-122.184,1640,14910,9,24,2014,UNK,-430,19009
1328310370,4/2/2015,375000.0,3,2.5,2340,10005,1.0,0.0,0.0,4,8,1460,880,1978,0,98058,47.4431,-122.133,2250,8162,4,2,2015,UNK,90,1843
546000875,5/23/2014,460000.0,3,1.0,1670,4005,1.5,0.0,0.0,4,7,1170,500,1939,0,98117,47.6878,-122.38,1240,4005,5,23,2014,UNK,430,0
3530510041,7/23/2014,188500.0,2,1.75,1240,2493,1.0,0.0,0.0,4,8,1240,0,1985,0,98198,47.3813,-122.322,1270,4966,7,23,2014,UNK,-30,-2473
1853000400,3/5/2015,680000.0,4,2.5,3140,28037,2.0,0.0,0.0,4,10,3140,0,1991,0,98077,47.7304,-122.08200000000001,2990,35001,3,5,2015,UNK,150,-6964
3134100116,8/27/2014,470000.0,5,1.75,2030,12342,2.0,0.0,0.0,4,7,2030,0,1942,0,98052,47.6417,-122.109,2500,9433,8,27,2014,UNK,-470,2909
9545230140,7/25/2014,597750.0,4,2.5,2310,9624,2.0,0.0,0.0,3,8,2310,0,1984,0,98027,47.5386,-122.053,1940,9636,7,25,2014,UNK,370,-12
3362400511,3/4/2015,570000.0,3,1.75,1260,3328,1.0,0.0,0.0,5,6,700,560,1905,0,98103,47.6823,-122.34899999999999,1380,3536,3,4,2015,UNK,-120,-208
2525310310,9/16/2014,272500.0,3,1.75,1540,12600,1.0,0.0,0.0,4,7,1160,0,1980,0,98038,47.3624,-122.031,1540,11656,9,16,2014,UNK,0,944
6126500060,11/24/2014,329950.0,3,1.75,2080,5969,1.0,0.0,2.0,3,7,1080,1000,1971,0,98108,47.5474,-122.295,2090,5500,11,24,2014,UNK,-10,469
8961960160,10/28/2014,480000.0,4,2.5,3230,16171,2.0,0.0,0.0,3,9,2520,710,2001,0,98001,47.3183,-122.25299999999999,2640,8517,10,28,2014,UNK,590,7654
3626039325,11/21/2014,740500.0,3,3.5,4380,6350,2.0,0.0,0.0,3,8,2780,0,1900,0,98117,47.6981,-122.368,1830,6350,11,21,2014,UNK,2550,0
3362400431,6/26/2014,518500.0,3,3.5,1590,1102,3.0,0.0,0.0,3,8,1590,0,2010,0,98103,47.6824,-122.34700000000001,1620,3166,6,26,2014,N,-30,-2064
4060000240,6/23/2014,205425.0,2,1.0,880,6780,1.0,0.0,0.0,4,6,880,0,1945,0,98178,47.5009,-122.24799999999999,1190,6780,6,23,2014,UNK,-310,0
3454800060,1/8/2015,171800.0,4,2.0,1570,9600,1.0,0.0,0.0,3,6,1570,0,1950,0,98168,47.4965,-122.303,1880,9000,1,8,2015,UNK,-310,600
1695900060,5/11/2015,535000.0,4,1.0,1610,2982,1.5,0.0,0.0,4,7,1610,0,1925,0,98144,47.586999999999996,-122.294,1610,4040,5,11,2015,UNK,0,-1058
7278700070,1/2/2015,660000.0,3,2.5,2400,6474,1.0,0.0,2.0,3,8,1560,840,1964,0,98177,47.7728,-122.38600000000001,2340,10856,1,2,2015,UNK,60,-4382
6675500070,11/19/2014,391500.0,3,2.0,1450,9132,1.0,0.0,0.0,3,7,1450,0,1987,0,98034,47.7288,-122.226,1580,9104,11,19,2014,UNK,-130,28
3626039187,4/6/2015,395000.0,2,1.0,770,6000,1.0,0.0,0.0,3,6,770,0,1953,0,98117,47.6999,-122.36399999999999,1710,6000,4,6,2015,UNK,-940,0
3524049083,11/4/2014,445000.0,4,1.75,2100,4400,1.5,0.0,0.0,5,7,1720,380,1924,0,98118,47.5299,-122.266,1850,4400,11,4,2014,UNK,250,0
3275860240,6/18/2014,770000.0,3,2.25,2910,10204,2.0,0.0,0.0,3,9,2910,0,1990,0,98052,47.6897,-122.098,2700,13992,6,18,2014,UNK,210,-3788
4389200955,3/2/2015,1450000.0,4,2.75,2750,17789,1.5,0.0,0.0,3,8,1980,770,1914,1992,98004,47.6141,-122.212,3060,11275,3,2,2015,Y,-310,6514
4058801670,7/17/2014,445000.0,3,2.25,2100,8201,1.0,0.0,2.0,3,8,1620,480,1967,0,98178,47.5091,-122.244,2660,8712,7,17,2014,UNK,-560,-511
8732020310,7/17/2014,260000.0,4,2.25,2160,8811,1.0,0.0,0.0,3,8,1360,800,1978,0,98023,47.3129,-122.39,2090,8400,7,17,2014,UNK,70,411
2331300505,6/13/2014,822500.0,5,3.5,2320,4960,2.0,0.0,0.0,5,7,1720,600,1926,0,98103,47.6763,-122.352,1700,4960,6,13,2014,UNK,620,0
7853210060,4/6/2015,430000.0,4,2.5,2070,4310,2.0,0.0,0.0,3,7,2070,0,2004,0,98065,47.5319,-121.85,1970,3748,4,6,2015,N,100,562
3668000070,1/5/2015,212000.0,3,1.75,1060,7875,1.0,0.0,0.0,4,7,1060,0,1986,0,98092,47.2761,-122.152,1420,7680,1,5,2015,UNK,-360,195
9545240070,4/28/2015,660500.0,4,2.25,2010,9603,1.0,0.0,0.0,3,8,1440,570,1986,0,98027,47.5343,-122.054,2060,9793,4,28,2015,UNK,-50,-190
1243100136,6/12/2014,784000.0,3,3.5,3950,111078,1.5,0.0,0.0,3,9,2460,1490,1989,0,98052,47.696999999999996,-122.072,2480,88500,6,12,2014,UNK,1470,22578
8929000270,5/12/2014,453246.0,3,2.5,2010,2287,2.0,0.0,0.0,3,8,1390,620,2014,0,98029,47.5517,-121.99799999999999,1690,1662,5,12,2014,N,320,625
2767602356,1/26/2015,675000.0,4,3.5,2140,2278,3.0,0.0,0.0,3,9,2140,0,2005,0,98107,47.6734,-122.38,1540,2285,1,26,2015,N,600,-7
921049315,8/13/2014,199000.0,3,1.75,1320,17390,1.0,0.0,0.0,4,7,1320,0,1956,0,98003,47.3257,-122.296,1550,19265,8,13,2014,UNK,-230,-1875
3655000070,8/5/2014,220000.0,4,1.75,2020,7840,1.0,0.0,0.0,3,7,1010,1010,1968,0,98003,47.3309,-122.29899999999999,1750,8140,8,5,2014,UNK,270,-300
4027700812,5/29/2014,452000.0,4,2.25,2590,10002,1.0,0.0,0.0,4,8,1340,1250,1968,0,98028,47.7689,-122.266,1550,10436,5,29,2014,UNK,1040,-434
3992700335,7/7/2014,382500.0,2,1.0,1190,4440,1.0,0.0,0.0,3,6,1190,0,1981,0,98125,47.7135,-122.287,1060,5715,7,7,2014,UNK,130,-1275
2767603505,5/7/2014,519950.0,3,2.25,1170,1249,3.0,0.0,0.0,3,8,1170,0,2014,0,98107,47.6722,-122.381,1350,1310,5,7,2014,N,-180,-61
4232901525,6/27/2014,665000.0,2,1.0,1110,3200,1.0,0.0,0.0,3,7,1110,0,1925,0,98119,47.6338,-122.35799999999999,1170,3600,6,27,2014,UNK,-60,-400
1777500060,7/8/2014,527700.0,5,2.5,2820,9375,1.0,0.0,0.0,4,8,1550,1270,1968,0,98006,47.5707,-122.12799999999999,2820,9375,7,8,2014,UNK,0,0
1432900240,5/8/2015,205000.0,3,1.0,1610,8579,1.0,0.0,0.0,4,7,1010,600,1962,0,98058,47.4563,-122.171,1610,8579,5,8,2015,UNK,0,0
6140100875,4/15/2015,420000.0,3,1.0,1060,8097,1.0,0.0,0.0,4,7,940,120,1923,0,98133,47.7144,-122.351,1560,7940,4,15,2015,UNK,-500,157
6071600370,2/27/2015,500000.0,4,2.25,2030,8517,1.0,0.0,0.0,4,8,1380,650,1961,0,98006,47.5495,-122.17399999999999,2230,8824,2,27,2015,UNK,-200,-307
1526069017,12/3/2014,921500.0,4,2.5,3670,315374,2.0,0.0,0.0,4,9,3670,0,1994,0,98077,47.7421,-122.02600000000001,2840,87991,12,3,2014,UNK,830,227383
809001525,6/25/2014,890000.0,4,1.0,2550,4000,2.0,0.0,0.0,3,8,2370,180,1905,0,98109,47.6354,-122.353,2200,4000,6,25,2014,UNK,350,0
3224079105,8/6/2014,430000.0,2,2.5,2420,60984,2.0,0.0,0.0,3,7,2420,0,2007,0,98027,47.5262,-121.943,1940,193842,8,6,2014,N,480,-132858
8075400570,10/30/2014,258000.0,5,2.0,2260,12500,1.0,0.0,0.0,4,8,1130,1130,1960,0,98032,47.3887,-122.286,1360,18000,10,30,2014,UNK,900,-5500
1994200024,11/4/2014,511000.0,3,1.0,1430,3455,1.0,0.0,0.0,3,7,980,450,1947,0,98103,47.6873,-122.336,1450,4599,11,4,2014,UNK,-20,-1144
3362900810,8/20/2014,532170.0,3,2.0,1360,3090,2.0,0.0,0.0,3,8,1360,0,1990,0,98103,47.6838,-122.353,1500,3090,8,20,2014,UNK,-140,0
1324300398,4/9/2015,560000.0,3,1.0,1110,5000,1.5,0.0,0.0,3,7,1110,0,1947,0,98107,47.655,-122.359,1420,5000,4,9,2015,UNK,-310,0
537000445,3/31/2015,282950.0,3,1.0,1250,8200,1.0,0.0,0.0,4,7,1250,0,1954,0,98003,47.3255,-122.304,1680,8633,3,31,2015,UNK,-430,-433
7855801670,4/1/2015,2250000.0,4,3.25,5180,19850,2.0,0.0,3.0,3,12,3540,1640,2006,0,98006,47.562,-122.162,3160,9750,4,1,2015,N,2020,10100
7920100045,5/16/2014,350000.0,1,1.0,700,5100,1.0,0.0,0.0,3,7,700,0,1942,0,98115,47.678999999999995,-122.3,1010,5100,5,16,2014,UNK,-310,0
8960000030,7/28/2014,215000.0,3,1.0,1180,7669,1.0,0.0,0.0,4,7,1180,0,1967,0,98058,47.4479,-122.176,1190,7669,7,28,2014,UNK,-10,0
6388930390,11/20/2014,650000.0,5,3.5,3960,25245,2.0,0.0,0.0,3,9,2500,1460,1996,0,98056,47.525,-122.17200000000001,2640,13675,11,20,2014,UNK,1320,11570
8731900200,8/7/2014,320000.0,4,2.75,2640,7500,1.0,0.0,0.0,3,8,1620,1020,1967,0,98023,47.3135,-122.369,1980,7875,8,7,2014,UNK,660,-375
8029200135,11/13/2014,247000.0,3,2.0,1270,7198,1.5,0.0,0.0,3,7,1270,0,1916,2013,98022,47.2086,-121.99600000000001,1160,7198,11,13,2014,Y,110,0
1081200350,10/3/2014,320000.0,4,1.75,1760,11180,1.0,0.0,0.0,4,8,1760,0,1968,0,98059,47.4715,-122.118,1730,11180,10,3,2014,UNK,30,0
84000105,5/7/2014,255000.0,5,2.25,2060,8632,1.0,0.0,0.0,3,7,1030,1030,1962,0,98146,47.4877,-122.335,1010,11680,5,7,2014,UNK,1050,-3048
3756500060,3/9/2015,438000.0,3,1.75,1780,9660,1.0,0.0,0.0,3,7,1780,0,1962,0,98034,47.7171,-122.193,1200,9660,3,9,2015,UNK,580,0
7215720160,3/4/2015,900000.0,3,2.5,3400,16603,2.0,0.0,0.0,3,10,3400,0,2000,0,98075,47.6012,-122.023,3400,12601,3,4,2015,UNK,0,4002
3574800520,6/20/2014,441000.0,3,2.75,1910,7280,1.0,0.0,0.0,3,7,1160,750,1979,0,98034,47.7319,-122.22399999999999,1710,8152,6,20,2014,UNK,200,-872
2617300160,8/12/2014,420000.0,3,2.0,2020,38332,1.0,0.0,0.0,4,7,1010,1010,1975,0,98027,47.4582,-122.023,2110,36590,8,12,2014,UNK,-90,1742
2558660270,12/8/2014,370000.0,3,1.75,1580,7000,1.0,0.0,0.0,3,7,1180,400,1976,0,98034,47.7209,-122.16799999999999,1640,7500,12,8,2014,UNK,-60,-500
2009000370,2/19/2015,269950.0,2,1.75,1340,7250,1.0,0.0,0.0,5,5,700,640,1949,0,98198,47.408,-122.32700000000001,1830,9750,2,19,2015,UNK,-490,-2500
1836980160,3/24/2015,807100.0,4,2.5,2680,4499,2.0,0.0,0.0,3,9,2680,0,1999,0,98006,47.565,-122.125,2920,4500,3,24,2015,UNK,-240,-1
3261020370,6/5/2014,653000.0,3,2.5,2680,9750,1.0,0.0,0.0,4,8,1610,1070,1979,0,98034,47.7028,-122.23100000000001,2480,8750,6,5,2014,UNK,200,1000
1755700060,6/11/2014,371500.0,3,2.0,1370,8336,1.0,0.0,0.0,5,7,1370,0,1964,0,98133,47.7458,-122.331,1770,7288,6,11,2014,UNK,-400,1048
4330600435,3/16/2015,284000.0,3,1.75,1560,21000,1.0,0.0,0.0,3,7,1560,0,1954,0,98166,47.4776,-122.337,1070,7920,3,16,2015,UNK,490,13080
9542800700,1/2/2015,272000.0,3,1.75,2160,7140,1.0,0.0,0.0,4,7,1670,490,1978,0,98023,47.3026,-122.374,1930,7350,1,2,2015,UNK,230,-210
1999700045,5/2/2014,313000.0,3,1.5,1340,7912,1.5,0.0,0.0,3,7,1340,0,1955,0,98133,47.7658,-122.339,1480,7940,5,2,2014,UNK,-140,-28
1762600070,1/16/2015,917500.0,4,2.5,3880,35003,2.0,0.0,0.0,3,10,2570,1310,1984,0,98033,47.6477,-122.182,3740,35230,1,16,2015,UNK,140,-227
1687900520,9/29/2014,673000.0,4,2.25,2590,8190,2.0,0.0,0.0,4,8,2590,0,1980,0,98006,47.5619,-122.125,2260,8335,9,29,2014,UNK,330,-145
7234600798,2/10/2015,425000.0,3,2.5,1120,1100,2.0,0.0,0.0,3,8,820,300,2008,0,98122,47.6106,-122.31,1590,1795,2,10,2015,N,-470,-695
3881900445,7/9/2014,399950.0,5,2.75,1970,5400,1.0,0.0,0.0,3,7,1320,650,1986,0,98144,47.5868,-122.30799999999999,1280,2150,7,9,2014,UNK,690,3250
2254502445,5/30/2014,385000.0,3,1.0,1220,4800,1.0,0.0,0.0,3,6,1220,0,1901,0,98122,47.6101,-122.307,1200,4800,5,30,2014,UNK,20,0
5437810320,11/17/2014,269950.0,3,1.5,1950,7560,1.0,0.0,2.0,4,7,1320,630,1975,0,98022,47.1976,-121.999,1950,8941,11,17,2014,UNK,0,-1381
9158100075,1/7/2015,330000.0,2,1.0,1350,8220,1.0,0.0,0.0,3,7,1060,290,1949,0,98177,47.7224,-122.35799999999999,1540,8280,1,7,2015,UNK,-190,-60
3830630310,7/25/2014,260000.0,3,2.5,1670,5797,2.0,0.0,0.0,3,7,1670,0,1988,0,98030,47.3505,-122.179,1670,6183,7,25,2014,UNK,0,-386
8123100045,4/14/2015,470000.0,4,3.0,2380,5125,1.5,0.0,0.0,4,7,1680,700,1925,0,98126,47.5384,-122.376,1410,5375,4,14,2015,UNK,970,-250
3127200041,6/13/2014,589000.0,4,3.0,2440,9600,2.0,0.0,0.0,5,7,2440,0,1961,0,98034,47.7044,-122.2,2290,9600,6,13,2014,UNK,150,0
6661200320,7/23/2014,163500.0,2,1.5,1050,3419,2.0,0.0,0.0,3,7,1050,0,1996,0,98038,47.3848,-122.039,1050,3417,7,23,2014,UNK,0,2
11510310,9/5/2014,835000.0,4,2.75,3130,13412,2.0,0.0,0.0,3,9,2140,990,1993,0,98052,47.6993,-122.102,2260,9984,9,5,2014,UNK,870,3428
825059270,11/21/2014,1100000.0,5,3.0,4090,12850,1.0,0.0,2.0,4,10,2090,2000,1986,0,98033,47.6627,-122.18799999999999,2540,10270,11,21,2014,UNK,1550,2580
8731951370,4/15/2015,269000.0,4,1.75,1490,10000,1.0,0.0,0.0,4,8,1100,390,1969,0,98023,47.3099,-122.37899999999999,2190,8910,4,15,2015,UNK,-700,1090
1954440060,5/5/2014,560000.0,3,2.5,1900,8744,2.0,0.0,0.0,3,8,1900,0,1987,0,98074,47.62,-122.04299999999999,2030,8744,5,5,2014,UNK,-130,0
2264500350,4/18/2015,615000.0,4,1.0,1330,2400,1.5,0.0,0.0,4,6,1330,0,1901,0,98103,47.65,-122.34,1330,4400,4,18,2015,UNK,0,-2000
1115810060,12/5/2014,585188.0,3,2.25,2230,10026,1.0,0.0,0.0,3,8,1430,800,1975,0,98052,47.6647,-122.15299999999999,2230,9340,12,5,2014,UNK,0,686
9477200200,8/18/2014,305000.0,3,1.75,1650,9480,1.0,0.0,0.0,3,7,1220,430,1977,0,98034,47.726000000000006,-122.191,1540,8400,8,18,2014,UNK,110,1080
1432600560,11/5/2014,166950.0,3,1.0,1190,8820,1.0,0.0,0.0,3,6,1190,0,1959,0,98058,47.4616,-122.184,1230,7980,11,5,2014,UNK,-40,840
2287000060,9/12/2014,799000.0,3,2.5,2140,9897,1.0,0.0,0.0,4,8,2140,0,1959,0,98040,47.5505,-122.219,2680,10083,9,12,2014,UNK,-540,-186
3663500060,6/25/2014,400000.0,3,2.5,2180,7508,1.0,0.0,0.0,4,7,1420,760,1962,0,98133,47.7606,-122.336,1900,7818,6,25,2014,UNK,280,-310
3996900125,12/1/2014,230000.0,3,1.0,1060,10228,1.0,0.0,0.0,3,7,1060,0,1948,0,98155,47.7481,-122.3,1570,10228,12,1,2014,UNK,-510,0
7796450200,5/15/2014,256883.0,3,2.5,1690,5025,2.0,0.0,0.0,3,8,1690,0,2003,0,98023,47.2779,-122.34700000000001,2550,5001,5,15,2014,UNK,-860,24
7549802535,11/11/2014,423000.0,4,2.0,1970,6480,1.5,0.0,0.0,5,7,1130,840,1920,0,98108,47.5511,-122.31200000000001,1500,6480,11,11,2014,UNK,470,0
3278600320,7/23/2014,465000.0,3,2.5,2150,4084,2.0,0.0,0.0,3,8,2150,0,2007,0,98126,47.5488,-122.37200000000001,1750,2385,7,23,2014,N,400,1699
2824079053,1/13/2015,440000.0,3,2.5,1910,66211,2.0,0.0,0.0,3,7,1910,0,1997,0,98024,47.5385,-121.911,2330,67268,1,13,2015,UNK,-420,-1057
1222069094,10/14/2014,385000.0,3,1.75,1350,155073,1.0,0.0,0.0,4,7,1350,0,1969,0,98038,47.4058,-121.994,1560,50965,10,14,2014,UNK,-210,104108
3542300060,3/11/2015,210000.0,3,1.0,860,11725,1.0,0.0,0.0,4,6,860,0,1943,0,98056,47.5093,-122.184,1300,9514,3,11,2015,UNK,-440,2211
2222059065,11/12/2014,297000.0,3,2.5,1940,14952,2.0,0.0,0.0,3,8,1940,0,1994,0,98042,47.3777,-122.165,2030,10450,11,12,2014,UNK,-90,4502
7551300060,7/16/2014,470000.0,3,1.0,1010,5000,1.0,0.0,0.0,3,7,1010,0,1952,0,98107,47.675,-122.39399999999999,1680,5000,7,16,2014,UNK,-670,0
100600550,8/4/2014,226500.0,3,1.5,1300,7370,1.0,0.0,0.0,4,7,900,400,1976,0,98023,47.3025,-122.37,1430,7500,8,4,2014,UNK,-130,-130
3211100860,3/3/2015,274250.0,3,1.0,910,8450,1.0,0.0,0.0,4,6,910,0,1962,0,98059,47.4787,-122.15799999999999,1400,8040,3,3,2015,UNK,-490,410
3456000310,8/4/2014,840000.0,4,1.75,2480,11010,1.0,0.0,0.0,4,9,1630,850,1966,0,98040,47.5378,-122.219,2770,10744,8,4,2014,UNK,-290,266
9526600140,9/19/2014,677900.0,3,2.5,2440,4587,2.0,0.0,0.0,3,8,2440,0,2010,0,98052,47.7073,-122.11399999999999,2750,4587,9,19,2014,N,-310,0
7465900060,2/5/2015,425000.0,3,1.0,1010,5864,1.0,0.0,0.0,3,7,1010,0,1915,0,98116,47.5733,-122.381,1290,5000,2,5,2015,UNK,-280,864
1222000055,11/23/2014,180250.0,2,0.75,900,9600,1.0,0.0,0.0,3,6,900,0,1941,0,98166,47.4604,-122.339,1250,14280,11,23,2014,UNK,-350,-4680
6300000550,7/17/2014,464000.0,6,3.0,2300,3404,2.0,0.0,0.0,3,7,1600,700,1920,1994,98133,47.7067,-122.34299999999999,1560,1312,7,17,2014,Y,740,2092
2310030510,4/22/2015,320000.0,4,2.25,1550,7579,2.0,0.0,0.0,3,8,1550,0,1993,0,98038,47.354,-122.04700000000001,1630,6397,4,22,2015,UNK,-80,1182
1025049114,7/17/2014,625504.0,3,2.25,1270,1566,2.0,0.0,0.0,3,8,1060,210,2014,0,98105,47.6647,-122.28399999999999,1160,1327,7,17,2014,N,110,239
8677300550,5/15/2014,592500.0,4,2.5,2240,12032,1.0,0.0,0.0,3,9,2240,0,1983,0,98074,47.6143,-122.01700000000001,2520,12368,5,15,2014,UNK,-280,-336
4014400292,1/14/2015,465000.0,3,2.5,2714,17936,2.0,0.0,0.0,3,9,2714,0,2005,0,98001,47.3185,-122.275,2590,18386,1,14,2015,N,124,-450
1102000196,5/27/2014,477000.0,4,2.75,1720,6270,2.0,0.0,0.0,3,8,1720,0,1978,0,98118,47.5458,-122.26799999999999,2130,8700,5,27,2014,UNK,-410,-2430
257000138,1/15/2015,280000.0,2,1.0,850,16400,1.0,0.0,0.0,3,6,850,0,1923,0,98168,47.4889,-122.29899999999999,1100,14459,1,15,2015,UNK,-250,1941
46100204,2/21/2015,1510000.0,5,3.0,3300,33474,1.0,0.0,3.0,3,9,1870,1430,1957,1991,98040,47.5673,-122.21,3836,20953,2,21,2015,Y,-536,12521
1909600046,7/3/2014,445838.0,3,2.5,2250,5692,2.0,0.0,0.0,3,8,2250,0,2000,0,98146,47.5133,-122.37899999999999,1320,5390,7,3,2014,UNK,930,302
1250202145,8/28/2014,1070000.0,2,2.25,3900,14864,1.0,0.0,3.0,3,8,1950,1950,1947,0,98144,47.5884,-122.291,2580,5184,8,28,2014,UNK,1320,9680
7611200125,10/23/2014,467000.0,2,1.5,1320,10800,1.0,0.0,0.0,4,8,1320,0,1947,0,98177,47.7145,-122.367,2120,12040,10,23,2014,UNK,-800,-1240
5611500140,8/22/2014,686000.0,4,2.5,2760,6440,2.0,0.0,0.0,3,10,2760,0,1999,0,98075,47.5836,-122.02600000000001,3070,8127,8,22,2014,UNK,-310,-1687
7138000260,6/5/2014,279950.0,3,2.0,1750,9750,1.0,0.0,0.0,3,7,1350,400,1961,0,98198,47.398,-122.29899999999999,1900,10125,6,5,2014,UNK,-150,-375
626059335,9/4/2014,527000.0,4,2.25,2330,19436,2.0,0.0,0.0,3,8,2330,0,1987,0,98011,47.7663,-122.215,1910,10055,9,4,2014,UNK,420,9381
1922059282,9/18/2014,325000.0,3,2.25,2220,16020,1.0,0.0,0.0,4,8,1780,440,1966,0,98030,47.3758,-122.21700000000001,2080,9583,9,18,2014,UNK,140,6437
705700390,9/3/2014,328000.0,3,2.25,2020,8379,2.0,0.0,0.0,3,7,2020,0,1994,0,98038,47.3828,-122.023,2020,8031,9,3,2014,UNK,0,348
7454001200,6/4/2014,390000.0,3,2.25,1250,7500,1.0,0.0,0.0,5,7,1250,0,1942,0,98146,47.5123,-122.37299999999999,1280,7392,6,4,2014,UNK,-30,108
8682281200,3/9/2015,479950.0,2,2.0,1510,6516,1.0,0.0,0.0,3,8,1510,0,2005,0,98053,47.7076,-122.01299999999999,1640,6009,3,9,2015,N,-130,507
7972000200,5/29/2014,264950.0,4,2.25,1720,9753,1.0,0.0,0.0,4,7,1120,600,1978,0,98023,47.2922,-122.37100000000001,1510,9753,5,29,2014,UNK,210,0
722059070,1/15/2015,235000.0,3,1.0,1430,15246,1.0,0.0,0.0,4,7,980,450,1961,0,98031,47.4075,-122.214,1960,13068,1,15,2015,UNK,-530,2178
7202340400,3/3/2015,516500.0,3,2.5,1480,4729,2.0,0.0,0.0,3,7,1480,0,2004,0,98053,47.6794,-122.03399999999999,2250,4729,3,3,2015,N,-770,0
8096000060,4/13/2015,655000.0,2,1.75,1450,15798,2.0,1.0,4.0,3,7,1230,220,1915,1978,98166,47.4497,-122.375,2030,13193,4,13,2015,Y,-580,2605
2424000060,6/16/2014,500000.0,4,2.75,2280,15347,1.0,0.0,0.0,5,7,2280,0,1960,0,98059,47.5218,-122.164,2280,15347,6,16,2014,UNK,0,0
9264902050,11/21/2014,315000.0,6,2.75,2940,7350,1.0,0.0,0.0,3,8,1780,1160,1978,0,98023,47.3103,-122.339,2120,8236,11,21,2014,UNK,820,-886
943100260,11/20/2014,213000.0,2,1.0,1000,10200,1.0,0.0,0.0,3,6,1000,0,1961,0,98024,47.5687,-121.899,1150,13702,11,20,2014,UNK,-150,-3502
3677400445,9/2/2014,475000.0,3,1.5,2480,5280,1.5,0.0,0.0,5,7,1620,860,1947,0,98108,47.5575,-122.303,2090,4800,9,2,2014,UNK,390,480
1762600320,6/10/2014,1030000.0,5,4.0,3760,28040,2.0,0.0,0.0,3,10,3760,0,1983,0,98033,47.6489,-122.18299999999999,3430,35096,6,10,2014,UNK,330,-7056
4058000060,4/9/2015,416000.0,3,2.0,2220,94300,1.0,0.0,0.0,5,7,1640,580,1976,0,98010,47.3459,-121.95,2070,80100,4,9,2015,UNK,150,14200
7228500560,3/20/2015,410000.0,4,1.0,1970,4740,1.5,0.0,0.0,3,7,1670,300,1904,2005,98122,47.6136,-122.303,1510,4740,3,20,2015,Y,460,0
326069104,7/1/2014,800000.0,3,3.5,3830,221284,2.0,0.0,0.0,3,10,3530,300,1993,0,98077,47.7641,-122.023,2920,148539,7,1,2014,UNK,910,72745
5152100060,5/29/2014,472000.0,6,2.5,4410,14034,1.0,0.0,2.0,4,9,2350,2060,1965,0,98003,47.3376,-122.324,2600,13988,5,29,2014,UNK,1810,46
3584000310,12/8/2014,225000.0,3,1.75,1430,8505,1.0,0.0,0.0,4,7,1430,0,1968,0,98003,47.3173,-122.319,1190,8640,12,8,2014,UNK,240,-135
8150100045,10/1/2014,210000.0,2,1.0,830,6000,1.0,0.0,0.0,3,6,830,0,1940,0,98126,47.5308,-122.376,830,4960,10,1,2014,UNK,0,1040
1868901275,1/27/2015,455000.0,2,1.0,1430,5000,1.5,0.0,0.0,2,7,1430,0,1925,0,98115,47.6727,-122.29899999999999,1450,3750,1,27,2015,UNK,-20,1250
6131600075,4/27/2015,225000.0,3,1.0,1300,8316,1.0,0.0,0.0,4,6,1300,0,1954,0,98002,47.3221,-122.21600000000001,1260,8316,4,27,2015,UNK,40,0
9468200125,8/26/2014,480000.0,2,1.0,1030,3060,1.0,0.0,2.0,4,7,790,240,1918,0,98103,47.6779,-122.353,1390,3060,8,26,2014,UNK,-360,0
8029510030,2/12/2015,363000.0,3,2.5,2740,11872,2.0,0.0,0.0,3,9,2740,0,1990,0,98023,47.3076,-122.395,2570,10377,2,12,2015,UNK,170,1495
2025069065,9/29/2014,2400000.0,4,2.5,3650,8354,1.0,1.0,4.0,3,9,1830,1820,2000,0,98074,47.6338,-122.072,3120,18841,9,29,2014,UNK,530,-10487
7899800890,2/26/2015,181000.0,2,1.5,720,5120,1.0,0.0,0.0,3,6,720,0,1954,0,98106,47.5218,-122.35700000000001,1150,2566,2,26,2015,UNK,-430,2554
3021059276,3/14/2015,250000.0,4,2.0,2010,7312,1.0,0.0,0.0,4,7,2010,0,1976,0,98002,47.2785,-122.213,2010,7650,3,14,2015,UNK,0,-338
3797001895,4/22/2015,481000.0,3,1.75,1560,3000,1.0,0.0,0.0,4,6,770,790,1918,0,98103,47.6846,-122.345,1390,3000,4,22,2015,UNK,170,0
3832710960,9/23/2014,260000.0,3,2.0,1810,7209,1.0,0.0,0.0,4,7,1240,570,1978,0,98032,47.3656,-122.27799999999999,1750,7209,9,23,2014,UNK,60,0
1310430400,5/13/2014,455000.0,4,2.5,3360,7685,2.0,0.0,0.0,3,9,3360,0,2001,0,98058,47.4369,-122.111,3060,6567,5,13,2014,UNK,300,1118
1422300030,4/1/2015,415000.0,3,2.25,1510,36224,2.0,0.0,0.0,3,8,1510,0,1991,0,98045,47.4616,-121.711,1730,36224,4,1,2015,UNK,-220,0
1105000588,4/21/2015,349500.0,3,1.0,1400,3538,1.0,0.0,0.0,3,7,800,600,1953,0,98118,47.5405,-122.27,1620,6331,4,21,2015,UNK,-220,-2793
3830630060,9/29/2014,245000.0,3,2.5,1730,7442,2.0,0.0,0.0,3,7,1730,0,1987,0,98030,47.3507,-122.178,1630,6458,9,29,2014,UNK,100,984
5101404898,5/19/2014,592500.0,2,2.0,1420,9191,1.5,0.0,2.0,5,7,1420,0,1928,0,98115,47.6979,-122.32,1420,6816,5,19,2014,UNK,0,2375
7972601890,10/20/2014,385000.0,4,1.75,2360,7620,1.0,0.0,0.0,4,7,1180,1180,1955,0,98106,47.5278,-122.345,1910,7620,10,20,2014,UNK,450,0
5127001620,2/11/2015,315000.0,3,1.75,1580,11455,1.0,0.0,0.0,4,7,1200,380,1974,0,98059,47.4756,-122.147,1550,10650,2,11,2015,UNK,30,805
9407100800,11/24/2014,255000.0,3,1.0,1230,10170,1.0,0.0,0.0,3,7,1230,0,1979,0,98045,47.4437,-121.772,1380,10098,11,24,2014,UNK,-150,72
1873100060,8/29/2014,693000.0,4,2.5,2460,4425,2.0,0.0,0.0,3,8,2460,0,2006,0,98052,47.7048,-122.109,2990,5659,8,29,2014,N,-530,-1234
8722101360,12/2/2014,780000.0,3,1.0,1660,4400,1.5,0.0,0.0,3,8,1460,200,1911,0,98112,47.6362,-122.302,1660,4400,12,2,2014,UNK,0,0
8644000060,10/24/2014,237000.0,3,1.75,1270,8470,1.0,0.0,0.0,4,7,1270,0,1960,0,98198,47.4207,-122.29,1600,8470,10,24,2014,UNK,-330,0
3325069129,12/16/2014,525000.0,3,2.25,2100,40510,2.0,0.0,0.0,3,10,1320,780,1979,0,98074,47.6154,-122.04700000000001,2380,33450,12,16,2014,UNK,-280,7060
1400300055,4/28/2015,425000.0,2,1.0,770,5040,1.0,0.0,0.0,3,5,770,0,1930,0,98144,47.5964,-122.29899999999999,1330,2580,4,28,2015,UNK,-560,2460
2123039032,10/27/2014,369900.0,1,0.75,760,10079,1.0,1.0,4.0,5,5,760,0,1936,0,98070,47.4683,-122.43799999999999,1230,14267,10,27,2014,UNK,-470,-4188
8078560140,5/19/2014,290000.0,4,2.5,1700,7280,2.0,0.0,0.0,4,7,1700,0,1988,0,98031,47.4045,-122.171,1950,7475,5,19,2014,UNK,-250,-195
3438500192,9/29/2014,285000.0,3,1.0,1120,10701,1.0,0.0,0.0,3,7,1120,0,1954,0,98106,47.5544,-122.35799999999999,1130,6350,9,29,2014,UNK,-10,4351
7974200510,8/14/2014,415000.0,2,1.0,1070,4500,1.0,0.0,0.0,3,7,1070,0,1937,0,98115,47.6802,-122.29,1320,4465,8,14,2014,UNK,-250,35
2557000400,4/9/2015,272500.0,3,2.5,2070,9900,1.0,0.0,0.0,3,8,1420,650,1979,0,98023,47.2988,-122.37100000000001,2070,8250,4,9,2015,UNK,0,1650
7960900060,5/4/2015,2900000.0,4,3.25,5050,20100,1.5,0.0,2.0,3,11,4750,300,1982,0,98004,47.6312,-122.223,3890,20060,5,4,2015,UNK,1160,40
4054500390,10/7/2014,1370000.0,4,4.75,5310,57346,2.0,0.0,0.0,4,11,5310,0,1989,0,98077,47.7285,-122.042,4180,47443,10,7,2014,UNK,1130,9903
6378500125,5/1/2015,436000.0,2,1.0,1040,7538,1.0,0.0,0.0,4,7,1040,0,1939,0,98133,47.7107,-122.352,1440,7530,5,1,2015,UNK,-400,8
1745100140,10/17/2014,210000.0,3,1.0,1700,11390,1.0,0.0,0.0,4,7,1700,0,1967,0,98003,47.3271,-122.323,1350,8164,10,17,2014,UNK,350,3226
2976800796,9/25/2014,236000.0,3,1.0,1300,5898,1.0,0.0,0.0,3,7,1300,0,1961,0,98178,47.5053,-122.255,1320,7619,9,25,2014,UNK,-20,-1721
4235400186,11/24/2014,331000.0,3,1.75,1080,1306,1.0,0.0,0.0,3,7,580,500,1954,2003,98199,47.6601,-122.4,1440,2225,11,24,2014,Y,-360,-919
4215100060,3/20/2015,365000.0,3,2.5,2653,4510,2.0,0.0,0.0,3,8,2653,0,2006,0,98031,47.4145,-122.166,2653,4927,3,20,2015,N,0,-417
9189700045,1/27/2015,450000.0,3,2.0,2290,16258,1.0,0.0,0.0,5,8,2290,0,1960,0,98058,47.4672,-122.165,1660,10530,1,27,2015,UNK,630,5728
1126049053,11/13/2014,770000.0,4,2.75,3820,26300,2.0,0.0,0.0,3,9,2850,970,2014,0,98028,47.7618,-122.26100000000001,1860,12136,11,13,2014,N,1960,14164
2022069200,5/5/2015,455000.0,4,2.5,2210,49375,1.0,0.0,0.0,3,8,2210,0,1997,0,98038,47.3828,-122.071,2670,49385,5,5,2015,UNK,-460,-10
9412900055,5/5/2015,405000.0,3,1.75,2390,6000,1.0,0.0,0.0,3,6,1240,1150,1908,0,98118,47.5362,-122.26799999999999,2020,6000,5,5,2015,UNK,370,0
1722059235,7/3/2014,304900.0,4,1.75,2600,11325,1.0,0.0,0.0,4,7,1610,990,1969,0,98031,47.3954,-122.206,1720,11088,7,3,2014,UNK,880,237
6874200960,2/27/2015,170000.0,2,1.0,860,5265,1.0,0.0,0.0,3,6,860,0,1931,0,98178,47.5048,-122.272,1650,8775,2,27,2015,UNK,-790,-3510
7424700045,5/13/2015,2050000.0,5,3.0,3830,8480,2.0,0.0,1.0,5,9,2630,1200,1905,1994,98122,47.6166,-122.287,3050,7556,5,13,2015,Y,780,924
7202360350,6/30/2014,780000.0,4,2.5,3500,7048,2.0,0.0,0.0,3,9,3500,0,2005,0,98053,47.6811,-122.025,3920,7864,6,30,2014,N,-420,-816
5634500392,4/10/2015,330000.0,3,3.0,2420,13959,1.0,0.0,0.0,4,8,1740,680,1988,0,98028,47.7486,-122.23,2570,13300,4,10,2015,UNK,-150,659
1509500060,9/5/2014,370000.0,4,2.5,2720,8666,2.0,0.0,0.0,3,9,2720,0,1992,0,98030,47.3846,-122.169,2410,8100,9,5,2014,UNK,310,566
7214810350,10/17/2014,467000.0,5,2.25,2500,13500,1.0,0.0,0.0,3,7,1850,650,1979,0,98072,47.7564,-122.14399999999999,2300,9750,10,17,2014,UNK,200,3750
6647200060,2/9/2015,405000.0,3,1.75,1670,6720,1.0,0.0,0.0,3,7,1140,530,1980,0,98034,47.7198,-122.193,1670,7320,2,9,2015,UNK,0,-600
9552700140,7/2/2014,675000.0,5,2.25,2900,10300,1.0,0.0,0.0,3,8,1450,1450,1985,0,98006,47.5461,-122.15100000000001,2310,10300,7,2,2014,UNK,590,0
2200500350,8/12/2014,500000.0,2,1.0,1640,14100,1.0,0.0,0.0,4,7,1140,500,1954,0,98006,47.5712,-122.14299999999999,1520,13527,8,12,2014,UNK,120,573
6113400046,7/23/2014,389999.0,4,2.5,1890,15770,2.0,0.0,0.0,4,7,1890,0,1968,0,98166,47.4281,-122.34299999999999,2410,15256,7,23,2014,UNK,-520,514
6619910140,2/24/2015,630000.0,4,1.75,2950,9025,1.0,0.0,2.0,4,8,1780,1170,1975,0,98034,47.7128,-122.223,2120,9600,2,24,2015,UNK,830,-575
1115450240,10/22/2014,360000.0,4,2.5,2160,9528,2.0,0.0,0.0,3,9,2160,0,1992,0,98001,47.3341,-122.255,2280,9937,10,22,2014,UNK,-120,-409
6073240060,10/2/2014,580000.0,4,3.0,3280,11060,2.0,0.0,0.0,3,8,2270,1010,1986,0,98056,47.5399,-122.181,2320,11004,10,2,2014,UNK,960,56
9297300045,7/9/2014,550000.0,3,2.0,1970,4166,2.0,0.0,3.0,5,8,1270,700,1929,0,98126,47.5717,-122.375,2390,4166,7,9,2014,UNK,-420,0
9510920070,7/10/2014,879000.0,4,2.5,3360,22111,2.0,0.0,0.0,3,10,3360,0,1994,0,98075,47.5951,-122.01700000000001,3150,11374,7,10,2014,UNK,210,10737
5468730030,8/22/2014,265000.0,3,2.0,1320,8959,1.0,0.0,0.0,3,7,1320,0,1993,0,98042,47.3536,-122.14399999999999,1740,7316,8,22,2014,UNK,-420,1643
8079030390,3/4/2015,446500.0,3,2.5,2650,7286,2.0,0.0,0.0,3,8,2650,0,1990,0,98059,47.5084,-122.154,2400,7220,3,4,2015,UNK,250,66
600000152,6/2/2014,404000.0,3,1.5,2030,8880,1.0,0.0,0.0,3,7,1330,700,1963,0,98108,47.5586,-122.311,2140,5592,6,2,2014,UNK,-110,3288
1840000030,5/29/2014,267500.0,3,1.75,1590,11914,1.0,0.0,2.0,3,7,1090,500,1957,0,98188,47.4427,-122.274,1630,9052,5,29,2014,UNK,-40,2862
3225069065,6/24/2014,3080000.0,4,5.0,4550,18641,1.0,1.0,4.0,3,10,2600,1950,2002,0,98074,47.6053,-122.07700000000001,4550,19508,6,24,2014,UNK,0,-867
3260800030,8/11/2014,335000.0,3,2.5,2440,7632,2.0,0.0,0.0,3,8,2440,0,1998,0,98003,47.3494,-122.301,2510,7903,8,11,2014,UNK,-70,-271
2747100024,6/19/2014,576000.0,3,2.5,1940,9000,1.0,0.0,0.0,4,7,970,970,1948,0,98117,47.6933,-122.39299999999999,2190,7310,6,19,2014,UNK,-250,1690
5104530560,4/1/2015,208633.0,3,2.5,2040,3810,2.0,0.0,0.0,3,8,2040,0,2006,0,98038,47.3537,-122.0,2370,4590,4,1,2015,N,-330,-780
4330600350,1/15/2015,315000.0,3,2.25,2200,8750,1.0,0.0,0.0,4,7,1120,1080,1964,0,98166,47.476000000000006,-122.337,1460,10139,1,15,2015,UNK,740,-1389
5016001535,2/17/2015,725000.0,3,1.75,1920,3300,1.0,0.0,0.0,4,8,960,960,1913,0,98112,47.6239,-122.29799999999999,1740,4000,2,17,2015,UNK,180,-700
7280300196,4/3/2015,550000.0,4,2.75,1800,7750,1.0,0.0,0.0,4,8,1400,400,1965,0,98177,47.7776,-122.384,1800,8275,4,3,2015,UNK,0,-525
8651520400,6/12/2014,610750.0,4,2.25,2180,7297,2.0,0.0,0.0,3,8,2180,0,1984,0,98074,47.6459,-122.05799999999999,2250,9781,6,12,2014,UNK,-70,-2484
7171200445,2/28/2015,550700.0,2,1.0,1010,5000,1.5,0.0,0.0,4,6,1010,0,1908,0,98105,47.6692,-122.29700000000001,1460,5000,2,28,2015,UNK,-450,0
3204800200,1/8/2015,665000.0,4,2.75,3320,10574,2.0,0.0,0.0,5,8,2220,0,1960,0,98056,47.5376,-122.18,2720,8330,1,8,2015,UNK,600,2244
3416600800,2/9/2015,834000.0,4,2.5,2370,4000,1.5,0.0,2.0,5,8,1980,390,1928,0,98144,47.601000000000006,-122.294,2440,5750,2,9,2015,UNK,-70,-1750
7994700030,10/23/2014,201000.0,5,1.75,1660,78408,1.5,0.0,0.0,3,6,1660,0,1915,0,98065,47.528999999999996,-121.837,1660,78408,10,23,2014,UNK,0,0
1860600135,5/2/2014,2380000.0,5,2.5,3650,9050,2.0,0.0,4.0,5,10,3370,280,1921,0,98119,47.6345,-122.367,2880,5400,5,2,2014,UNK,770,3650
4139480200,6/18/2014,1380000.0,4,3.25,4290,12103,1.0,0.0,3.0,3,11,2690,1600,1997,0,98006,47.5503,-122.102,3860,11244,6,18,2014,UNK,430,859
4139480200,12/9/2014,1400000.0,4,3.25,4290,12103,1.0,0.0,3.0,3,11,2690,1600,1997,0,98006,47.5503,-122.102,3860,11244,12,9,2014,UNK,430,859
1328320800,11/5/2014,305000.0,4,2.25,1950,7700,1.0,0.0,0.0,3,8,1350,600,1979,0,98058,47.4441,-122.125,2150,7350,11,5,2014,UNK,-200,350
7771300125,4/8/2015,487000.0,3,2.0,2590,14052,1.0,0.0,0.0,5,8,1720,870,1948,0,98133,47.7357,-122.333,1570,8162,4,8,2015,UNK,1020,5890
3422059208,5/11/2015,390000.0,3,2.5,1930,64904,1.0,0.0,0.0,4,8,1930,0,1988,0,98042,47.346000000000004,-122.15700000000001,2350,57500,5,11,2015,UNK,-420,7404
9521101455,7/23/2014,548000.0,2,1.0,1470,3864,1.0,0.0,0.0,4,7,1170,300,1916,0,98103,47.6638,-122.345,1570,3864,7,23,2014,UNK,-100,0
4337000335,11/22/2014,268750.0,4,1.0,800,8775,1.0,0.0,0.0,3,6,800,0,1943,0,98166,47.48,-122.336,1310,8775,11,22,2014,UNK,-510,0
325059286,5/13/2014,819900.0,5,2.75,3150,7119,2.0,0.0,0.0,3,9,3150,0,2013,0,98052,47.6759,-122.15100000000001,1560,8384,5,13,2014,N,1590,-1265
2597650240,10/23/2014,520000.0,3,2.25,2030,16200,2.0,0.0,0.0,3,8,2030,0,1984,0,98027,47.5162,-122.057,2660,17958,10,23,2014,UNK,-630,-1758
3353400435,7/21/2014,230000.0,3,2.0,1450,11204,1.0,0.0,0.0,3,7,1450,0,2003,0,98001,47.2639,-122.25200000000001,1520,9518,7,21,2014,UNK,-70,1686
7972000240,2/2/2015,240000.0,3,1.75,1510,10248,1.0,0.0,0.0,3,7,1510,0,1969,0,98023,47.2929,-122.37100000000001,1510,9753,2,2,2015,UNK,0,495
7520000520,9/5/2014,232000.0,2,1.0,1240,12092,1.0,0.0,0.0,3,6,960,280,1922,1984,98146,47.4957,-122.352,1820,7460,9,5,2014,Y,-580,4632
7520000520,3/11/2015,240500.0,2,1.0,1240,12092,1.0,0.0,0.0,3,6,960,280,1922,1984,98146,47.4957,-122.352,1820,7460,3,11,2015,Y,-580,4632
3530210260,10/27/2014,274975.0,3,2.5,3030,45004,2.0,0.0,0.0,3,9,3030,0,1987,0,98077,47.7721,-122.09299999999999,3080,35781,10,27,2014,UNK,-50,9223
1959700550,9/5/2014,740000.0,4,2.0,2050,4400,1.5,0.0,0.0,4,9,2050,0,1922,0,98102,47.644,-122.319,2320,5500,9,5,2014,UNK,-270,-1100
1665400045,4/28/2015,186375.0,3,1.0,1000,7636,1.0,0.0,0.0,2,7,1000,0,1952,0,98166,47.472,-122.344,1150,7600,4,28,2015,UNK,-150,36
9542850320,7/25/2014,790000.0,3,2.25,2370,10289,1.0,0.0,0.0,4,9,1590,780,1977,0,98005,47.592,-122.166,2500,10004,7,25,2014,UNK,-130,285
3179100060,9/16/2014,880000.0,4,3.5,2800,6750,2.0,0.0,0.0,3,9,1890,910,1951,2002,98105,47.669,-122.275,2370,6120,9,16,2014,Y,430,630
2946001550,4/16/2015,279000.0,6,1.75,2240,11180,2.0,0.0,0.0,4,7,2240,0,1955,0,98198,47.42,-122.323,1590,7955,4,16,2015,UNK,650,3225
8078490390,7/29/2014,295000.0,3,2.0,1810,10530,1.0,0.0,2.0,3,8,1810,0,1991,0,98022,47.1913,-122.012,1910,10450,7,29,2014,UNK,-100,80
9550201550,4/8/2015,640000.0,2,1.0,1070,5000,1.0,0.0,0.0,3,7,1070,0,1924,0,98103,47.6666,-122.331,1710,5000,4,8,2015,UNK,-640,0
191100045,7/3/2014,940000.0,4,2.0,2490,9525,2.0,0.0,0.0,5,9,2490,0,1968,0,98040,47.5639,-122.21700000000001,2770,9525,7,3,2014,UNK,-280,0
5009600070,10/7/2014,260000.0,4,2.5,1960,5238,2.0,0.0,0.0,3,7,1960,0,2003,0,98038,47.3483,-122.052,1800,5894,10,7,2014,UNK,160,-656
200350070,6/2/2014,559900.0,3,2.75,2930,5569,1.0,0.0,0.0,3,9,1860,1070,2004,0,98072,47.7648,-122.164,2580,11045,6,2,2014,N,350,-5476
2877103726,7/22/2014,791500.0,4,2.0,1510,3500,1.5,0.0,0.0,5,7,1510,0,1911,0,98103,47.6794,-122.35700000000001,1820,3750,7,22,2014,UNK,-310,-250
405100295,8/26/2014,265000.0,3,1.75,1420,8250,1.0,0.0,0.0,3,7,1420,0,1954,0,98133,47.7535,-122.354,1740,8000,8,26,2014,UNK,-320,250
4268200055,5/1/2015,245000.0,3,1.75,1740,11547,1.0,0.0,0.0,3,7,1740,0,1954,0,98178,47.4945,-122.22,880,78408,5,1,2015,UNK,860,-66861
3126069068,4/24/2015,485000.0,4,1.75,2560,43995,2.0,0.0,0.0,4,7,2560,0,1962,0,98052,47.6945,-122.09299999999999,2560,14764,4,24,2015,UNK,0,29231
1115300070,11/6/2014,684000.0,4,3.5,3040,8414,2.0,0.0,0.0,3,9,2420,620,2010,0,98059,47.5222,-122.15700000000001,3470,8066,11,6,2014,N,-430,348
6414100671,9/9/2014,425000.0,3,1.75,2500,6840,1.0,0.0,0.0,3,8,1300,1200,1957,0,98125,47.7222,-122.32,1580,8691,9,9,2014,UNK,920,-1851
7004200060,10/17/2014,309600.0,4,1.75,1275,20000,1.0,0.0,0.0,4,6,1275,0,1991,0,98070,47.3796,-122.49,1660,20000,10,17,2014,UNK,-385,0
7852110140,7/18/2014,552250.0,4,2.5,2580,5823,2.0,0.0,0.0,3,8,2580,0,2002,0,98065,47.5374,-121.875,2380,5823,7,18,2014,UNK,200,0
3969300030,7/23/2014,165000.0,4,1.0,1000,7134,1.0,0.0,0.0,3,6,1000,0,1943,0,98178,47.4897,-122.24,1020,7138,7,23,2014,UNK,-20,-4
3969300030,12/29/2014,239900.0,4,1.0,1000,7134,1.0,0.0,0.0,3,6,1000,0,1943,0,98178,47.4897,-122.24,1020,7138,12,29,2014,UNK,-20,-4
4048400070,12/5/2014,320000.0,2,1.0,1070,32633,1.0,0.0,0.0,4,6,1070,0,1930,0,98059,47.4716,-122.07799999999999,1360,32156,12,5,2014,UNK,-290,477
808000070,10/21/2014,206600.0,3,2.0,1390,13464,1.0,0.0,0.0,4,7,1390,0,1987,0,98030,47.3581,-122.17299999999999,1720,12080,10,21,2014,UNK,-330,1384
7374200030,4/16/2015,387000.0,4,1.75,2500,7690,1.0,0.0,0.0,3,7,1250,1250,1973,0,98155,47.7713,-122.307,2040,8646,4,16,2015,UNK,460,-956
7325600160,6/4/2014,299000.0,1,0.75,560,12120,1.0,0.0,0.0,3,4,560,0,1967,0,98014,47.675,-121.854,1300,19207,6,4,2014,UNK,-740,-7087
2757000030,9/22/2014,855000.0,4,2.75,2270,10460,2.0,0.0,0.0,3,9,2270,0,1965,0,98040,47.5603,-122.22200000000001,2610,10180,9,22,2014,UNK,-340,280
616000140,1/26/2015,315000.0,3,1.0,1900,14400,1.0,0.0,0.0,4,7,1300,600,1954,0,98166,47.4147,-122.337,1940,14400,1,26,2015,UNK,-40,0
3363900111,12/3/2014,437500.0,2,1.0,990,3120,1.0,0.0,2.0,5,7,790,200,1907,0,98103,47.68,-122.353,1930,3120,12,3,2014,UNK,-940,0
9262800171,3/24/2015,252000.0,4,1.5,1550,19800,1.0,0.0,0.0,4,7,1050,500,1969,0,98001,47.3117,-122.27,1640,22654,3,24,2015,UNK,-90,-2854
6607000126,6/4/2014,375000.0,4,1.75,2200,7475,1.0,0.0,0.0,5,7,1100,1100,1955,0,98118,47.543,-122.28,1600,5766,6,4,2014,UNK,600,1709
5416510830,8/6/2014,300000.0,4,2.5,1910,4862,2.0,0.0,0.0,3,7,1910,0,2005,0,98038,47.3607,-122.03399999999999,2010,5091,8,6,2014,N,-100,-229
2201500030,10/6/2014,420000.0,4,1.0,1750,9600,1.5,0.0,0.0,4,7,1750,0,1954,0,98006,47.5759,-122.137,1750,10530,10,6,2014,UNK,0,-930
325059171,5/5/2014,900000.0,3,1.0,1330,77972,1.0,0.0,0.0,3,7,1330,0,1928,1954,98033,47.6891,-122.15899999999999,1340,17689,5,5,2014,Y,-10,60283
952003285,8/5/2014,679900.0,3,2.5,2440,5750,2.0,0.0,2.0,3,9,1980,460,2000,0,98116,47.565,-122.381,1520,5750,8,5,2014,UNK,920,0
3211290370,6/5/2014,463000.0,3,2.5,1640,29970,2.0,0.0,0.0,3,7,1640,0,1992,0,98053,47.6359,-121.97399999999999,1580,28399,6,5,2014,UNK,60,1571
1072010350,8/28/2014,380000.0,5,2.5,2760,11340,2.0,0.0,0.0,4,9,2760,0,1978,0,98059,47.4769,-122.141,2470,11340,8,28,2014,UNK,290,0
8856950070,12/10/2014,329500.0,4,2.5,1820,7912,2.0,0.0,0.0,3,7,1820,0,1994,0,98038,47.3845,-122.029,1820,8168,12,10,2014,UNK,0,-256
925059078,8/19/2014,604950.0,3,2.5,2110,5608,1.0,0.0,0.0,3,8,1340,770,2013,0,98033,47.6743,-122.184,2040,9363,8,19,2014,N,70,-3755
7855801090,9/17/2014,795000.0,5,2.5,3040,9570,1.0,0.0,2.0,4,8,1640,1400,1966,0,98006,47.5651,-122.164,2920,8800,9,17,2014,UNK,120,770
723099065,1/30/2015,465000.0,3,2.0,1840,40438,2.0,0.0,0.0,3,7,1840,0,1994,0,98045,47.4853,-121.709,1380,44049,1,30,2015,UNK,460,-3611
6116500075,3/26/2015,673000.0,4,2.5,2990,10400,2.0,0.0,0.0,3,9,2990,0,2002,0,98166,47.4508,-122.359,2140,17449,3,26,2015,UNK,850,-7049
1118500030,10/1/2014,810000.0,4,2.5,3520,15420,2.0,0.0,0.0,3,10,3520,0,1991,0,98074,47.6375,-122.016,3400,21455,10,1,2014,UNK,120,-6035
424069250,4/23/2015,785000.0,4,2.75,2440,69415,1.0,0.0,0.0,4,8,1910,530,1989,0,98075,47.5944,-122.042,2770,24361,4,23,2015,UNK,-330,45054
3291800710,11/20/2014,338000.0,4,3.0,2090,7500,1.0,0.0,0.0,3,7,1370,720,1986,0,98056,47.4888,-122.182,1810,7650,11,20,2014,UNK,280,-150
6838700060,12/4/2014,280000.0,3,2.25,1430,7222,2.0,0.0,0.0,3,7,1430,0,1993,0,98056,47.5112,-122.19,1430,7220,12,4,2014,UNK,0,2
2231500030,10/1/2014,315000.0,4,2.25,2180,10754,1.0,0.0,0.0,5,7,1100,1080,1954,0,98133,47.7711,-122.34100000000001,1810,6929,10,1,2014,UNK,370,3825
2231500030,3/24/2015,530000.0,4,2.25,2180,10754,1.0,0.0,0.0,5,7,1100,1080,1954,0,98133,47.7711,-122.34100000000001,1810,6929,3,24,2015,UNK,370,3825
7683900200,12/23/2014,380000.0,5,3.0,3450,9914,2.0,0.0,0.0,3,9,3450,0,2004,0,98023,47.2813,-122.345,2860,9721,12,23,2014,N,590,193
8155830060,8/11/2014,297000.0,3,2.25,1450,7562,2.0,0.0,0.0,3,7,1450,0,1994,0,98056,47.5038,-122.189,1650,7625,8,11,2014,UNK,-200,-63
98020310,5/20/2014,730000.0,4,2.5,3230,7331,2.0,0.0,0.0,3,10,3230,0,2004,0,98075,47.5823,-121.97,3480,7447,5,20,2014,N,-250,-116
9423400140,6/9/2014,450000.0,3,1.75,1640,13500,1.0,0.0,0.0,3,7,1110,530,1940,0,98125,47.7164,-122.304,1770,12600,6,9,2014,UNK,-130,900
1545804860,10/27/2014,275000.0,3,3.0,1590,7750,1.0,0.0,0.0,3,7,1060,530,1997,0,98038,47.3624,-122.045,1680,7500,10,27,2014,UNK,-90,250
2883200160,4/29/2015,595000.0,4,2.0,2020,2849,2.0,0.0,0.0,3,7,2020,0,1960,0,98115,47.6831,-122.329,1910,3120,4,29,2015,UNK,110,-271
7132300695,4/21/2015,435000.0,3,1.5,1300,3348,1.5,0.0,0.0,3,7,1300,0,1904,2014,98144,47.592,-122.307,1590,2577,4,21,2015,Y,-290,771
1726059053,9/16/2014,270000.0,2,1.5,1380,209959,1.0,0.0,0.0,1,6,1380,0,1954,0,98011,47.7461,-122.195,3130,19868,9,16,2014,UNK,-1750,190091
624111000,8/5/2014,950000.0,3,3.0,4040,14338,2.0,0.0,0.0,3,10,3030,1010,1986,0,98077,47.7268,-122.06,3360,14142,8,5,2014,UNK,680,196
808300310,3/13/2015,389000.0,4,2.25,2130,5337,2.0,0.0,0.0,3,7,2130,0,2001,0,98019,47.7237,-121.959,2300,6930,3,13,2015,UNK,-170,-1593
8563040160,1/21/2015,560000.0,4,2.25,2550,7800,1.0,0.0,0.0,3,8,1580,970,1968,0,98052,47.6283,-122.095,2420,8050,1,21,2015,UNK,130,-250
713500030,7/28/2014,1350000.0,5,3.5,4800,14984,2.0,0.0,2.0,3,11,3480,0,1998,0,98006,47.5543,-122.148,4050,19009,7,28,2014,UNK,750,-4025
8651600160,11/11/2014,799000.0,4,2.25,2510,11585,2.0,0.0,0.0,4,8,2510,0,1969,0,98040,47.5483,-122.226,2450,9691,11,11,2014,UNK,60,1894
9517200030,6/25/2014,365500.0,3,2.0,1410,9600,1.0,0.0,0.0,4,7,1410,0,1983,0,98072,47.7591,-122.146,1410,9600,6,25,2014,UNK,0,0
2460700700,5/15/2014,252350.0,3,2.0,1650,7352,1.0,0.0,0.0,3,7,1160,490,1979,0,98058,47.4612,-122.169,1710,7350,5,15,2014,UNK,-60,2
1223039290,9/5/2014,403950.0,4,2.5,2120,13780,2.0,0.0,0.0,3,8,2120,0,1993,0,98146,47.4987,-122.365,1880,12000,9,5,2014,UNK,240,1780
2890100060,8/1/2014,385000.0,4,1.5,2040,10726,1.0,0.0,0.0,3,7,1380,660,1954,0,98177,47.772,-122.35799999999999,1610,10020,8,1,2014,UNK,430,706
7972600860,12/10/2014,345000.0,4,1.0,1550,7620,1.5,0.0,0.0,3,7,1550,0,1957,0,98106,47.5287,-122.35,1450,7620,12,10,2014,UNK,100,0
8857320070,9/17/2014,490000.0,3,2.75,1980,3128,2.0,0.0,0.0,4,9,1980,0,1979,0,98008,47.6109,-122.11399999999999,1950,2856,9,17,2014,UNK,30,272
4047200695,6/18/2014,330000.0,3,2.5,1600,26977,2.0,0.0,0.0,3,8,1600,0,2005,0,98019,47.7736,-121.90100000000001,1790,27743,6,18,2014,N,-190,-766
1653500070,5/12/2014,927000.0,4,2.75,3300,12090,2.0,0.0,0.0,3,8,3300,0,1953,0,98004,47.6294,-122.21799999999999,3180,12239,5,12,2014,UNK,120,-149
1923000030,7/28/2014,1120000.0,4,2.5,3840,16619,2.0,0.0,1.0,4,10,3840,0,1983,0,98040,47.5634,-122.213,3600,16553,7,28,2014,UNK,240,66
3649100320,4/30/2015,330000.0,2,1.0,1220,10000,1.0,0.0,0.0,5,7,1220,0,1950,0,98028,47.7405,-122.241,2000,9600,4,30,2015,UNK,-780,400
7375300160,3/9/2015,530000.0,5,2.25,2720,8800,1.0,0.0,0.0,4,7,1500,1220,1958,0,98008,47.5976,-122.118,2110,8800,3,9,2015,UNK,610,0
5175800060,6/23/2014,365000.0,4,2.0,1940,25600,1.0,0.0,0.0,1,8,1940,0,1962,0,98006,47.5722,-122.12899999999999,2000,10071,6,23,2014,UNK,-60,15529
1604601375,6/19/2014,378750.0,3,2.5,2160,3000,1.5,0.0,0.0,3,7,1260,900,1909,2011,98118,47.5644,-122.289,1060,3500,6,19,2014,Y,1100,-500
2473251090,6/19/2014,269900.0,4,1.75,1530,8750,1.5,0.0,0.0,4,7,1530,0,1968,0,98058,47.4556,-122.15700000000001,1390,8750,6,19,2014,UNK,140,0
9126100861,3/6/2015,557000.0,3,3.5,1710,2096,2.0,0.0,0.0,3,8,1290,420,2008,0,98122,47.6055,-122.305,1630,1543,3,6,2015,N,80,553
3420069065,8/25/2014,360000.0,4,1.75,3730,16980,1.0,0.0,0.0,4,7,2150,1580,1974,0,98022,47.1775,-122.022,1880,16963,8,25,2014,UNK,1850,17
6021501685,4/22/2015,352000.0,2,1.0,940,5000,1.0,0.0,0.0,4,7,940,0,1937,0,98117,47.6879,-122.385,1560,4500,4,22,2015,UNK,-620,500
1151100070,2/24/2015,437000.0,3,2.5,1750,22357,2.0,0.0,0.0,3,8,1750,0,1994,0,98045,47.4807,-121.779,2430,22357,2,24,2015,UNK,-680,0
8856950240,6/18/2014,322500.0,4,2.5,1820,6753,2.0,0.0,0.0,3,7,1820,0,1994,0,98038,47.3845,-122.03200000000001,1820,7107,6,18,2014,UNK,0,-354
9385200055,9/12/2014,650000.0,3,3.25,1510,2000,2.0,0.0,0.0,3,9,1330,180,2001,0,98116,47.5815,-122.402,1510,1352,9,12,2014,UNK,0,648
7821200390,8/6/2014,450000.0,3,2.0,1290,1213,3.0,0.0,0.0,3,8,1290,0,2001,0,98103,47.6609,-122.344,1290,3235,8,6,2014,UNK,0,-2022
8078520310,4/17/2015,278500.0,3,2.0,1570,5250,1.0,0.0,0.0,3,7,1570,0,1998,0,98092,47.3163,-122.18799999999999,1570,5250,4,17,2015,UNK,0,0
1565950030,4/27/2015,364950.0,4,2.5,1930,6957,2.0,0.0,0.0,3,8,1930,0,1995,0,98055,47.4309,-122.191,2090,6996,4,27,2015,UNK,-160,-39
1560930070,9/11/2014,840000.0,4,3.5,2840,40139,1.0,0.0,4.0,4,10,2840,0,1986,0,98038,47.401,-122.02600000000001,3180,36852,9,11,2014,UNK,-340,3287
6700400140,3/18/2015,268000.0,3,2.5,1550,8134,2.0,0.0,0.0,3,7,1550,0,1991,0,98031,47.403999999999996,-122.191,1550,8134,3,18,2015,UNK,0,0
2422029094,7/16/2014,517534.0,2,1.0,833,143947,1.0,0.0,0.0,3,5,833,0,2006,0,98070,47.3889,-122.48200000000001,1380,143947,7,16,2014,N,-547,0
1774220160,11/4/2014,632925.0,3,2.5,2990,32239,2.0,0.0,0.0,4,8,2990,0,1978,0,98077,47.7718,-122.095,2990,36497,11,4,2014,UNK,0,-4258
1525200060,7/23/2014,577500.0,3,2.5,2000,7251,2.0,0.0,0.0,3,9,2000,0,1995,0,98034,47.7067,-122.2,2450,8118,7,23,2014,UNK,-450,-867
1678400105,2/12/2015,339000.0,4,1.5,2390,7480,1.5,0.0,2.0,3,7,2390,0,1920,0,98178,47.504,-122.227,2850,6867,2,12,2015,UNK,-460,613
3426059070,9/9/2014,570000.0,3,1.75,2910,37461,1.0,0.0,0.0,4,7,1530,1380,1967,0,98052,47.7015,-122.164,2520,18295,9,9,2014,UNK,390,19166
824079032,6/26/2014,563500.0,4,1.75,2085,174240,1.0,0.0,0.0,3,7,1610,475,1964,0,98024,47.5753,-121.95,2690,174240,6,26,2014,UNK,-605,0
2697100140,1/5/2015,423000.0,4,2.25,2200,9351,1.0,0.0,0.0,5,7,1290,910,1962,0,98133,47.7448,-122.333,1910,8660,1,5,2015,UNK,290,691
8724300030,12/23/2014,355000.0,3,2.25,1860,5028,2.0,0.0,0.0,3,8,1860,0,2012,0,98019,47.7318,-121.98200000000001,2320,5465,12,23,2014,N,-460,-437
8678500060,7/10/2014,1550000.0,5,4.25,6070,171626,2.0,0.0,0.0,3,12,6070,0,1999,0,98024,47.5954,-121.95,4680,211267,7,10,2014,UNK,1390,-39641
625049299,12/3/2014,482000.0,2,1.0,950,3960,1.0,0.0,0.0,3,7,950,0,1941,0,98103,47.6885,-122.337,1320,4050,12,3,2014,UNK,-370,-90
6073200075,7/30/2014,625000.0,3,1.75,1600,9135,1.0,0.0,0.0,5,7,1600,0,1955,0,98006,47.5724,-122.179,1580,9800,7,30,2014,UNK,20,-665
6388900710,12/19/2014,538000.0,3,2.5,2250,11632,2.0,0.0,0.0,3,8,2250,0,1988,0,98056,47.5272,-122.169,2360,11632,12,19,2014,UNK,-110,0
1442860160,1/7/2015,380000.0,3,2.5,2280,10255,2.0,0.0,0.0,4,8,2280,0,1985,0,98058,47.4334,-122.161,2310,10094,1,7,2015,UNK,-30,161
7942600310,7/17/2014,375000.0,2,1.0,940,5120,1.0,0.0,0.0,3,7,940,0,1909,0,98122,47.6073,-122.30799999999999,1300,5120,7,17,2014,UNK,-360,0
1545808560,4/3/2015,245000.0,3,2.5,1530,8500,1.0,0.0,0.0,5,7,1030,500,1996,0,98038,47.3592,-122.046,1850,8140,4,3,2015,UNK,-320,360
936000060,11/14/2014,310000.0,5,1.75,2190,27260,1.0,0.0,0.0,4,7,2190,0,1947,0,98166,47.4546,-122.337,1620,39480,11,14,2014,UNK,570,-12220
9808650060,2/25/2015,1300000.0,3,2.0,2350,15021,1.0,0.0,0.0,4,8,1770,580,1976,0,98004,47.6408,-122.219,3530,15715,2,25,2015,UNK,-1180,-694
3754700160,5/6/2014,397000.0,4,2.0,1440,7680,1.0,0.0,0.0,3,7,1200,240,1971,0,98034,47.7245,-122.2,1460,9660,5,6,2014,UNK,-20,-1980
305500140,5/12/2015,365000.0,3,2.5,2200,4052,2.0,0.0,0.0,3,8,2200,0,2005,0,98058,47.4362,-122.178,2310,5082,5,12,2015,N,-110,-1030
5468750060,10/28/2014,328500.0,4,3.0,2290,8250,2.0,0.0,0.0,3,9,2290,0,1990,0,98042,47.3739,-122.156,2290,8250,10,28,2014,UNK,0,0
2944010240,9/8/2014,988000.0,4,3.0,4040,19700,2.0,0.0,0.0,3,11,4040,0,1987,0,98052,47.7205,-122.12700000000001,3930,21887,9,8,2014,UNK,110,-2187
3454000060,7/22/2014,1000000.0,4,2.5,2610,3277,1.5,0.0,0.0,5,8,1920,690,1922,0,98103,47.6636,-122.33,1810,3277,7,22,2014,UNK,800,0
646910160,9/3/2014,237000.0,3,2.5,1490,2138,2.0,0.0,0.0,3,7,1490,0,2005,0,98055,47.4324,-122.197,1490,2094,9,3,2014,N,0,44
8564950390,9/19/2014,525000.0,4,2.5,2450,5280,2.0,0.0,0.0,3,8,2450,0,2003,0,98011,47.7734,-122.22399999999999,2300,4674,9,19,2014,UNK,150,606
2268400350,9/16/2014,749000.0,4,2.5,1710,9627,1.0,0.0,0.0,3,9,1440,270,1976,2014,98006,47.559,-122.164,2140,9131,9,16,2014,Y,-430,496
7504101040,8/21/2014,722500.0,5,2.5,4870,11800,2.0,0.0,0.0,3,10,3470,1400,1983,0,98074,47.633,-122.041,3180,11398,8,21,2014,UNK,1690,402
11500890,3/12/2015,843000.0,3,2.5,3130,8750,2.0,0.0,0.0,3,10,3130,0,1991,0,98052,47.6954,-122.103,2860,9003,3,12,2015,UNK,270,-253
9528102772,7/8/2014,438000.0,2,2.0,1270,1372,3.0,0.0,0.0,3,8,1270,0,2000,0,98115,47.6776,-122.318,1610,3090,7,8,2014,UNK,-340,-1718
284000223,9/16/2014,578000.0,3,1.75,2120,10875,1.0,0.0,2.0,3,8,1540,580,1977,0,98146,47.504,-122.382,2460,11760,9,16,2014,UNK,-340,-885
3353401710,9/23/2014,227950.0,3,1.5,1670,8230,1.0,0.0,0.0,5,7,1670,0,1954,0,98001,47.2613,-122.255,2077,4910,9,23,2014,UNK,-407,3320
8159610030,7/22/2014,196000.0,3,2.25,2070,11576,2.0,0.0,0.0,3,7,2070,0,1974,0,98001,47.3417,-122.271,1890,7519,7,22,2014,UNK,180,4057
3179100435,7/15/2014,641000.0,2,1.0,1420,5332,1.0,0.0,0.0,3,8,1070,350,1953,0,98105,47.6694,-122.275,2400,5406,7,15,2014,UNK,-980,-74
822079033,4/22/2015,350000.0,3,1.5,1250,219978,1.0,0.0,0.0,4,6,1250,0,1980,0,98038,47.4056,-121.955,1930,210394,4,22,2015,UNK,-680,9584
8857600960,8/19/2014,205000.0,3,1.0,940,7980,1.0,0.0,0.0,4,7,940,0,1960,0,98032,47.3838,-122.289,1150,8050,8,19,2014,UNK,-210,-70
1774000200,12/2/2014,400000.0,3,1.75,1920,9102,1.0,0.0,0.0,3,7,1920,0,1968,0,98072,47.7487,-122.08200000000001,1920,9760,12,2,2014,UNK,0,-658
2024069128,11/10/2014,1030000.0,3,2.5,3545,9816,1.0,0.0,0.0,3,10,2610,935,2005,0,98027,47.5534,-122.07799999999999,3630,7704,11,10,2014,N,-85,2112
1049010390,3/19/2015,505000.0,3,2.0,1260,5460,1.0,0.0,0.0,3,7,1260,0,1972,0,98034,47.7355,-122.18,1510,5460,3,19,2015,UNK,-250,0
7905370390,10/9/2014,475000.0,5,2.5,2340,7200,1.0,0.0,0.0,3,7,1300,1040,1975,0,98034,47.7206,-122.211,1930,7221,10,9,2014,UNK,410,-21
4140090240,11/5/2014,520000.0,3,2.25,2590,9263,1.0,0.0,0.0,5,8,1440,1150,1977,0,98028,47.7691,-122.262,2580,9450,11,5,2014,UNK,10,-187
4055700030,5/2/2015,1450000.0,3,4.5,3970,24920,2.0,0.0,2.0,3,10,3260,710,1977,0,98034,47.7183,-122.258,2610,13838,5,2,2015,UNK,1360,11082
3775300030,12/31/2014,333500.0,3,1.75,1220,9732,1.0,0.0,0.0,3,7,1220,0,1965,0,98011,47.7736,-122.214,1630,10007,12,31,2014,UNK,-410,-275
2525300030,2/22/2015,232000.0,3,1.0,1400,10403,1.0,0.0,0.0,4,6,1400,0,1976,0,98038,47.361999999999995,-122.029,1230,10209,2,22,2015,UNK,170,194
1324059104,4/21/2015,691100.0,3,2.75,2360,16117,1.0,0.0,0.0,4,8,1710,650,1983,0,98006,47.5698,-122.12100000000001,2120,16117,4,21,2015,UNK,240,0
2287000030,10/14/2014,811000.0,3,1.75,1870,9897,1.0,0.0,0.0,4,8,1870,0,1960,0,98040,47.5505,-122.221,1900,10005,10,14,2014,UNK,-30,-108
7702010030,5/20/2014,551000.0,3,2.5,2830,5802,2.0,0.0,0.0,3,9,2830,0,2001,0,98028,47.7605,-122.234,2500,5788,5,20,2014,UNK,330,14
1529200340,1/8/2015,496500.0,3,2.5,2260,3640,2.0,0.0,0.0,3,8,2260,0,1994,0,98072,47.7356,-122.15700000000001,2350,3710,1,8,2015,UNK,-90,-70
2122039094,11/26/2014,705000.0,3,3.0,1970,20978,2.0,1.0,3.0,4,9,1770,200,1980,0,98070,47.3844,-122.43799999999999,2280,75396,11,26,2014,UNK,-310,-54418
1742800030,6/12/2014,578000.0,4,2.5,3140,9225,1.0,0.0,2.0,5,9,1770,1370,1966,0,98055,47.4904,-122.226,2460,9600,6,12,2014,UNK,680,-375
1796360350,1/28/2015,255000.0,3,1.75,1240,8659,1.0,0.0,0.0,5,7,1240,0,1986,0,98042,47.3663,-122.089,1490,8223,1,28,2015,UNK,-250,436
6154500070,6/26/2014,1050000.0,4,3.5,3450,7832,2.0,0.0,0.0,3,10,3450,0,2007,0,98006,47.5637,-122.12299999999999,3220,8567,6,26,2014,N,230,-735
1843100340,3/5/2015,348000.0,3,2.25,2570,8491,2.0,0.0,0.0,4,8,2570,0,1989,0,98042,47.3759,-122.125,2400,8049,3,5,2015,UNK,170,442
8944290160,11/4/2014,230000.0,3,2.0,1510,3413,2.0,0.0,0.0,3,7,1510,0,1985,0,98031,47.3912,-122.167,1570,3777,11,4,2014,UNK,-60,-364
4166600473,12/9/2014,359500.0,4,2.25,2390,11250,2.0,0.0,0.0,3,9,2390,0,1988,0,98023,47.3305,-122.37100000000001,2480,11250,12,9,2014,UNK,-90,0
7282300125,11/12/2014,330000.0,3,1.0,980,7000,1.0,0.0,0.0,3,6,980,0,1953,0,98133,47.7617,-122.35700000000001,1220,7000,11,12,2014,UNK,-240,0
8658300340,5/23/2014,80000.0,1,0.75,430,5050,1.0,0.0,0.0,2,4,430,0,1912,0,98014,47.6499,-121.90899999999999,1200,7500,5,23,2014,UNK,-770,-2450
2419600075,12/1/2014,465000.0,3,1.75,1480,6360,1.0,0.0,0.0,3,7,1480,0,1954,0,98133,47.7311,-122.353,1480,6360,12,1,2014,UNK,0,0
2621760350,10/15/2014,325000.0,4,2.5,1850,7324,2.0,0.0,0.0,3,8,1850,0,1997,0,98042,47.3701,-122.10700000000001,2100,7329,10,15,2014,UNK,-250,-5
1723049270,1/7/2015,340500.0,3,2.0,2270,28025,1.0,0.0,0.0,4,7,1920,350,1947,0,98168,47.4857,-122.318,1770,14833,1,7,2015,UNK,500,13192
4123840310,1/6/2015,342500.0,3,2.5,1810,5192,2.0,0.0,0.0,3,8,1810,0,1993,0,98038,47.3724,-122.042,1810,6200,1,6,2015,UNK,0,-1008
2172000075,6/23/2014,290900.0,2,2.0,1610,17600,2.0,0.0,0.0,3,6,1610,0,1930,1983,98178,47.4855,-122.266,1310,12950,6,23,2014,Y,300,4650
8651611170,2/13/2015,868700.0,3,4.25,3840,6161,2.0,0.0,0.0,3,10,3840,0,2000,0,98074,47.6336,-122.064,3230,7709,2,13,2015,UNK,610,-1548
8820902200,11/13/2014,1200000.0,4,2.75,4110,8400,2.0,0.0,1.0,3,9,3130,980,1928,0,98125,47.717,-122.281,2820,8400,11,13,2014,UNK,1290,0
8651610890,10/14/2014,1150000.0,4,3.25,4190,10259,2.0,0.0,0.0,3,11,3150,1040,2000,0,98074,47.6332,-122.066,4300,11919,10,14,2014,UNK,-110,-1660
1853080570,8/11/2014,859900.0,4,2.75,3390,6298,2.0,0.0,0.0,3,9,3390,0,2011,0,98074,47.5906,-122.06200000000001,3390,7111,8,11,2014,N,0,-813
3629920030,8/8/2014,520000.0,4,2.25,1890,3006,2.0,0.0,0.0,3,7,1890,0,2003,0,98029,47.5461,-121.99799999999999,1580,3000,8,8,2014,UNK,310,6
1604602050,7/11/2014,460000.0,3,2.5,1610,2527,2.0,0.0,2.0,3,9,1080,530,2005,0,98118,47.5674,-122.29,1610,4173,7,11,2014,N,0,-1646
6844700810,9/1/2014,438924.0,3,1.5,1050,4590,1.0,0.0,0.0,3,7,850,200,1949,0,98115,47.6943,-122.29,1770,5400,9,1,2014,UNK,-720,-810
66000070,4/6/2015,315000.0,2,1.0,630,6550,1.0,0.0,0.0,3,5,630,0,1918,0,98126,47.5486,-122.38,1420,6550,4,6,2015,UNK,-790,0
6665800030,7/18/2014,590000.0,4,2.75,2910,10650,1.0,0.0,2.0,3,8,1780,1130,1975,0,98033,47.6658,-122.18799999999999,2920,10988,7,18,2014,UNK,-10,-338
2205700350,11/4/2014,378500.0,4,1.75,1700,8640,1.0,0.0,0.0,3,7,850,850,1955,0,98006,47.5772,-122.15299999999999,1620,9000,11,4,2014,UNK,80,-360
5466000030,6/3/2014,328500.0,3,2.5,1950,8130,2.0,0.0,0.0,4,9,1950,0,1990,0,98042,47.3875,-122.161,2350,7691,6,3,2014,UNK,-400,439
6189200125,3/25/2015,849950.0,3,3.0,2990,9773,2.0,0.0,0.0,4,8,2990,0,1973,0,98005,47.6344,-122.17399999999999,2230,11553,3,25,2015,UNK,760,-1780
9169600135,10/27/2014,525000.0,3,1.5,1350,6000,1.0,0.0,2.0,3,7,900,450,1950,0,98136,47.5275,-122.391,1730,6012,10,27,2014,UNK,-380,-12
2625069070,4/10/2015,1390000.0,4,3.25,4860,181319,2.5,0.0,0.0,3,9,4860,0,1993,0,98074,47.6179,-122.005,3850,181319,4,10,2015,UNK,1010,0
8732131090,4/28/2015,295000.0,4,2.5,2160,7725,1.0,0.0,0.0,4,8,1460,700,1978,0,98023,47.3078,-122.37799999999999,2060,8250,4,28,2015,UNK,100,-525
9286000240,7/11/2014,1070000.0,6,3.5,4860,11793,2.0,0.0,0.0,3,11,3860,1000,1998,0,98006,47.5521,-122.137,3600,11793,7,11,2014,UNK,1260,0
1895000260,7/21/2014,207950.0,2,2.0,890,5000,1.0,0.0,0.0,3,6,890,0,1917,0,98118,47.5158,-122.264,1860,5000,7,21,2014,UNK,-970,0
8691370400,12/16/2014,699900.0,4,2.75,2810,7302,2.0,0.0,0.0,3,9,2810,0,2002,0,98075,47.5985,-121.977,2820,7302,12,16,2014,UNK,-10,0
5423010350,2/10/2015,1280000.0,5,2.5,3400,9500,2.0,0.0,1.0,4,8,3400,0,1977,0,98027,47.5645,-122.08200000000001,3080,11081,2,10,2015,UNK,320,-1581
8562501040,11/20/2014,452000.0,4,1.5,1580,7350,1.0,0.0,0.0,4,7,960,620,1963,0,98052,47.6734,-122.154,1560,7350,11,20,2014,UNK,20,0
2475200140,2/5/2015,370000.0,3,2.0,1680,5036,1.0,0.0,1.0,4,7,1680,0,1987,0,98055,47.4734,-122.186,1680,4921,2,5,2015,UNK,0,115
7942100310,1/27/2015,232000.0,3,1.75,1300,11230,1.0,0.0,0.0,5,7,1300,0,1968,0,98042,47.3811,-122.087,1300,10794,1,27,2015,UNK,0,436
3760000030,10/30/2014,669950.0,5,2.5,2820,14062,2.0,0.0,0.0,4,7,2380,440,1960,0,98034,47.7081,-122.215,1910,10392,10,30,2014,UNK,910,3670
1727500340,6/14/2014,397500.0,3,2.0,1510,6710,1.0,0.0,0.0,3,7,1070,440,1972,0,98034,47.7193,-122.21600000000001,1660,6600,6,14,2014,UNK,-150,110
9828702519,5/12/2014,490000.0,2,2.5,1230,1391,2.0,0.0,0.0,3,8,870,360,2004,0,98112,47.6192,-122.301,1240,1350,5,12,2014,N,-10,41
4432600075,1/28/2015,725000.0,4,2.0,2110,4140,2.0,0.0,0.0,3,9,1710,400,1925,2003,98116,47.5836,-122.387,1440,4420,1,28,2015,Y,670,-280
7806300030,9/17/2014,299000.0,3,2.75,3080,19635,1.0,0.0,2.0,4,7,1610,1470,1958,0,98032,47.3841,-122.28399999999999,2424,12410,9,17,2014,UNK,656,7225
9274202270,8/18/2014,625000.0,2,1.5,1490,5750,1.5,0.0,0.0,4,7,1190,300,1900,0,98116,47.5872,-122.39,1590,4025,8,18,2014,UNK,-100,1725
7852030960,11/6/2014,437500.0,3,2.5,2120,4500,2.0,0.0,0.0,3,7,2120,0,2000,0,98065,47.5322,-121.88,2530,4816,11,6,2014,UNK,-410,-316
7852170140,5/10/2015,650000.0,4,2.5,3180,5438,2.0,0.0,0.0,3,9,3180,0,2003,0,98065,47.5416,-121.86399999999999,3030,5335,5,10,2015,UNK,150,103
7518503335,5/19/2014,475000.0,2,1.0,1490,3825,1.0,0.0,0.0,3,7,860,630,1929,0,98117,47.6799,-122.381,1460,3825,5,19,2014,UNK,30,0
5467900070,5/2/2014,342000.0,3,2.0,1930,11947,1.0,0.0,0.0,4,8,1930,0,1966,0,98042,47.3672,-122.15100000000001,2200,12825,5,2,2014,UNK,-270,-878
1245002952,10/15/2014,1200000.0,4,2.5,2770,7800,2.0,0.0,0.0,3,10,2770,0,1999,0,98033,47.684,-122.205,2720,10000,10,15,2014,UNK,50,-2200
8906200070,2/10/2015,280000.0,3,1.5,1670,11610,1.0,0.0,0.0,4,7,1670,0,1963,0,98055,47.4404,-122.191,1930,10200,2,10,2015,UNK,-260,1410
5379805885,5/21/2014,240000.0,2,1.75,1330,7200,1.0,0.0,0.0,3,7,1330,0,1993,0,98188,47.4467,-122.281,1450,11682,5,21,2014,UNK,-120,-4482
2769600560,5/27/2014,529000.0,3,1.0,1210,3328,1.5,0.0,0.0,4,7,1210,0,1924,0,98107,47.6729,-122.363,1640,3333,5,27,2014,UNK,-430,-5
9238901420,2/2/2015,442000.0,3,1.0,1190,5100,1.0,0.0,0.0,4,7,1030,160,1941,0,98136,47.5346,-122.385,1690,5100,2,2,2015,UNK,-500,0
5113400431,5/8/2014,615000.0,2,1.0,1540,6872,1.0,0.0,0.0,4,7,820,0,1946,0,98119,47.6454,-122.37299999999999,1420,5538,5,8,2014,UNK,120,1334
3885805665,6/12/2014,1490000.0,4,3.75,4030,10800,2.0,0.0,0.0,3,10,4030,0,2006,0,98033,47.6821,-122.196,2160,7200,6,12,2014,N,1870,3600
8121200810,5/5/2015,585000.0,4,1.75,2430,7559,1.0,0.0,0.0,4,8,1580,850,1981,0,98052,47.7206,-122.11,1980,8750,5,5,2015,UNK,450,-1191
5126310400,3/5/2015,480000.0,4,2.5,2600,7787,2.0,0.0,0.0,3,8,2600,0,2005,0,98059,47.4877,-122.139,2830,7787,3,5,2015,N,-230,0
7322910030,7/21/2014,1100000.0,5,3.5,4410,57063,2.0,0.0,0.0,4,9,4410,0,1990,0,98053,47.6554,-122.01799999999999,2900,50529,7,21,2014,UNK,1510,6534
2827100070,11/5/2014,290000.0,4,1.0,1330,8184,1.5,0.0,0.0,3,7,1330,0,1949,0,98133,47.7343,-122.34700000000001,1220,660,11,5,2014,UNK,110,7524
9276201895,8/20/2014,615000.0,3,1.75,1900,5000,1.0,0.0,0.0,5,7,950,950,1951,0,98116,47.5789,-122.39299999999999,1770,5000,8,20,2014,UNK,130,0
4402700070,3/11/2015,300000.0,2,1.0,1100,7680,1.0,0.0,0.0,4,7,1100,0,1950,0,98133,47.7439,-122.339,1460,7680,3,11,2015,UNK,-360,0
1922059046,10/29/2014,308000.0,3,1.0,1980,39150,1.5,0.0,0.0,3,6,1580,400,1932,0,98030,47.3818,-122.225,1860,11811,10,29,2014,UNK,120,27339
925059288,5/7/2015,750000.0,3,2.5,2400,7745,2.0,0.0,0.0,3,9,2400,0,2001,0,98033,47.6734,-122.17299999999999,2080,8615,5,7,2015,UNK,320,-870
4386700135,11/14/2014,2250000.0,4,2.25,4760,8036,2.5,0.0,0.0,5,9,3390,1370,1916,0,98112,47.6415,-122.285,2950,9323,11,14,2014,UNK,1810,-1287
1923069078,8/5/2014,890000.0,4,3.25,3180,194278,2.0,0.0,0.0,3,10,3180,0,2005,0,98059,47.4711,-122.084,2200,178160,8,5,2014,N,980,16118
1432400335,3/25/2015,288000.0,3,1.0,1190,7560,1.0,0.0,0.0,5,6,1190,0,1958,0,98058,47.452,-122.177,1190,7560,3,25,2015,UNK,0,0
1180003090,9/6/2014,190000.0,2,1.0,630,6000,1.0,0.0,0.0,3,6,630,0,1943,2005,98178,47.4973,-122.221,1470,6840,9,6,2014,Y,-840,-840
726049331,3/26/2015,515000.0,5,3.0,2530,5105,1.0,0.0,0.0,3,8,1520,1010,2005,0,98133,47.7546,-122.34100000000001,2290,4011,3,26,2015,N,240,1094
3340401555,11/5/2014,235000.0,4,1.5,1690,11054,1.0,0.0,0.0,4,5,1690,0,1930,0,98055,47.4667,-122.215,1690,9040,11,5,2014,UNK,0,2014
7453000070,8/18/2014,275000.0,2,1.0,940,5000,1.0,0.0,0.0,3,6,940,0,1951,0,98126,47.5186,-122.374,940,5000,8,18,2014,UNK,0,0
4348800030,11/21/2014,727500.0,2,2.0,1240,9119,1.0,0.0,0.0,4,7,1240,0,1952,0,98004,47.6221,-122.193,1380,9121,11,21,2014,UNK,-140,-2
7202331420,6/20/2014,650000.0,4,2.5,3040,6587,2.0,0.0,0.0,3,7,3040,0,2003,0,98053,47.683,-122.039,2740,6587,6,20,2014,UNK,300,0
3225079035,6/18/2014,1600000.0,6,5.0,6050,230652,2.0,0.0,3.0,3,11,6050,0,2001,0,98024,47.6033,-121.943,4210,233971,6,18,2014,UNK,1840,-3319
6381500700,11/5/2014,365000.0,4,1.0,1590,7085,1.5,0.0,0.0,3,6,1590,0,1944,0,98125,47.7315,-122.305,1320,7085,11,5,2014,UNK,270,0
339500160,10/8/2014,662000.0,3,1.75,2500,36947,1.0,0.0,0.0,3,9,2500,0,1984,0,98052,47.6917,-122.084,2590,28837,10,8,2014,UNK,-90,8110
1545807610,4/29/2015,270500.0,3,2.5,1780,7848,1.0,0.0,0.0,3,7,1320,460,1978,0,98038,47.3608,-122.056,1680,7848,4,29,2015,UNK,100,0
1843200240,5/5/2015,200000.0,2,1.5,1360,1898,2.0,0.0,0.0,3,7,1360,0,1978,0,98092,47.2852,-122.19,1360,1898,5,5,2015,UNK,0,0
4403600270,2/24/2015,970000.0,4,3.25,4740,76230,2.0,0.0,0.0,3,10,4740,0,1987,0,98075,47.5931,-122.071,3340,49206,2,24,2015,UNK,1400,27024
2008200060,6/24/2014,160000.0,3,1.5,1010,9600,1.0,0.0,0.0,4,7,1010,0,1962,0,98198,47.4097,-122.316,1400,9660,6,24,2014,UNK,-390,-60
1521069070,2/18/2015,204000.0,3,1.0,1040,7405,1.0,0.0,0.0,4,6,1040,0,1971,0,98010,47.3105,-122.021,1580,7405,2,18,2015,UNK,-540,0
2459500310,2/18/2015,358000.0,3,2.25,1610,6655,2.0,0.0,0.0,4,7,1610,0,1985,0,98058,47.4296,-122.161,1780,7529,2,18,2015,UNK,-170,-874
6204420070,5/1/2015,452000.0,4,1.75,1570,8268,1.0,0.0,0.0,3,7,1570,0,1979,0,98011,47.7373,-122.197,1870,8190,5,1,2015,UNK,-300,78
5694500105,12/4/2014,595000.0,2,2.0,1510,4000,1.0,0.0,0.0,4,7,1010,500,1900,0,98103,47.6582,-122.345,1920,4000,12,4,2014,UNK,-410,0
5466410030,4/10/2015,249000.0,3,2.0,1360,6082,1.0,0.0,0.0,3,7,1360,0,1994,0,98042,47.3577,-122.16,1360,6987,4,10,2015,UNK,0,-905
9485740340,3/10/2015,346900.0,4,2.5,1970,5106,2.0,0.0,0.0,3,8,1970,0,1999,0,98055,47.449,-122.205,2230,5109,3,10,2015,UNK,-260,-3
622049114,2/18/2015,2130000.0,3,2.5,5403,24069,2.0,1.0,4.0,4,12,5403,0,1976,0,98166,47.4169,-122.348,3980,104374,2,18,2015,UNK,1423,-80305
2270000070,10/30/2014,280000.0,4,2.5,1560,4350,2.0,0.0,0.0,3,7,1560,0,2003,0,98056,47.5025,-122.186,1560,4350,10,30,2014,UNK,0,0
1310900260,10/13/2014,318888.0,4,1.75,2320,12000,1.0,0.0,0.0,4,8,2270,50,1973,0,98032,47.3644,-122.28,2120,9880,10,13,2014,UNK,200,2120
224069094,9/11/2014,530000.0,3,2.25,2120,40518,1.0,0.0,0.0,3,8,2120,0,1967,0,98075,47.5896,-122.009,2480,13492,9,11,2014,UNK,-360,27026
7800800160,11/21/2014,375000.0,3,2.25,2120,18500,2.0,0.0,0.0,4,8,2120,0,1983,0,98031,47.3914,-122.169,2120,14479,11,21,2014,UNK,0,4021
2944000240,4/22/2015,910000.0,4,2.5,3350,29242,2.0,0.0,0.0,3,11,3350,0,1988,0,98052,47.7197,-122.131,3920,24728,4,22,2015,UNK,-570,4514
4139400710,5/23/2014,782000.0,4,2.5,2380,9614,2.0,0.0,0.0,4,10,2380,0,1991,0,98006,47.5623,-122.116,2560,9770,5,23,2014,UNK,-180,-156
7899800860,3/19/2015,259950.0,2,2.0,1070,649,2.0,0.0,0.0,3,9,720,350,2008,0,98106,47.5213,-122.35700000000001,1070,928,3,19,2015,N,0,-279
2473420140,9/23/2014,315000.0,4,2.75,2300,18360,1.0,0.0,0.0,4,7,1560,740,1979,0,98058,47.4518,-122.16,1870,9588,9,23,2014,UNK,430,8772
5000500055,5/28/2014,215000.0,2,1.0,1320,8865,1.0,0.0,0.0,4,6,1320,0,1943,0,98168,47.4949,-122.3,1190,6490,5,28,2014,UNK,130,2375
4099500935,7/23/2014,705000.0,3,1.75,2180,10221,1.0,0.0,2.0,4,7,1140,1040,1946,0,98040,47.5885,-122.24799999999999,2180,8535,7,23,2014,UNK,0,1686
1373800295,10/13/2014,1450000.0,3,3.0,4380,6320,2.0,0.0,3.0,5,10,3580,800,1952,0,98199,47.6452,-122.411,3080,7680,10,13,2014,UNK,1300,-1360
4025300135,5/8/2015,451000.0,3,1.75,1790,9813,2.0,0.0,0.0,3,7,1790,0,1949,0,98155,47.748999999999995,-122.305,1520,10125,5,8,2015,UNK,270,-312
3294700310,9/2/2014,261000.0,2,1.0,750,8125,1.0,0.0,0.0,4,6,750,0,1943,0,98055,47.4727,-122.198,1340,8750,9,2,2014,UNK,-590,-625
8718500075,11/17/2014,396000.0,3,1.5,1300,8280,1.0,0.0,0.0,5,7,1300,0,1956,0,98028,47.7403,-122.256,1570,8692,11,17,2014,UNK,-270,-412
4309710240,7/22/2014,725000.0,4,2.5,2990,29170,2.0,0.0,3.0,3,9,2990,0,1999,0,98059,47.5146,-122.117,3715,29170,7,22,2014,UNK,-725,0
5486800070,6/20/2014,1950000.0,7,3.5,4640,15235,2.0,0.0,1.0,3,11,2860,1780,1965,2003,98040,47.5666,-122.23100000000001,3230,20697,6,20,2014,Y,1410,-5462
236400320,7/15/2014,238000.0,4,1.0,1400,7242,1.5,0.0,0.0,3,7,1400,0,1959,0,98188,47.4339,-122.291,1310,7314,7,15,2014,UNK,90,-72
4376700570,4/27/2015,750000.0,6,1.75,2750,9563,2.0,0.0,0.0,4,8,2750,0,1973,0,98052,47.6368,-122.09700000000001,2040,9563,4,27,2015,UNK,710,0
8648100200,10/27/2014,331500.0,4,2.5,2050,10271,2.0,0.0,0.0,3,7,2050,0,1998,0,98042,47.3628,-122.075,2050,8103,10,27,2014,UNK,0,2168
3624079046,10/28/2014,460000.0,4,3.0,2230,108900,1.0,0.0,0.0,3,7,1410,820,1978,0,98065,47.52,-121.845,1960,65340,10,28,2014,UNK,270,43560
1921069084,7/7/2014,404950.0,4,2.25,2340,217014,1.0,0.0,0.0,4,8,2340,0,1982,0,98092,47.2953,-122.083,2340,107898,7,7,2014,UNK,0,109116
6431500140,12/17/2014,880000.0,3,2.5,2870,5163,2.0,0.0,0.0,3,9,2870,0,2014,0,98103,47.6935,-122.352,1630,7995,12,17,2014,N,1240,-2832
2725069050,6/13/2014,863000.0,4,2.5,4120,22370,2.0,0.0,0.0,3,10,4120,0,1997,0,98074,47.6239,-122.023,3180,7257,6,13,2014,UNK,940,15113
5307100060,12/16/2014,638700.0,3,1.75,2080,9162,1.0,0.0,0.0,3,7,1370,710,1960,0,98005,47.5846,-122.16799999999999,1870,8944,12,16,2014,UNK,210,218
7203102050,7/28/2014,435000.0,3,2.5,1840,5680,2.0,0.0,0.0,3,7,1840,0,2008,0,98053,47.6969,-122.02600000000001,1600,4697,7,28,2014,N,240,983
561000075,12/31/2014,260000.0,3,1.0,1180,5350,1.5,0.0,0.0,4,6,1180,0,1959,0,98178,47.505,-122.259,1490,5350,12,31,2014,UNK,-310,0
2436701180,8/14/2014,671500.0,5,2.75,2160,4000,1.5,0.0,0.0,5,7,1530,630,1927,0,98105,47.667,-122.289,2040,4000,8,14,2014,UNK,120,0
809002765,10/22/2014,610000.0,3,1.0,1180,3400,1.5,0.0,0.0,3,8,1180,0,1907,0,98109,47.6376,-122.353,1440,3400,10,22,2014,UNK,-260,0
4045500710,12/18/2014,405000.0,2,0.75,1160,15029,1.0,0.0,0.0,4,6,870,290,1937,0,98014,47.6929,-121.87,1870,25346,12,18,2014,UNK,-710,-10317
5104510270,7/18/2014,338900.0,4,2.5,1830,5612,2.0,0.0,0.0,3,7,1830,0,2003,0,98038,47.3572,-122.015,1830,5998,7,18,2014,UNK,0,-386
98020350,1/23/2015,720000.0,4,4.0,3200,7708,2.0,0.0,0.0,3,10,3200,0,2004,0,98075,47.5816,-121.97,3480,7944,1,23,2015,N,-280,-236
1714900060,4/24/2015,442000.0,5,3.0,2560,5445,1.5,0.0,0.0,4,7,1760,800,1927,0,98108,47.5502,-122.311,1080,5445,4,24,2015,UNK,1480,0
1189000030,6/3/2014,650000.0,5,2.75,2550,5040,1.5,0.0,0.0,5,8,2550,0,1902,0,98122,47.6136,-122.29899999999999,1590,3840,6,3,2014,UNK,960,1200
2473360060,1/2/2015,263500.0,3,1.75,1330,9917,1.0,0.0,0.0,3,7,1040,290,1981,0,98058,47.4478,-122.161,1330,9081,1,2,2015,UNK,0,836
222069082,12/17/2014,300000.0,2,1.0,1220,75794,1.0,0.0,0.0,4,7,1220,0,1963,0,98038,47.4219,-122.007,2010,98010,12,17,2014,UNK,-790,-22216
8669160310,12/9/2014,266000.0,3,2.5,1805,3402,2.0,0.0,0.0,3,7,1805,0,2009,0,98002,47.3521,-122.212,2095,3402,12,9,2014,N,-290,0
1526069135,12/11/2014,930000.0,4,4.0,6050,84942,2.5,0.0,2.0,3,9,4150,1900,2009,0,98077,47.7466,-122.029,2700,199504,12,11,2014,N,3350,-114562
1088650310,1/27/2015,530000.0,4,2.5,2320,5493,2.0,0.0,0.0,3,8,2320,0,2004,0,98028,47.7727,-122.229,2450,5471,1,27,2015,N,-130,22
8945200860,12/11/2014,180000.0,3,1.0,1384,8960,1.0,0.0,0.0,4,6,1384,0,1965,0,98023,47.3062,-122.37100000000001,1000,8470,12,11,2014,UNK,384,490
7853240200,5/16/2014,619000.0,3,2.5,2720,6439,2.0,0.0,0.0,3,9,2720,0,2005,0,98065,47.5422,-121.86,3180,7320,5,16,2014,N,-460,-881
7511800070,8/21/2014,264000.0,3,1.5,1820,10608,1.0,0.0,0.0,4,7,1820,0,1962,0,98003,47.3366,-122.306,1380,8976,8,21,2014,UNK,440,1632
2998800125,7/1/2014,730000.0,2,2.25,2130,4920,1.5,0.0,4.0,4,7,1530,600,1941,0,98116,47.573,-122.40899999999999,2130,4920,7,1,2014,UNK,0,0
3876300310,10/22/2014,439000.0,4,2.25,2060,10070,2.0,0.0,0.0,3,7,2060,0,1975,0,98034,47.7258,-122.177,2060,8155,10,22,2014,UNK,0,1915
5419800510,11/17/2014,268500.0,4,1.75,1420,7500,1.0,0.0,0.0,4,7,1080,340,1981,0,98031,47.4025,-122.176,1500,7260,11,17,2014,UNK,-80,240
192460060,7/15/2014,330000.0,3,1.75,1510,15744,1.0,0.0,0.0,3,7,1510,0,1985,0,98045,47.476000000000006,-121.755,1470,15744,7,15,2014,UNK,40,0
7942601895,8/19/2014,640000.0,3,2.5,2160,4000,1.5,0.0,0.0,3,8,1960,200,1903,2013,98122,47.6045,-122.307,2160,5120,8,19,2014,Y,0,-1120
7504010570,7/8/2014,900000.0,3,2.5,3180,12600,2.0,0.0,0.0,4,11,3180,0,1978,0,98074,47.6366,-122.05799999999999,3030,12835,7,8,2014,UNK,150,-235
1442740140,9/30/2014,370000.0,3,2.25,2110,13300,2.0,0.0,0.0,4,8,2110,0,1985,0,98038,47.3725,-122.06,2470,14000,9,30,2014,UNK,-360,-700
6909200575,3/14/2015,685000.0,3,2.0,2060,2900,1.5,0.0,0.0,5,8,1330,730,1931,0,98144,47.5897,-122.292,1910,3900,3,14,2015,UNK,150,-1000
2525069041,9/4/2014,505000.0,3,1.5,1830,217800,1.0,0.0,0.0,3,7,1010,820,1981,0,98053,47.6277,-121.97200000000001,2450,165963,9,4,2014,UNK,-620,51837
3620069036,10/21/2014,265000.0,3,1.75,1820,32666,1.0,0.0,0.0,4,7,1820,0,1966,0,98022,47.1803,-121.97399999999999,2050,43560,10,21,2014,UNK,-230,-10894
2781280390,3/24/2015,290000.0,3,2.5,1610,2937,2.0,0.0,0.0,3,8,1610,0,2006,0,98055,47.4489,-122.18799999999999,1610,3049,3,24,2015,N,0,-112
9542830350,9/2/2014,296000.0,4,2.5,1780,3600,2.0,0.0,0.0,3,7,1780,0,2006,0,98038,47.3665,-122.01700000000001,2020,3802,9,2,2014,N,-240,-202
1123049053,2/13/2015,360000.0,4,2.5,1840,9611,2.0,0.0,0.0,3,7,1840,0,1996,0,98178,47.4964,-122.251,1830,8505,2,13,2015,UNK,10,1106
8018600765,6/4/2014,240500.0,3,1.75,1460,10584,1.0,0.0,0.0,3,7,990,470,1997,0,98168,47.492,-122.31700000000001,1220,12012,6,4,2014,UNK,240,-1428
3278600240,7/22/2014,372500.0,2,2.5,1400,2958,2.0,0.0,0.0,3,8,1400,0,2007,0,98126,47.5496,-122.37299999999999,1540,2385,7,22,2014,N,-140,573
7846200070,10/2/2014,595000.0,3,2.5,3370,14402,2.0,0.0,2.0,3,9,3370,0,2004,0,98045,47.5008,-121.77600000000001,3330,9691,10,2,2014,N,40,4711
662310400,10/17/2014,515000.0,4,3.0,3590,8249,2.0,0.0,0.0,3,9,3590,0,1997,0,98023,47.2846,-122.34100000000001,2860,7995,10,17,2014,UNK,730,254
8651100140,8/5/2014,1220000.0,4,2.25,3200,15367,2.0,0.0,0.0,4,9,3200,0,1962,0,98040,47.5494,-122.21600000000001,3070,15263,8,5,2014,UNK,130,104
8682250350,10/9/2014,507000.0,2,1.75,1670,6460,1.0,0.0,0.0,3,8,1670,0,2004,0,98053,47.7123,-122.027,2170,6254,10,9,2014,N,-500,206
3211230260,2/4/2015,399950.0,4,2.0,2420,31465,1.0,0.0,0.0,3,9,2420,0,1984,0,98092,47.3131,-122.115,2560,32186,2,4,2015,UNK,-140,-721
4233400340,8/20/2014,185000.0,3,1.75,1430,10816,2.0,0.0,0.0,3,7,1430,0,1994,0,98010,47.3122,-121.99600000000001,1560,10816,8,20,2014,UNK,-130,0
7199350340,8/25/2014,460000.0,3,1.75,1440,7070,1.0,0.0,0.0,3,7,1440,0,1980,0,98052,47.6947,-122.125,1440,7210,8,25,2014,UNK,0,-140
3904901710,2/24/2015,435500.0,3,2.25,1450,4789,2.0,0.0,0.0,3,7,1450,0,1985,0,98029,47.5665,-122.01799999999999,1560,4490,2,24,2015,UNK,-110,299
240000058,4/8/2015,469000.0,4,2.75,3550,13938,1.0,0.0,0.0,5,8,2100,1450,1966,0,98188,47.425,-122.28299999999999,2050,9000,4,8,2015,UNK,1500,4938
6865200444,5/5/2014,531000.0,2,3.0,1270,1175,2.0,0.0,0.0,3,8,1110,160,2000,0,98103,47.6634,-122.34,1290,1800,5,5,2014,UNK,-20,-625
9498200046,2/6/2015,443500.0,2,1.0,940,6804,1.0,0.0,0.0,3,7,940,0,1949,0,98177,47.7047,-122.37299999999999,1150,6930,2,6,2015,UNK,-210,-126
1796380960,11/26/2014,223000.0,3,2.0,1670,6824,1.0,0.0,0.0,3,7,1300,370,1990,0,98042,47.3666,-122.084,1660,7586,11,26,2014,UNK,10,-762
5631500868,4/17/2015,590000.0,4,3.5,3100,15842,2.0,0.0,0.0,3,8,2400,700,1996,0,98028,47.7466,-122.242,2200,19400,4,17,2015,UNK,900,-3558
3126049411,12/9/2014,340000.0,2,2.5,1100,1760,3.0,0.0,0.0,3,7,1100,0,1997,0,98103,47.6972,-122.35,1200,1415,12,9,2014,UNK,-100,345
2321300390,11/5/2014,650000.0,3,2.0,1870,3388,1.0,0.0,0.0,4,8,1230,640,1925,0,98199,47.6372,-122.395,1780,4050,11,5,2014,UNK,90,-662
3905040800,9/25/2014,533600.0,3,2.5,1930,5080,2.0,0.0,0.0,4,8,1930,0,1990,0,98029,47.5694,-122.001,2190,5085,9,25,2014,UNK,-260,-5
4379400260,6/10/2014,695000.0,3,2.75,2540,4694,2.0,0.0,0.0,3,9,2540,0,2005,0,98074,47.6214,-122.024,2600,6344,6,10,2014,N,-60,-1650
5115000160,6/17/2014,242000.0,3,1.75,1280,7524,1.5,0.0,0.0,4,7,1280,0,1988,0,98031,47.3961,-122.18799999999999,1500,7777,6,17,2014,UNK,-220,-253
2826049234,1/14/2015,425000.0,3,2.25,1820,8814,1.0,0.0,0.0,3,7,1280,540,1967,0,98125,47.7162,-122.309,1810,7515,1,14,2015,UNK,10,1299
6600700030,5/6/2015,525000.0,3,2.25,1490,9414,2.0,0.0,0.0,3,7,1490,0,1981,0,98052,47.6844,-122.113,1290,10125,5,6,2015,UNK,200,-711
3904930240,9/22/2014,485000.0,3,2.5,1880,5502,2.0,0.0,0.0,3,8,1880,0,1988,0,98029,47.5737,-122.01799999999999,2040,5411,9,22,2014,UNK,-160,91
9407110700,1/13/2015,175000.0,3,1.0,1250,9775,1.0,0.0,0.0,3,7,1250,0,1971,0,98045,47.4474,-121.771,1390,9650,1,13,2015,UNK,-140,125
1682500160,6/19/2014,210000.0,3,2.0,1440,7210,1.0,0.0,0.0,3,8,1440,0,1983,0,98092,47.3128,-122.184,1700,7245,6,19,2014,UNK,-260,-35
8078570390,4/15/2015,260000.0,3,2.5,1920,7415,2.0,0.0,0.0,3,7,1920,0,1989,0,98031,47.4022,-122.171,1930,7536,4,15,2015,UNK,-10,-121
3010300240,6/23/2014,577000.0,3,2.5,2060,5750,1.0,0.0,0.0,3,7,1330,730,1976,0,98116,47.5671,-122.391,1920,5750,6,23,2014,UNK,140,0
9500900135,10/21/2014,200000.0,3,1.5,1210,10588,1.0,0.0,0.0,4,7,1210,0,1958,0,98002,47.2876,-122.212,1408,10588,10,21,2014,UNK,-198,0
461001615,2/25/2015,605000.0,2,1.75,1760,5000,1.0,0.0,0.0,4,7,940,820,1927,0,98117,47.681999999999995,-122.37200000000001,1530,5000,2,25,2015,UNK,230,0
6411600069,5/21/2014,325000.0,3,1.0,990,6750,1.0,0.0,0.0,4,6,990,0,1947,0,98133,47.7125,-122.331,1440,6860,5,21,2014,UNK,-450,-110
7812800565,8/14/2014,289500.0,3,1.0,960,6400,1.0,0.0,0.0,4,6,820,140,1944,0,98178,47.496,-122.23899999999999,1200,6600,8,14,2014,UNK,-240,-200
7548300731,8/8/2014,559950.0,3,2.5,1660,1458,3.0,0.0,0.0,3,9,1660,0,2014,0,98144,47.5876,-122.309,1660,1784,8,8,2014,N,0,-326
8925100390,4/6/2015,1040000.0,3,1.75,1900,9375,1.0,0.0,1.0,4,8,1330,570,1941,0,98115,47.6821,-122.273,2760,9375,4,6,2015,UNK,-860,0
7010700292,10/9/2014,543500.0,3,2.25,1270,2790,1.0,0.0,0.0,3,7,990,280,1970,0,98199,47.6581,-122.396,1920,4000,10,9,2014,UNK,-650,-1210
9485951170,5/22/2014,480000.0,4,2.25,3250,34293,2.0,0.0,0.0,4,9,3250,0,1983,0,98042,47.3496,-122.094,3110,35982,5,22,2014,UNK,140,-1689
5437820310,5/23/2014,218000.0,3,1.0,960,9633,1.0,0.0,0.0,5,6,960,0,1982,0,98022,47.1951,-122.001,1080,8610,5,23,2014,UNK,-120,1023
582000135,6/22/2014,565000.0,2,1.75,1330,6000,1.0,0.0,0.0,4,7,960,370,1914,1945,98199,47.6539,-122.396,1620,6000,6,22,2014,Y,-290,0
3204800370,12/12/2014,426700.0,3,1.75,2080,7700,1.0,0.0,0.0,5,7,1600,480,1968,0,98056,47.5375,-122.178,1680,7700,12,12,2014,UNK,400,0
8832900550,9/12/2014,650000.0,3,2.5,2690,11575,1.0,0.0,3.0,3,8,2130,0,1957,0,98028,47.7605,-122.26700000000001,2390,11782,9,12,2014,UNK,300,-207
9550204515,9/24/2014,542000.0,2,1.0,890,3060,1.0,0.0,0.0,3,7,770,120,1910,0,98105,47.6663,-122.32600000000001,1760,4080,9,24,2014,UNK,-870,-1020
7199330390,6/24/2014,415000.0,3,1.75,1070,8000,1.0,0.0,0.0,3,7,1070,0,1977,0,98052,47.6978,-122.13,1200,7990,6,24,2014,UNK,-130,10
6131600060,8/15/2014,214000.0,3,1.0,1200,8316,1.0,0.0,0.0,4,6,1200,0,1953,0,98002,47.3221,-122.215,1200,8316,8,15,2014,UNK,0,0
5379805460,1/21/2015,245000.0,3,1.5,1360,8910,2.0,0.0,0.0,5,7,1360,0,1949,0,98188,47.4488,-122.275,1220,8912,1,21,2015,UNK,140,-2
7212652180,7/1/2014,314500.0,3,2.0,2050,13303,1.0,0.0,0.0,3,8,2050,0,1993,0,98003,47.2681,-122.31,2180,11590,7,1,2014,UNK,-130,1713
6379500640,4/9/2015,1120000.0,3,1.5,3000,5750,2.0,0.0,0.0,5,9,2000,1000,1924,0,98116,47.5821,-122.39,1820,5750,4,9,2015,UNK,1180,0
4315700060,3/3/2015,378000.0,2,2.0,1300,3850,1.0,0.0,0.0,3,7,800,500,1963,0,98136,47.5395,-122.39,950,5500,3,3,2015,UNK,350,-1650
3329500060,7/28/2014,305000.0,4,2.5,2250,9091,1.0,0.0,0.0,3,7,1340,910,1982,0,98001,47.33600000000001,-122.26899999999999,1540,7802,7,28,2014,UNK,710,1289
4140090320,3/20/2015,595000.0,5,2.75,3740,6750,1.0,0.0,0.0,4,8,1980,1760,1978,0,98028,47.7679,-122.26100000000001,2620,7920,3,20,2015,UNK,1120,-1170
9385200045,5/12/2015,729500.0,3,2.5,1660,1091,3.0,0.0,1.0,3,9,1530,130,2015,0,98116,47.5818,-122.402,1510,1352,5,12,2015,N,150,-261
7852180340,9/30/2014,430000.0,3,2.5,2360,6699,2.0,0.0,0.0,3,7,2360,0,2003,0,98065,47.5317,-121.853,2360,4744,9,30,2014,UNK,0,1955
1545804340,4/9/2015,240000.0,3,1.75,1760,6500,1.0,0.0,0.0,3,7,1150,0,1987,0,98038,47.3647,-122.05,1760,8125,4,9,2015,UNK,0,-1625
2490200320,3/20/2015,545000.0,3,1.75,1680,6200,1.5,0.0,0.0,3,7,1680,0,1916,0,98136,47.5338,-122.384,1680,5100,3,20,2015,UNK,0,1100
2218000335,7/7/2014,530000.0,3,1.75,1320,2500,1.0,0.0,0.0,3,7,870,450,1918,0,98105,47.6681,-122.305,1580,2750,7,7,2014,UNK,-260,-250
922049078,11/18/2014,157000.0,1,1.0,870,26326,1.0,0.0,0.0,3,6,870,0,1939,0,98198,47.4152,-122.3,1250,10608,11,18,2014,UNK,-380,15718
2586800270,4/7/2015,425000.0,4,1.0,1260,7645,1.5,0.0,0.0,3,6,1260,0,1925,0,98146,47.5044,-122.35,1170,7649,4,7,2015,UNK,90,-4
4338800370,11/17/2014,220000.0,3,1.0,1000,6020,1.0,0.0,0.0,3,6,1000,0,1944,0,98166,47.4793,-122.346,1300,8640,11,17,2014,UNK,-300,-2620
7214700350,11/24/2014,521000.0,4,1.75,2020,36400,1.0,0.0,0.0,4,8,1550,470,1976,0,98077,47.7627,-122.07600000000001,2520,38255,11,24,2014,UNK,-500,-1855
3226200105,5/23/2014,325000.0,3,1.0,1920,6862,1.0,0.0,2.0,3,7,1120,800,1952,0,98118,47.5193,-122.274,2000,6900,5,23,2014,UNK,-80,-38
2324039036,4/3/2015,597500.0,3,2.0,2150,5400,1.5,0.0,0.0,4,7,1380,770,1911,0,98126,47.555,-122.37899999999999,1940,6500,4,3,2015,UNK,210,-1100
7849202231,7/23/2014,337000.0,3,2.5,1470,3976,2.0,0.0,0.0,3,7,1470,0,1999,0,98065,47.526,-121.82600000000001,1490,4400,7,23,2014,UNK,-20,-424
5196410260,4/22/2015,1000000.0,3,2.5,3180,10492,2.0,0.0,2.0,3,10,3180,0,1991,0,98052,47.655,-122.124,3000,9812,4,22,2015,UNK,180,680
3760500116,11/20/2014,3070000.0,3,2.5,3930,55867,1.0,1.0,4.0,4,8,2330,1600,1957,0,98034,47.7022,-122.22399999999999,2730,26324,11,20,2014,UNK,1200,29543
2985800030,5/7/2014,495000.0,3,1.0,990,6000,1.0,0.0,0.0,3,6,990,0,1943,0,98105,47.6718,-122.26700000000001,1250,6000,5,7,2014,UNK,-260,0
259900160,1/2/2015,748000.0,4,3.5,2770,3330,2.0,0.0,0.0,3,8,1970,800,2001,0,98052,47.6327,-122.109,2180,3380,1,2,2015,UNK,590,-50
708000030,9/2/2014,888000.0,3,1.5,1250,8710,1.0,0.0,0.0,4,7,1250,0,1953,0,98004,47.6245,-122.198,1750,9185,9,2,2014,UNK,-500,-475
192460310,3/24/2015,269900.0,3,1.75,1140,22267,1.0,0.0,0.0,3,7,1140,0,1986,0,98045,47.4761,-121.758,1150,15625,3,24,2015,UNK,-10,6642
9412200260,11/13/2014,496500.0,4,2.5,2250,14440,1.0,0.0,0.0,3,7,1550,700,1967,0,98027,47.5221,-122.045,2090,11400,11,13,2014,UNK,160,3040
1062100116,1/21/2015,475000.0,3,2.5,1640,5097,2.0,0.0,0.0,3,7,1640,0,1969,0,98155,47.7522,-122.27799999999999,1880,6000,1,21,2015,UNK,-240,-903
6798100662,5/27/2014,312000.0,3,1.5,1255,1374,3.0,0.0,0.0,3,7,1255,0,2004,0,98125,47.7145,-122.311,1307,1232,5,27,2014,N,-52,142
1775920350,11/24/2014,323000.0,3,1.0,1290,12231,1.0,0.0,0.0,3,7,1290,0,1976,0,98072,47.7404,-122.11,1390,11632,11,24,2014,UNK,-100,599
2525500260,11/24/2014,331000.0,3,1.75,1300,9079,1.0,0.0,0.0,3,7,1300,0,1986,0,98059,47.4834,-122.15899999999999,1890,7369,11,24,2014,UNK,-590,1710
6145600041,5/14/2014,306000.0,3,1.5,1220,1086,3.0,0.0,0.0,3,8,1220,0,2007,0,98133,47.7049,-122.353,1220,1422,5,14,2014,N,0,-336
3300701615,9/30/2014,655000.0,4,2.5,2630,4000,3.0,0.0,0.0,3,8,2630,0,2002,0,98117,47.6915,-122.381,1640,4000,9,30,2014,UNK,990,0
5151600340,7/9/2014,290000.0,3,1.5,1950,15954,1.0,0.0,0.0,4,8,1950,0,1959,0,98003,47.33600000000001,-122.319,1940,12667,7,9,2014,UNK,10,3287
7613700521,8/2/2014,1250000.0,4,3.25,3160,5000,2.0,0.0,0.0,5,9,2360,800,1965,0,98105,47.6597,-122.274,2220,4000,8,2,2014,UNK,940,1000
2710600045,6/16/2014,460000.0,3,1.75,1550,4708,1.0,0.0,0.0,4,7,860,690,1949,0,98115,47.6759,-122.286,1880,5600,6,16,2014,UNK,-330,-892
5101405124,9/12/2014,435000.0,4,2.5,1700,6380,1.0,0.0,0.0,4,7,850,0,1940,0,98115,47.6988,-122.319,1380,6380,9,12,2014,UNK,320,0
6067910030,3/16/2015,664000.0,4,2.75,2510,11880,1.0,0.0,0.0,5,8,1630,880,1978,0,98006,47.5427,-122.181,2390,11211,3,16,2015,UNK,120,669
1959701890,7/29/2014,865000.0,4,1.75,1800,4180,2.0,0.0,3.0,4,8,1800,0,1921,0,98102,47.6462,-122.318,2180,4620,7,29,2014,UNK,-380,-440
1402200340,8/13/2014,385000.0,3,1.75,1800,18000,1.0,0.0,0.0,3,8,1200,600,1968,0,98058,47.4406,-122.146,1800,18000,8,13,2014,UNK,0,0
3558900070,7/18/2014,497000.0,3,2.25,1870,9315,1.0,0.0,0.0,3,7,1350,520,1975,0,98034,47.705,-122.20200000000001,2230,9579,7,18,2014,UNK,-360,-264
7846700310,6/23/2014,280000.0,2,1.0,1010,3000,1.0,0.0,0.0,4,7,1010,0,1925,0,98045,47.4965,-121.785,1150,7000,6,23,2014,UNK,-140,-4000
3348401740,1/27/2015,188000.0,2,1.5,1120,17487,1.0,0.0,0.0,3,6,1120,0,1924,0,98178,47.5024,-122.271,1690,8056,1,27,2015,UNK,-570,9431
3013300288,9/30/2014,478500.0,3,1.0,2090,4755,1.0,0.0,2.0,3,8,1200,890,1969,0,98136,47.5304,-122.387,1850,5300,9,30,2014,UNK,240,-545
7852070060,7/31/2014,1150000.0,4,3.5,4370,18361,2.0,0.0,0.0,3,11,4370,0,2001,0,98065,47.544,-121.87200000000001,4190,13641,7,31,2014,UNK,180,4720
5029450160,8/15/2014,222000.0,3,2.0,1440,7187,1.0,0.0,0.0,4,7,970,470,1981,0,98023,47.291000000000004,-122.368,1440,7187,8,15,2014,UNK,0,0
3526069070,5/28/2014,799000.0,4,3.0,2580,209523,2.0,0.0,0.0,3,8,2580,0,1984,0,98053,47.6932,-122.006,3440,213444,5,28,2014,UNK,-860,-3921
5104540240,6/9/2014,609900.0,4,2.5,3190,7399,2.0,0.0,0.0,3,10,3190,0,2006,0,98038,47.3558,-122.00399999999999,3250,7323,6,9,2014,N,-60,76
3438500486,10/16/2014,413000.0,4,3.5,2380,5809,2.0,0.0,0.0,4,7,1750,630,1995,0,98106,47.5536,-122.359,1620,5775,10,16,2014,UNK,760,34
5102400105,10/13/2014,400000.0,4,1.0,1420,4875,1.5,0.0,0.0,3,7,1420,0,1930,0,98115,47.6942,-122.321,1110,5413,10,13,2014,UNK,310,-538
2346200030,1/5/2015,802541.0,5,2.75,2990,6768,2.0,0.0,0.0,3,9,2990,0,2014,0,98006,47.5462,-122.182,2870,6768,1,5,2015,N,120,0
1321710030,5/19/2014,320000.0,3,2.5,2680,7757,2.0,0.0,0.0,3,8,2680,0,1990,0,98023,47.2918,-122.346,2430,8231,5,19,2014,UNK,250,-474
7853290030,3/11/2015,507000.0,4,2.5,2730,7649,2.0,0.0,0.0,3,7,2730,0,2006,0,98065,47.5441,-121.882,2730,6216,3,11,2015,N,0,1433
1566100400,9/24/2014,387500.0,3,1.0,1220,8329,1.0,0.0,0.0,3,6,1220,0,1946,0,98115,47.6982,-122.29799999999999,1490,8322,9,24,2014,UNK,-270,7
1775800800,2/24/2015,396000.0,3,1.0,1500,12616,1.0,0.0,0.0,3,7,1500,0,1967,0,98072,47.7415,-122.101,1820,13950,2,24,2015,UNK,-320,-1334
9133600075,8/21/2014,373000.0,3,1.75,1830,11788,1.0,0.0,1.0,3,8,1430,400,1958,0,98055,47.4862,-122.22399999999999,2140,11964,8,21,2014,UNK,-310,-176
5450900060,9/23/2014,1480000.0,5,2.5,4570,19252,2.0,0.0,0.0,5,10,4570,0,1965,0,98040,47.5553,-122.22,3180,13314,9,23,2014,UNK,1390,5938
1402600700,7/21/2014,359900.0,4,2.25,2470,7698,2.0,0.0,0.0,3,8,2470,0,1983,0,98058,47.4406,-122.141,2330,7986,7,21,2014,UNK,140,-288
8024200350,3/4/2015,410000.0,2,1.0,800,4342,1.0,0.0,0.0,3,6,670,130,1927,0,98115,47.6997,-122.316,1210,4343,3,4,2015,UNK,-410,-1
3121500340,7/12/2014,690000.0,4,2.5,2900,23488,2.0,0.0,0.0,3,9,2900,0,1992,0,98053,47.6726,-122.03,2900,34589,7,12,2014,UNK,0,-11101
7697870860,6/25/2014,245000.0,3,2.0,1410,5760,1.0,0.0,0.0,3,7,1410,0,1985,0,98030,47.3702,-122.185,1670,6222,6,25,2014,UNK,-260,-462
7527200030,12/29/2014,700000.0,5,2.5,2830,25958,1.0,0.0,1.0,5,8,1610,1220,1979,0,98075,47.5896,-122.083,2670,21567,12,29,2014,UNK,160,4391
2013200390,9/22/2014,268000.0,4,1.75,1680,9966,1.0,0.0,0.0,3,7,1100,580,1977,0,98198,47.3923,-122.311,2400,10369,9,22,2014,UNK,-720,-403
766500030,6/10/2014,225000.0,3,1.75,1760,26055,1.0,0.0,0.0,3,7,920,840,1979,0,98042,47.3664,-122.1,1350,13475,6,10,2014,UNK,410,12580
6664000030,10/9/2014,980000.0,4,2.25,2240,11034,2.0,0.0,0.0,3,8,2240,0,1976,0,98004,47.5894,-122.195,2300,11550,10,9,2014,UNK,-60,-516
9349900105,4/7/2015,795000.0,2,1.0,1380,5000,1.5,0.0,2.0,3,5,1380,0,1905,0,98106,47.5708,-122.359,1500,5000,4,7,2015,UNK,-120,0
1895000045,5/4/2015,195000.0,2,1.0,820,5100,1.0,0.0,0.0,3,6,820,0,1953,0,98118,47.5156,-122.262,1170,5304,5,4,2015,UNK,-350,-204
6205500030,11/3/2014,480000.0,4,2.0,2180,10575,1.0,0.0,0.0,2,6,1730,450,1950,0,98005,47.589,-122.177,2180,12010,11,3,2014,UNK,0,-1435
7011200260,12/19/2014,485000.0,4,2.0,1400,3600,1.0,0.0,0.0,3,7,1100,300,1900,0,98119,47.6385,-122.37,1630,2048,12,19,2014,UNK,-230,1552
41000454,8/15/2014,130000.0,2,1.0,880,9000,1.0,0.0,0.0,3,5,880,0,1928,0,98188,47.4672,-122.291,1410,10000,8,15,2014,UNK,-530,-1000
7203600550,8/4/2014,325000.0,2,1.0,1060,5703,1.0,0.0,2.0,4,6,1060,0,1946,0,98198,47.3444,-122.32700000000001,2240,4416,8,4,2014,UNK,-1180,1287
9477200560,4/13/2015,440000.0,3,1.75,1530,7245,1.0,0.0,0.0,4,7,1530,0,1984,0,98034,47.731,-122.191,1530,7490,4,13,2015,UNK,0,-245
4022907770,10/14/2014,550000.0,4,1.75,2480,14782,1.0,0.0,3.0,3,8,1460,1020,1958,0,98155,47.7646,-122.271,2910,10800,10,14,2014,UNK,-430,3982
5231000060,8/5/2014,310000.0,3,1.75,1490,7150,1.0,0.0,0.0,5,6,1490,0,1967,0,98059,47.5015,-122.124,1350,9100,8,5,2014,UNK,140,-1950
6055000310,7/1/2014,530000.0,3,2.5,3660,39478,2.0,0.0,2.0,4,9,3260,400,1989,0,98022,47.2413,-121.97200000000001,2700,38312,7,1,2014,UNK,960,1166
3216900060,6/25/2014,390000.0,4,2.5,2340,8548,2.0,0.0,0.0,3,8,2340,0,1993,0,98031,47.4206,-122.18299999999999,1970,6818,6,25,2014,UNK,370,1730
7967200060,9/8/2014,243000.0,3,1.75,1450,12125,1.0,0.0,0.0,4,7,1450,0,1981,0,98001,47.3575,-122.28,1210,12125,9,8,2014,UNK,240,0
8077210350,7/22/2014,639000.0,4,2.5,2210,9875,2.0,0.0,0.0,3,9,2210,0,1990,0,98074,47.6285,-122.025,2440,8799,7,22,2014,UNK,-230,1076
7203000640,9/18/2014,215000.0,4,1.0,1130,7400,1.0,0.0,0.0,4,7,1130,0,1969,0,98003,47.3437,-122.316,1540,7379,9,18,2014,UNK,-410,21
2988000070,3/4/2015,405000.0,5,1.75,1550,10500,1.0,0.0,0.0,3,7,1100,450,1961,0,98011,47.7573,-122.22,1420,9823,3,4,2015,UNK,130,677
3832200070,12/22/2014,250000.0,4,1.75,1710,7140,1.0,0.0,0.0,5,7,1010,700,1968,0,98032,47.3745,-122.275,1770,8960,12,22,2014,UNK,-60,-1820
3670500710,7/15/2014,405500.0,3,1.5,1010,8108,1.0,0.0,0.0,5,7,1010,0,1954,0,98155,47.7359,-122.309,1300,8108,7,15,2014,UNK,-290,0
8820903380,7/28/2014,452000.0,6,2.25,2660,13579,2.0,0.0,0.0,3,7,2660,0,1937,1990,98125,47.7142,-122.286,1120,8242,7,28,2014,Y,1540,5337
8820903380,1/2/2015,730000.0,6,2.25,2660,13579,2.0,0.0,0.0,3,7,2660,0,1937,1990,98125,47.7142,-122.286,1120,8242,1,2,2015,Y,1540,5337
4233400400,4/14/2015,267000.0,3,2.0,1300,9644,1.0,0.0,0.0,3,7,1300,0,1994,0,98010,47.3131,-121.99799999999999,1430,9656,4,14,2015,UNK,-130,-12
3793500550,8/8/2014,289950.0,3,2.5,1670,6186,2.0,0.0,0.0,3,7,1670,0,2002,0,98038,47.3668,-122.031,2390,6924,8,8,2014,UNK,-720,-738
6431000270,7/28/2014,565000.0,2,1.0,960,4080,1.0,0.0,0.0,5,7,960,0,1911,0,98103,47.6893,-122.34899999999999,1300,4080,7,28,2014,UNK,-340,0
2225059214,8/8/2014,1580000.0,4,3.25,4670,51836,2.0,0.0,0.0,4,12,4670,0,1988,0,98005,47.635,-122.164,4230,41075,8,8,2014,UNK,440,10761
7694800270,4/20/2015,636000.0,3,2.5,2140,2770,2.0,0.0,0.0,3,8,1770,370,2007,0,98052,47.6664,-122.131,2510,2708,4,20,2015,N,-370,62
2171400197,9/18/2014,350000.0,5,3.0,2520,5500,1.0,0.0,0.0,3,8,1550,970,2004,0,98178,47.4938,-122.255,1700,8000,9,18,2014,N,820,-2500
2473400340,6/4/2014,320000.0,3,1.5,1650,9380,1.0,0.0,0.0,5,7,1130,520,1978,0,98058,47.4525,-122.162,1720,8856,6,4,2014,UNK,-70,524
3530490070,6/13/2014,210000.0,2,1.75,1440,5680,1.0,0.0,0.0,4,8,1440,0,1978,0,98198,47.3825,-122.319,1320,3547,6,13,2014,UNK,120,2133
1932300075,9/10/2014,245000.0,2,1.0,1050,5900,1.0,0.0,0.0,3,7,1050,0,1950,0,98126,47.5326,-122.376,1280,5900,9,10,2014,UNK,-230,0
2525000510,11/6/2014,328000.0,3,1.75,1470,7650,1.0,0.0,0.0,3,7,1130,340,1983,0,98059,47.4818,-122.161,1590,7500,11,6,2014,UNK,-120,150
1853000510,5/9/2014,985000.0,4,2.25,4230,37769,2.0,0.0,0.0,3,11,4230,0,1989,0,98077,47.7287,-122.07700000000001,3890,37034,5,9,2014,UNK,340,735
1742800060,6/12/2014,501000.0,3,1.75,1970,7972,1.0,0.0,3.0,5,8,1370,600,1976,0,98055,47.4908,-122.225,2460,9796,6,12,2014,UNK,-490,-1824
2723089104,9/17/2014,315000.0,3,2.25,1540,17424,2.0,0.0,0.0,3,7,1540,0,1992,0,98045,47.4429,-121.759,1560,11439,9,17,2014,UNK,-20,5985
2619950350,5/8/2014,403000.0,3,2.75,2090,8354,2.0,0.0,0.0,3,8,2090,0,2012,0,98019,47.7336,-121.965,2280,6348,5,8,2014,N,-190,2006
4021100045,7/15/2014,550000.0,3,2.0,2380,17950,2.0,0.0,0.0,4,8,2110,270,1934,0,98155,47.7591,-122.28,2030,23900,7,15,2014,UNK,350,-5950
731500200,1/13/2015,347500.0,4,2.5,2156,3562,2.0,0.0,0.0,3,9,2156,0,2012,0,98030,47.3591,-122.20100000000001,1708,3539,1,13,2015,N,448,23
2591820310,10/6/2014,365000.0,4,2.25,2070,8893,2.0,0.0,0.0,4,8,2070,0,1986,0,98058,47.4388,-122.162,2390,7700,10,6,2014,UNK,-320,1193
3626039299,2/24/2015,588000.0,3,1.0,1910,8167,1.0,0.0,0.0,4,8,1270,640,1951,0,98117,47.7004,-122.368,1500,6816,2,24,2015,UNK,410,1351
9346980140,8/20/2014,605000.0,3,1.75,1920,7400,1.0,0.0,0.0,4,8,1260,660,1977,0,98006,47.5633,-122.131,2360,8048,8,20,2014,UNK,-440,-648
6613000140,11/13/2014,1300000.0,3,3.25,3400,5979,2.0,0.0,0.0,4,9,2290,1110,1937,0,98105,47.6585,-122.273,3090,6435,11,13,2014,UNK,310,-456
8159610060,11/19/2014,233000.0,3,2.0,1400,9177,1.0,0.0,0.0,3,7,1400,0,1974,0,98001,47.3415,-122.272,2020,8547,11,19,2014,UNK,-620,630
7830800339,7/28/2014,360000.0,4,2.5,2210,17715,2.0,0.0,0.0,3,8,2210,0,1997,0,98030,47.3818,-122.2,2210,16907,7,28,2014,UNK,0,808
1588600045,12/15/2014,459000.0,2,1.75,1170,4887,1.0,0.0,0.0,3,6,1020,150,1929,0,98117,47.695,-122.366,1170,5441,12,15,2014,UNK,0,-554
826069046,11/7/2014,740000.0,3,2.0,2100,72745,1.0,0.0,0.0,4,9,2100,0,1995,0,98077,47.7479,-122.06200000000001,2290,54885,11,7,2014,UNK,-190,17860
1771000890,9/17/2014,305000.0,3,1.0,1160,9750,1.0,0.0,0.0,3,7,1160,0,1967,0,98077,47.7422,-122.073,1160,9650,9,17,2014,UNK,0,100
3300701170,6/20/2014,395000.0,3,1.0,1500,4000,1.0,0.0,0.0,3,6,900,600,1925,0,98117,47.6921,-122.38,950,4000,6,20,2014,UNK,550,0
7340500270,1/23/2015,560000.0,4,2.5,2940,6000,2.0,0.0,0.0,3,8,2940,0,2000,0,98011,47.7533,-122.198,2510,6600,1,23,2015,UNK,430,-600
9277200111,7/14/2014,650000.0,4,1.75,2010,5070,1.0,0.0,1.0,4,7,1300,710,1963,0,98116,47.5793,-122.402,2180,5400,7,14,2014,UNK,-170,-330
293720140,6/5/2014,449950.0,3,2.5,2170,4912,2.0,0.0,0.0,3,7,2170,0,2003,0,98028,47.7767,-122.23899999999999,2010,4395,6,5,2014,UNK,160,517
579003610,2/24/2015,517500.0,3,1.5,1430,5200,1.0,0.0,3.0,4,7,1250,180,1940,0,98117,47.6988,-122.387,2210,6240,2,24,2015,UNK,-780,-1040
1138020200,9/3/2014,435000.0,4,1.5,1510,6460,1.0,0.0,0.0,3,7,1070,440,1970,0,98034,47.7121,-122.214,1450,6630,9,3,2014,UNK,60,-170
3432500200,4/9/2015,329999.0,3,1.0,1150,6908,1.0,0.0,0.0,3,6,800,350,1952,0,98155,47.7447,-122.31299999999999,1150,6908,4,9,2015,UNK,0,0
1563102435,12/10/2014,950000.0,3,1.75,2150,4200,1.0,0.0,4.0,5,8,1140,1010,1960,0,98116,47.5671,-122.405,2510,7500,12,10,2014,UNK,-360,-3300
3959400710,7/30/2014,447000.0,3,1.0,1370,6001,1.0,0.0,0.0,5,7,1230,140,1944,0,98108,47.5646,-122.31700000000001,1370,5520,7,30,2014,UNK,0,481
8682300890,8/28/2014,699800.0,2,2.5,2380,6600,1.0,0.0,0.0,3,8,2380,0,2010,0,98053,47.717,-122.02,1870,6600,8,28,2014,N,510,0
4385700765,6/3/2014,850000.0,3,1.75,1370,3850,1.0,0.0,0.0,5,7,770,600,1911,1988,98112,47.6374,-122.279,1390,3600,6,3,2014,Y,-20,250
5149300200,9/2/2014,316500.0,3,1.75,1600,14250,1.0,0.0,0.0,3,7,1070,0,1979,0,98023,47.3272,-122.355,2140,14960,9,2,2014,UNK,-540,-710
9323600060,7/15/2014,942500.0,5,3.5,3750,9612,1.0,0.0,2.0,4,9,2030,1720,1981,0,98006,47.5511,-122.15700000000001,3270,9688,7,15,2014,UNK,480,-76
9273200140,1/21/2015,1310000.0,2,2.25,3950,3938,2.0,0.0,4.0,3,10,2910,1040,1991,0,98116,47.5912,-122.384,3220,4500,1,21,2015,UNK,730,-562
9542300320,2/2/2015,856600.0,4,2.25,2400,13430,1.0,0.0,0.0,4,9,2400,0,1964,0,98005,47.5987,-122.178,2580,10077,2,2,2015,UNK,-180,3353
770000045,10/24/2014,405600.0,5,1.5,2830,4000,2.5,0.0,0.0,4,8,2830,0,1918,0,98118,47.5132,-122.262,1480,4000,10,24,2014,UNK,1350,0
6979900390,5/29/2014,565000.0,4,2.5,2440,22594,2.0,0.0,0.0,3,8,2440,0,1996,0,98053,47.6333,-121.97,2560,33341,5,29,2014,UNK,-120,-10747
6379500159,9/11/2014,400000.0,3,2.25,1190,1149,2.0,0.0,0.0,3,8,1050,140,2008,0,98116,47.5818,-122.387,1210,1316,9,11,2014,N,-20,-167
826079094,3/24/2015,330000.0,3,2.0,1400,218252,1.0,0.0,0.0,3,7,1400,0,1997,0,98019,47.7576,-121.934,2230,218222,3,24,2015,UNK,-830,30
8856940060,2/27/2015,374950.0,4,2.75,2730,4683,2.0,0.0,0.0,3,7,2730,0,2005,0,98038,47.3608,-122.04299999999999,2230,4924,2,27,2015,N,500,-241
2972300060,12/17/2014,405300.0,3,2.75,2390,7939,1.0,0.0,0.0,5,7,1610,780,1983,0,98056,47.4987,-122.166,1920,7939,12,17,2014,UNK,470,0
3575200070,11/4/2014,560000.0,3,2.25,2060,31400,2.0,0.0,0.0,3,8,2060,0,1984,0,98074,47.6216,-122.056,2160,34500,11,4,2014,UNK,-100,-3100
8146100270,3/24/2015,824000.0,4,2.25,2490,9864,1.0,0.0,0.0,4,8,1290,1200,1961,0,98004,47.6051,-122.195,2360,9864,3,24,2015,UNK,130,0
8648200030,7/16/2014,260000.0,3,1.75,1100,10968,1.0,0.0,0.0,5,7,1100,0,1984,0,98042,47.363,-122.08,1400,7799,7,16,2014,UNK,-300,3169
208500160,1/7/2015,760000.0,4,2.5,2430,6099,1.0,0.0,0.0,5,8,1470,960,1965,0,98115,47.6777,-122.287,2180,6099,1,7,2015,UNK,250,0
1196003428,6/24/2014,405000.0,3,2.5,3170,12750,2.0,0.0,0.0,3,10,2360,810,1995,0,98023,47.3384,-122.336,2970,13125,6,24,2014,UNK,200,-375
5104450990,6/19/2014,429900.0,4,2.5,2640,8625,2.0,0.0,0.0,3,8,2640,0,1987,0,98058,47.4598,-122.15,2240,8700,6,19,2014,UNK,400,-75
3343901234,11/13/2014,341500.0,3,1.5,1130,7223,1.0,0.0,0.0,4,7,1130,0,1961,0,98056,47.5089,-122.189,1320,7356,11,13,2014,UNK,-190,-133
226039214,6/12/2014,465250.0,5,2.0,1940,7642,1.5,0.0,0.0,3,7,1940,0,1957,0,98177,47.7751,-122.38,1940,8724,6,12,2014,UNK,0,-1082
1623300160,5/6/2014,450000.0,2,2.0,1100,3000,1.5,0.0,0.0,3,7,1100,0,1912,2005,98117,47.6797,-122.36200000000001,1390,4000,5,6,2014,Y,-290,-1000
2205500575,2/9/2015,390000.0,3,1.0,1200,10800,1.0,0.0,0.0,4,7,1200,0,1955,0,98006,47.5771,-122.14399999999999,1370,9950,2,9,2015,UNK,-170,850
4040800810,5/2/2014,420000.0,3,2.25,2000,8030,1.0,0.0,0.0,4,8,1000,1000,1963,0,98008,47.6188,-122.11399999999999,2070,8250,5,2,2014,UNK,-70,-220
2612000390,6/15/2014,269950.0,3,2.5,1890,4838,2.0,0.0,0.0,3,8,1730,160,2002,0,98168,47.4802,-122.279,1910,7409,6,15,2014,UNK,-20,-2571
3814400125,10/16/2014,493000.0,4,2.0,1910,2874,1.0,0.0,0.0,3,7,1060,850,1910,0,98122,47.6101,-122.295,1520,2874,10,16,2014,UNK,390,0
7300400060,5/15/2014,370000.0,4,2.5,2710,5880,2.0,0.0,0.0,3,9,2710,0,1998,0,98092,47.3314,-122.17200000000001,2520,6000,5,15,2014,UNK,190,-120
1954700695,6/12/2014,2250000.0,5,4.25,4860,9453,1.5,0.0,1.0,5,10,3100,1760,1905,0,98112,47.6196,-122.286,3150,8557,6,12,2014,UNK,1710,896
7230200340,2/25/2015,305000.0,3,1.0,1250,23680,1.0,0.0,0.0,5,7,1250,0,1967,0,98059,47.475,-122.11,1450,23680,2,25,2015,UNK,-200,0
3191000240,6/12/2014,400000.0,3,1.75,1590,8219,1.5,0.0,0.0,5,6,970,620,1938,0,98034,47.7146,-122.21700000000001,2030,7504,6,12,2014,UNK,-440,715
1139000069,11/18/2014,320000.0,3,1.5,1240,1221,2.0,0.0,0.0,3,8,1050,190,2009,0,98133,47.7073,-122.35600000000001,1180,887,11,18,2014,N,60,334
5693500270,1/21/2015,715000.0,4,1.0,2000,4800,2.0,0.0,0.0,4,7,2000,0,1911,0,98103,47.6583,-122.351,1260,1452,1,21,2015,UNK,740,3348
686500030,12/2/2014,650000.0,6,2.75,3610,10003,1.5,0.0,0.0,4,8,3610,0,1966,0,98008,47.6261,-122.125,2560,10004,12,2,2014,UNK,1050,-1
8731901940,3/4/2015,218000.0,5,1.75,1930,8040,1.0,0.0,0.0,4,8,1930,0,1966,0,98023,47.3109,-122.376,2370,8000,3,4,2015,UNK,-440,40
2688100071,4/15/2015,500000.0,2,1.0,1280,5400,1.0,0.0,0.0,3,7,1280,0,1964,0,98117,47.6949,-122.37100000000001,1540,5670,4,15,2015,UNK,-260,-270
2423069155,11/20/2014,460000.0,4,2.0,2090,40419,1.0,0.0,0.0,4,7,2090,0,1984,0,98027,47.4691,-121.993,2380,63162,11,20,2014,UNK,-290,-22743
2329500260,7/9/2014,232500.0,3,1.5,1940,9887,1.0,0.0,0.0,4,7,1140,800,1969,0,98003,47.3289,-122.32700000000001,1410,9936,7,9,2014,UNK,530,-49
2608300030,5/16/2014,408200.0,3,2.5,1800,5761,2.0,0.0,0.0,4,7,1800,0,1990,0,98106,47.5293,-122.363,1800,5952,5,16,2014,UNK,0,-191
1494300060,6/11/2014,522000.0,3,1.75,1730,8400,1.0,0.0,0.0,4,7,1400,330,1980,0,98052,47.6792,-122.115,1830,8636,6,11,2014,UNK,-100,-236
7504101230,6/23/2014,675000.0,4,2.5,2810,11120,2.0,0.0,0.0,3,9,2810,0,1982,0,98074,47.6337,-122.044,3100,12672,6,23,2014,UNK,-290,-1552
8081020370,7/9/2014,1360000.0,4,3.5,3550,11000,1.0,0.0,2.0,3,11,2260,1290,1999,0,98006,47.5506,-122.134,4100,10012,7,9,2014,UNK,-550,988
1446800511,10/9/2014,249950.0,4,1.0,1330,7980,1.5,0.0,0.0,3,6,1330,0,1952,0,98168,47.492,-122.333,1570,8588,10,9,2014,UNK,-240,-608
1623049062,3/4/2015,210000.0,2,1.0,750,34133,1.0,0.0,0.0,3,6,750,0,1950,0,98168,47.4781,-122.294,1460,25792,3,4,2015,UNK,-710,8341
6145601000,7/11/2014,429950.0,4,1.0,1760,7216,1.0,0.0,0.0,3,7,1090,670,1947,0,98133,47.7041,-122.355,1180,3844,7,11,2014,UNK,580,3372
205000520,10/6/2014,737500.0,4,2.5,3200,36276,2.0,0.0,0.0,3,9,3200,0,1993,0,98053,47.6304,-121.994,2930,33171,10,6,2014,UNK,270,3105
3885805935,9/26/2014,710000.0,4,2.0,1740,9000,1.0,0.0,0.0,5,8,1740,0,1958,0,98033,47.6815,-122.198,1850,7700,9,26,2014,UNK,-110,1300
7852020640,10/20/2014,470000.0,3,2.5,2100,4700,2.0,0.0,0.0,3,8,2100,0,1999,0,98065,47.5341,-121.867,2100,4700,10,20,2014,UNK,0,0
6838800140,2/24/2015,1100000.0,4,3.5,4270,40097,1.0,0.0,0.0,4,12,4270,0,1993,0,98077,47.7354,-122.07799999999999,3510,36149,2,24,2015,UNK,760,3948
4083305445,8/15/2014,650000.0,3,2.0,1340,2720,1.5,0.0,0.0,3,7,1340,0,1913,0,98103,47.6518,-122.335,2030,4590,8,15,2014,UNK,-690,-1870
7855801610,5/19/2014,1220000.0,4,2.5,3190,8684,1.0,0.0,3.0,5,9,1680,1510,1967,0,98006,47.5619,-122.162,3160,8684,5,19,2014,UNK,30,0
7940700260,1/15/2015,422120.0,3,2.5,1630,4534,2.0,0.0,0.0,3,8,1630,0,1987,0,98034,47.7148,-122.205,1380,4779,1,15,2015,UNK,250,-245
8854100350,1/7/2015,625000.0,5,2.5,2990,15085,2.0,0.0,0.0,3,9,2990,0,2007,0,98011,47.746,-122.21799999999999,3150,13076,1,7,2015,N,-160,2009
4365200860,6/6/2014,385200.0,4,1.0,1550,7740,1.5,0.0,0.0,3,6,1550,0,1954,0,98126,47.5222,-122.375,1220,7740,6,6,2014,UNK,330,0
3904980030,4/14/2015,500000.0,3,2.25,1690,4964,2.0,0.0,0.0,3,8,1690,0,1989,0,98029,47.5756,-122.01,1800,5036,4,14,2015,UNK,-110,-72
7843500070,11/18/2014,308000.0,4,2.25,1960,12243,2.0,0.0,0.0,3,8,1960,0,1989,0,98042,47.3405,-122.05799999999999,1910,12230,11,18,2014,UNK,50,13
6067900060,6/5/2014,565000.0,3,2.75,2390,9966,1.0,0.0,0.0,5,8,1360,1030,1977,0,98006,47.5433,-122.185,2140,10713,6,5,2014,UNK,250,-747
7202340960,9/8/2014,581000.0,3,2.5,2600,4438,2.0,0.0,0.0,3,7,2600,0,2004,0,98053,47.6799,-122.03399999999999,2600,4904,9,8,2014,N,0,-466
1786640070,8/6/2014,361000.0,3,2.0,1950,8698,1.0,0.0,0.0,3,8,1950,0,1999,0,98042,47.39,-122.15299999999999,2330,7212,8,6,2014,UNK,-380,1486
259600260,1/22/2015,345000.0,3,1.0,1250,7210,1.0,0.0,0.0,4,7,1250,0,1964,0,98008,47.6329,-122.12100000000001,1530,8800,1,22,2015,UNK,-280,-1590
7234600903,10/16/2014,419000.0,2,2.25,1180,1253,2.0,0.0,0.0,3,8,840,340,2008,0,98122,47.6124,-122.309,1310,1963,10,16,2014,N,-130,-710
4307350200,5/12/2015,347000.0,3,2.5,1680,4308,2.0,0.0,0.0,3,7,1680,0,2004,0,98056,47.4802,-122.179,2160,4182,5,12,2015,N,-480,126
3276930400,10/22/2014,625000.0,4,2.25,2220,36085,2.0,0.0,0.0,3,9,2220,0,1989,0,98075,47.5839,-121.991,3000,36906,10,22,2014,UNK,-780,-821
4045100075,3/25/2015,2400000.0,4,4.25,4890,15188,2.0,0.0,2.0,3,11,3090,1800,1999,0,98040,47.5602,-122.227,3470,16201,3,25,2015,UNK,1420,-1013
1421069208,12/23/2014,379000.0,3,3.25,2660,17852,2.5,0.0,0.0,3,8,2660,0,2014,0,98010,47.3077,-122.01100000000001,1320,11876,12,23,2014,N,1340,5976
4057300200,12/22/2014,310000.0,3,1.5,1150,3323,2.0,0.0,0.0,3,7,1150,0,1988,0,98029,47.5707,-122.01700000000001,1150,2980,12,22,2014,UNK,0,343
1922059135,5/13/2015,250000.0,2,2.0,1130,5500,1.0,0.0,0.0,4,6,1130,0,1941,0,98030,47.3839,-122.225,1320,6600,5,13,2015,UNK,-190,-1100
5014600240,8/14/2014,682000.0,5,2.75,2760,5000,2.0,0.0,0.0,3,9,2760,0,2005,0,98059,47.538999999999994,-122.18799999999999,2870,5030,8,14,2014,N,-110,-30
1565900070,7/21/2014,246500.0,3,2.0,1430,8919,1.0,0.0,0.0,3,7,1430,0,1992,0,98022,47.2118,-121.98299999999999,1580,8919,7,21,2014,UNK,-150,0
3121059033,10/29/2014,325000.0,3,1.0,1490,57381,1.5,0.0,0.0,4,5,1490,0,1932,0,98092,47.2597,-122.228,1580,101529,10,29,2014,UNK,-90,-44148
6799300270,8/6/2014,310950.0,4,2.5,2030,4997,2.0,0.0,0.0,3,8,2030,0,2004,0,98031,47.393,-122.184,2095,5500,8,6,2014,N,-65,-503
2021200370,9/1/2014,1100000.0,3,2.0,3010,5000,2.0,0.0,2.0,5,9,1890,1120,1931,0,98199,47.6347,-122.396,2688,5000,9,1,2014,UNK,322,0
726049190,10/2/2014,287500.0,3,1.0,1810,7200,1.0,0.0,0.0,4,7,1130,680,1954,0,98133,47.7493,-122.351,1810,8100,10,2,2014,UNK,0,-900
726049190,2/18/2015,431000.0,3,1.0,1810,7200,1.0,0.0,0.0,4,7,1130,680,1954,0,98133,47.7493,-122.351,1810,8100,2,18,2015,UNK,0,-900
4006000251,8/22/2014,226000.0,3,1.0,970,5000,1.0,0.0,0.0,3,6,970,0,1968,0,98118,47.5282,-122.279,1290,5875,8,22,2014,UNK,-320,-875
3362400640,5/12/2015,825000.0,3,1.75,2010,3090,1.5,0.0,0.0,5,7,1510,500,1926,0,98103,47.681999999999995,-122.348,1600,3150,5,12,2015,UNK,410,-60
1610000016,9/11/2014,175000.0,4,1.0,1300,6030,1.5,0.0,0.0,3,6,1300,0,1947,0,98168,47.4778,-122.286,1240,6900,9,11,2014,UNK,60,-870
7376300060,5/15/2014,465750.0,3,1.5,1260,10350,1.0,0.0,0.0,3,7,1260,0,1959,0,98008,47.6357,-122.12299999999999,1800,10350,5,15,2014,UNK,-540,0
7300200550,3/19/2015,659000.0,4,2.25,2610,24931,2.0,0.0,0.0,3,8,2610,0,1983,0,98075,47.5771,-122.05,2550,18306,3,19,2015,UNK,60,6625
2061100570,2/10/2015,595000.0,3,1.75,1910,5753,1.0,0.0,3.0,3,8,1110,800,1941,0,98115,47.6898,-122.32700000000001,1630,5580,2,10,2015,UNK,280,173
8856890200,6/26/2014,350000.0,3,2.25,1780,16290,2.0,0.0,0.0,4,8,1780,0,1987,0,98058,47.4622,-122.12700000000001,1780,8810,6,26,2014,UNK,0,7480
8731951670,6/6/2014,270000.0,4,2.25,1900,8600,1.0,0.0,0.0,4,8,1900,0,1975,0,98023,47.3102,-122.381,2120,8000,6,6,2014,UNK,-220,600
4037200075,9/11/2014,662500.0,6,2.25,2450,25600,1.0,0.0,2.0,3,7,1340,1110,1957,0,98008,47.6061,-122.117,1850,10230,9,11,2014,UNK,600,15370
5066400483,11/20/2014,249900.0,3,1.75,1380,14000,1.0,0.0,0.0,4,5,1380,0,1939,0,98001,47.294,-122.281,1490,18503,11,20,2014,UNK,-110,-4503
4167300310,3/17/2015,324500.0,3,1.75,1920,11340,1.0,0.0,0.0,4,7,1230,690,1977,0,98023,47.3272,-122.36200000000001,1980,9638,3,17,2015,UNK,-60,1702
8682262400,7/18/2014,430000.0,2,1.75,1350,4003,1.0,0.0,0.0,3,8,1350,0,2004,0,98053,47.7176,-122.03299999999999,1350,4479,7,18,2014,N,0,-476
8682262400,5/13/2015,419950.0,2,1.75,1350,4003,1.0,0.0,0.0,3,8,1350,0,2004,0,98053,47.7176,-122.03299999999999,1350,4479,5,13,2015,N,0,-476
6777800160,7/28/2014,285000.0,4,1.75,2510,7440,1.0,0.0,2.0,4,8,1290,1220,1962,0,98032,47.3748,-122.27600000000001,1790,8000,7,28,2014,UNK,720,-560
1402950550,1/7/2015,332000.0,4,2.5,2470,7780,2.0,0.0,0.0,3,8,2470,0,2002,0,98092,47.3337,-122.191,2100,5972,1,7,2015,UNK,370,1808
2843200070,12/15/2014,282000.0,4,1.75,1660,10725,1.0,0.0,0.0,3,7,960,700,1956,0,98168,47.5033,-122.3,1340,9023,12,15,2014,UNK,320,1702
6450303785,11/18/2014,320000.0,3,1.0,1340,5175,1.0,0.0,0.0,3,7,940,400,1987,0,98133,47.7321,-122.34,1020,5500,11,18,2014,UNK,320,-325
9429500045,5/9/2014,428750.0,3,1.0,1620,30736,1.5,0.0,0.0,4,7,1620,0,1911,1977,98006,47.5719,-122.119,2440,28826,5,9,2014,Y,-820,1910
1443300140,1/14/2015,330000.0,3,2.25,2300,35287,2.0,0.0,0.0,3,8,2300,0,1977,0,98022,47.2477,-121.93700000000001,1760,47916,1,14,2015,UNK,540,-12629
108000127,12/9/2014,456500.0,4,3.5,2000,2309,3.0,0.0,0.0,3,8,2000,0,2008,0,98177,47.7027,-122.361,1440,1548,12,9,2014,N,560,761
1081300200,5/9/2014,352000.0,3,2.25,1640,11050,1.0,0.0,0.0,4,8,1640,0,1972,0,98059,47.4723,-122.12100000000001,1870,11050,5,9,2014,UNK,-230,0
8818900060,11/25/2014,664000.0,4,2.0,1530,4080,1.5,0.0,0.0,4,7,1530,0,1912,0,98105,47.6645,-122.325,1860,4080,11,25,2014,UNK,-330,0
3395050060,7/22/2014,628000.0,3,1.75,4000,11894,1.0,0.0,0.0,3,9,2190,1810,1987,0,98011,47.7738,-122.20299999999999,2530,8650,7,22,2014,UNK,1470,3244
7197350070,3/4/2015,512000.0,3,1.75,1610,12555,1.0,0.0,0.0,3,7,1080,530,1977,0,98052,47.6618,-122.13600000000001,1780,10374,3,4,2015,UNK,-170,2181
9510900270,12/11/2014,254000.0,3,2.0,2070,9000,1.0,0.0,0.0,4,7,1450,620,1969,0,98023,47.3085,-122.376,1630,7885,12,11,2014,UNK,440,1115
3905081070,5/21/2014,535800.0,4,2.5,1900,5790,2.0,0.0,0.0,3,8,1900,0,1994,0,98029,47.5691,-121.99600000000001,2030,5790,5,21,2014,UNK,-130,0
2322069114,10/10/2014,287653.0,3,1.0,1050,16050,1.0,0.0,0.0,4,7,1050,0,1960,1981,98038,47.3841,-122.006,1610,27600,10,10,2014,Y,-560,-11550
5637500070,7/31/2014,438000.0,3,2.5,1520,1304,2.0,0.0,0.0,3,8,1180,340,2006,0,98136,47.5446,-122.385,1270,1718,7,31,2014,N,250,-414
4164100160,7/16/2014,450000.0,4,1.75,2390,23899,1.0,0.0,0.0,3,7,1750,640,1949,0,98028,47.7557,-122.23700000000001,1840,33900,7,16,2014,UNK,550,-10001
4136890260,6/27/2014,327000.0,5,2.75,2400,8050,2.0,0.0,0.0,3,8,2400,0,1998,0,98092,47.2635,-122.209,2400,8050,6,27,2014,UNK,0,0
3056800160,8/12/2014,370500.0,4,2.5,1790,6120,2.0,0.0,0.0,3,7,1790,0,2005,0,98059,47.4829,-122.12799999999999,1950,5660,8,12,2014,N,-160,460
3654800200,10/22/2014,265000.0,3,2.5,1720,6271,2.0,0.0,0.0,3,7,1720,0,1993,0,98038,47.3898,-122.04899999999999,1570,6587,10,22,2014,UNK,150,-316
2296500036,3/10/2015,450000.0,4,2.75,2980,13260,1.0,0.0,0.0,4,8,1800,1180,1979,0,98056,47.5152,-122.197,1920,10731,3,10,2015,UNK,1060,2529
623069068,6/27/2014,425000.0,3,1.0,1520,213444,1.5,0.0,3.0,5,8,1520,0,1988,0,98027,47.5081,-122.09299999999999,2640,213444,6,27,2014,UNK,-1120,0
1865820370,11/13/2014,166600.0,3,1.75,1150,8690,1.0,0.0,0.0,4,7,1150,0,1977,0,98042,47.3729,-122.115,1330,7040,11,13,2014,UNK,-180,1650
1723049033,6/20/2014,245000.0,1,0.75,380,15000,1.0,0.0,0.0,3,5,380,0,1963,0,98168,47.481,-122.323,1170,15000,6,20,2014,UNK,-790,0
2359300030,5/8/2015,565000.0,3,1.0,910,5212,1.0,0.0,0.0,3,7,910,0,1951,0,98115,47.6742,-122.28399999999999,1520,6300,5,8,2015,UNK,-610,-1088
6403310060,8/11/2014,539900.0,3,1.75,1650,10150,1.0,0.0,0.0,3,8,1230,420,1976,0,98033,47.6963,-122.169,1930,8958,8,11,2014,UNK,-280,1192
1937300270,3/3/2015,910000.0,3,3.5,2480,3200,2.0,0.0,0.0,3,10,2480,0,2010,0,98144,47.5951,-122.307,1980,3200,3,3,2015,N,500,0
4137050060,11/4/2014,280000.0,4,2.5,2050,7416,2.0,0.0,0.0,3,8,2050,0,1990,0,98092,47.2658,-122.219,2050,7920,11,4,2014,UNK,0,-504
2310000240,3/13/2015,275000.0,3,2.25,1420,8549,2.0,0.0,0.0,4,7,1420,0,1989,0,98038,47.3576,-122.039,1560,7471,3,13,2015,UNK,-140,1078
3955900830,4/27/2015,467000.0,3,2.5,3460,6590,2.0,0.0,0.0,3,7,3460,0,2001,0,98056,47.4802,-122.18799999999999,2490,6312,4,27,2015,UNK,970,278
8665050060,7/31/2014,457500.0,3,2.5,1500,4445,2.0,0.0,0.0,3,8,1500,0,1996,0,98029,47.5682,-122.005,1730,4408,7,31,2014,UNK,-230,37
3330500875,12/26/2014,381156.0,2,1.0,1320,3090,1.0,0.0,0.0,4,7,1320,0,1908,0,98118,47.5517,-122.27600000000001,1270,4120,12,26,2014,UNK,50,-1030
3327020400,4/23/2015,289999.0,5,2.5,2180,8240,1.0,0.0,0.0,4,8,1220,960,1977,0,98092,47.3122,-122.191,2050,7590,4,23,2015,UNK,130,650
1250700060,4/22/2015,642450.0,3,1.75,1830,4160,1.0,0.0,0.0,3,7,1230,600,1919,0,98144,47.5962,-122.288,1950,4160,4,22,2015,UNK,-120,0
4039300400,9/19/2014,469950.0,3,2.25,1620,8701,1.0,0.0,0.0,3,7,1220,400,1962,0,98007,47.6071,-122.137,1600,7910,9,19,2014,UNK,20,791
6665800060,3/5/2015,795000.0,3,2.0,2920,13650,1.0,0.0,2.0,5,8,1460,1460,1975,0,98033,47.6652,-122.18799999999999,2920,10988,3,5,2015,UNK,0,2662
7504110030,2/11/2015,785000.0,4,2.5,3300,10514,2.0,0.0,0.0,3,10,3300,0,1984,0,98074,47.6323,-122.036,2820,11462,2,11,2015,UNK,480,-948
7805450810,5/30/2014,860000.0,3,2.25,3060,12095,2.0,0.0,0.0,3,10,3060,0,1983,0,98006,47.5611,-122.10600000000001,3060,11455,5,30,2014,UNK,0,640
8802400416,2/13/2015,147500.0,3,1.0,1530,8498,1.0,0.0,0.0,3,7,1530,0,1959,0,98031,47.403999999999996,-122.20299999999999,1380,8498,2,13,2015,UNK,150,0
6204400270,11/25/2014,390000.0,3,2.0,1910,11576,1.0,0.0,0.0,3,7,1410,500,1978,0,98011,47.7356,-122.198,2040,8750,11,25,2014,UNK,-130,2826
9536602080,12/19/2014,229000.0,3,1.0,1020,8100,1.0,0.0,0.0,3,7,1020,0,1954,0,98198,47.3586,-122.314,1020,8100,12,19,2014,UNK,0,0
3826000070,5/15/2014,185000.0,3,1.0,1150,8100,1.0,0.0,0.0,3,6,1150,0,1932,0,98168,47.494,-122.307,1120,8100,5,15,2014,UNK,30,0
5101405335,8/26/2014,414900.0,3,1.5,1260,9570,1.0,0.0,0.0,3,7,870,390,1941,0,98115,47.7004,-122.305,1620,7000,8,26,2014,UNK,-360,2570
2349300060,2/12/2015,200000.0,4,2.0,1920,4822,1.0,0.0,0.0,2,6,920,1000,1914,0,98136,47.5507,-122.381,1120,4822,2,12,2015,UNK,800,0
7749500370,10/21/2014,225000.0,4,2.25,1800,9350,1.0,0.0,0.0,3,8,1800,0,1969,0,98092,47.2959,-122.191,2060,8800,10,21,2014,UNK,-260,550
2436701200,9/12/2014,720000.0,3,1.75,2040,4000,2.0,0.0,0.0,5,7,1360,680,1924,0,98105,47.6675,-122.289,1610,4000,9,12,2014,UNK,430,0
7871500070,6/3/2014,930000.0,4,2.5,2200,4000,2.0,0.0,0.0,5,8,1430,770,1908,0,98119,47.6402,-122.37,2100,4000,6,3,2014,UNK,100,0
3323500030,6/4/2014,1270000.0,5,2.5,3200,17204,1.0,0.0,0.0,3,7,2160,1040,1952,0,98004,47.6209,-122.22200000000001,4090,15732,6,4,2014,UNK,-890,1472
2110200036,11/11/2014,700000.0,5,3.25,2400,3118,2.0,0.0,0.0,4,7,1780,620,1928,0,98122,47.6094,-122.291,2100,3941,11,11,2014,UNK,300,-823
510002519,7/15/2014,466000.0,2,1.5,1140,1058,3.0,0.0,0.0,3,7,1140,0,2005,0,98103,47.6608,-122.333,1170,1116,7,15,2014,N,-30,-58
1387300070,8/25/2014,374000.0,3,1.5,1330,10640,1.0,0.0,0.0,3,7,1330,0,1976,0,98011,47.7364,-122.193,1460,8520,8,25,2014,UNK,-130,2120
9465910070,7/16/2014,480000.0,3,2.5,1940,10035,2.0,0.0,0.0,4,8,1940,0,1994,0,98072,47.7438,-122.17200000000001,2810,8333,7,16,2014,UNK,-870,1702
2324800070,6/10/2014,740000.0,3,2.5,3000,25341,2.0,0.0,0.0,3,9,3000,0,1995,0,98053,47.6724,-122.01299999999999,3000,32417,6,10,2014,UNK,0,-7076
1962200435,11/10/2014,1010000.0,4,1.0,1820,5400,1.5,0.0,0.0,3,8,1820,0,1923,2014,98102,47.6476,-122.318,1820,5400,11,10,2014,Y,0,0
8562890700,5/30/2014,395000.0,4,2.5,2910,5000,2.0,0.0,0.0,3,8,2910,0,2002,0,98042,47.3782,-122.12700000000001,2740,5045,5,30,2014,UNK,170,-45
3298700946,7/25/2014,340000.0,2,1.0,1090,6771,1.0,0.0,0.0,3,6,1090,0,1954,0,98106,47.5185,-122.352,1200,4992,7,25,2014,UNK,-110,1779
880000189,8/11/2014,209000.0,3,2.0,1230,1340,2.0,0.0,0.0,3,7,1020,210,2003,0,98106,47.526,-122.361,1260,1312,8,11,2014,UNK,-30,28
643500030,11/14/2014,431650.0,5,2.5,1710,7700,1.5,0.0,0.0,3,7,1710,0,1962,0,98007,47.5922,-122.146,1530,7700,11,14,2014,UNK,180,0
8566100200,5/8/2014,980000.0,5,2.5,3160,11470,1.0,0.0,0.0,4,9,1780,1380,1971,0,98040,47.5368,-122.21600000000001,3260,11470,5,8,2014,UNK,-100,0
4298100240,8/5/2014,660000.0,3,2.5,2680,28243,2.0,0.0,0.0,3,9,2680,0,1993,0,98077,47.7637,-122.05,2670,32130,8,5,2014,UNK,10,-3887
3275780030,3/11/2015,730000.0,4,2.25,2190,9009,2.0,0.0,0.0,4,8,1840,350,1977,0,98033,47.6916,-122.18799999999999,2190,10251,3,11,2015,UNK,0,-1242
8648220270,4/14/2015,291500.0,3,1.75,1260,9600,1.0,0.0,0.0,4,7,1260,0,1988,0,98042,47.3592,-122.07600000000001,1640,9946,4,14,2015,UNK,-380,-346
1923000160,6/20/2014,905000.0,4,3.5,2970,14486,2.0,0.0,0.0,3,9,2340,630,1997,0,98040,47.5627,-122.215,3680,14486,6,20,2014,UNK,-710,0
7574910860,8/11/2014,800000.0,4,2.5,2570,50308,1.5,0.0,0.0,3,10,2570,0,1993,0,98077,47.7418,-122.039,3420,37891,8,11,2014,UNK,-850,12417
2296500136,5/9/2014,839900.0,4,3.5,3810,13592,1.0,0.0,1.0,3,9,2560,1250,2013,0,98056,47.5134,-122.2,3230,9311,5,9,2014,N,580,4281
3278600710,7/14/2014,200000.0,1,1.5,1010,1157,2.0,0.0,0.0,3,8,950,60,2007,0,98126,47.5492,-122.37200000000001,1360,1688,7,14,2014,N,-350,-531
2460700260,2/18/2015,300000.0,3,2.0,1480,6698,1.0,0.0,0.0,4,7,1080,400,1979,0,98058,47.4614,-122.16799999999999,1850,7348,2,18,2015,UNK,-370,-650
3188100400,6/3/2014,530000.0,3,1.75,1250,6041,1.5,0.0,0.0,5,7,1250,0,1942,0,98115,47.69,-122.304,1180,6042,6,3,2014,UNK,70,-1
9406520830,3/26/2015,314950.0,3,2.25,1654,8479,2.0,0.0,0.0,3,7,1654,0,1995,0,98038,47.3627,-122.037,1654,8479,3,26,2015,UNK,0,0
3387900390,10/7/2014,255000.0,3,1.75,1410,9315,1.0,0.0,0.0,5,7,1410,0,1960,0,98031,47.3969,-122.198,1630,8250,10,7,2014,UNK,-220,1065
1596600024,10/16/2014,550000.0,5,2.75,2160,5720,1.0,0.0,0.0,5,7,1500,660,1950,0,98144,47.5728,-122.304,2160,4996,10,16,2014,UNK,0,724
7625701891,8/6/2014,435000.0,3,1.0,1400,4800,1.0,0.0,0.0,4,6,700,700,1917,0,98136,47.5499,-122.391,1470,6000,8,6,2014,UNK,-70,-1200
3224800075,11/24/2014,234000.0,3,1.75,1420,8738,1.0,0.0,0.0,4,7,1420,0,1966,0,98002,47.3113,-122.20700000000001,1660,8738,11,24,2014,UNK,-240,0
7526800200,10/10/2014,615000.0,4,2.25,2500,10062,1.0,0.0,0.0,3,8,1600,900,1975,0,98052,47.638999999999996,-122.1,2500,9750,10,10,2014,UNK,0,312
3329530200,9/10/2014,205000.0,3,2.0,1410,8384,1.0,0.0,0.0,3,7,1410,0,1985,0,98001,47.3315,-122.26299999999999,1410,9205,9,10,2014,UNK,0,-821
2115200125,9/19/2014,384000.0,4,1.75,2100,7135,1.0,0.0,0.0,4,7,1050,1050,1955,0,98106,47.5353,-122.34899999999999,1730,4000,9,19,2014,UNK,370,3135
6623400135,5/22/2014,324000.0,3,2.5,1750,7208,2.0,0.0,0.0,3,8,1750,0,1994,0,98055,47.4315,-122.19200000000001,2050,7524,5,22,2014,UNK,-300,-316
103000116,7/22/2014,645000.0,3,1.75,2070,5500,1.0,0.0,0.0,4,7,1130,940,1946,0,98115,47.6733,-122.301,1800,4400,7,22,2014,UNK,270,1100
2768301525,10/23/2014,570000.0,3,3.25,1570,1777,2.0,0.0,0.0,3,8,1260,310,2007,0,98107,47.6655,-122.369,1000,1777,10,23,2014,N,570,0
739980260,12/10/2014,324000.0,3,2.5,1920,5322,2.0,0.0,0.0,3,8,1920,0,1999,0,98031,47.4095,-122.195,1920,5000,12,10,2014,UNK,0,322
4302200695,8/28/2014,270000.0,2,1.0,1000,10320,1.0,0.0,0.0,3,6,1000,0,1943,0,98106,47.527,-122.35600000000001,1100,5160,8,28,2014,UNK,-100,5160
1431700370,5/19/2014,290000.0,5,1.5,2120,7700,1.5,0.0,0.0,5,7,2120,0,1962,0,98058,47.4599,-122.17200000000001,1730,7700,5,19,2014,UNK,390,0
7524000030,6/30/2014,250000.0,3,2.0,1440,9220,1.0,0.0,0.0,3,7,1440,0,1965,0,98198,47.3702,-122.31700000000001,1390,7830,6,30,2014,UNK,50,1390
4046500320,1/20/2015,342000.0,3,1.75,1660,16275,2.0,0.0,0.0,3,7,1660,0,1990,0,98014,47.6903,-121.915,1520,16275,1,20,2015,UNK,140,0
4325000125,3/18/2015,255000.0,3,1.5,1340,8450,1.0,0.0,0.0,4,7,1340,0,1958,0,98188,47.4405,-122.28,1340,8920,3,18,2015,UNK,0,-470
3456000160,6/23/2014,800000.0,3,2.25,2380,11824,1.0,0.0,0.0,4,9,1450,930,1972,0,98040,47.5371,-122.21799999999999,2750,11491,6,23,2014,UNK,-370,333
9297301580,5/16/2014,451000.0,3,1.75,1560,4049,1.5,0.0,2.0,3,7,1000,560,1926,0,98126,47.5666,-122.375,1430,3738,5,16,2014,UNK,130,311
2465400036,12/3/2014,990000.0,4,2.5,2780,10480,1.0,0.0,3.0,3,7,1390,1390,1967,0,98033,47.6597,-122.204,2860,10506,12,3,2014,UNK,-80,-26
5412200270,5/20/2014,288400.0,4,2.5,1860,6687,1.0,0.0,0.0,4,7,1220,640,1983,0,98031,47.4046,-122.186,1860,6117,5,20,2014,UNK,0,570
1109000390,3/10/2015,420000.0,3,1.5,2390,4600,2.0,0.0,0.0,3,8,1750,640,1920,1995,98118,47.5383,-122.26799999999999,1690,5220,3,10,2015,Y,700,-620
8730000270,5/14/2015,359000.0,2,2.75,1370,1140,2.0,0.0,0.0,3,8,1080,290,2009,0,98133,47.7052,-122.34299999999999,1370,1090,5,14,2015,N,0,50
7937600830,8/8/2014,390000.0,4,3.0,2570,262018,1.0,0.0,0.0,3,7,1420,1150,1988,0,98058,47.4417,-122.09,2260,19811,8,8,2014,UNK,310,242207
3395070640,9/2/2014,300000.0,3,2.5,1320,2614,2.0,0.0,0.0,3,7,1320,0,2005,0,98118,47.5355,-122.28299999999999,1320,2533,9,2,2014,N,0,81
8663280160,3/5/2015,545000.0,5,2.5,2520,7863,1.0,0.0,0.0,3,7,1500,1020,1981,0,98034,47.7096,-122.199,2030,8580,3,5,2015,UNK,490,-717
6151800624,4/8/2015,288349.0,3,1.0,1250,18616,1.0,0.0,0.0,4,6,1250,0,1972,0,98010,47.3414,-122.04700000000001,1920,15654,4,8,2015,UNK,-670,2962
8594400370,2/5/2015,299900.0,3,2.25,1560,35026,1.0,0.0,0.0,3,7,1290,270,1985,0,98092,47.3023,-122.069,1660,35160,2,5,2015,UNK,-100,-134
2301400640,7/17/2014,891000.0,4,2.0,2330,5000,1.5,0.0,0.0,5,7,1720,610,1925,0,98117,47.6804,-122.35799999999999,2090,5000,7,17,2014,UNK,240,0
4441300240,3/31/2015,1200000.0,3,2.0,3660,22410,1.0,0.0,3.0,4,9,1830,1830,1947,0,98117,47.6972,-122.4,2680,8250,3,31,2015,UNK,980,14160
7714000070,2/5/2015,378000.0,4,2.5,2790,4650,2.0,0.0,0.0,3,8,2790,0,2004,0,98038,47.3556,-122.02600000000001,2820,4650,2,5,2015,N,-30,0
3432500486,6/23/2014,299995.0,2,1.0,1060,7200,1.0,0.0,0.0,4,6,1060,0,1951,0,98155,47.7463,-122.315,1850,8291,6,23,2014,UNK,-790,-1091
5466420030,10/7/2014,253000.0,3,2.5,2020,6564,1.0,0.0,0.0,3,7,1310,710,1994,0,98042,47.3545,-122.15799999999999,1710,5151,10,7,2014,UNK,310,1413
1324079046,1/20/2015,350000.0,3,2.25,1580,47916,1.0,0.0,0.0,3,7,1580,0,1979,0,98024,47.5583,-121.852,1980,75358,1,20,2015,UNK,-400,-27442
2768301715,3/11/2015,565000.0,4,3.0,2020,4300,1.5,0.0,0.0,3,6,2020,0,1900,0,98107,47.6653,-122.37200000000001,1290,3440,3,11,2015,UNK,730,860
3332000135,6/12/2014,315000.0,2,1.0,970,5665,1.0,0.0,0.0,4,6,970,0,1908,0,98118,47.5513,-122.273,1490,4429,6,12,2014,UNK,-520,1236
65000400,10/22/2014,570000.0,4,3.0,1490,6766,1.5,0.0,1.0,5,7,1490,0,1915,0,98136,47.5446,-122.382,1990,6526,10,22,2014,UNK,-500,240
8820901670,8/11/2014,971000.0,5,3.5,4390,10140,2.0,0.0,0.0,3,9,3350,1040,2005,0,98125,47.7174,-122.28200000000001,2010,8400,8,11,2014,N,2380,1740
8712100575,8/28/2014,915000.0,5,2.5,2750,5589,1.5,0.0,0.0,5,9,1840,910,1910,0,98112,47.6364,-122.3,1460,4250,8,28,2014,UNK,1290,1339
6116500341,1/12/2015,419000.0,4,1.5,2150,23568,1.0,0.0,0.0,4,7,2150,0,1950,0,98166,47.4522,-122.355,2150,10125,1,12,2015,UNK,0,13443
4167300030,2/9/2015,260000.0,4,1.75,1810,7480,1.0,0.0,0.0,3,7,1230,580,1977,0,98023,47.3275,-122.361,1870,9594,2,9,2015,UNK,-60,-2114
2925059135,4/8/2015,1320000.0,3,3.0,2230,12968,2.0,0.0,0.0,3,9,2230,0,1990,0,98004,47.6271,-122.197,2260,10160,4,8,2015,UNK,-30,2808
7708300140,3/6/2015,369950.0,3,1.0,2430,10720,1.0,0.0,0.0,3,7,2430,0,1977,0,98045,47.4895,-121.787,1660,11560,3,6,2015,UNK,770,-840
4139430340,10/15/2014,1030000.0,3,2.5,3680,13384,2.0,0.0,0.0,3,10,3680,0,1994,0,98006,47.5484,-122.119,3600,11306,10,15,2014,UNK,80,2078
3812400070,5/6/2015,435000.0,5,1.0,1410,6750,1.5,0.0,0.0,3,6,1410,0,1929,0,98118,47.5453,-122.27799999999999,1360,6750,5,6,2015,UNK,50,0
9455200445,3/25/2015,601000.0,3,1.75,1330,6743,1.0,0.0,0.0,3,8,1330,0,1958,2002,98125,47.7012,-122.286,2600,7350,3,25,2015,Y,-1270,-607
6203000160,7/16/2014,460500.0,3,1.0,1490,10650,1.0,0.0,0.0,3,7,1150,340,1963,0,98033,47.663000000000004,-122.178,1730,9800,7,16,2014,UNK,-240,850
7517500611,5/21/2014,720000.0,3,2.5,2020,1159,3.0,0.0,3.0,3,8,2020,0,2000,0,98103,47.6617,-122.35600000000001,1920,3600,5,21,2014,UNK,100,-2441
8691300860,4/21/2015,851000.0,4,2.5,3130,13202,2.0,0.0,0.0,3,10,3130,0,1996,0,98075,47.5878,-121.976,2840,10470,4,21,2015,UNK,290,2732
5489200435,9/4/2014,550000.0,4,3.0,2670,5000,2.0,0.0,2.0,3,7,2670,0,1916,0,98126,47.5784,-122.37700000000001,2300,5000,9,4,2014,UNK,370,0
510002065,3/23/2015,700000.0,4,1.0,1980,4560,1.5,0.0,0.0,3,7,1980,0,1920,0,98103,47.6606,-122.331,1810,3245,3,23,2015,UNK,170,1315
252000400,9/8/2014,323000.0,3,1.75,2100,14850,1.0,0.0,0.0,4,7,2100,0,1963,0,98042,47.3622,-122.059,1930,17238,9,8,2014,UNK,170,-2388
7279300070,9/22/2014,345500.0,3,1.0,1350,8581,1.0,0.0,0.0,5,6,1350,0,1944,0,98177,47.7612,-122.36200000000001,2080,8451,9,22,2014,UNK,-730,130
8113101670,12/3/2014,378000.0,4,1.5,2140,7920,1.0,0.0,0.0,3,7,1190,950,1959,0,98118,47.5491,-122.272,2140,7238,12,3,2014,UNK,0,682
7578200310,11/12/2014,650000.0,4,2.0,2208,5000,3.0,0.0,0.0,5,8,2208,0,1917,0,98116,47.5711,-122.383,1760,5000,11,12,2014,UNK,448,0
7715800570,4/13/2015,385000.0,3,2.0,1010,7380,1.0,0.0,0.0,3,7,1010,0,1982,0,98074,47.6273,-122.06200000000001,1650,9030,4,13,2015,UNK,-640,-1650
6852700478,9/16/2014,425000.0,2,1.0,970,2970,1.0,0.0,0.0,3,7,970,0,1910,0,98102,47.6233,-122.319,1670,3000,9,16,2014,UNK,-700,-30
1917300260,12/2/2014,210000.0,4,2.0,1520,6174,1.5,0.0,0.0,5,6,1520,0,1920,0,98022,47.2105,-121.98899999999999,1390,5407,12,2,2014,UNK,130,767
4298100070,5/28/2014,630000.0,4,2.5,2740,43101,2.0,0.0,0.0,3,9,2740,0,1993,0,98077,47.7649,-122.04899999999999,2740,33447,5,28,2014,UNK,0,9654
1842000140,7/30/2014,335000.0,3,1.75,1570,7500,1.0,0.0,1.0,3,7,1300,270,1953,0,98146,47.4999,-122.368,1590,7660,7,30,2014,UNK,-20,-160
5462100240,6/25/2014,196500.0,3,1.0,1320,9000,1.0,0.0,0.0,3,7,1320,0,1966,0,98001,47.3461,-122.272,1320,9800,6,25,2014,UNK,0,-800
8651520510,5/15/2014,582800.0,4,2.75,2550,7636,1.0,0.0,0.0,3,8,1440,1110,1986,0,98074,47.6471,-122.06,2290,8223,5,15,2014,UNK,260,-587
3578110200,6/23/2014,440000.0,3,1.75,1560,7207,1.0,0.0,0.0,3,7,1250,310,1983,0,98034,47.7283,-122.22200000000001,1540,7485,6,23,2014,UNK,20,-278
7555210340,8/25/2014,752500.0,4,2.25,2360,8616,2.0,0.0,0.0,4,8,2360,0,1974,0,98033,47.6495,-122.198,2360,9337,8,25,2014,UNK,0,-721
2313900510,10/28/2014,532500.0,3,1.75,1330,5000,2.0,0.0,0.0,4,7,1210,120,1909,0,98116,47.5724,-122.384,1500,4000,10,28,2014,UNK,-170,1000
2009001600,5/6/2015,265000.0,3,1.0,1070,9000,1.0,0.0,0.0,4,7,1070,0,1950,0,98198,47.4061,-122.33,1840,12000,5,6,2015,UNK,-770,-3000
1455100116,2/2/2015,397500.0,3,1.25,1510,13737,1.0,0.0,3.0,4,6,810,700,1961,0,98125,47.7289,-122.28299999999999,2560,10202,2,2,2015,UNK,-1050,3535
3629790160,7/24/2014,524250.0,3,2.5,1710,3469,2.0,0.0,0.0,3,8,1710,0,1999,0,98029,47.54600000000001,-122.01100000000001,2120,3560,7,24,2014,UNK,-410,-91
1778350070,5/9/2014,765000.0,4,2.75,2790,10819,2.0,0.0,0.0,3,10,2790,0,1996,0,98027,47.5515,-122.08,3080,12603,5,9,2014,UNK,-290,-1784
1703050200,8/6/2014,648000.0,4,2.5,2620,5450,2.0,0.0,0.0,3,9,2620,0,2001,0,98074,47.6301,-122.01899999999999,2590,5371,8,6,2014,UNK,30,79
5469700570,8/12/2014,469500.0,5,2.5,2970,24759,1.0,0.0,0.0,4,8,1670,1300,1969,0,98031,47.3908,-122.17299999999999,2100,21803,8,12,2014,UNK,870,2956
100600860,3/24/2015,237500.0,3,1.75,1050,7854,1.0,0.0,0.0,4,7,1050,0,1975,0,98023,47.3011,-122.369,1360,7668,3,24,2015,UNK,-310,186
421049116,1/21/2015,216000.0,3,1.0,1280,8712,1.0,0.0,0.0,4,7,1280,0,1956,0,98003,47.3298,-122.29700000000001,1420,8800,1,21,2015,UNK,-140,-88
3205200640,3/30/2015,427200.0,3,1.0,1030,8400,1.0,0.0,0.0,4,7,1030,0,1963,0,98056,47.5364,-122.17299999999999,1270,8400,3,30,2015,UNK,-240,0
8899200570,3/11/2015,280000.0,3,2.25,1900,7800,1.0,0.0,0.0,4,8,1390,510,1977,0,98055,47.4545,-122.208,1730,7800,3,11,2015,UNK,170,0
1777500160,4/25/2015,718000.0,5,3.0,3070,9804,1.0,0.0,0.0,4,9,1740,1330,1968,0,98006,47.5702,-122.12799999999999,2550,9689,4,25,2015,UNK,520,115
7853340860,3/10/2015,420000.0,2,2.75,1760,4139,2.0,0.0,0.0,3,8,1760,0,2010,0,98065,47.5175,-121.87799999999999,1870,3076,3,10,2015,N,-110,1063
1862400132,9/16/2014,379000.0,2,1.0,930,5400,1.0,0.0,0.0,3,7,930,0,1952,0,98117,47.6971,-122.37200000000001,1050,5400,9,16,2014,UNK,-120,0
6380500135,5/27/2014,326100.0,2,1.0,880,7683,1.0,0.0,0.0,3,6,880,0,1942,0,98177,47.7145,-122.361,1370,7695,5,27,2014,UNK,-490,-12
9528104108,5/29/2014,535000.0,3,2.5,1360,1016,3.0,0.0,0.0,3,7,1310,50,2003,0,98115,47.6774,-122.324,1365,1156,5,29,2014,UNK,-5,-140
2571910160,10/1/2014,283000.0,4,2.75,2130,8560,1.0,0.0,0.0,3,7,1560,570,1992,0,98022,47.1949,-122.01,2130,8560,10,1,2014,UNK,0,0
316000160,8/21/2014,260000.0,3,1.0,1480,7469,1.5,0.0,0.0,3,6,1120,360,1940,0,98168,47.5048,-122.301,1460,7379,8,21,2014,UNK,20,90
2695600505,4/13/2015,399000.0,4,1.0,1500,6388,1.5,0.0,0.0,4,7,1500,0,1951,0,98126,47.5303,-122.37799999999999,980,5366,4,13,2015,UNK,520,1022
3904910320,2/25/2015,484950.0,3,2.25,1670,5004,2.0,0.0,0.0,3,8,1670,0,1987,0,98029,47.5688,-122.01700000000001,1850,5276,2,25,2015,UNK,-180,-272
4100000140,10/13/2014,640000.0,4,1.75,2060,9828,1.0,0.0,0.0,4,8,2060,0,1960,0,98005,47.5867,-122.17399999999999,2260,9996,10,13,2014,UNK,-200,-168
3226049270,3/4/2015,585000.0,4,2.5,2160,8158,1.0,0.0,0.0,4,8,1660,500,1952,0,98115,47.6948,-122.32799999999999,1520,7208,3,4,2015,UNK,640,950
1455600030,1/8/2015,645000.0,4,2.0,2780,11583,1.0,0.0,3.0,3,8,1190,1590,1955,0,98125,47.7293,-122.28399999999999,2580,10241,1,8,2015,UNK,200,1342
5559600140,5/5/2015,253000.0,3,2.0,1490,7651,1.0,0.0,0.0,3,7,1490,0,1988,0,98003,47.3211,-122.325,1590,7795,5,5,2015,UNK,-100,-144
5147600105,7/21/2014,178500.0,2,1.0,740,6460,1.0,0.0,0.0,3,6,740,0,1953,0,98146,47.5077,-122.344,1170,6975,7,21,2014,UNK,-430,-515
7437100570,8/21/2014,291000.0,4,2.5,1860,6325,2.0,0.0,0.0,4,7,1860,0,1991,0,98038,47.3492,-122.03,1860,6449,8,21,2014,UNK,0,-124
8856004730,9/17/2014,199950.0,2,2.75,1590,20917,1.5,0.0,0.0,3,5,1590,0,1920,0,98001,47.2786,-122.25,1310,6000,9,17,2014,UNK,280,14917
3856902996,8/4/2014,553500.0,2,1.0,850,2340,1.0,0.0,0.0,3,7,850,0,1922,0,98105,47.6707,-122.32799999999999,1300,3000,8,4,2014,UNK,-450,-660
1442800370,4/15/2015,189950.0,2,1.0,1030,4188,1.0,0.0,0.0,3,8,1030,0,1981,0,98038,47.3738,-122.057,1450,3376,4,15,2015,UNK,-420,812
8001400340,9/24/2014,289000.0,3,2.0,1850,9550,1.0,0.0,0.0,3,8,1850,0,1988,0,98001,47.3225,-122.273,2250,9550,9,24,2014,UNK,-400,0
3131200640,4/27/2015,700000.0,4,2.0,1830,4590,2.0,0.0,0.0,3,8,1830,0,1908,0,98105,47.6593,-122.32700000000001,1650,4590,4,27,2015,UNK,180,0
984000710,10/22/2014,270000.0,3,2.0,1560,8853,1.0,0.0,0.0,3,7,1560,0,1967,0,98058,47.4312,-122.171,1610,8750,10,22,2014,UNK,-50,103
4167300350,5/8/2014,258000.0,4,1.75,1730,8320,1.0,0.0,0.0,3,7,1230,500,1977,0,98023,47.327,-122.361,1840,9800,5,8,2014,UNK,-110,-1480
2826049282,6/14/2014,530000.0,3,2.5,1930,7214,2.0,0.0,0.0,3,8,1930,0,2005,0,98125,47.7191,-122.309,1930,7266,6,14,2014,N,0,-52
8946750030,12/18/2014,245000.0,3,2.25,1422,3677,2.0,0.0,0.0,3,7,1422,0,2012,0,98092,47.3204,-122.178,1677,3677,12,18,2014,N,-255,0
461004720,4/22/2015,563000.0,3,2.0,1380,5000,1.5,0.0,0.0,4,7,1380,0,1917,0,98117,47.6807,-122.369,1350,5000,4,22,2015,UNK,30,0
7852090810,11/19/2014,515000.0,3,2.5,2430,4203,2.0,0.0,0.0,3,8,2430,0,2001,0,98065,47.5346,-121.875,2500,4798,11,19,2014,UNK,-70,-595
9264960340,6/17/2014,325000.0,4,2.5,2610,7091,2.0,0.0,0.0,3,9,2610,0,1987,0,98023,47.3017,-122.34899999999999,2610,7773,6,17,2014,UNK,0,-682
1624079104,4/2/2015,540000.0,3,2.25,2000,217800,2.0,0.0,0.0,3,8,2000,0,1996,0,98024,47.5599,-121.911,2220,217800,4,2,2015,UNK,-220,0
4310700570,12/10/2014,280300.0,2,1.0,920,5000,1.0,0.0,0.0,4,6,490,430,1949,0,98103,47.7008,-122.338,1500,5000,12,10,2014,UNK,-580,0
1254200075,5/9/2014,460000.0,4,1.75,1750,5500,1.5,0.0,0.0,5,7,1050,700,1926,0,98117,47.6802,-122.38799999999999,1640,5500,5,9,2014,UNK,110,0
7214820030,12/12/2014,475000.0,3,1.75,2020,8970,1.0,0.0,0.0,4,7,1180,840,1981,0,98072,47.7571,-122.145,2140,8008,12,12,2014,UNK,-120,962
865100055,6/12/2014,900000.0,4,2.25,2460,44431,1.0,0.0,0.0,4,9,2460,0,1957,0,98007,47.6042,-122.147,2830,44431,6,12,2014,UNK,-370,0
686201000,12/30/2014,538200.0,4,3.0,1780,7260,1.0,0.0,0.0,4,8,1780,0,1964,0,98008,47.626999999999995,-122.11399999999999,1810,7920,12,30,2014,UNK,-30,-660
342000570,9/9/2014,429000.0,2,1.0,1080,3600,1.0,0.0,0.0,3,7,1080,0,1922,0,98122,47.6078,-122.291,2230,4500,9,9,2014,UNK,-1150,-900
5476200160,7/25/2014,164808.0,3,1.0,1250,5411,1.0,0.0,0.0,3,7,1250,0,1980,0,98178,47.5064,-122.265,1490,6320,7,25,2014,UNK,-240,-909
7199320570,1/26/2015,520000.0,4,2.25,1870,7700,2.0,0.0,0.0,3,7,1870,0,1977,0,98052,47.6937,-122.12700000000001,1970,7700,1,26,2015,UNK,-100,0
6414100560,6/18/2014,475000.0,3,1.75,1700,8432,1.0,0.0,0.0,3,8,1230,470,1977,0,98125,47.7221,-122.31700000000001,1800,7842,6,18,2014,UNK,-100,590
1623049214,9/26/2014,283000.0,4,1.5,1480,47045,1.0,0.0,0.0,5,6,1480,0,1942,0,98168,47.4809,-122.3,1530,11000,9,26,2014,UNK,-50,36045
2379300340,3/31/2015,321500.0,4,2.5,1930,6228,2.0,0.0,0.0,3,8,1930,0,2000,0,98030,47.3572,-122.191,1930,6168,3,31,2015,UNK,0,60
7701990560,7/29/2014,840000.0,4,2.75,3130,21810,2.0,0.0,0.0,4,10,3130,0,1993,0,98077,47.7083,-122.073,3330,21810,7,29,2014,UNK,-200,0
2025700860,4/14/2015,287000.0,3,2.25,1370,6000,2.0,0.0,0.0,4,7,1370,0,1992,0,98038,47.3484,-122.03299999999999,1370,6200,4,14,2015,UNK,0,-200
8562500200,6/5/2014,375000.0,3,1.75,960,8106,1.0,0.0,0.0,3,7,960,0,1962,0,98052,47.6737,-122.156,1650,8035,6,5,2014,UNK,-690,71
8143100350,8/25/2014,349500.0,3,1.75,1260,7128,1.0,0.0,0.0,4,7,1260,0,1969,0,98034,47.7263,-122.205,1330,7326,8,25,2014,UNK,-70,-198
37000335,8/14/2014,446450.0,3,1.5,1480,7749,1.0,0.0,0.0,5,7,1480,0,1960,0,98126,47.5144,-122.37899999999999,1140,5320,8,14,2014,UNK,340,2429
1862900350,6/10/2014,315000.0,4,2.5,1930,9643,2.0,0.0,0.0,4,7,1930,0,1992,0,98031,47.4065,-122.18,1930,7525,6,10,2014,UNK,0,2118
1498302774,5/20/2014,271310.0,2,1.0,870,5340,1.5,0.0,0.0,2,6,870,0,1906,0,98144,47.5849,-122.302,1190,4440,5,20,2014,UNK,-320,900
2224700136,1/22/2015,315000.0,4,1.0,1300,8400,1.5,0.0,0.0,4,7,1300,0,1953,0,98133,47.7612,-122.33200000000001,1330,8400,1,22,2015,UNK,-30,0
7697920160,5/15/2014,245000.0,3,1.75,1490,6930,1.0,0.0,0.0,4,7,1490,0,1990,0,98030,47.3682,-122.179,1880,6861,5,15,2014,UNK,-390,69
1370804430,3/5/2015,543115.0,2,1.0,1380,5484,1.0,0.0,0.0,3,8,1030,350,1947,0,98199,47.6382,-122.399,1380,5347,3,5,2015,UNK,0,137
2267000160,10/20/2014,900000.0,4,2.0,1190,8190,1.5,0.0,0.0,3,7,1190,0,1945,0,98117,47.6908,-122.397,1190,1567,10,20,2014,UNK,0,6623
5700004028,4/17/2015,2450000.0,4,4.25,4250,6552,2.0,0.0,3.0,4,10,2870,1380,2008,0,98144,47.5747,-122.28299999999999,3640,8841,4,17,2015,N,610,-2289
8682231170,4/29/2015,554000.0,2,2.0,1920,6045,1.0,0.0,0.0,3,8,1920,0,2003,0,98053,47.7107,-122.031,1670,5200,4,29,2015,UNK,250,845
3353400860,7/17/2014,249900.0,3,1.75,2080,12522,1.0,0.0,0.0,5,6,2080,0,1950,0,98001,47.266999999999996,-122.25,1690,11200,7,17,2014,UNK,390,1322
2424059035,8/20/2014,768000.0,3,2.5,3220,54160,2.0,0.0,2.0,4,9,2690,530,1981,0,98006,47.5468,-122.109,3460,44374,8,20,2014,UNK,-240,9786
2021201000,5/23/2014,980000.0,4,3.0,3680,5854,1.0,0.0,3.0,3,10,2060,1620,1967,0,98199,47.6327,-122.395,3140,5000,5,23,2014,UNK,540,854
3919000030,4/20/2015,395000.0,5,2.5,2070,9600,1.0,0.0,0.0,3,7,1270,800,1962,0,98146,47.4997,-122.36399999999999,1950,7800,4,20,2015,UNK,120,1800
789000550,4/13/2015,415000.0,3,1.75,1480,2200,2.0,0.0,0.0,3,7,1480,0,1995,0,98103,47.6969,-122.35,1360,2190,4,13,2015,UNK,120,10
5104511040,2/20/2015,380000.0,4,2.5,2000,6921,2.0,0.0,0.0,3,8,2000,0,2003,0,98038,47.3559,-122.014,2430,6339,2,20,2015,UNK,-430,582
7215722010,2/26/2015,566000.0,3,2.5,1560,5259,2.0,0.0,0.0,3,8,1560,0,1999,0,98075,47.5985,-122.016,2170,5461,2,26,2015,UNK,-610,-202
16000435,3/16/2015,218500.0,2,1.0,1600,8961,1.0,0.0,0.0,4,7,1390,210,1949,0,98002,47.3098,-122.21,1502,6798,3,16,2015,UNK,98,2163
7197300105,5/2/2014,550000.0,4,2.5,1940,10500,1.0,0.0,0.0,4,7,1140,800,1976,0,98052,47.683,-122.11399999999999,2200,10500,5,2,2014,UNK,-260,0
2877101031,7/2/2014,512031.0,3,1.75,1540,3000,1.0,0.0,2.0,3,7,770,770,1920,0,98117,47.6769,-122.36,1420,4200,7,2,2014,UNK,120,-1200
2892600016,3/17/2015,197500.0,2,1.0,820,8860,1.0,0.0,0.0,3,6,820,0,1950,0,98055,47.452,-122.19,1660,15375,3,17,2015,UNK,-840,-6515
2423020270,7/15/2014,470000.0,3,2.25,1780,8784,1.0,0.0,0.0,3,7,1230,550,1977,0,98033,47.701,-122.17200000000001,1780,7704,7,15,2014,UNK,0,1080
1825079070,3/13/2015,590000.0,3,1.75,1560,242629,1.0,0.0,0.0,3,7,1560,0,1981,0,98053,47.6493,-121.956,2320,220654,3,13,2015,UNK,-760,21975
5255710160,3/18/2015,465000.0,4,2.25,2210,8862,1.0,0.0,0.0,4,8,1270,940,1977,0,98011,47.7725,-122.198,2030,8862,3,18,2015,UNK,180,0
723069135,9/15/2014,499000.0,2,1.75,2040,114562,1.0,0.0,0.0,4,7,2040,0,1968,0,98027,47.4985,-122.09200000000001,1850,94960,9,15,2014,UNK,190,19602
2024059094,8/25/2014,515000.0,3,2.25,1920,11500,1.0,0.0,0.0,3,8,1920,0,1972,2000,98006,47.5498,-122.18799999999999,2260,8866,8,25,2014,Y,-340,2634
7613700860,11/6/2014,716500.0,3,1.75,1930,5000,1.0,0.0,0.0,3,9,1230,700,1936,0,98105,47.6582,-122.27799999999999,2300,6000,11,6,2014,UNK,-370,-1000
2771101200,5/17/2014,410000.0,3,2.0,1700,4250,1.0,0.0,0.0,3,6,890,810,1944,0,98199,47.6542,-122.385,1440,4250,5,17,2014,UNK,260,0
7625704510,10/22/2014,850000.0,4,3.25,3450,6500,2.0,0.0,0.0,3,8,2450,1000,1994,0,98136,47.5437,-122.38799999999999,1750,6500,10,22,2014,UNK,1700,0
1762600260,5/22/2014,1050000.0,4,3.25,3440,35021,2.0,0.0,0.0,3,10,3440,0,1983,0,98033,47.6476,-122.184,3440,35021,5,22,2014,UNK,0,0
2553300030,6/9/2014,648000.0,4,2.5,2380,13435,2.0,0.0,0.0,3,10,2380,0,1992,0,98075,47.5833,-122.02799999999999,2730,9677,6,9,2014,UNK,-350,3758
5309101200,6/5/2014,620000.0,4,2.25,2400,5350,1.5,0.0,0.0,4,7,1460,940,1929,0,98117,47.6763,-122.37,1250,4880,6,5,2014,UNK,1150,470
5416300240,2/2/2015,935000.0,4,4.5,5670,84267,2.0,0.0,2.0,3,11,5670,0,2008,0,98010,47.323,-122.044,4100,83729,2,2,2015,N,1570,538
3756600240,3/19/2015,379000.0,3,1.0,1140,10320,1.0,0.0,0.0,4,7,1140,0,1963,0,98034,47.7168,-122.196,1140,10412,3,19,2015,UNK,0,-92
8127700445,7/16/2014,699000.0,3,1.75,1670,5375,1.0,0.0,0.0,3,7,1270,400,1952,0,98199,47.6416,-122.397,1460,6125,7,16,2014,UNK,210,-750
9421500070,12/30/2014,528000.0,4,2.25,1910,8005,1.0,0.0,0.0,3,8,1280,630,1960,0,98125,47.7259,-122.29799999999999,1860,8010,12,30,2014,UNK,50,-5
9477710160,4/26/2015,425000.0,3,1.75,1560,9452,1.0,0.0,0.0,4,8,1560,0,1974,0,98056,47.5197,-122.18,2200,9985,4,26,2015,UNK,-640,-533
1795500240,6/23/2014,249500.0,2,1.75,1500,8645,1.0,0.0,0.0,4,7,1500,0,1963,0,98042,47.3643,-122.115,1220,8645,6,23,2014,UNK,280,0
7203220260,7/16/2014,1040000.0,5,3.25,4475,6642,2.0,0.0,0.0,3,9,4475,0,2014,0,98053,47.6849,-122.01799999999999,3720,6633,7,16,2014,N,755,9
3524039204,8/13/2014,790000.0,4,2.75,2840,11900,1.0,0.0,3.0,4,9,1640,1200,1961,0,98136,47.5271,-122.38600000000001,2790,10070,8,13,2014,UNK,50,1830
5706200060,8/18/2014,399950.0,3,1.0,1020,18050,1.0,0.0,0.0,3,7,1020,0,1969,0,98027,47.5254,-122.04299999999999,1750,11640,8,18,2014,UNK,-730,6410
7283900012,10/21/2014,275000.0,3,1.5,1410,9000,1.0,0.0,0.0,3,7,1410,0,1953,0,98133,47.7635,-122.35,1910,7214,10,21,2014,UNK,-500,1786
809001070,1/23/2015,550000.0,3,1.0,1520,2500,1.5,0.0,0.0,3,8,1520,0,1912,0,98109,47.6347,-122.352,1880,3600,1,23,2015,UNK,-360,-1100
3340401535,11/5/2014,140000.0,1,1.0,730,6890,1.0,0.0,0.0,4,4,730,0,1926,0,98055,47.467,-122.215,1790,7969,11,5,2014,UNK,-1060,-1079
1607100139,7/25/2014,250000.0,3,1.0,1190,6250,1.0,0.0,0.0,3,7,990,200,1954,0,98108,47.5658,-122.292,1760,6434,7,25,2014,UNK,-570,-184
8699800060,9/3/2014,318000.0,3,2.25,1410,8909,2.0,0.0,2.0,3,7,1410,0,1988,0,98198,47.3983,-122.31,2050,8909,9,3,2014,UNK,-640,0
524069037,7/10/2014,505000.0,2,1.0,1240,57000,1.0,0.0,0.0,3,7,1240,0,1962,0,98075,47.597,-122.059,3050,25545,7,10,2014,UNK,-1810,31455
6072600200,4/17/2015,470500.0,5,2.5,2500,9248,1.0,0.0,0.0,3,8,1300,1200,1966,0,98006,47.5415,-122.18,2090,8568,4,17,2015,UNK,410,680
5144000036,5/27/2014,360000.0,3,1.0,1050,9206,1.5,0.0,0.0,3,7,1050,0,1954,0,98125,47.7071,-122.301,1380,6384,5,27,2014,UNK,-330,2822
7855300200,3/19/2015,1240000.0,4,2.75,2680,8500,1.0,0.0,4.0,4,9,1480,1200,1962,0,98006,47.5634,-122.156,2940,8650,3,19,2015,UNK,-260,-150
2485000202,4/10/2015,986000.0,3,2.5,2380,16080,1.0,0.0,2.0,4,9,1340,1040,1964,0,98136,47.5262,-122.38600000000001,2560,10070,4,10,2015,UNK,-180,6010
9209900270,2/5/2015,515000.0,2,1.0,1060,4228,1.0,0.0,0.0,3,7,860,0,1906,0,98112,47.6231,-122.29299999999999,1060,4187,2,5,2015,UNK,0,41
6099400030,1/14/2015,320000.0,3,1.75,2300,41900,1.0,0.0,0.0,4,8,1310,990,1939,0,98168,47.477,-122.292,1160,8547,1,14,2015,UNK,1140,33353
9368700223,2/2/2015,310000.0,4,3.0,2010,7426,1.0,0.0,0.0,5,7,1090,920,1951,0,98178,47.5042,-122.265,1470,7426,2,2,2015,UNK,540,0
1782000160,5/30/2014,356700.0,2,1.0,1090,5000,1.0,0.0,0.0,4,7,730,360,1942,0,98126,47.5258,-122.37799999999999,990,5250,5,30,2014,UNK,100,-250
269001360,4/22/2015,775000.0,4,1.75,2320,5595,1.0,0.0,0.0,3,7,1510,810,1956,0,98199,47.6397,-122.38799999999999,1840,5596,4,22,2015,UNK,480,-1
390100060,4/21/2015,325000.0,3,1.0,1040,7541,1.0,0.0,0.0,3,6,1040,0,1951,0,98133,47.7565,-122.339,1140,6100,4,21,2015,UNK,-100,1441
7888400560,10/2/2014,208000.0,4,2.75,1810,8677,1.5,0.0,0.0,3,7,1810,0,1962,0,98198,47.3668,-122.31,1740,8677,10,2,2014,UNK,70,0
7567600045,8/27/2014,825000.0,2,1.0,1150,12775,1.0,1.0,4.0,4,6,1150,0,1908,0,98178,47.501999999999995,-122.22200000000001,2440,11852,8,27,2014,UNK,-1290,923
7764200030,7/16/2014,515000.0,3,2.5,2360,11254,1.0,0.0,2.0,3,9,2360,0,1990,0,98003,47.3356,-122.333,2390,11254,7,16,2014,UNK,-30,0
9828202545,1/27/2015,490000.0,3,1.5,1970,3400,1.5,0.0,0.0,4,8,1420,550,1929,0,98122,47.6163,-122.292,1940,4000,1,27,2015,UNK,30,-600
6114600030,5/20/2014,675000.0,4,3.0,2690,28300,1.0,0.0,0.0,3,8,2690,0,1954,1999,98166,47.4458,-122.34299999999999,2820,27100,5,20,2014,Y,-130,1200
9834200885,7/17/2014,360000.0,4,2.5,2080,4080,1.0,0.0,0.0,5,7,1040,1040,1962,0,98144,47.571999999999996,-122.29,1340,4080,7,17,2014,UNK,740,0
9834200885,4/20/2015,550000.0,4,2.5,2080,4080,1.0,0.0,0.0,5,7,1040,1040,1962,0,98144,47.571999999999996,-122.29,1340,4080,4,20,2015,UNK,740,0
3509600070,7/25/2014,225000.0,3,1.5,1370,9000,1.0,0.0,0.0,3,7,1370,0,1962,0,98168,47.4973,-122.32799999999999,1400,9075,7,25,2014,UNK,-30,-75
2473002080,3/17/2015,500000.0,3,2.75,3410,9360,1.5,0.0,0.0,4,8,3410,0,1967,0,98058,47.4497,-122.147,2260,10128,3,17,2015,UNK,1150,-768
1081300370,4/27/2015,385000.0,4,2.0,1850,11700,1.0,0.0,0.0,4,8,1850,0,1969,0,98059,47.4702,-122.12,2110,11700,4,27,2015,UNK,-260,0
11501160,6/17/2014,837700.0,5,2.75,3010,12611,2.0,0.0,0.0,3,10,3010,0,1994,0,98052,47.69600000000001,-122.102,2890,9456,6,17,2014,UNK,120,3155
7202330370,2/10/2015,448000.0,3,2.25,1530,3056,2.0,0.0,0.0,3,7,1530,0,2003,0,98053,47.6817,-122.035,1560,3064,2,10,2015,UNK,-30,-8
7000100631,5/7/2015,730000.0,5,1.75,2690,21357,1.0,0.0,0.0,4,7,1420,1270,1952,0,98004,47.5831,-122.191,2600,17539,5,7,2015,UNK,90,3818
2484200171,7/14/2014,575000.0,4,1.5,2810,7140,1.0,0.0,2.0,3,8,1490,1320,1954,0,98136,47.5252,-122.382,2240,6825,7,14,2014,UNK,570,315
9477201040,11/18/2014,430000.0,3,1.75,1810,7300,1.0,0.0,0.0,4,7,1240,570,1976,0,98034,47.7299,-122.19200000000001,1460,7560,11,18,2014,UNK,350,-260
7202290160,1/14/2015,435000.0,3,2.5,1560,3987,2.0,0.0,0.0,3,7,1560,0,2002,0,98053,47.687,-122.04299999999999,1600,3152,1,14,2015,UNK,-40,835
4366700140,12/19/2014,241000.0,3,1.0,1010,9611,1.0,0.0,0.0,4,6,1010,0,1973,0,98092,47.3006,-122.066,1200,9611,12,19,2014,UNK,-190,0
5457300478,5/13/2015,453500.0,2,1.75,1000,1760,1.0,0.0,0.0,4,6,600,400,1924,0,98109,47.6261,-122.355,2120,2802,5,13,2015,UNK,-1120,-1042
9158100116,4/6/2015,285000.0,2,1.5,990,1380,3.0,0.0,0.0,3,7,990,0,2001,0,98133,47.7218,-122.35600000000001,1050,1380,4,6,2015,UNK,-60,0
7227500830,5/28/2014,151000.0,2,1.0,720,4222,1.0,0.0,0.0,4,5,720,0,1942,0,98056,47.4965,-122.186,860,4785,5,28,2014,UNK,-140,-563
7237500390,11/10/2014,1570000.0,5,4.5,6070,14731,2.0,0.0,0.0,3,11,6070,0,2004,0,98059,47.5306,-122.134,4750,13404,11,10,2014,N,1320,1327
2197600451,11/5/2014,631000.0,5,2.0,2270,2400,2.0,0.0,0.0,3,7,2270,0,1905,0,98122,47.6051,-122.319,1320,2400,11,5,2014,UNK,950,0
3278604400,6/2/2014,285000.0,2,2.5,1380,1073,2.0,0.0,0.0,3,7,1140,240,2011,0,98126,47.5462,-122.369,1580,2036,6,2,2014,N,-200,-963
1788700160,2/20/2015,195000.0,3,1.0,1260,8378,1.0,0.0,0.0,4,6,840,420,1959,1977,98023,47.3274,-122.348,1140,8496,2,20,2015,Y,120,-118
3276930270,4/25/2015,817500.0,4,2.5,2910,35679,2.0,0.0,0.0,4,9,2910,0,1987,0,98075,47.5859,-121.991,2720,36728,4,25,2015,UNK,190,-1049
7374600060,1/9/2015,550000.0,3,2.0,1810,12825,1.0,0.0,0.0,4,7,1810,0,1960,0,98007,47.5953,-122.14,1490,10800,1,9,2015,UNK,320,2025
2505500030,7/3/2014,1130000.0,4,2.5,3160,8281,2.0,0.0,0.0,4,9,3160,0,1995,0,98033,47.6699,-122.195,3000,8281,7,3,2014,UNK,160,0
2770604942,12/30/2014,609850.0,2,2.75,1910,1369,3.0,0.0,0.0,3,9,1910,0,2002,0,98119,47.6544,-122.37299999999999,1910,1879,12,30,2014,UNK,0,-510
7831800505,1/6/2015,200000.0,3,1.0,1230,4380,1.0,0.0,0.0,3,6,1230,0,1947,0,98106,47.5352,-122.361,1525,6026,1,6,2015,UNK,-295,-1646
5416510060,3/6/2015,367000.0,4,2.5,2960,6219,2.0,0.0,0.0,3,9,2960,0,2006,0,98038,47.3603,-122.037,2960,5361,3,6,2015,N,0,858
4137010260,8/25/2014,285167.0,3,2.25,2200,8375,2.0,0.0,0.0,3,8,2200,0,1988,0,98092,47.2626,-122.21799999999999,2200,10002,8,25,2014,UNK,0,-1627
7683800200,4/2/2015,275000.0,2,1.5,1270,32175,1.0,0.0,0.0,4,7,1270,0,1947,0,98003,47.3347,-122.304,1270,10200,4,2,2015,UNK,0,21975
1509500160,3/24/2015,350900.0,4,2.5,2540,12843,2.0,0.0,0.0,3,9,2540,0,1992,0,98030,47.3866,-122.169,2410,9383,3,24,2015,UNK,130,3460
3904940200,6/20/2014,660000.0,4,3.25,3030,9273,2.0,0.0,0.0,5,8,3030,0,1988,0,98029,47.5747,-122.014,2360,7632,6,20,2014,UNK,670,1641
4037200295,8/19/2014,525000.0,3,1.75,1520,8835,1.0,0.0,0.0,4,7,1520,0,1957,0,98008,47.6054,-122.118,1760,8580,8,19,2014,UNK,-240,255
7258200055,2/6/2015,262000.0,4,2.5,1560,7800,2.0,0.0,0.0,3,7,1560,0,1997,0,98168,47.513999999999996,-122.316,1160,7800,2,6,2015,UNK,400,0
9178600560,6/23/2014,690000.0,2,1.0,970,4560,1.0,0.0,0.0,4,7,970,0,1907,0,98103,47.6561,-122.33200000000001,1500,4560,6,23,2014,UNK,-530,0
255520260,3/24/2015,624000.0,5,3.75,3570,14648,2.0,0.0,0.0,3,9,3570,0,2005,0,98019,47.7377,-121.97399999999999,3160,7882,3,24,2015,N,410,6766
751000060,5/6/2014,353000.0,3,1.0,1350,7740,1.0,0.0,0.0,4,6,860,490,1947,0,98125,47.7098,-122.291,1130,7740,5,6,2014,UNK,220,0
3343900326,3/11/2015,552500.0,4,3.5,3710,10400,2.0,0.0,0.0,3,8,2290,1420,2002,0,98056,47.5041,-122.186,1720,4276,3,11,2015,UNK,1990,6124
7137900320,5/9/2014,224500.0,4,1.0,1430,8355,1.5,0.0,0.0,4,7,1430,0,1983,0,98092,47.3178,-122.17399999999999,1550,7938,5,9,2014,UNK,-120,417
2641800060,4/27/2015,239000.0,3,1.0,940,8571,1.0,0.0,0.0,3,6,940,0,1950,0,98146,47.5006,-122.336,1100,8573,4,27,2015,UNK,-160,-2
293760310,7/11/2014,975000.0,5,4.5,4300,12250,2.0,0.0,0.0,3,10,4300,0,2004,0,98029,47.5557,-122.027,3950,12250,7,11,2014,N,350,0
7237501180,6/25/2014,1200000.0,4,1.75,3990,13470,2.0,0.0,0.0,3,11,3990,0,2006,0,98059,47.5305,-122.131,5790,13709,6,25,2014,N,-1800,-239
5332200550,3/25/2015,505000.0,3,1.0,1380,4000,1.5,0.0,0.0,3,7,1380,0,1910,0,98112,47.6261,-122.296,1690,4000,3,25,2015,UNK,-310,0
3450300240,5/15/2014,302000.0,4,1.75,2020,7865,1.0,0.0,0.0,4,7,1010,1010,1963,0,98059,47.5008,-122.162,1650,7865,5,15,2014,UNK,370,0
9352900695,9/22/2014,170000.0,3,1.0,1480,5670,1.0,0.0,0.0,3,6,780,700,1944,0,98106,47.5175,-122.36,760,5040,9,22,2014,UNK,720,630
3324069070,7/7/2014,195000.0,2,1.0,1190,27007,1.0,0.0,0.0,4,5,1190,0,1910,0,98027,47.523999999999994,-122.04,1730,12632,7,7,2014,UNK,-540,14375
8062900070,9/9/2014,272000.0,5,1.5,2550,6300,1.0,0.0,0.0,4,7,1560,990,1959,0,98056,47.5014,-122.17200000000001,1380,6300,9,9,2014,UNK,1170,0
8062900070,2/13/2015,369000.0,5,1.5,2550,6300,1.0,0.0,0.0,4,7,1560,990,1959,0,98056,47.5014,-122.17200000000001,1380,6300,2,13,2015,UNK,1170,0
4427100030,1/14/2015,332500.0,3,1.5,1500,6332,1.0,0.0,0.0,3,7,1500,0,1953,0,98125,47.7274,-122.31200000000001,1500,6337,1,14,2015,UNK,0,-5
4039100400,5/6/2015,515000.0,3,2.5,3000,8250,1.0,0.0,0.0,4,8,1760,1240,1963,0,98008,47.6191,-122.11200000000001,2040,8250,5,6,2015,UNK,960,0
2171400126,6/5/2014,269000.0,3,1.0,1690,4250,1.0,0.0,0.0,3,7,1020,670,1967,0,98178,47.4945,-122.258,1820,8865,6,5,2014,UNK,-130,-4615
7135520810,7/30/2014,1280000.0,4,4.0,4390,17832,1.0,0.0,0.0,4,11,2430,1960,1994,0,98059,47.5283,-122.14299999999999,3090,12369,7,30,2014,UNK,1300,5463
2475201180,2/6/2015,303000.0,3,2.5,1560,4100,2.0,0.0,0.0,3,7,1560,0,1985,0,98055,47.4733,-122.189,1660,4400,2,6,2015,UNK,-100,-300
4024100951,1/5/2015,420000.0,7,3.0,2940,8624,1.0,0.0,0.0,3,8,1690,1250,1977,0,98155,47.7555,-122.307,1850,8031,1,5,2015,UNK,1090,593
6021502830,11/10/2014,400000.0,3,1.0,1130,4100,1.0,0.0,0.0,3,7,990,140,1941,0,98117,47.6856,-122.385,1800,4100,11,10,2014,UNK,-670,0
7710100083,2/4/2015,225000.0,3,1.0,1020,8437,1.0,0.0,0.0,5,6,1020,0,1987,0,98022,47.2093,-122.0,1420,8500,2,4,2015,UNK,-400,-63
2781270550,9/16/2014,219000.0,2,2.0,1310,2550,2.0,0.0,0.0,3,6,1310,0,2004,0,98038,47.3496,-122.022,1310,2550,9,16,2014,N,0,0
200510060,12/31/2014,605000.0,3,2.5,2570,9487,2.0,0.0,3.0,3,9,2570,0,1989,0,98011,47.7408,-122.21600000000001,2490,9898,12,31,2014,UNK,80,-411
9554200105,10/14/2014,625000.0,4,2.0,2020,6867,1.0,0.0,0.0,5,8,1010,1010,1942,0,98115,47.7,-122.292,1250,6842,10,14,2014,UNK,770,25
3320000810,2/24/2015,380000.0,5,2.0,1680,3240,1.0,0.0,0.0,3,5,840,840,1906,0,98144,47.5965,-122.311,1380,1260,2,24,2015,UNK,300,1980
643500060,4/24/2015,620000.0,4,2.0,1770,7700,1.5,0.0,0.0,4,7,1770,0,1962,0,98007,47.5916,-122.146,1710,7700,4,24,2015,UNK,60,0
2537500140,6/27/2014,687500.0,4,2.75,3190,10970,2.0,0.0,0.0,3,10,3190,0,1994,0,98075,47.5862,-122.029,2850,8416,6,27,2014,UNK,340,2554
5112800421,7/23/2014,225500.0,4,2.0,1440,7950,1.0,0.0,0.0,5,6,1440,0,1962,0,98058,47.4517,-122.08200000000001,1530,20037,7,23,2014,UNK,-90,-12087
3352402236,12/15/2014,252500.0,3,2.0,1150,6000,1.0,0.0,0.0,5,7,1150,0,1956,0,98178,47.49800000000001,-122.26299999999999,1980,6360,12,15,2014,UNK,-830,-360
3905100520,10/29/2014,510000.0,3,2.5,1860,3658,2.0,0.0,0.0,3,8,1860,0,1994,0,98029,47.5703,-122.00399999999999,1840,3739,10,29,2014,UNK,20,-81
6332940070,5/7/2014,510000.0,4,2.5,2430,5203,2.0,0.0,0.0,3,8,2430,0,2003,0,98155,47.7402,-122.31700000000001,2260,7474,5,7,2014,UNK,170,-2271
809002435,8/8/2014,725000.0,3,2.5,1940,4000,1.5,0.0,0.0,5,7,1940,0,1906,0,98109,47.6372,-122.352,1440,4000,8,8,2014,UNK,500,0
3797000295,3/12/2015,492000.0,2,1.0,880,2970,1.0,0.0,0.0,3,7,880,0,1927,0,98103,47.6868,-122.34899999999999,1370,3060,3,12,2015,UNK,-490,-90
1775801260,3/11/2015,425000.0,4,2.5,1930,14196,1.0,0.0,0.0,4,7,1330,600,1977,0,98072,47.7407,-122.09700000000001,1470,12852,3,11,2015,UNK,460,1344
4055701200,4/21/2015,1960000.0,4,2.75,3120,7898,1.0,1.0,4.0,4,8,1560,1560,1963,0,98034,47.7165,-122.259,2630,13868,4,21,2015,UNK,490,-5970
7137960030,3/9/2015,298900.0,3,2.5,1830,6162,2.0,0.0,0.0,3,8,1830,0,1994,0,98092,47.3291,-122.17,1860,7017,3,9,2015,UNK,-30,-855
7880010060,4/6/2015,699000.0,4,2.5,3230,40319,2.0,0.0,0.0,4,10,3230,0,1987,0,98027,47.4856,-122.069,2990,40234,4,6,2015,UNK,240,85
3797001920,7/2/2014,310000.0,2,1.0,700,3000,1.0,0.0,0.0,4,6,700,0,1918,0,98103,47.6846,-122.346,1560,4500,7,2,2014,UNK,-860,-1500
3901100055,12/22/2014,350000.0,3,1.75,1010,8580,1.0,0.0,0.0,3,7,1010,0,1961,0,98033,47.6703,-122.17399999999999,1500,8580,12,22,2014,UNK,-490,0
8069000075,12/29/2014,790000.0,4,1.75,2460,10061,1.0,1.0,4.0,3,7,1410,1050,1961,0,98178,47.5105,-122.238,2300,10061,12,29,2014,UNK,160,0
1541700240,7/29/2014,305000.0,4,2.5,2230,5000,2.0,0.0,0.0,3,8,2230,0,2003,0,98031,47.3919,-122.184,2230,6137,7,29,2014,UNK,0,-1137
6064800710,10/2/2014,315000.0,3,2.5,1570,2865,2.0,0.0,0.0,3,7,1570,0,2003,0,98118,47.5412,-122.288,1610,2582,10,2,2014,UNK,-40,283
1865810060,8/12/2014,267500.0,5,3.5,2390,6600,2.0,0.0,0.0,5,7,2390,0,1977,0,98042,47.3737,-122.115,1140,6600,8,12,2014,UNK,1250,0
7533800295,8/19/2014,1750000.0,4,3.25,3460,7749,2.0,0.0,1.0,3,10,3020,440,1950,1998,98115,47.6849,-122.273,3030,8680,8,19,2014,Y,430,-931
5415300060,8/13/2014,435000.0,6,3.5,2400,8620,2.0,0.0,0.0,3,8,1640,760,1987,0,98034,47.7152,-122.162,1940,7350,8,13,2014,UNK,460,1270
3876100320,9/5/2014,482500.0,6,4.5,2940,7500,1.5,0.0,0.0,4,8,2940,0,1966,0,98034,47.7208,-122.182,2010,7500,9,5,2014,UNK,930,0
1247600105,10/20/2014,5110000.0,5,5.25,8010,45517,2.0,1.0,4.0,3,12,5990,2020,1999,0,98033,47.6767,-122.211,3430,26788,10,20,2014,UNK,4580,18729
3705900238,8/28/2014,439995.0,3,1.75,1570,8400,1.0,0.0,0.0,4,7,1570,0,1959,0,98133,47.76,-122.34,1860,8639,8,28,2014,UNK,-290,-239
3876200070,5/8/2015,460000.0,3,3.0,1520,7500,1.0,0.0,0.0,3,7,1180,340,1967,0,98034,47.7276,-122.181,2080,8000,5,8,2015,UNK,-560,-500
4388000140,7/29/2014,194000.0,3,1.0,1070,6440,1.0,0.0,0.0,4,7,1070,0,1971,0,98023,47.3186,-122.37299999999999,1190,6532,7,29,2014,UNK,-120,-92
3523029041,10/9/2014,290000.0,2,0.75,440,8313,1.0,1.0,3.0,4,5,440,0,1943,0,98070,47.4339,-122.512,880,26289,10,9,2014,UNK,-440,-17976
3110800260,7/15/2014,274700.0,4,2.0,2440,9600,1.0,0.0,0.0,5,7,1220,1220,1963,0,98031,47.4142,-122.179,1370,9600,7,15,2014,UNK,1070,0
3131201290,3/17/2015,900000.0,4,2.5,2660,3672,2.0,0.0,0.0,5,8,1800,860,1910,0,98105,47.6609,-122.324,1510,3825,3,17,2015,UNK,1150,-153
1117200390,5/7/2014,1150000.0,4,4.0,4460,103382,2.0,0.0,0.0,3,11,4460,0,2001,0,98053,47.63399999999999,-121.99700000000001,3470,88519,5,7,2014,UNK,990,14863
8956000350,9/3/2014,605000.0,3,2.5,2010,3667,2.0,0.0,0.0,3,9,2010,0,2008,0,98027,47.545,-122.015,2350,3600,9,3,2014,N,-340,67
7853210140,3/9/2015,359000.0,3,2.5,1450,3850,2.0,0.0,0.0,3,7,1450,0,2004,0,98065,47.5318,-121.85,1970,3748,3,9,2015,N,-520,102
3250500140,10/8/2014,850000.0,3,1.75,1400,9900,1.0,0.0,0.0,3,7,1400,0,1951,0,98004,47.6272,-122.209,1810,10796,10,8,2014,UNK,-410,-896
2767601375,8/21/2014,505000.0,3,2.0,1500,2500,2.0,0.0,0.0,3,8,1500,0,2002,0,98107,47.6748,-122.385,1550,5000,8,21,2014,UNK,-50,-2500
9465910320,7/9/2014,565000.0,3,2.5,2500,7394,2.0,0.0,0.0,3,9,2500,0,1990,0,98072,47.7441,-122.17299999999999,2790,7642,7,9,2014,UNK,-290,-248
3334000055,4/29/2015,585000.0,2,1.75,1280,7110,1.0,0.0,0.0,4,7,1000,280,1955,0,98118,47.5569,-122.273,1550,6835,4,29,2015,UNK,-270,275
7893800335,4/30/2015,328000.0,4,3.25,3380,7500,2.0,0.0,3.0,3,7,2420,960,1990,0,98198,47.4092,-122.33,1920,7500,4,30,2015,UNK,1460,0
3586500700,7/9/2014,749950.0,4,2.75,2910,18700,1.0,0.0,0.0,3,9,2210,700,1957,0,98177,47.7557,-122.368,2420,26140,7,9,2014,UNK,490,-7440
3630180400,6/26/2014,826000.0,4,2.5,3060,7140,2.0,0.0,0.0,3,9,3060,0,2006,0,98027,47.5393,-121.99799999999999,3240,6218,6,26,2014,N,-180,922
3210950510,9/4/2014,535000.0,3,1.0,1330,40259,1.0,0.0,0.0,4,7,1330,0,1977,0,98024,47.552,-121.89,1710,34787,9,4,2014,UNK,-380,5472
1224069074,8/6/2014,925000.0,4,2.5,3300,101930,2.0,0.0,0.0,4,10,3300,0,1991,0,98029,47.576,-121.976,2880,213879,8,6,2014,UNK,420,-111949
7625700935,6/5/2014,875000.0,3,3.5,3250,6000,2.0,0.0,0.0,3,10,2500,750,2001,0,98136,47.5533,-122.391,1650,6000,6,5,2014,UNK,1600,0
7856610200,5/23/2014,902000.0,4,2.25,2530,9200,1.0,0.0,0.0,5,9,1570,960,1976,0,98006,47.5612,-122.152,3030,9400,5,23,2014,UNK,-500,-200
7287100135,10/1/2014,423000.0,3,1.0,1830,13900,1.0,0.0,0.0,3,7,1830,0,1951,0,98133,47.7654,-122.352,1840,10667,10,1,2014,UNK,-10,3233
1023059324,6/23/2014,235000.0,3,1.0,1170,11100,1.0,0.0,0.0,4,6,1170,0,1968,0,98059,47.4954,-122.164,2080,8481,6,23,2014,UNK,-910,2619
6398000171,7/10/2014,545000.0,2,2.0,2930,14057,1.0,0.0,2.0,4,8,1680,1250,1980,0,98070,47.4025,-122.463,2234,61011,7,10,2014,UNK,696,-46954
6149700350,10/16/2014,343000.0,2,1.0,1230,7560,1.0,0.0,0.0,3,7,1230,0,1961,0,98133,47.7298,-122.34,1270,7560,10,16,2014,UNK,-40,0
9558020890,3/24/2015,334950.0,3,2.5,1620,2930,2.0,0.0,0.0,3,8,1620,0,2002,0,98058,47.4491,-122.12,1900,2943,3,24,2015,UNK,-280,-13
2624049185,9/9/2014,405000.0,3,1.75,1760,5355,1.0,0.0,0.0,3,7,1160,600,1956,0,98118,47.5368,-122.26700000000001,1790,6225,9,9,2014,UNK,-30,-870
236400260,12/15/2014,220000.0,4,1.0,1440,8250,1.0,0.0,0.0,3,7,1440,0,1959,0,98188,47.4325,-122.291,1440,8466,12,15,2014,UNK,0,-216
3826000560,10/2/2014,173000.0,2,1.0,1740,8100,1.0,0.0,0.0,3,6,1050,690,1947,0,98168,47.4942,-122.304,960,8100,10,2,2014,UNK,780,0
7011201245,11/7/2014,655000.0,3,1.0,1270,3600,1.5,0.0,0.0,3,7,1270,0,1906,0,98119,47.6368,-122.37,1710,3600,11,7,2014,UNK,-440,0
9222400510,1/7/2015,406000.0,2,1.0,880,3000,1.0,0.0,0.0,3,6,880,0,1924,0,98115,47.6749,-122.323,890,3000,1,7,2015,UNK,-10,0
9455200570,12/17/2014,632000.0,6,2.5,2560,8320,1.0,0.0,0.0,3,7,1370,1190,1961,0,98125,47.7021,-122.287,2360,7800,12,17,2014,UNK,200,520
2112700030,11/26/2014,357000.0,5,2.75,1540,4000,1.0,0.0,0.0,3,7,1140,400,1990,0,98106,47.533,-122.354,1630,4000,11,26,2014,UNK,-90,0
8658300260,12/9/2014,361000.0,3,1.75,1150,17585,1.0,0.0,0.0,3,7,1150,0,1964,0,98014,47.6503,-121.90799999999999,1200,7500,12,9,2014,UNK,-50,10085
3996900160,7/8/2014,277000.0,2,1.0,770,8149,1.0,0.0,0.0,3,6,770,0,1948,0,98155,47.7458,-122.29799999999999,1160,8149,7,8,2014,UNK,-390,0
5561400340,6/5/2014,630000.0,4,3.75,4610,40202,1.0,0.0,0.0,4,10,2500,2110,1980,0,98027,47.4599,-122.0,3050,41056,6,5,2014,UNK,1560,-854
11900140,5/9/2014,254000.0,3,2.5,1850,4597,2.0,0.0,0.0,3,8,1850,0,2003,0,98042,47.3755,-122.13600000000001,2210,5000,5,9,2014,UNK,-360,-403
6071600340,11/13/2014,472800.0,3,2.25,1840,8400,1.0,0.0,0.0,3,8,1290,550,1961,0,98006,47.5497,-122.17200000000001,2110,8400,11,13,2014,UNK,-270,0
1231000510,9/22/2014,263000.0,3,1.75,1490,3800,1.0,0.0,0.0,3,6,700,790,1913,0,98118,47.5554,-122.27,2180,4000,9,22,2014,UNK,-690,-200
1231000510,5/4/2015,510000.0,3,1.75,1490,3800,1.0,0.0,0.0,3,6,700,790,1913,0,98118,47.5554,-122.27,2180,4000,5,4,2015,UNK,-690,-200
7683800192,11/7/2014,179950.0,3,1.0,960,10125,1.0,0.0,0.0,4,7,960,0,1952,0,98003,47.3335,-122.305,1250,9769,11,7,2014,UNK,-290,356
4123400340,12/3/2014,525000.0,4,2.25,1580,7307,1.0,0.0,0.0,3,8,1160,420,1973,0,98027,47.568999999999996,-122.086,2020,7458,12,3,2014,UNK,-440,-151
5458300685,5/20/2014,479000.0,3,2.5,1260,889,3.0,0.0,0.0,3,8,1260,0,2008,0,98109,47.6277,-122.345,1340,1324,5,20,2014,N,-80,-435
194000505,9/4/2014,651000.0,3,2.0,1940,6440,1.0,0.0,2.0,5,7,970,0,1940,0,98116,47.5664,-122.389,1730,4640,9,4,2014,UNK,210,1800
3885804305,9/11/2014,949000.0,4,1.75,2490,7834,1.0,0.0,3.0,4,8,1240,1250,1958,0,98033,47.6851,-122.209,3210,7834,9,11,2014,UNK,-720,0
3971700560,4/21/2015,392400.0,5,2.5,2520,27951,1.5,0.0,0.0,3,7,1890,630,1942,1970,98155,47.7733,-122.318,1830,14373,4,21,2015,Y,690,13578
8585400135,11/5/2014,585000.0,4,1.75,1760,5356,1.0,0.0,0.0,4,7,920,840,1950,0,98115,47.678999999999995,-122.288,1680,5184,11,5,2014,UNK,80,172
8691500990,12/12/2014,460000.0,4,2.5,4190,7504,2.0,0.0,0.0,3,7,4190,0,2004,0,98058,47.4394,-122.11399999999999,2480,6727,12,12,2014,N,1710,777
2770606685,8/13/2014,470000.0,3,1.0,1170,4400,1.0,0.0,0.0,3,7,870,300,1951,0,98199,47.6584,-122.391,1240,4400,8,13,2014,UNK,-70,0
8856971000,4/6/2015,245000.0,3,2.5,1600,4271,2.0,0.0,0.0,3,7,1600,0,2003,0,98038,47.386,-122.036,1520,3225,4,6,2015,UNK,80,1046
1026049082,11/25/2014,500000.0,4,2.0,2760,27631,2.0,0.0,0.0,4,8,1800,960,1978,0,98155,47.7484,-122.291,2490,13158,11,25,2014,UNK,270,14473
2095800400,11/13/2014,455000.0,3,2.5,2090,8653,2.0,0.0,0.0,3,8,2090,0,1989,0,98011,47.7498,-122.184,2090,6396,11,13,2014,UNK,0,2257
7852030240,4/8/2015,485500.0,4,2.5,2320,3974,2.0,0.0,0.0,3,7,2320,0,1999,0,98065,47.532,-121.88,2620,4539,4,8,2015,UNK,-300,-565
6321000045,12/22/2014,1880000.0,5,3.25,4110,7920,2.0,0.0,3.0,3,9,3150,960,1921,0,98122,47.617,-122.28200000000001,3890,7800,12,22,2014,UNK,220,120
3751600030,7/17/2014,100000.0,2,1.0,770,17334,1.0,0.0,0.0,3,7,770,0,1978,0,98001,47.2997,-122.26899999999999,1480,17334,7,17,2014,UNK,-710,0
4046500510,9/5/2014,307000.0,3,1.75,1410,16105,1.0,0.0,0.0,3,7,1410,0,1982,0,98014,47.6927,-121.913,1550,18615,9,5,2014,UNK,-140,-2510
8029520240,10/10/2014,475000.0,4,3.5,3660,14401,2.0,0.0,0.0,3,10,2660,1000,1994,0,98023,47.3076,-122.396,2780,10653,10,10,2014,UNK,880,3748
7016310030,2/19/2015,330000.0,4,2.5,2180,7210,1.0,0.0,0.0,3,7,1190,990,1972,0,98011,47.7419,-122.181,2070,7210,2,19,2015,UNK,110,0
1238500451,2/9/2015,130000.0,3,1.0,1110,7520,1.0,0.0,0.0,4,7,1110,0,1960,0,98033,47.683,-122.176,1440,8400,2,9,2015,UNK,-330,-880
4401150070,6/23/2014,320000.0,3,2.5,2280,7417,2.0,0.0,0.0,3,8,2280,0,1998,0,98001,47.3557,-122.27799999999999,2370,6443,6,23,2014,UNK,-90,974
3331000070,6/6/2014,735000.0,4,2.5,2820,6180,2.0,0.0,0.0,3,9,2050,770,2013,0,98118,47.5529,-122.281,1390,4635,6,6,2014,N,1430,1545
2636900126,3/12/2015,365000.0,4,2.5,1570,9600,1.0,0.0,0.0,3,7,800,770,1972,0,98155,47.7757,-122.303,1340,9110,3,12,2015,UNK,230,490
1842900030,4/16/2015,234000.0,3,1.5,1200,11935,1.0,0.0,0.0,4,7,1200,0,1968,0,98042,47.3434,-122.08200000000001,1350,11935,4,16,2015,UNK,-150,0
1761300310,8/27/2014,211000.0,4,2.0,1710,8288,1.5,0.0,0.0,3,7,1710,0,1970,0,98031,47.3947,-122.17399999999999,1710,7200,8,27,2014,UNK,0,1088
5249800729,3/30/2015,680000.0,6,3.5,3000,6320,2.0,0.0,2.0,3,8,2400,600,1969,0,98118,47.562,-122.279,1720,6360,3,30,2015,UNK,1280,-40
5104511600,11/12/2014,457000.0,4,3.0,2800,7845,2.0,0.0,0.0,3,8,2800,0,2002,0,98038,47.3544,-122.01299999999999,2800,6977,11,12,2014,UNK,0,868
8663370060,10/9/2014,349000.0,3,2.25,1640,7261,2.0,0.0,0.0,3,7,1640,0,1989,0,98034,47.7192,-122.176,1640,6789,10,9,2014,UNK,0,472
613400030,10/24/2014,360000.0,3,2.75,2030,6840,1.0,0.0,0.0,3,7,1210,820,1979,0,98108,47.5413,-122.29899999999999,1910,6365,10,24,2014,UNK,120,475
6004510240,4/14/2015,350000.0,4,2.5,2530,10155,2.0,0.0,0.0,3,8,2530,0,1998,0,98042,47.351000000000006,-122.146,2330,7205,4,14,2015,UNK,200,2950
1450100070,4/30/2015,208000.0,3,1.0,990,7420,1.0,0.0,0.0,5,6,990,0,1960,0,98002,47.2898,-122.221,1010,7420,4,30,2015,UNK,-20,0
6117501820,6/18/2014,250275.0,2,1.0,790,11234,1.0,0.0,0.0,4,6,790,0,1942,0,98166,47.4413,-122.34899999999999,1930,11871,6,18,2014,UNK,-1140,-637
6117501820,4/28/2015,435000.0,2,1.0,790,11234,1.0,0.0,0.0,4,6,790,0,1942,0,98166,47.4413,-122.34899999999999,1930,11871,4,28,2015,UNK,-1140,-637
5420300240,12/5/2014,270000.0,3,1.75,1800,7763,1.0,0.0,0.0,3,6,1470,330,1984,0,98030,47.3766,-122.184,1440,7483,12,5,2014,UNK,360,280
4140900140,5/27/2014,438000.0,3,1.75,1650,12940,1.0,0.0,0.0,4,7,1650,0,1961,0,98028,47.7629,-122.26799999999999,2830,12600,5,27,2014,UNK,-1180,340
1630700135,11/19/2014,659000.0,4,2.0,1980,23625,2.0,0.0,0.0,3,8,1980,0,1938,1984,98072,47.7553,-122.09200000000001,2300,24640,11,19,2014,Y,-320,-1015
5166700055,5/4/2015,645000.0,4,2.75,2340,6350,1.0,0.0,0.0,4,7,1310,1030,1974,0,98126,47.5559,-122.37899999999999,2020,6350,5,4,2015,UNK,320,0
3224600310,10/30/2014,685100.0,4,2.5,2790,5423,2.0,0.0,0.0,3,9,2790,0,1999,0,98074,47.6085,-122.01700000000001,2450,6453,10,30,2014,UNK,340,-1030
7227802030,6/23/2014,350000.0,7,3.0,2800,9569,1.0,0.0,2.0,3,7,1400,1400,1963,0,98056,47.5102,-122.18299999999999,2150,7333,6,23,2014,UNK,650,2236
226059078,2/27/2015,375000.0,2,1.0,1840,81892,1.0,0.0,0.0,3,6,1840,0,1955,0,98072,47.7694,-122.124,2550,40089,2,27,2015,UNK,-710,41803
1796100140,7/15/2014,170000.0,3,1.5,1350,81549,1.0,0.0,0.0,2,7,1350,0,1966,0,98092,47.3099,-122.09,2220,93825,7,15,2014,UNK,-870,-12276
5309100140,6/24/2014,880000.0,4,2.5,3030,3841,3.0,0.0,0.0,3,9,3030,0,2005,0,98117,47.6781,-122.369,1080,4922,6,24,2014,N,1950,-1081
8658300510,4/19/2015,410500.0,4,2.5,1980,5000,2.0,0.0,0.0,3,8,1980,0,2008,0,98014,47.6492,-121.90799999999999,1400,8500,4,19,2015,N,580,-3500
8691300060,10/23/2014,780000.0,4,2.5,3690,13609,2.0,0.0,2.0,3,10,3690,0,1996,0,98075,47.5872,-121.97200000000001,3600,13609,10,23,2014,UNK,90,0
9103000393,9/10/2014,1230000.0,5,4.5,3732,4426,2.5,0.0,0.0,3,10,2932,800,2001,0,98112,47.6189,-122.288,2950,4000,9,10,2014,UNK,782,426
8682281170,11/13/2014,449000.0,2,1.75,1510,6852,1.0,0.0,0.0,3,8,1510,0,2005,0,98053,47.7073,-122.012,1510,5912,11,13,2014,N,0,940
472000055,5/14/2014,546000.0,3,1.75,2000,5000,1.0,0.0,0.0,4,7,1110,890,1921,0,98117,47.6859,-122.399,1750,5000,5,14,2014,UNK,250,0
2473400570,5/16/2014,317000.0,3,2.0,1760,11410,1.0,0.0,0.0,5,7,1060,700,1977,0,98058,47.4528,-122.163,1680,9165,5,16,2014,UNK,80,2245
3449500135,6/25/2014,276900.0,3,1.0,1270,7566,1.0,0.0,0.0,4,7,1270,0,1958,0,98056,47.5074,-122.175,1780,7520,6,25,2014,UNK,-510,46
1926049355,10/28/2014,399000.0,5,2.0,2620,7030,1.0,0.0,0.0,3,8,1420,1200,1965,0,98133,47.7338,-122.352,1360,7964,10,28,2014,UNK,1260,-934
8650000070,8/8/2014,495000.0,5,2.75,2630,10165,1.0,0.0,0.0,4,8,1690,940,1976,0,98027,47.5196,-122.04899999999999,2440,10165,8,8,2014,UNK,190,0
8732131200,8/8/2014,258000.0,3,1.75,2270,9000,1.0,0.0,0.0,4,8,1330,940,1978,0,98023,47.3077,-122.381,2090,8400,8,8,2014,UNK,180,600
1624079051,7/10/2014,600000.0,2,2.5,2410,102366,1.0,0.0,0.0,4,7,1940,470,1912,1989,98024,47.5629,-121.91799999999999,2460,310582,7,10,2014,Y,-50,-208216
993001629,11/17/2014,265000.0,3,2.75,1120,881,3.0,0.0,0.0,3,8,1120,0,1999,0,98103,47.6914,-122.34299999999999,1120,1087,11,17,2014,UNK,0,-206
3832711040,4/24/2015,321000.0,5,2.75,3030,7000,1.0,0.0,0.0,4,7,1540,1490,1978,0,98032,47.3661,-122.28,1790,7330,4,24,2015,UNK,1240,-330
5244801230,8/29/2014,682000.0,5,2.25,2120,4000,1.5,0.0,0.0,4,7,1720,400,1910,0,98109,47.644,-122.353,1960,4000,8,29,2014,UNK,160,0
2798600240,11/14/2014,295700.0,4,2.5,1720,5805,2.0,0.0,0.0,3,8,1720,0,2000,0,98092,47.3286,-122.208,2360,7700,11,14,2014,UNK,-640,-1895
5701800030,5/6/2014,609000.0,4,2.5,2150,37981,2.0,0.0,0.0,3,9,2150,0,1985,0,98052,47.7227,-122.098,2450,37981,5,6,2014,UNK,-300,0
7636800041,6/25/2014,995000.0,3,4.5,4380,47044,2.0,1.0,3.0,3,9,3720,660,1968,1990,98166,47.4734,-122.365,2460,18512,6,25,2014,Y,1920,28532
3904901200,8/18/2014,530000.0,3,2.25,2010,11817,2.0,0.0,0.0,4,8,2010,0,1986,0,98029,47.5665,-122.023,2190,10168,8,18,2014,UNK,-180,1649
4109600055,12/29/2014,614000.0,5,2.5,3150,5150,2.0,0.0,0.0,5,8,1870,1280,1907,2004,98118,47.5506,-122.26899999999999,1550,5150,12,29,2014,Y,1600,0
3339400349,11/24/2014,390000.0,3,2.5,2500,21780,1.0,0.0,0.0,3,8,1770,730,1986,0,98092,47.3282,-122.198,2670,23400,11,24,2014,UNK,-170,-1620
7202340370,11/10/2014,467000.0,3,2.5,1690,6642,2.0,0.0,0.0,3,7,1690,0,2004,0,98053,47.6793,-122.03299999999999,2120,5080,11,10,2014,N,-430,1562
9477500060,8/13/2014,484000.0,6,2.5,3300,13501,1.0,0.0,0.0,3,8,2060,1240,1980,0,98059,47.5116,-122.163,2060,8745,8,13,2014,UNK,1240,4756
4310701600,11/13/2014,340000.0,3,2.5,1240,1115,3.0,0.0,0.0,3,8,1240,0,2003,0,98103,47.6985,-122.34,1410,1355,11,13,2014,UNK,-170,-240
2215450060,12/23/2014,302495.0,3,2.5,2200,7201,2.0,0.0,0.0,3,8,2200,0,1994,0,98030,47.3821,-122.20700000000001,2250,7240,12,23,2014,UNK,-50,-39
2919702075,9/25/2014,532500.0,3,1.75,1620,3360,1.0,0.0,0.0,5,7,980,640,1927,0,98117,47.6886,-122.361,1400,3840,9,25,2014,UNK,220,-480
8079030350,9/10/2014,441500.0,3,2.5,2420,9592,2.0,0.0,0.0,3,8,1780,640,1993,0,98059,47.5093,-122.15299999999999,2420,9145,9,10,2014,UNK,0,447
7893804340,7/24/2014,470000.0,4,2.5,2680,8062,1.0,0.0,3.0,4,7,1530,1150,1967,0,98198,47.4132,-122.32799999999999,1920,8600,7,24,2014,UNK,760,-538
4389200765,6/25/2014,2300000.0,4,3.25,4250,8570,2.0,0.0,0.0,3,9,4250,0,2004,0,98004,47.6154,-122.21,2830,12821,6,25,2014,N,1420,-4251
1822069116,12/17/2014,590000.0,3,2.5,2400,99752,1.0,0.0,0.0,3,9,2400,0,1996,0,98058,47.3917,-122.084,2800,98010,12,17,2014,UNK,-400,1742
7276100282,7/29/2014,320000.0,3,1.75,2300,12000,1.0,0.0,0.0,3,8,1770,530,1942,0,98133,47.7599,-122.34299999999999,2030,6000,7,29,2014,UNK,270,6000
567000392,11/3/2014,363000.0,2,2.0,920,1201,2.0,0.0,0.0,3,8,800,120,2009,0,98144,47.5926,-122.295,1150,1161,11,3,2014,N,-230,40
5729200030,7/7/2014,747500.0,4,2.25,2350,18600,2.0,0.0,0.0,4,9,2350,0,1977,0,98028,47.7473,-122.257,2880,14400,7,7,2014,UNK,-530,4200
8682220390,7/23/2014,750000.0,2,2.5,2630,7957,2.0,0.0,0.0,3,8,2630,0,2003,0,98053,47.7106,-122.023,2305,7220,7,23,2014,UNK,325,737
9828700200,5/5/2014,831000.0,4,3.0,2170,4000,2.0,0.0,0.0,4,9,1610,560,1982,2011,98112,47.6196,-122.292,1670,4000,5,5,2014,Y,500,0
7852180560,4/24/2015,403000.0,3,2.5,1700,4125,2.0,0.0,0.0,3,7,1700,0,2004,0,98065,47.5305,-121.854,1970,4105,4,24,2015,N,-270,20
3655400060,8/8/2014,445000.0,3,2.5,2470,4565,2.0,0.0,0.0,3,7,2470,0,2005,0,98056,47.513999999999996,-122.189,2470,5064,8,8,2014,N,0,-499
7955030060,3/26/2015,345000.0,3,1.0,1250,17380,1.0,0.0,0.0,4,7,1250,0,1970,0,98072,47.7502,-122.10799999999999,1410,18200,3,26,2015,UNK,-160,-820
8964800445,2/9/2015,2260000.0,3,3.5,3110,14872,1.0,0.0,0.0,3,10,3110,0,2003,0,98004,47.6178,-122.209,3110,12433,2,9,2015,UNK,0,2439
6204410200,6/16/2014,371025.0,3,2.0,1530,8925,1.0,0.0,0.0,3,7,1530,0,1977,0,98011,47.736000000000004,-122.199,2040,8856,6,16,2014,UNK,-510,69
7625702400,7/30/2014,355000.0,2,1.0,960,6250,1.0,0.0,0.0,3,6,960,0,1916,0,98136,47.5491,-122.38600000000001,1350,6250,7,30,2014,UNK,-390,0
5113200310,9/9/2014,270000.0,3,1.0,1240,14110,1.0,0.0,0.0,4,7,1240,0,1972,0,98058,47.4579,-122.09,2060,19350,9,9,2014,UNK,-820,-5240
7893802800,6/5/2014,425000.0,4,2.75,2440,15349,2.0,0.0,1.0,4,7,2440,0,1957,0,98198,47.4117,-122.333,2280,9250,6,5,2014,UNK,160,6099
2473003210,3/13/2015,364808.0,3,1.75,2320,7875,1.0,0.0,0.0,3,8,1620,700,1967,0,98058,47.4524,-122.146,1990,9720,3,13,2015,UNK,330,-1845
1402600570,1/13/2015,320000.0,3,2.25,1580,6561,1.0,0.0,0.0,3,8,1200,380,1981,0,98058,47.4394,-122.14,1710,7241,1,13,2015,UNK,-130,-680
8944460030,10/14/2014,325000.0,4,2.5,2963,5797,2.0,0.0,0.0,3,9,2963,0,2006,0,98030,47.3831,-122.185,2665,6119,10,14,2014,N,298,-322
2473480560,9/4/2014,350000.0,3,2.25,2470,10290,2.0,0.0,0.0,3,8,2230,240,1984,0,98058,47.4459,-122.124,1970,10150,9,4,2014,UNK,500,140
3365900465,2/19/2015,170000.0,3,1.5,1370,10176,1.0,0.0,0.0,3,6,1370,0,1947,0,98168,47.4738,-122.26299999999999,1650,10176,2,19,2015,UNK,-280,0
5341600030,5/9/2014,255000.0,2,1.0,960,28717,1.0,0.0,0.0,4,6,960,0,1984,0,98070,47.3356,-122.50200000000001,1860,28717,5,9,2014,UNK,-900,0
6073500160,12/10/2014,550000.0,3,1.0,1130,7500,1.0,0.0,0.0,3,7,880,250,1947,0,98117,47.6973,-122.389,2190,5250,12,10,2014,UNK,-1060,2250
2025760160,7/3/2014,835000.0,4,4.25,4930,25714,2.0,0.0,0.0,3,12,4930,0,2005,0,98092,47.3069,-122.148,3620,23035,7,3,2014,N,1310,2679
9393700140,3/10/2015,420000.0,3,1.0,1150,5120,1.0,0.0,0.0,4,6,800,350,1946,0,98116,47.5588,-122.39200000000001,1220,5120,3,10,2015,UNK,-70,0
5458800125,5/14/2014,925000.0,4,2.5,2190,7350,2.5,0.0,0.0,5,8,2190,0,1958,0,98040,47.5786,-122.236,1880,7350,5,14,2014,UNK,310,0
2492200435,6/6/2014,389250.0,2,1.5,1490,4080,1.0,0.0,0.0,3,7,930,560,1956,0,98126,47.5344,-122.381,1320,4080,6,6,2014,UNK,170,0
3759500046,5/1/2015,748000.0,3,2.5,2600,10183,1.0,0.0,0.0,3,8,1300,1300,2004,0,98033,47.6984,-122.20100000000001,1860,10401,5,1,2015,N,740,-218
8648220260,3/24/2015,284000.0,3,1.75,1530,9600,1.0,0.0,0.0,3,7,1200,330,1988,0,98042,47.3594,-122.07600000000001,1680,9680,3,24,2015,UNK,-150,-80
6392001670,6/11/2014,588000.0,4,2.0,1680,5000,1.0,0.0,0.0,3,7,980,700,1950,0,98115,47.6858,-122.286,1680,6000,6,11,2014,UNK,0,-1000
2026049155,3/20/2015,372500.0,3,1.75,1680,8648,1.0,0.0,0.0,4,7,1680,0,1963,0,98133,47.7338,-122.33200000000001,1290,8147,3,20,2015,UNK,390,501
2329800240,2/18/2015,285000.0,4,3.0,1900,7194,2.0,0.0,0.0,4,7,1900,0,1988,0,98042,47.3768,-122.117,1690,7194,2,18,2015,UNK,210,0
3380900125,5/27/2014,360000.0,3,1.0,1570,9467,1.0,0.0,0.0,3,7,1570,0,1954,0,98177,47.7683,-122.359,1570,9100,5,27,2014,UNK,0,367
1324079041,11/18/2014,275000.0,3,1.0,1370,17859,1.0,0.0,0.0,4,7,1150,220,1930,0,98024,47.5617,-121.859,1460,47044,11,18,2014,UNK,-90,-29185
8682230550,9/16/2014,428000.0,2,2.0,1350,4225,1.0,0.0,0.0,3,8,1350,0,2003,0,98053,47.7106,-122.03,1660,4225,9,16,2014,UNK,-310,0
853400240,3/25/2015,847000.0,6,2.5,3010,17864,2.0,0.0,0.0,3,8,3010,0,1969,0,98177,47.7209,-122.37200000000001,2560,11532,3,25,2015,UNK,450,6332
2130702075,9/26/2014,316000.0,3,1.0,1010,7838,1.0,0.0,0.0,4,6,1010,0,1977,0,98019,47.7422,-121.98100000000001,1380,8128,9,26,2014,UNK,-370,-290
3260810260,5/5/2015,375000.0,3,2.5,2050,7205,2.0,0.0,0.0,3,8,2050,0,2000,0,98003,47.3487,-122.304,2050,7264,5,5,2015,UNK,0,-59
2878600200,5/8/2014,533000.0,3,1.0,1670,4080,1.0,0.0,0.0,3,7,1170,500,1967,0,98115,47.6899,-122.321,1560,4080,5,8,2014,UNK,110,0
7298040310,5/23/2014,556000.0,5,2.5,3840,16905,2.0,0.0,0.0,3,11,3840,0,1991,0,98023,47.2996,-122.34200000000001,3270,12133,5,23,2014,UNK,570,4772
766000240,9/15/2014,225000.0,4,2.0,2220,14120,1.0,0.0,0.0,3,7,1200,1020,1966,0,98042,47.361000000000004,-122.116,1300,9709,9,15,2014,UNK,920,4411
3459700340,10/30/2014,537250.0,4,2.5,2590,9530,1.0,0.0,0.0,4,8,1640,950,1978,0,98155,47.7752,-122.285,2710,10970,10,30,2014,UNK,-120,-1440
2473251180,12/17/2014,255000.0,3,1.0,1180,13650,1.0,0.0,0.0,4,7,1180,0,1967,0,98058,47.4551,-122.154,1460,11730,12,17,2014,UNK,-280,1920
2407900200,4/9/2015,530000.0,4,2.5,2950,4836,2.0,0.0,0.0,3,7,2950,0,2006,0,98059,47.479,-122.12899999999999,2120,4750,4,9,2015,N,830,86
7558700030,4/13/2015,5300000.0,6,6.0,7390,24829,2.0,1.0,0.0,4,12,5000,2390,1991,0,98040,47.5631,-122.21,4320,24619,4,13,2015,UNK,3070,210
203600140,3/24/2015,595000.0,3,2.75,2150,31238,2.0,0.0,0.0,3,9,2150,0,1996,0,98014,47.6596,-121.96,2650,38307,3,24,2015,UNK,-500,-7069
4037800140,8/14/2014,548000.0,4,2.0,2100,8880,1.0,0.0,0.0,4,7,2100,0,1958,0,98008,47.6115,-122.124,1280,9102,8,14,2014,UNK,820,-222
1683600240,3/20/2015,234975.0,3,1.75,1650,8073,1.0,0.0,0.0,3,7,1100,550,1980,0,98092,47.3187,-122.182,1280,8073,3,20,2015,UNK,370,0
1962200036,8/19/2014,600000.0,3,1.75,1620,1325,2.5,0.0,0.0,3,9,1430,190,2005,0,98102,47.6498,-122.321,1750,1572,8,19,2014,N,-130,-247
1775800510,3/24/2015,432000.0,4,1.0,1750,12528,1.0,0.0,0.0,4,7,1750,0,1967,0,98072,47.743,-122.09700000000001,1550,14120,3,24,2015,UNK,200,-1592
1822350070,2/2/2015,455000.0,3,1.5,1380,6657,2.0,0.0,0.0,3,7,1380,0,1986,0,98034,47.7085,-122.21700000000001,1420,8187,2,2,2015,UNK,-40,-1530
7772400160,10/24/2014,279950.0,3,1.75,1510,11234,1.0,0.0,0.0,3,7,1210,300,1965,0,98155,47.7571,-122.32799999999999,2080,9076,10,24,2014,UNK,-570,2158
273900030,10/20/2014,267500.0,3,1.5,1600,9072,1.0,0.0,0.0,4,7,1600,0,1963,0,98030,47.3737,-122.21600000000001,1710,8000,10,20,2014,UNK,-110,1072
3323069084,9/9/2014,620000.0,4,2.5,1840,220308,2.0,0.0,0.0,3,8,1840,0,2000,0,98038,47.4306,-122.04899999999999,1890,65340,9,9,2014,UNK,-50,154968
4337000160,1/27/2015,110000.0,2,1.0,830,7590,1.0,0.0,0.0,2,6,830,0,1943,0,98166,47.4784,-122.335,980,7590,1,27,2015,UNK,-150,0
9126100550,5/13/2014,625000.0,3,3.5,1810,1846,2.0,0.0,0.0,4,8,1440,370,2009,0,98122,47.607,-122.305,1480,3600,5,13,2014,N,330,-1754
5101405274,5/29/2014,389000.0,2,1.0,910,7000,1.0,0.0,0.0,3,7,910,0,1952,0,98115,47.6999,-122.305,1260,7528,5,29,2014,UNK,-350,-528
4232400860,6/30/2014,1200000.0,4,2.0,2120,3360,2.0,0.0,0.0,3,9,2120,0,1905,0,98112,47.6227,-122.31,2090,3600,6,30,2014,UNK,30,-240
2723069082,4/24/2015,788500.0,4,2.25,2510,133729,2.0,0.0,0.0,4,8,2510,0,1977,0,98027,47.4569,-122.02,2510,69696,4,24,2015,UNK,0,64033
7436500270,7/25/2014,567000.0,5,2.25,2100,6936,1.0,0.0,0.0,3,8,1600,500,1974,0,98033,47.6737,-122.169,2100,8661,7,25,2014,UNK,0,-1725
5153200030,1/13/2015,515000.0,2,2.25,2690,15000,1.0,0.0,2.0,3,8,1870,820,1987,0,98023,47.3361,-122.353,2690,15000,1,13,2015,UNK,0,0
4022900125,9/2/2014,605000.0,4,2.5,2430,11870,1.0,0.0,0.0,5,8,1590,840,1968,0,98155,47.7761,-122.285,2430,9600,9,2,2014,UNK,0,2270
7841300505,10/27/2014,430000.0,4,3.75,2452,4800,2.0,0.0,0.0,3,7,2452,0,1936,1994,98055,47.4744,-122.213,1180,4800,10,27,2014,Y,1272,0
573000685,7/17/2014,805000.0,2,1.75,1550,6000,1.0,0.0,1.0,3,7,1550,0,1920,0,98199,47.6712,-122.40899999999999,2360,6000,7,17,2014,UNK,-810,0
8961990160,4/13/2015,567500.0,3,2.5,2080,4556,2.0,0.0,0.0,3,8,2080,0,1999,0,98074,47.6036,-122.014,1530,5606,4,13,2015,UNK,550,-1050
1250202255,6/5/2014,647500.0,3,1.75,1290,3870,1.0,0.0,0.0,5,7,1290,0,1916,0,98144,47.5873,-122.29,2020,5850,6,5,2014,UNK,-730,-1980
7234600796,11/26/2014,495000.0,2,1.75,1850,2530,2.5,0.0,0.0,4,7,1850,0,1903,0,98122,47.6106,-122.31,1500,1795,11,26,2014,UNK,350,735
3630180340,11/4/2014,825000.0,4,2.5,3370,5000,2.0,0.0,0.0,3,9,3370,0,2006,0,98027,47.541000000000004,-121.99799999999999,3370,5237,11,4,2014,N,0,-237
5104450070,3/9/2015,435000.0,4,2.25,2730,7506,2.0,0.0,0.0,4,8,2730,0,1987,0,98058,47.4627,-122.152,2390,8015,3,9,2015,UNK,340,-509
9477100060,9/9/2014,445950.0,3,1.75,1300,7800,1.0,0.0,0.0,5,7,1300,0,1968,0,98034,47.7321,-122.195,1520,7344,9,9,2014,UNK,-220,456
4139440830,6/3/2014,960000.0,5,2.75,3040,10257,2.0,0.0,0.0,3,10,3040,0,1993,0,98006,47.5531,-122.119,2860,9327,6,3,2014,UNK,180,930
6772200055,9/17/2014,780000.0,4,3.0,2440,3600,1.5,0.0,0.0,5,8,1480,960,1929,0,98103,47.6853,-122.331,1770,4000,9,17,2014,UNK,670,-400
8731982190,6/18/2014,274500.0,3,2.25,1720,9000,1.0,0.0,0.0,4,8,1320,400,1969,0,98023,47.3191,-122.383,1930,8000,6,18,2014,UNK,-210,1000
6300000335,4/29/2015,729953.0,5,3.0,3230,5167,1.5,0.0,0.0,4,8,2000,1230,1909,0,98133,47.7053,-122.34,1509,1626,4,29,2015,UNK,1721,3541
9301300751,7/28/2014,464950.0,3,1.5,1200,890,2.0,0.0,0.0,3,8,1030,170,2008,0,98109,47.6384,-122.34200000000001,1230,2120,7,28,2014,N,-30,-1230
9542100135,11/12/2014,620000.0,4,1.75,2350,18800,1.0,0.0,2.0,3,8,2350,0,1959,0,98005,47.5904,-122.177,3050,14640,11,12,2014,UNK,-700,4160
8691410700,1/16/2015,735000.0,4,3.5,3100,5600,2.0,0.0,0.0,3,9,3100,0,2005,0,98075,47.5968,-121.978,3080,5600,1,16,2015,N,20,0
217500135,4/21/2015,450000.0,4,2.25,2040,9565,1.0,0.0,0.0,3,8,1400,640,1959,0,98133,47.7356,-122.335,1890,8580,4,21,2015,UNK,150,985
3731800055,6/5/2014,450000.0,4,1.0,2000,4676,1.5,0.0,0.0,3,7,1250,750,1916,1986,98118,47.5529,-122.26799999999999,1140,4676,6,5,2014,Y,860,0
7234600786,5/11/2014,842500.0,4,2.5,2160,5298,2.5,0.0,0.0,4,9,2160,0,1902,0,98122,47.6106,-122.31,1720,2283,5,11,2014,UNK,440,3015
2423059104,10/8/2014,360000.0,3,2.0,1970,79714,1.0,0.0,0.0,3,7,1070,900,1979,0,98058,47.4674,-122.10700000000001,1890,36626,10,8,2014,UNK,80,43088
1823039205,6/24/2014,585000.0,3,2.5,2270,100545,2.0,0.0,0.0,3,8,2270,0,1998,0,98070,47.4815,-122.47,1277,100545,6,24,2014,UNK,993,0
2423020260,8/14/2014,461000.0,3,2.25,1850,7923,1.0,0.0,0.0,4,7,1150,700,1977,0,98033,47.7011,-122.171,1780,7420,8,14,2014,UNK,70,503
2695600070,8/18/2014,345000.0,2,1.0,1350,4494,1.0,0.0,0.0,3,7,920,430,1949,0,98126,47.5315,-122.38,1470,5225,8,18,2014,UNK,-120,-731
6844703240,7/2/2014,1080000.0,3,2.5,3280,10302,1.0,0.0,0.0,3,10,1680,1600,1970,0,98115,47.6948,-122.286,1550,6300,7,2,2014,UNK,1730,4002
3904940070,2/27/2015,643000.0,4,2.5,2270,8391,2.0,0.0,0.0,3,8,2270,0,1988,0,98029,47.574,-122.01299999999999,2420,8391,2,27,2015,UNK,-150,0
1939130070,9/29/2014,690000.0,4,2.5,2820,8307,2.0,0.0,0.0,3,9,2820,0,1990,0,98074,47.6253,-122.027,2820,8307,9,29,2014,UNK,0,0
5589300370,4/1/2015,282000.0,4,1.0,1200,11111,1.5,0.0,0.0,3,7,1200,0,1949,0,98155,47.7529,-122.306,1350,9113,4,1,2015,UNK,-150,1998
3526039116,11/18/2014,549000.0,3,1.75,2000,6130,1.0,0.0,0.0,4,8,1120,880,1951,0,98117,47.6925,-122.38799999999999,2140,7150,11,18,2014,UNK,-140,-1020
6821600390,1/8/2015,815000.0,3,2.0,2310,6000,2.0,0.0,1.0,4,9,1560,750,1926,0,98199,47.648,-122.395,2000,6000,1,8,2015,UNK,310,0
1925069082,5/11/2015,2200000.0,5,4.25,4640,22703,2.0,1.0,4.0,5,8,2860,1780,1952,0,98052,47.6393,-122.09700000000001,3140,14200,5,11,2015,UNK,1500,8503
8100400160,4/13/2015,700000.0,3,2.25,2330,11424,2.0,0.0,0.0,4,8,2330,0,1984,0,98052,47.6386,-122.11,2050,11448,4,13,2015,UNK,280,-24
5556300102,7/14/2014,933399.0,3,2.5,3940,10360,2.0,0.0,0.0,3,9,3110,830,1992,0,98052,47.6468,-122.116,2720,11941,7,14,2014,UNK,1220,-1581
7222000393,7/3/2014,290000.0,3,1.0,1440,11250,1.0,0.0,0.0,3,7,1440,0,1967,0,98055,47.4627,-122.213,2200,11250,7,3,2014,UNK,-760,0
9407001860,5/24/2014,372000.0,4,1.75,1960,9300,1.0,0.0,0.0,5,7,1340,620,1979,0,98045,47.4487,-121.772,1500,9752,5,24,2014,UNK,460,-452
9468200140,8/19/2014,450000.0,2,1.75,1250,2890,1.0,0.0,0.0,4,7,790,460,1920,0,98103,47.6795,-122.353,1500,3225,8,19,2014,UNK,-250,-335
3295950240,9/5/2014,303700.0,3,2.5,1981,5700,2.0,0.0,0.0,3,8,1981,0,2010,0,98030,47.3668,-122.178,1981,5894,9,5,2014,N,0,-194
3905000340,7/24/2014,672000.0,4,2.5,2440,10049,2.0,0.0,0.0,4,9,2440,0,1989,0,98029,47.5744,-121.993,2820,8484,7,24,2014,UNK,-380,1565
3374300070,6/23/2014,334000.0,4,1.5,1150,9360,1.5,0.0,0.0,3,6,1150,0,1970,0,98034,47.7197,-122.17299999999999,1480,8155,6,23,2014,UNK,-330,1205
7812800310,6/25/2014,260000.0,2,1.0,1120,5650,1.0,0.0,0.0,3,6,1120,0,1944,0,98178,47.4979,-122.241,1270,6875,6,25,2014,UNK,-150,-1225
7015200685,7/31/2014,749950.0,3,1.75,1800,5700,1.0,0.0,0.0,4,8,1000,800,1941,0,98119,47.6491,-122.367,1680,5350,7,31,2014,UNK,120,350
3521069051,12/23/2014,330000.0,4,2.25,2380,122038,2.0,0.0,0.0,4,8,2380,0,1984,0,98022,47.2624,-122.015,2030,48000,12,23,2014,UNK,350,74038
8032700140,10/28/2014,830000.0,5,3.0,2920,2808,2.0,0.0,0.0,3,8,2140,780,1960,0,98103,47.653999999999996,-122.34200000000001,1620,1544,10,28,2014,UNK,1300,1264
6117500320,7/8/2014,1130000.0,3,2.25,2790,13791,1.0,0.0,3.0,3,8,2790,0,2006,0,98166,47.4389,-122.351,2720,12600,7,8,2014,N,70,1191
7305300045,7/7/2014,320000.0,3,1.0,1560,7552,1.0,0.0,0.0,4,6,910,650,1948,0,98155,47.7552,-122.32700000000001,1200,8152,7,7,2014,UNK,360,-600
922069139,4/14/2015,260000.0,2,1.0,1550,15250,1.5,0.0,0.0,5,7,1550,0,1920,0,98038,47.407,-122.045,1520,34929,4,14,2015,UNK,30,-19679
84000335,6/26/2014,225000.0,3,2.0,1700,11475,1.0,0.0,0.0,5,6,970,730,1945,0,98146,47.4851,-122.338,1560,11475,6,26,2014,UNK,140,0
9232400055,9/17/2014,279200.0,1,1.0,640,6350,1.0,0.0,0.0,3,5,640,0,1939,0,98117,47.6976,-122.359,1270,6350,9,17,2014,UNK,-630,0
1453600202,5/20/2014,520000.0,4,3.5,2680,10000,2.0,0.0,0.0,3,8,2040,640,1942,2014,98125,47.726000000000006,-122.296,1530,8000,5,20,2014,Y,1150,2000
3904910520,6/25/2014,505000.0,3,2.5,1860,8060,2.0,0.0,0.0,4,8,1860,0,1987,0,98029,47.5674,-122.01700000000001,1850,4661,6,25,2014,UNK,10,3399
5469300270,5/6/2014,234000.0,3,1.75,1490,8366,1.0,0.0,0.0,4,7,1010,480,1975,0,98042,47.375,-122.14,1490,7469,5,6,2014,UNK,0,897
8681660060,9/29/2014,503000.0,4,2.5,2470,5044,2.0,0.0,0.0,3,9,2470,0,2005,0,98155,47.7728,-122.271,2790,5583,9,29,2014,N,-320,-539
3902300350,8/6/2014,606000.0,4,2.25,2390,8858,1.0,0.0,0.0,4,8,1740,650,1979,0,98033,47.6925,-122.184,2240,8858,8,6,2014,UNK,150,0
6392003490,7/23/2014,433500.0,3,1.0,1230,6000,1.0,0.0,0.0,4,7,780,450,1937,0,98115,47.6839,-122.281,1570,5000,7,23,2014,UNK,-340,1000
3342700465,1/23/2015,250000.0,3,1.5,2840,10182,1.0,0.0,0.0,3,8,1510,1330,1951,0,98056,47.523999999999994,-122.2,2210,9669,1,23,2015,UNK,630,513
2592210160,8/5/2014,719000.0,3,2.5,2120,9307,2.0,0.0,0.0,4,9,2120,0,1984,0,98006,47.5477,-122.141,2290,11524,8,5,2014,UNK,-170,-2217
616000160,12/10/2014,381000.0,3,2.0,1770,14400,1.0,0.0,0.0,4,8,1770,0,1959,0,98166,47.415,-122.337,1900,14400,12,10,2014,UNK,-130,0
1687000270,5/28/2014,267000.0,3,2.5,2495,4400,2.0,0.0,0.0,3,8,2495,0,2007,0,98001,47.288000000000004,-122.28299999999999,2434,4400,5,28,2014,N,61,0
4102000075,5/22/2014,275000.0,1,0.75,1170,14149,1.0,0.0,0.0,5,7,880,290,1962,0,98022,47.2653,-121.91,1130,24513,5,22,2014,UNK,40,-10364
8078460550,5/13/2014,651000.0,4,2.5,2740,7140,2.0,0.0,0.0,3,8,2740,0,1993,0,98074,47.6334,-122.021,2260,7035,5,13,2014,UNK,480,105
2710600070,2/4/2015,439000.0,2,1.0,1050,5671,1.0,0.0,0.0,3,7,850,200,1949,0,98115,47.6767,-122.286,1850,5243,2,4,2015,UNK,-800,428
37000435,2/14/2015,325000.0,2,1.0,1130,5070,1.0,0.0,0.0,4,7,1130,0,1955,0,98146,47.5141,-122.37700000000001,860,6300,2,14,2015,UNK,270,-1230
5100401414,5/2/2014,490000.0,2,1.0,880,6380,1.0,0.0,0.0,3,7,880,0,1938,1994,98115,47.6924,-122.322,1340,6380,5,2,2014,Y,-460,0
5631500254,10/7/2014,519900.0,4,2.5,2403,6172,2.0,0.0,0.0,3,9,2403,0,1999,0,98028,47.7361,-122.234,2380,6075,10,7,2014,UNK,23,97
8567300140,7/23/2014,545000.0,4,2.75,3410,35040,2.0,0.0,0.0,3,9,3410,0,1984,0,98038,47.4054,-122.03,2580,37263,7,23,2014,UNK,830,-2223
98000060,7/14/2014,1060000.0,4,4.0,5320,20041,2.0,0.0,0.0,3,11,5320,0,2003,0,98075,47.5852,-121.96600000000001,4640,17268,7,14,2014,UNK,680,2773
2205500400,5/14/2014,542000.0,4,1.75,1900,8250,1.0,0.0,0.0,4,7,950,950,1955,0,98006,47.5765,-122.147,1480,8360,5,14,2014,UNK,420,-110
1726069084,12/8/2014,465000.0,4,1.75,1810,21650,2.0,0.0,0.0,4,7,1810,0,1961,0,98077,47.7358,-122.07600000000001,2700,29680,12,8,2014,UNK,-890,-8030
8682291840,3/31/2015,408000.0,2,2.0,1200,3900,1.0,0.0,0.0,3,8,1200,0,2006,0,98053,47.72,-122.024,1440,5580,3,31,2015,N,-240,-1680
5003600240,12/4/2014,292000.0,4,2.5,2060,5950,2.0,0.0,0.0,3,8,2060,0,2000,0,98030,47.3631,-122.19200000000001,2242,6406,12,4,2014,UNK,-182,-456
5636000400,5/7/2014,253000.0,3,1.75,1250,10122,1.0,0.0,0.0,3,7,1250,0,1994,0,98010,47.3277,-122.001,1980,10175,5,7,2014,UNK,-730,-53
3298700125,9/5/2014,280000.0,2,1.0,910,4662,1.0,0.0,0.0,5,6,910,0,1942,0,98106,47.5232,-122.354,890,6050,9,5,2014,UNK,20,-1388
7880000060,6/4/2014,658588.0,3,2.25,2560,41346,2.0,0.0,0.0,3,10,2560,0,1986,0,98027,47.4871,-122.065,3040,35395,6,4,2014,UNK,-480,5951
7811200310,12/16/2014,635000.0,4,2.25,1920,8910,1.0,0.0,0.0,4,8,1200,720,1969,0,98005,47.5897,-122.156,2250,8800,12,16,2014,UNK,-330,110
5255690160,10/9/2014,439000.0,4,2.25,2240,8300,2.0,0.0,0.0,3,8,2240,0,1978,0,98011,47.7746,-122.197,2340,8500,10,9,2014,UNK,-100,-200
869700320,8/6/2014,300000.0,3,2.5,1260,3855,2.0,0.0,0.0,3,8,1260,0,1999,0,98059,47.4908,-122.154,1310,3344,8,6,2014,UNK,-50,511
6052401631,2/5/2015,345000.0,3,1.5,1360,13496,1.0,0.0,0.0,4,8,1360,0,1960,0,98198,47.4032,-122.314,1900,10538,2,5,2015,UNK,-540,2958
5089700260,8/12/2014,283500.0,4,2.25,2100,8050,2.0,0.0,0.0,3,8,2100,0,1978,0,98055,47.4391,-122.193,2190,7700,8,12,2014,UNK,-90,350
9473200105,9/24/2014,425000.0,2,1.0,2110,4920,1.5,0.0,0.0,3,7,1460,650,1911,0,98103,47.6872,-122.339,1390,4732,9,24,2014,UNK,720,188
6678900140,3/19/2015,685000.0,3,1.75,2210,8955,1.0,0.0,1.0,3,8,1560,650,1974,0,98033,47.6621,-122.189,2210,8976,3,19,2015,UNK,0,-21
9552700550,4/21/2015,750000.0,3,2.5,2360,12987,2.0,0.0,0.0,3,8,2360,0,1983,0,98006,47.5471,-122.149,2480,11665,4,21,2015,UNK,-120,1322
2171400218,4/16/2015,245000.0,4,1.5,1280,8000,1.0,0.0,0.0,3,6,1280,0,1960,0,98178,47.4949,-122.255,1420,8211,4,16,2015,UNK,-140,-211
9122001231,4/3/2015,585444.0,6,3.75,2740,6924,1.0,0.0,2.0,3,7,1640,1100,1962,0,98144,47.5816,-122.296,1940,6000,4,3,2015,UNK,800,924
6639900012,9/17/2014,706000.0,4,2.5,2740,7571,2.0,0.0,0.0,3,9,2740,0,2009,0,98033,47.6962,-122.179,2880,7203,9,17,2014,N,-140,368
8151601090,8/1/2014,445000.0,4,2.0,2630,9099,1.5,0.0,0.0,3,7,1830,800,1944,0,98146,47.5067,-122.361,1430,6825,8,1,2014,UNK,1200,2274
6664900260,2/19/2015,241000.0,3,2.0,1650,6000,1.0,0.0,0.0,3,7,1650,0,1990,0,98023,47.2904,-122.353,1870,6000,2,19,2015,UNK,-220,0
7663700030,5/3/2015,1180000.0,2,2.5,1770,7155,2.0,1.0,4.0,3,8,1770,0,1957,0,98155,47.7345,-122.285,2410,10476,5,3,2015,UNK,-640,-3321
952000055,2/6/2015,530000.0,3,1.0,1500,5750,1.5,0.0,0.0,4,7,1050,450,1927,0,98126,47.5677,-122.376,1500,5060,2,6,2015,UNK,0,690
4292300024,3/2/2015,350000.0,3,1.5,1430,12199,1.0,0.0,0.0,3,7,1130,300,1948,0,98133,47.7352,-122.33,1490,8196,3,2,2015,UNK,-60,4003
8073000550,4/15/2015,1700000.0,4,3.75,3190,17186,2.0,1.0,4.0,3,10,3190,0,1999,0,98178,47.5115,-122.24600000000001,2290,13496,4,15,2015,UNK,900,3690
9238450160,4/28/2015,389000.0,3,1.0,1280,9630,1.0,0.0,0.0,3,7,1280,0,1968,0,98072,47.7677,-122.163,1300,9453,4,28,2015,UNK,-20,177
6127600036,11/5/2014,799000.0,4,2.75,2390,6820,2.0,0.0,0.0,4,7,2140,250,1945,0,98115,47.6788,-122.27,1980,6820,11,5,2014,UNK,410,0
1370801331,8/4/2014,1400000.0,4,2.5,4040,9630,1.0,0.0,3.0,4,9,2020,2020,1951,0,98199,47.6408,-122.41,3160,8025,8,4,2014,UNK,880,1605
3500100226,12/29/2014,340895.0,2,1.0,920,8612,1.0,0.0,0.0,5,7,920,0,1947,0,98155,47.733999999999995,-122.301,1500,7956,12,29,2014,UNK,-580,656
319500570,5/5/2014,780000.0,4,2.5,2730,10281,2.0,0.0,2.0,3,9,2730,0,1996,0,98074,47.6227,-122.029,2750,7220,5,5,2014,UNK,-20,3061
3751604974,12/4/2014,350000.0,2,1.5,1320,73600,1.0,0.0,0.0,3,7,1320,0,1993,0,98001,47.2755,-122.271,1320,33600,12,4,2014,UNK,0,40000
7852030320,2/17/2015,470000.0,3,2.5,2620,4874,2.0,0.0,0.0,3,7,2620,0,1999,0,98065,47.5328,-121.87899999999999,2360,4231,2,17,2015,UNK,260,643
2481630070,1/28/2015,914600.0,4,3.0,3180,80837,2.0,0.0,0.0,3,11,3180,0,1985,0,98072,47.7336,-122.134,3180,38715,1,28,2015,UNK,0,42122
4299000030,9/23/2014,354000.0,4,2.5,2900,4762,2.0,0.0,0.0,3,8,2900,0,2005,0,98042,47.3663,-122.12899999999999,2900,5173,9,23,2014,N,0,-411
3886902590,2/26/2015,470000.0,5,2.0,1900,6000,1.5,0.0,0.0,4,6,1900,0,1920,0,98033,47.6831,-122.186,2110,8400,2,26,2015,UNK,-210,-2400
9178601000,7/30/2014,715000.0,3,2.0,1760,5400,1.0,0.0,0.0,5,7,1160,600,1927,0,98103,47.6558,-122.331,1640,5400,7,30,2014,UNK,120,0
2861100030,10/7/2014,265000.0,2,1.0,760,4000,1.0,0.0,0.0,4,6,760,0,1950,0,98108,47.5466,-122.304,1640,4500,10,7,2014,UNK,-880,-500
9471200370,3/30/2015,2540000.0,4,3.0,3710,20000,2.0,0.0,2.0,5,10,2760,950,1936,0,98105,47.6696,-122.26100000000001,3970,20000,3,30,2015,UNK,-260,0
625049286,8/15/2014,640000.0,3,1.0,1530,4944,1.0,0.0,0.0,3,7,1530,0,1950,0,98103,47.6857,-122.34100000000001,1500,4944,8,15,2014,UNK,30,0
133000135,11/20/2014,290000.0,4,1.75,1990,18900,2.0,0.0,0.0,4,7,1870,120,1929,0,98168,47.5131,-122.31299999999999,1710,12400,11,20,2014,UNK,280,6500
7214700830,5/13/2014,480000.0,5,4.75,3830,35000,1.0,0.0,0.0,3,8,2130,1700,1976,0,98077,47.7597,-122.079,2750,36150,5,13,2014,UNK,1080,-1150
4473400045,8/26/2014,535000.0,3,2.0,2040,5600,1.0,0.0,1.0,5,7,1120,920,1954,0,98144,47.5959,-122.29299999999999,2120,4958,8,26,2014,UNK,-80,642
9413600350,8/29/2014,907000.0,3,1.75,2170,12220,1.0,0.0,0.0,5,8,2170,0,1965,0,98033,47.6537,-122.195,1980,9000,8,29,2014,UNK,190,3220
1138010520,6/1/2014,459000.0,3,1.75,1620,7330,1.0,0.0,0.0,4,7,1090,530,1974,0,98034,47.7148,-122.213,1380,7191,6,1,2014,UNK,240,139
7431500341,4/24/2015,1360000.0,3,2.5,3600,21399,1.0,0.0,3.0,3,9,2310,1290,1950,2007,98008,47.6191,-122.09899999999999,2830,17559,4,24,2015,Y,770,3840
8830400135,3/5/2015,264950.0,3,1.5,1470,11599,1.0,0.0,0.0,3,7,1070,400,1967,0,98030,47.3632,-122.18799999999999,1580,9760,3,5,2015,UNK,-110,1839
5694000710,11/7/2014,352950.0,3,1.0,1760,3000,1.5,0.0,0.0,1,6,1760,0,1900,0,98103,47.6598,-122.348,1320,1266,11,7,2014,UNK,440,1734
1951820070,8/22/2014,491500.0,3,2.25,2230,13100,1.0,0.0,0.0,4,8,1510,720,1974,0,98006,47.5413,-122.17399999999999,2010,10650,8,22,2014,UNK,220,2450
6137500320,6/25/2014,1230000.0,4,3.5,3770,37034,2.0,0.0,0.0,3,10,2830,940,1989,0,98007,47.6463,-122.15100000000001,3200,36342,6,25,2014,UNK,570,692
6703100070,4/6/2015,369500.0,3,1.0,1200,9194,1.0,0.0,0.0,4,7,1200,0,1952,0,98155,47.7362,-122.319,1330,8650,4,6,2015,UNK,-130,544
339350070,3/18/2015,566000.0,3,2.5,2090,6294,2.0,0.0,0.0,3,9,2090,0,2004,0,98052,47.68600000000001,-122.095,2520,5735,3,18,2015,N,-430,559
7399300860,8/25/2014,290000.0,3,2.25,1500,7308,1.0,0.0,0.0,4,7,1210,290,1968,0,98055,47.4621,-122.18700000000001,1480,7400,8,25,2014,UNK,20,-92
8907500070,4/13/2015,5350000.0,5,5.0,8000,23985,2.0,0.0,4.0,3,12,6720,1280,2009,0,98004,47.6232,-122.22,4600,21750,4,13,2015,N,3400,2235
8651430560,5/22/2014,180000.0,3,1.0,870,5330,1.0,0.0,0.0,3,6,870,0,1969,0,98042,47.369,-122.07700000000001,840,5200,5,22,2014,UNK,30,130
2228900270,8/12/2014,215000.0,2,1.0,1010,6000,1.0,0.0,0.0,4,6,1010,0,1944,0,98133,47.771,-122.353,1610,7313,8,12,2014,UNK,-600,-1313
2228900270,2/12/2015,302000.0,2,1.0,1010,6000,1.0,0.0,0.0,4,6,1010,0,1944,0,98133,47.771,-122.353,1610,7313,2,12,2015,UNK,-600,-1313
6880200030,4/10/2015,352500.0,3,1.75,1860,7881,1.0,0.0,0.0,3,7,1160,700,1986,0,98198,47.3855,-122.322,1490,7527,4,10,2015,UNK,370,354
7227501170,6/26/2014,235867.0,4,2.0,1330,5926,1.0,0.0,0.0,4,5,1330,0,1942,0,98056,47.496,-122.19,1150,5485,6,26,2014,UNK,180,441
7504460200,7/17/2014,500000.0,3,2.25,1760,11946,2.0,0.0,0.0,3,8,1760,0,1978,0,98074,47.623999999999995,-122.05,2080,12068,7,17,2014,UNK,-320,-122
1559900200,3/26/2015,382000.0,3,2.25,1800,4500,2.0,0.0,0.0,3,7,1800,0,1995,0,98019,47.7462,-121.98,1760,6589,3,26,2015,UNK,40,-2089
546000400,4/22/2015,515000.0,5,2.5,1690,2402,1.5,0.0,0.0,3,7,990,700,1930,0,98117,47.6903,-122.38,1200,4005,4,22,2015,UNK,490,-1603
1596600060,5/1/2015,250000.0,1,1.0,660,2600,1.0,0.0,0.0,3,6,660,0,1919,0,98144,47.5723,-122.304,1560,5445,5,1,2015,UNK,-900,-2845
6021501920,6/27/2014,672500.0,3,2.25,2400,5300,1.5,0.0,0.0,4,7,1250,1150,1939,0,98117,47.6876,-122.384,1540,4800,6,27,2014,UNK,860,500
3275860270,10/22/2014,755000.0,3,2.25,3020,13031,2.0,0.0,0.0,3,9,3020,0,1989,0,98052,47.6897,-122.098,2480,10204,10,22,2014,UNK,540,2827
5457300703,3/20/2015,707500.0,3,1.0,1500,2555,2.0,0.0,2.0,3,7,1500,0,1910,0,98109,47.626999999999995,-122.353,1820,2555,3,20,2015,UNK,-320,0
2919700885,8/26/2014,459000.0,4,2.0,1560,3840,1.0,0.0,0.0,4,6,960,600,1924,0,98117,47.6882,-122.365,1560,4800,8,26,2014,UNK,0,-960
1951500030,2/4/2015,140000.0,3,1.0,1090,10620,1.5,0.0,0.0,3,7,1090,0,1959,0,98032,47.3748,-122.294,1380,10620,2,4,2015,UNK,-290,0
9550200310,8/11/2014,495000.0,2,1.0,970,4284,1.0,0.0,0.0,3,7,970,0,1905,0,98103,47.6667,-122.333,2050,4284,8,11,2014,UNK,-1080,0
3630120700,5/13/2014,757000.0,3,3.25,3190,5283,2.0,0.0,0.0,3,9,3190,0,2007,0,98029,47.5534,-122.00200000000001,2950,5198,5,13,2014,N,240,85
3630120700,1/7/2015,765000.0,3,3.25,3190,5283,2.0,0.0,0.0,3,9,3190,0,2007,0,98029,47.5534,-122.00200000000001,2950,5198,1,7,2015,N,240,85
6370000070,9/19/2014,359000.0,4,1.5,1890,6052,1.0,0.0,0.0,4,7,1890,0,1955,0,98125,47.7055,-122.3,1510,6072,9,19,2014,UNK,380,-20
7935000125,6/5/2014,440000.0,3,1.0,1050,7500,1.0,0.0,0.0,3,6,1050,0,1900,0,98136,47.5473,-122.396,1380,7500,6,5,2014,UNK,-330,0
3034200058,5/29/2014,400000.0,4,1.5,1390,7200,1.0,0.0,0.0,3,7,1140,250,1965,0,98133,47.7224,-122.33200000000001,1630,7702,5,29,2014,UNK,-240,-502
2856102336,3/25/2015,652000.0,3,2.0,1700,4080,1.0,0.0,0.0,4,7,850,850,1941,0,98117,47.6785,-122.39299999999999,1480,5100,3,25,2015,UNK,220,-1020
2523039239,5/30/2014,260000.0,3,1.75,1050,5850,1.0,0.0,0.0,3,7,1050,0,1980,0,98166,47.4574,-122.35799999999999,1220,8880,5,30,2014,UNK,-170,-3030
5452800310,4/20/2015,1330000.0,5,3.0,3340,10796,1.0,0.0,2.0,3,9,2120,1220,1964,1990,98040,47.5421,-122.229,3290,12955,4,20,2015,Y,50,-2159
2724069070,2/20/2015,519500.0,4,2.0,1540,17859,1.0,0.0,0.0,3,6,1540,0,1964,0,98027,47.5326,-122.03200000000001,1390,9688,2,20,2015,UNK,150,8171
6690500320,10/27/2014,650000.0,3,1.0,1710,5992,1.5,0.0,0.0,4,7,1560,150,1928,0,98103,47.6861,-122.354,1240,3001,10,27,2014,UNK,470,2991
2413301070,3/24/2015,280000.0,4,2.25,2100,8075,2.0,0.0,0.0,3,8,2100,0,1978,0,98003,47.3251,-122.329,2100,7464,3,24,2015,UNK,0,611
1562100030,9/10/2014,515000.0,4,1.75,1730,7980,1.0,0.0,0.0,4,8,1730,0,1965,0,98007,47.6219,-122.13799999999999,2080,8400,9,10,2014,UNK,-350,-420
7941140070,3/18/2015,400000.0,3,2.25,1500,2692,2.0,0.0,0.0,3,7,1500,0,1986,0,98034,47.7159,-122.20299999999999,1470,2418,3,18,2015,UNK,30,274
1703050520,4/14/2015,652100.0,3,2.5,2380,5017,2.0,0.0,0.0,3,9,2380,0,2003,0,98074,47.6297,-122.021,2670,6066,4,14,2015,UNK,-290,-1049
2412600030,6/23/2014,235000.0,6,3.0,2180,7956,2.0,0.0,0.0,3,7,2180,0,1980,0,98003,47.3054,-122.305,2214,7684,6,23,2014,UNK,-34,272
5266300140,4/8/2015,701000.0,4,1.5,1840,10080,2.0,0.0,0.0,3,8,1840,0,1907,0,98118,47.5575,-122.279,1830,5040,4,8,2015,UNK,10,5040
11520030,6/24/2014,640000.0,4,2.5,2341,9594,2.0,0.0,0.0,3,9,2341,0,1997,0,98052,47.6993,-122.115,2850,9421,6,24,2014,UNK,-509,173
7202290140,7/28/2014,455800.0,3,2.5,1690,4584,2.0,0.0,0.0,3,7,1690,0,2002,0,98053,47.6866,-122.04299999999999,1600,3164,7,28,2014,UNK,90,1420
8161010060,12/18/2014,504750.0,3,2.5,2490,21937,2.0,0.0,0.0,3,8,2490,0,1993,0,98014,47.6442,-121.898,2450,21937,12,18,2014,UNK,40,0
8562900710,7/11/2014,483000.0,3,3.0,2440,15540,2.0,0.0,0.0,3,9,2440,0,1992,0,98074,47.6104,-122.06,2440,15283,7,11,2014,UNK,0,257
8888000055,12/30/2014,530000.0,3,0.75,920,20412,1.0,0.0,2.0,5,6,920,0,1950,0,98070,47.4781,-122.49,1162,54705,12,30,2014,UNK,-242,-34293
3395800295,7/11/2014,250000.0,2,1.0,1030,8786,1.0,0.0,0.0,3,6,1030,0,1956,0,98146,47.4814,-122.34100000000001,1480,8121,7,11,2014,UNK,-450,665
5557320030,9/24/2014,229950.0,5,2.75,2000,5885,1.0,0.0,0.0,3,7,1260,740,1994,0,98023,47.3155,-122.34700000000001,1960,6514,9,24,2014,UNK,40,-629
2909300640,7/23/2014,884744.0,4,3.5,4210,9414,2.0,0.0,0.0,3,9,4210,0,2001,0,98074,47.6067,-122.022,3950,8880,7,23,2014,UNK,260,534
5202500030,4/1/2015,514000.0,3,1.5,1610,9964,1.0,0.0,0.0,3,7,1080,530,1977,0,98052,47.6681,-122.14299999999999,1610,9964,4,1,2015,UNK,0,0
5561300640,5/6/2015,532000.0,3,2.25,1910,35015,1.0,0.0,0.0,4,8,1430,480,1977,0,98027,47.4672,-122.006,2340,36680,5,6,2015,UNK,-430,-1665
3449900030,9/11/2014,423000.0,4,2.5,2660,5539,2.0,0.0,0.0,3,8,2660,0,2004,0,98059,47.4981,-122.162,2380,5539,9,11,2014,N,280,0
952003435,8/26/2014,420000.0,2,1.0,820,4025,1.0,0.0,2.0,5,6,820,0,1922,0,98126,47.5649,-122.38,1410,5750,8,26,2014,UNK,-590,-1725
6204200340,11/10/2014,521000.0,3,1.75,1730,18250,1.0,0.0,0.0,3,8,1730,0,1988,0,98011,47.736999999999995,-122.20100000000001,2180,10027,11,10,2014,UNK,-450,8223
1737100830,2/5/2015,577000.0,4,2.25,2360,7490,2.0,0.0,0.0,3,8,2360,0,1979,0,98033,47.6988,-122.169,2360,7490,2,5,2015,UNK,0,0
2207200520,9/29/2014,425000.0,3,1.0,970,8040,1.0,0.0,0.0,3,7,970,0,1956,0,98007,47.603,-122.132,1250,7000,9,29,2014,UNK,-280,1040
3818400060,10/31/2014,495000.0,4,2.5,2460,4862,2.0,0.0,0.0,3,8,2460,0,2004,0,98028,47.7719,-122.235,2900,4895,10,31,2014,N,-440,-33
9264960560,10/1/2014,340000.0,3,2.5,2690,8577,2.0,0.0,0.0,3,9,2690,0,1987,0,98023,47.3026,-122.351,2570,8066,10,1,2014,UNK,120,511
6362900172,9/23/2014,499950.0,3,3.5,1820,1991,2.0,0.0,0.0,3,8,1430,390,2014,0,98144,47.596000000000004,-122.29799999999999,1550,1460,9,23,2014,N,270,531
9272200810,3/16/2015,1220000.0,4,3.0,3470,4750,2.0,0.0,2.0,3,9,2370,1100,2014,0,98116,47.5917,-122.38600000000001,2420,4761,3,16,2015,N,1050,-11
3629160060,2/27/2015,720000.0,4,2.75,3370,7634,1.0,0.0,2.0,5,8,2110,1260,1977,0,98056,47.5259,-122.204,2460,7634,2,27,2015,UNK,910,0
4324200060,3/12/2015,249000.0,3,1.5,1700,8247,1.0,0.0,0.0,3,7,1010,690,1970,0,98031,47.4216,-122.17399999999999,1440,8400,3,12,2015,UNK,260,-153
3830620710,6/13/2014,206135.0,3,1.0,1340,11070,1.0,0.0,0.0,4,7,1340,0,1978,0,98030,47.3527,-122.178,1650,7630,6,13,2014,UNK,-310,3440
3276900030,10/6/2014,300000.0,5,2.75,2000,9276,2.0,0.0,0.0,4,7,2000,0,1968,0,98055,47.443999999999996,-122.19,1240,8270,10,6,2014,UNK,760,1006
4058800830,3/18/2015,612000.0,6,3.0,3840,14040,1.5,0.0,3.0,3,8,2460,1380,1949,0,98178,47.506,-122.241,2170,6765,3,18,2015,UNK,1670,7275
6202600070,11/6/2014,1100000.0,5,2.5,3890,27311,2.0,0.0,2.0,3,10,3890,0,1950,1990,98177,47.7291,-122.363,3160,22641,11,6,2014,Y,730,4670
8581200030,2/24/2015,230000.0,4,2.0,1220,9100,1.5,0.0,0.0,4,7,1220,0,1970,0,98023,47.2964,-122.376,1160,7700,2,24,2015,UNK,60,1400
2771601940,5/4/2015,850000.0,3,1.0,2280,4600,1.0,0.0,2.0,3,8,1250,1030,1936,0,98119,47.6378,-122.37200000000001,1910,4000,5,4,2015,UNK,370,600
2214800270,9/25/2014,355000.0,4,2.5,2770,7000,1.0,0.0,0.0,4,7,1940,830,1979,0,98001,47.3396,-122.256,2140,7684,9,25,2014,UNK,630,-684
7312000240,6/23/2014,442000.0,4,2.5,2520,7253,2.0,0.0,0.0,3,9,2520,0,1990,0,98059,47.5148,-122.15899999999999,2570,8359,6,23,2014,UNK,-50,-1106
8562890560,6/26/2014,399000.0,4,3.0,3060,5000,2.0,0.0,0.0,3,8,3060,0,2001,0,98042,47.3786,-122.126,3060,5668,6,26,2014,UNK,0,-668
4136930310,11/6/2014,360000.0,4,2.5,2390,7115,2.0,0.0,0.0,3,9,2390,0,1999,0,98092,47.2593,-122.22200000000001,2600,7916,11,6,2014,UNK,-210,-801
1328330350,2/13/2015,390000.0,3,1.75,1320,7725,1.0,0.0,0.0,3,8,1320,0,1978,0,98058,47.4425,-122.133,2020,7210,2,13,2015,UNK,-700,515
5255690060,3/18/2015,413000.0,5,2.5,2900,8711,1.0,0.0,0.0,3,8,1650,1250,1977,0,98011,47.7752,-122.197,2340,8869,3,18,2015,UNK,560,-158
402000260,2/11/2015,190000.0,2,1.0,700,9500,1.0,0.0,0.0,3,6,700,0,1951,0,98118,47.5294,-122.27600000000001,1020,5617,2,11,2015,UNK,-320,3883
7787110060,10/13/2014,432900.0,3,2.5,2210,9226,2.0,0.0,0.0,3,8,2210,0,1998,0,98045,47.4849,-121.78200000000001,2430,8902,10,13,2014,UNK,-220,324
8651580310,5/28/2014,621138.0,3,2.25,2180,7741,2.0,0.0,0.0,3,9,2180,0,1986,0,98074,47.6482,-122.072,2300,8581,5,28,2014,UNK,-120,-840
3705000060,6/4/2014,270000.0,3,2.25,2080,4252,1.5,0.0,0.0,3,7,1550,530,2003,0,98042,47.4203,-122.15700000000001,2080,2275,6,4,2014,UNK,0,1977
7525410060,1/9/2015,610000.0,4,2.25,2090,35040,1.0,0.0,0.0,3,8,1490,600,1980,0,98075,47.5739,-122.03200000000001,2910,21132,1,9,2015,UNK,-820,13908
3295700060,6/2/2014,500000.0,3,2.0,1720,5525,1.0,0.0,2.0,5,7,960,760,1941,0,98108,47.559,-122.29799999999999,1760,5525,6,2,2014,UNK,-40,0
8121500060,8/7/2014,715000.0,4,2.25,2460,40635,1.0,0.0,0.0,5,8,2460,0,1968,0,98053,47.6627,-122.03200000000001,2250,40635,8,7,2014,UNK,210,0
3728800320,5/29/2014,264000.0,3,1.5,1470,14821,1.0,0.0,0.0,4,7,1470,0,1958,0,98042,47.3658,-122.148,1760,15370,5,29,2014,UNK,-290,-549
6003501535,8/28/2014,550000.0,3,1.75,1650,3200,1.5,0.0,0.0,3,8,1650,0,1901,0,98102,47.6209,-122.31700000000001,1500,2400,8,28,2014,UNK,150,800
2621750340,10/15/2014,337000.0,3,2.0,1690,9087,1.0,0.0,0.0,3,8,1690,0,1997,0,98042,47.3724,-122.10799999999999,2090,8100,10,15,2014,UNK,-400,987
3445000274,5/13/2015,170000.0,3,1.0,970,8710,1.0,0.0,0.0,4,6,970,0,1962,0,98198,47.4167,-122.302,1280,11805,5,13,2015,UNK,-310,-3095
3288200030,8/29/2014,405000.0,4,2.5,2030,9095,1.0,0.0,0.0,4,7,1130,900,1972,0,98034,47.7321,-122.185,1940,8000,8,29,2014,UNK,90,1095
4188000640,9/11/2014,775000.0,4,2.5,2540,28563,1.0,0.0,0.0,3,10,2540,0,1984,0,98052,47.7185,-122.11399999999999,2790,20301,9,11,2014,UNK,-250,8262
2558730070,8/25/2014,425000.0,3,2.25,1570,7475,1.0,0.0,0.0,4,7,1200,370,1983,0,98034,47.7223,-122.17399999999999,1700,7230,8,25,2014,UNK,-130,245
7923500060,9/22/2014,713000.0,5,2.75,2580,9242,2.0,0.0,2.0,4,8,1720,860,1967,0,98007,47.5943,-122.133,2240,9316,9,22,2014,UNK,340,-74
8016300030,11/3/2014,555000.0,5,2.5,2090,8712,1.0,0.0,0.0,3,8,1420,670,1966,0,98008,47.5968,-122.12700000000001,2490,8712,11,3,2014,UNK,-400,0
3629920830,5/6/2015,810000.0,4,2.5,3260,5608,2.0,0.0,0.0,3,9,3260,0,2003,0,98029,47.5453,-121.995,3010,5608,5,6,2015,UNK,250,0
4054510270,8/27/2014,1250000.0,4,3.75,3830,41263,2.0,0.0,0.0,4,11,3830,0,1990,0,98077,47.7237,-122.042,5600,56568,8,27,2014,UNK,-1770,-15305
2864600105,6/24/2014,819000.0,3,3.5,2130,6150,2.0,0.0,2.0,5,8,1530,600,1908,0,98199,47.6491,-122.405,2040,5381,6,24,2014,UNK,90,769
8165500830,3/27/2015,409900.0,3,2.5,1690,1200,2.0,0.0,0.0,3,8,1410,280,2013,0,98106,47.5389,-122.367,1690,1760,3,27,2015,N,0,-560
4395600060,6/30/2014,935000.0,2,2.5,1780,2067,2.0,0.0,0.0,5,9,1780,0,1974,0,98004,47.6132,-122.21,2320,2067,6,30,2014,UNK,-540,0
4444800045,4/20/2015,657500.0,4,1.75,1620,7560,1.0,0.0,3.0,4,7,1380,240,1947,0,98117,47.6981,-122.4,2170,8650,4,20,2015,UNK,-550,-1090
1115300270,4/28/2015,900000.0,6,3.75,4210,6105,2.0,0.0,0.0,3,9,3280,930,2008,0,98059,47.5211,-122.15700000000001,3820,6368,4,28,2015,N,390,-263
5363200200,4/2/2015,932800.0,5,3.25,2980,7095,2.5,0.0,0.0,3,9,2980,0,1998,2007,98115,47.6919,-122.294,1670,7140,4,2,2015,Y,1310,-45
6067900640,4/20/2015,391000.0,3,2.0,1490,9000,1.0,0.0,0.0,4,8,1490,0,1977,0,98006,47.5455,-122.184,2190,9000,4,20,2015,UNK,-700,0
4279200060,12/30/2014,420000.0,4,2.5,2110,9825,2.0,0.0,0.0,3,8,2110,0,2000,0,98059,47.4979,-122.15299999999999,1650,9900,12,30,2014,UNK,460,-75
3425059222,11/24/2014,1300000.0,6,3.5,6563,32670,2.0,0.0,0.0,3,10,5153,1410,2002,0,98005,47.6078,-122.15700000000001,2610,22651,11,24,2014,UNK,3953,10019
5253300397,4/9/2015,415000.0,3,1.5,1510,16800,1.0,0.0,0.0,5,8,1510,0,1956,0,98133,47.75100000000001,-122.338,1560,7276,4,9,2015,UNK,-50,9524
1769600204,2/25/2015,350000.0,3,1.75,1830,9425,1.0,0.0,0.0,3,8,1590,240,1946,0,98146,47.5038,-122.37899999999999,1670,8430,2,25,2015,UNK,160,995
1176001195,6/21/2014,375000.0,2,1.0,1230,1820,2.0,0.0,0.0,4,7,830,400,1948,0,98107,47.6684,-122.40100000000001,1660,3056,6,21,2014,UNK,-430,-1236
1239400570,11/17/2014,860000.0,3,1.75,2180,14135,1.0,0.0,2.0,5,8,1300,880,1947,0,98033,47.673,-122.18700000000001,3540,10318,11,17,2014,UNK,-1360,3817
6071600270,6/3/2014,495000.0,4,2.25,2220,8872,1.0,0.0,0.0,4,8,1110,1110,1961,0,98006,47.5491,-122.17,2220,9106,6,3,2014,UNK,0,-234
1311100520,4/14/2015,250000.0,4,2.25,1730,8400,1.0,0.0,0.0,3,7,1730,0,1962,0,98001,47.3386,-122.288,1550,7920,4,14,2015,UNK,180,480
1402200070,10/13/2014,365000.0,4,2.25,1990,21312,1.0,0.0,0.0,4,8,1990,0,1968,0,98058,47.43899999999999,-122.14399999999999,2400,19210,10,13,2014,UNK,-410,2102
1419700270,5/7/2014,503000.0,3,2.75,1540,6760,1.0,0.0,0.0,5,7,1210,330,1980,0,98034,47.7163,-122.212,1540,7416,5,7,2014,UNK,0,-656
5126900310,3/25/2015,150000.0,2,1.0,1100,7200,1.0,0.0,0.0,4,6,1100,0,1944,0,98058,47.4752,-122.17200000000001,1390,7200,3,25,2015,UNK,-290,0
8816400885,10/8/2014,450000.0,4,1.75,1640,1480,1.0,0.0,0.0,4,7,820,820,1912,0,98105,47.6684,-122.314,1420,2342,10,8,2014,UNK,220,-862
5412100550,12/8/2014,355000.0,4,3.0,2590,7213,2.0,0.0,0.0,3,8,2590,0,2001,0,98001,47.2609,-122.289,2550,6800,12,8,2014,UNK,40,413
7203000465,10/18/2014,245000.0,3,2.0,1450,9333,2.0,0.0,0.0,4,7,1450,0,1972,0,98003,47.346000000000004,-122.315,1910,7701,10,18,2014,UNK,-460,1632
1862900160,7/3/2014,265900.0,3,2.0,1180,7793,1.0,0.0,0.0,4,7,1180,0,1992,0,98031,47.4053,-122.181,1720,7793,7,3,2014,UNK,-540,0
984220240,11/25/2014,299000.0,4,2.5,1820,7575,1.0,0.0,0.0,3,7,1220,600,1975,0,98058,47.4339,-122.167,1840,7650,11,25,2014,UNK,-20,-75
4458800060,4/9/2015,957500.0,4,2.25,2360,11523,2.0,0.0,0.0,4,10,2360,0,1968,0,98040,47.5318,-122.22399999999999,2850,11362,4,9,2015,UNK,-490,161
1138000160,9/8/2014,343000.0,3,1.0,1120,7250,1.0,0.0,0.0,4,7,1120,0,1972,0,98034,47.7143,-122.211,1340,7302,9,8,2014,UNK,-220,-52
9406520550,10/27/2014,307500.0,3,2.25,1646,7364,2.0,0.0,0.0,3,7,1646,0,1994,0,98038,47.3646,-122.037,1975,9161,10,27,2014,UNK,-329,-1797
7852160070,1/5/2015,937500.0,5,3.75,4210,14599,2.0,0.0,3.0,3,10,4210,0,2004,0,98065,47.5364,-121.85799999999999,3950,13591,1,5,2015,N,260,1008
7214700160,5/9/2014,610000.0,3,3.0,2480,45302,1.0,0.0,0.0,4,8,1620,860,1976,0,98077,47.7591,-122.073,1260,14100,5,9,2014,UNK,1220,31202
2483700160,9/17/2014,720000.0,3,1.5,1590,7080,1.0,0.0,2.0,3,8,1310,280,1952,0,98136,47.5244,-122.38600000000001,2080,7200,9,17,2014,UNK,-490,-120
1972201820,10/16/2014,610000.0,4,2.0,2130,2620,1.5,0.0,0.0,5,7,1650,0,1919,0,98103,47.6515,-122.346,1330,2719,10,16,2014,UNK,800,-99
9477000060,3/31/2015,434500.0,3,1.75,1650,7965,1.0,0.0,0.0,4,7,1650,0,1967,0,98034,47.7335,-122.193,1560,7350,3,31,2015,UNK,90,615
7932000041,5/12/2015,602500.0,2,2.5,3090,47044,1.0,0.0,0.0,4,10,2250,840,1979,0,98058,47.4291,-122.177,1860,62829,5,12,2015,UNK,1230,-15785
1231000520,11/18/2014,607010.0,4,2.5,2180,4000,2.0,0.0,0.0,3,8,1700,480,2002,0,98118,47.5553,-122.26899999999999,2180,4000,11,18,2014,UNK,0,0
7522500070,2/4/2015,610000.0,3,1.0,1800,5750,1.0,0.0,0.0,3,7,1040,760,1947,0,98117,47.68600000000001,-122.395,1320,5625,2,4,2015,UNK,480,125
4215250310,9/19/2014,828500.0,4,2.5,3720,35000,2.0,0.0,0.0,3,10,3720,0,1983,0,98072,47.7582,-122.13,3720,35000,9,19,2014,UNK,0,0
5560000070,7/7/2014,199990.0,3,1.0,1100,8560,1.0,0.0,0.0,3,6,1100,0,1961,0,98023,47.32899999999999,-122.338,1120,8470,7,7,2014,UNK,-20,90
1545804460,4/1/2015,294000.0,3,1.75,1530,9362,1.0,0.0,0.0,3,7,1530,0,1987,0,98038,47.3643,-122.04899999999999,1480,8125,4,1,2015,UNK,50,1237
9510970310,6/12/2014,789500.0,4,2.5,3010,6100,2.0,0.0,0.0,3,9,3010,0,2005,0,98052,47.6647,-122.08,2890,5176,6,12,2014,N,120,924
98030160,2/12/2015,797000.0,3,3.5,3500,9473,2.0,0.0,0.0,3,10,3500,0,2008,0,98075,47.5807,-121.97200000000001,3510,7833,2,12,2015,N,-10,1640
7853300070,8/18/2014,539950.0,5,3.0,3100,5250,2.0,0.0,0.0,3,7,3100,0,2006,0,98065,47.5369,-121.88799999999999,2460,5250,8,18,2014,N,640,0
934300140,3/23/2015,284950.0,4,1.5,2000,6778,1.0,0.0,0.0,4,7,1170,830,1962,0,98198,47.3708,-122.311,1940,7531,3,23,2015,UNK,60,-753
1245001820,4/29/2015,776500.0,4,1.5,2290,10372,1.0,0.0,0.0,3,7,1510,780,1965,1987,98033,47.6888,-122.199,1900,8109,4,29,2015,Y,390,2263
1974200060,4/24/2015,525000.0,4,2.5,2400,10070,1.0,0.0,0.0,3,7,1510,890,1967,0,98034,47.7104,-122.24,2030,9964,4,24,2015,UNK,370,106
7300410060,4/25/2015,303000.0,3,2.5,1850,4957,2.0,0.0,0.0,3,8,1850,0,1999,0,98092,47.3311,-122.17,2400,6367,4,25,2015,UNK,-550,-1410
1939110310,3/10/2015,722080.0,3,3.25,3680,7650,2.0,0.0,0.0,3,9,2340,1340,1988,0,98074,47.6272,-122.03299999999999,2280,8515,3,10,2015,UNK,1400,-865
7888000390,6/27/2014,140000.0,3,1.0,1060,7473,1.0,0.0,0.0,3,7,1060,0,1959,0,98198,47.3699,-122.309,1320,7912,6,27,2014,UNK,-260,-439
7888000390,4/1/2015,235000.0,3,1.0,1060,7473,1.0,0.0,0.0,3,7,1060,0,1959,0,98198,47.3699,-122.309,1320,7912,4,1,2015,UNK,-260,-439
1529300435,11/20/2014,440000.0,3,1.0,1610,5500,1.5,0.0,0.0,3,7,1610,0,1903,0,98103,47.698,-122.351,1200,5701,11,20,2014,UNK,410,-201
2960900045,7/18/2014,605000.0,3,1.75,2330,6000,1.5,0.0,0.0,4,7,1630,700,1940,0,98126,47.5765,-122.37799999999999,1600,4000,7,18,2014,UNK,730,2000
3959400135,6/2/2014,380000.0,2,1.0,1210,4800,1.0,0.0,0.0,3,8,1060,150,1950,0,98108,47.5625,-122.316,1380,4800,6,2,2014,UNK,-170,0
7972600765,6/25/2014,352000.0,4,1.0,1530,8890,1.0,0.0,0.0,3,7,980,550,1925,0,98106,47.5308,-122.35,1100,5203,6,25,2014,UNK,430,3687
7214810550,4/13/2015,420000.0,4,2.25,2270,12000,1.0,0.0,0.0,4,7,1360,910,1979,0,98072,47.7559,-122.148,2500,10120,4,13,2015,UNK,-230,1880
3271801090,4/30/2015,1180000.0,4,2.0,2590,7220,2.0,0.0,2.0,4,10,2590,0,1930,0,98199,47.647,-122.41,2530,6380,4,30,2015,UNK,60,840
8964800370,10/22/2014,1380000.0,3,1.5,1850,10572,1.0,0.0,0.0,4,8,1850,0,1953,0,98004,47.6194,-122.208,3030,12752,10,22,2014,UNK,-1180,-2180
8019200030,9/26/2014,300000.0,3,1.5,1500,14750,1.5,0.0,0.0,4,6,1500,0,1933,0,98168,47.495,-122.318,1270,15100,9,26,2014,UNK,230,-350
2954400400,11/12/2014,1150000.0,4,3.25,4740,49091,2.0,0.0,0.0,3,11,4740,0,1990,0,98053,47.6624,-122.071,4800,42387,11,12,2014,UNK,-60,6704
3013301525,10/13/2014,453500.0,2,1.5,1710,4189,1.0,0.0,1.0,5,7,1160,550,1951,0,98136,47.5286,-122.383,1530,5608,10,13,2014,UNK,180,-1419
3303100075,10/14/2014,443500.0,3,2.0,1920,7598,1.0,0.0,0.0,4,8,1920,0,1972,0,98177,47.7735,-122.363,2220,7598,10,14,2014,UNK,-300,0
2004100075,3/26/2015,332000.0,2,1.0,1150,8138,1.0,0.0,0.0,3,7,1150,0,1954,0,98155,47.736999999999995,-122.325,1300,8139,3,26,2015,UNK,-150,-1
4221270340,3/27/2015,655000.0,3,2.5,2320,4721,2.0,0.0,0.0,3,8,2320,0,2004,0,98075,47.591,-122.01700000000001,2250,4356,3,27,2015,N,70,365
7177300575,9/3/2014,475000.0,4,1.0,1420,6000,1.5,0.0,0.0,3,7,1420,0,1950,0,98115,47.6844,-122.302,1420,6180,9,3,2014,UNK,0,-180
1471630350,10/24/2014,372500.0,3,1.75,1550,12956,1.0,0.0,0.0,3,7,1210,340,1988,0,98045,47.4711,-121.75200000000001,1630,15360,10,24,2014,UNK,-80,-2404
1250203335,5/27/2014,1050000.0,4,2.5,2920,7200,1.0,0.0,3.0,3,8,1470,1450,1921,2006,98144,47.5947,-122.288,3210,6825,5,27,2014,Y,-290,375
8815400105,6/3/2014,500000.0,3,1.75,1620,4200,1.0,0.0,0.0,5,7,830,790,1945,0,98115,47.6743,-122.285,1580,5000,6,3,2014,UNK,40,-800
5315100737,5/28/2014,900000.0,6,2.75,2300,24773,1.5,0.0,0.0,4,9,2300,0,1950,1985,98040,47.5833,-122.242,2720,11740,5,28,2014,Y,-420,13033
3333002440,6/4/2014,327500.0,3,1.0,1070,7140,1.0,0.0,0.0,3,7,1070,0,1989,0,98118,47.5427,-122.288,1390,2374,6,4,2014,UNK,-320,4766
2130702205,4/6/2015,390000.0,3,1.75,1790,7123,1.0,0.0,0.0,3,7,1790,0,1913,0,98019,47.7429,-121.98100000000001,1660,8128,4,6,2015,UNK,130,-1005
2159900060,1/13/2015,451101.0,2,1.5,1510,1962,2.0,0.0,0.0,4,8,1510,0,1985,0,98007,47.6214,-122.15299999999999,1510,2182,1,13,2015,UNK,0,-220
194000575,10/14/2014,455000.0,4,1.0,1340,5800,1.5,0.0,2.0,3,7,1340,0,1914,0,98116,47.5658,-122.389,1900,5800,10,14,2014,UNK,-560,0
1531000140,7/1/2014,650000.0,4,2.5,3350,46748,2.0,0.0,0.0,3,10,3350,0,2004,0,98010,47.3432,-122.025,3350,39683,7,1,2014,N,0,7065
2125049139,8/6/2014,895000.0,3,2.5,2500,7746,2.0,0.0,0.0,4,10,1910,590,1993,0,98112,47.6393,-122.311,2480,5099,8,6,2014,UNK,20,2647
3623500135,3/26/2015,800000.0,4,2.25,2350,10664,1.0,0.0,1.0,2,7,1510,0,1952,0,98040,47.5743,-122.238,2350,10140,3,26,2015,UNK,0,524
7805460310,11/13/2014,703770.0,4,2.25,2550,12918,2.0,0.0,0.0,3,9,2550,0,1987,0,98006,47.5623,-122.109,2550,11036,11,13,2014,UNK,0,1882
3021059244,8/14/2014,249950.0,3,1.75,1320,10454,1.0,0.0,0.0,4,7,1320,0,1968,0,98002,47.2844,-122.21600000000001,1680,10183,8,14,2014,UNK,-360,271
925049360,4/28/2015,512000.0,2,2.0,1270,3881,1.0,0.0,0.0,4,6,610,660,1926,0,98105,47.6694,-122.29799999999999,1370,5000,4,28,2015,UNK,-100,-1119
3286800260,5/6/2015,780000.0,5,2.5,3480,74052,1.0,0.0,0.0,4,8,1980,1500,1972,0,98027,47.4961,-122.06299999999999,2610,65775,5,6,2015,UNK,870,8277
4137010240,7/16/2014,336000.0,3,2.25,2820,11625,2.0,0.0,0.0,3,8,2820,0,1986,0,98092,47.2621,-122.21799999999999,2290,8488,7,16,2014,UNK,530,3137
9368700341,8/22/2014,285000.0,3,2.0,2110,6900,1.5,0.0,0.0,5,6,1220,890,1955,0,98178,47.504,-122.26,1350,7683,8,22,2014,UNK,760,-783
3832310350,10/21/2014,229900.0,3,1.75,1100,7224,1.0,0.0,0.0,3,7,1100,0,1981,0,98032,47.3717,-122.277,1700,8447,10,21,2014,UNK,-600,-1223
324000350,4/15/2015,667500.0,4,3.0,1920,4000,1.5,0.0,0.0,4,8,1540,380,1931,0,98116,47.5718,-122.385,1660,4000,4,15,2015,UNK,260,0
9407101840,6/20/2014,378000.0,4,2.5,1890,12236,1.0,0.0,0.0,3,7,1230,660,1978,0,98045,47.4491,-121.78,1390,11360,6,20,2014,UNK,500,876
1422300140,9/5/2014,454000.0,3,2.5,2530,43733,2.0,0.0,0.0,3,8,1530,1000,1991,0,98045,47.46,-121.708,1730,43548,9,5,2014,UNK,800,185
6127011000,5/8/2014,537500.0,4,2.5,2550,4630,2.0,0.0,0.0,3,7,2550,0,2005,0,98075,47.5928,-122.00399999999999,2550,5151,5,8,2014,N,0,-521
2624049117,9/3/2014,425000.0,3,1.0,1550,4160,1.5,0.0,0.0,4,6,1550,0,1926,0,98118,47.5387,-122.265,1590,5000,9,3,2014,UNK,-40,-840
3295750550,11/24/2014,290000.0,3,2.0,1760,6600,1.0,0.0,0.0,3,7,1760,0,1998,0,98030,47.3836,-122.184,2590,6600,11,24,2014,UNK,-830,0
7960100260,7/1/2014,349500.0,3,2.0,1270,3600,1.0,0.0,0.0,3,7,1270,0,1963,0,98122,47.6099,-122.29700000000001,1660,3600,7,1,2014,UNK,-390,0
7625700012,12/2/2014,370000.0,3,2.75,1250,1655,2.0,0.0,0.0,3,7,830,420,2006,0,98136,47.5554,-122.382,1520,3001,12,2,2014,N,-270,-1346
5418200295,3/9/2015,549500.0,3,1.75,1620,8438,1.0,0.0,0.0,4,8,1620,0,1961,0,98125,47.703,-122.281,2040,9450,3,9,2015,UNK,-420,-1012
7454000295,1/30/2015,245000.0,2,1.0,710,6322,1.0,0.0,0.0,3,6,710,0,1942,0,98126,47.5165,-122.376,740,6720,1,30,2015,UNK,-30,-398
8100000060,7/29/2014,208000.0,3,1.75,1070,7200,1.0,0.0,0.0,3,7,1070,0,1994,0,98010,47.3134,-122.023,1480,7200,7,29,2014,UNK,-410,0
1310500550,12/20/2014,248000.0,4,2.25,2320,8760,1.0,0.0,0.0,4,8,1160,1160,1966,0,98032,47.3627,-122.285,1970,8690,12,20,2014,UNK,350,70
9485950310,10/3/2014,610000.0,4,3.25,5450,37058,1.5,0.0,0.0,5,9,5450,0,1984,0,98042,47.351000000000006,-122.087,2800,35716,10,3,2014,UNK,2650,1342
4213910030,4/1/2015,550000.0,4,2.5,1670,5116,2.0,0.0,0.0,3,8,1670,0,1999,0,98155,47.7667,-122.33,1910,7210,4,1,2015,UNK,-240,-2094
1223089083,10/28/2014,750000.0,3,2.75,3010,206910,2.0,0.0,2.0,3,10,3010,0,2001,0,98045,47.4881,-121.721,1580,120675,10,28,2014,UNK,1430,86235
2143700861,10/30/2014,192000.0,2,1.75,1340,7380,1.0,0.0,0.0,3,6,1340,0,1940,0,98055,47.4785,-122.229,1980,9600,10,30,2014,UNK,-640,-2220
5016003230,2/18/2015,169317.0,2,1.0,790,4000,1.0,0.0,2.0,3,7,790,0,1908,0,98112,47.6248,-122.301,1700,4200,2,18,2015,UNK,-910,-200
1338801019,7/1/2014,1200000.0,4,3.5,3400,3850,2.5,0.0,0.0,3,10,2790,610,2008,0,98112,47.6258,-122.302,2030,4000,7,1,2014,N,1370,-150
3592500565,10/29/2014,880000.0,2,1.0,1530,6350,1.5,0.0,0.0,4,7,1530,0,1923,0,98112,47.6325,-122.303,2640,6350,10,29,2014,UNK,-1110,0
6414600070,6/17/2014,210000.0,1,1.0,930,7129,1.0,0.0,0.0,3,6,930,0,1948,0,98133,47.7234,-122.333,1300,8075,6,17,2014,UNK,-370,-946
8645500160,1/7/2015,180500.0,3,1.5,1540,9800,1.0,0.0,0.0,3,7,1010,530,1973,0,98058,47.4676,-122.184,1600,8250,1,7,2015,UNK,-60,1550
8651520240,7/28/2014,540000.0,4,2.0,1990,29078,2.0,0.0,0.0,3,9,1990,0,1984,0,98074,47.6471,-122.057,2310,28353,7,28,2014,UNK,-320,725
9408300310,6/24/2014,520000.0,3,1.75,2300,35722,1.0,0.0,0.0,3,9,2300,0,1984,0,98072,47.7455,-122.11200000000001,2600,34798,6,24,2014,UNK,-300,924
4202400135,6/26/2014,177500.0,3,1.5,1220,6000,1.0,0.0,0.0,3,7,1220,0,1968,0,98055,47.4904,-122.22200000000001,1660,6000,6,26,2014,UNK,-440,0
7129300935,11/5/2014,415000.0,3,1.75,2380,5650,1.0,0.0,2.0,4,8,1190,1190,1956,0,98118,47.5119,-122.255,2350,6554,11,5,2014,UNK,30,-904
8143000310,9/9/2014,495000.0,4,2.5,2020,7200,1.0,0.0,0.0,5,7,1010,1010,1968,0,98034,47.7289,-122.20100000000001,1620,7275,9,9,2014,UNK,400,-75
6082400152,3/4/2015,325000.0,3,2.25,1890,9646,1.0,0.0,0.0,3,8,1890,0,1966,0,98168,47.4838,-122.29899999999999,1580,9488,3,4,2015,UNK,310,158
6838000520,2/20/2015,440000.0,2,1.75,1330,4903,1.0,0.0,0.0,3,7,1330,0,1985,0,98052,47.6819,-122.161,1470,2735,2,20,2015,UNK,-140,2168
4023500118,7/23/2014,411000.0,3,1.75,1490,9844,1.0,0.0,0.0,4,7,1190,300,1959,0,98155,47.7626,-122.29700000000001,1840,10150,7,23,2014,UNK,-350,-306
8952900204,10/29/2014,810000.0,5,3.5,3550,9600,2.0,0.0,0.0,3,9,2550,1000,1998,0,98118,47.5484,-122.26899999999999,2030,9600,10,29,2014,UNK,1520,0
7922800320,10/16/2014,561750.0,5,1.75,2040,8996,1.0,0.0,2.0,4,7,1020,1020,1962,0,98008,47.588,-122.118,1950,8270,10,16,2014,UNK,90,726
9542000030,7/22/2014,835100.0,4,2.5,2380,12573,1.0,0.0,0.0,4,9,2380,0,1963,0,98005,47.5984,-122.176,2900,10700,7,22,2014,UNK,-520,1873
3787000140,9/1/2014,450000.0,3,2.25,1780,9969,1.0,0.0,0.0,3,8,1450,330,1985,0,98034,47.7286,-122.16799999999999,1950,7974,9,1,2014,UNK,-170,1995
646910030,11/4/2014,238000.0,3,2.5,1650,2807,2.0,0.0,0.0,3,7,1650,0,2004,0,98055,47.4328,-122.196,1460,1875,11,4,2014,N,190,932
5515600075,12/5/2014,299000.0,3,1.0,1510,142803,1.0,0.0,0.0,3,7,1510,0,1974,0,98001,47.3192,-122.287,1330,46609,12,5,2014,UNK,180,96194
1377300135,10/17/2014,570000.0,2,1.0,1100,6240,1.0,0.0,0.0,4,7,1100,0,1941,0,98199,47.6446,-122.40299999999999,1250,6240,10,17,2014,UNK,-150,0
5469501940,6/4/2014,340000.0,3,1.75,2190,12626,2.0,0.0,0.0,4,8,2190,0,1978,0,98042,47.3845,-122.154,3110,14592,6,4,2014,UNK,-920,-1966
9276200890,4/29/2015,450000.0,2,1.75,1760,2275,1.5,0.0,0.0,3,6,1040,720,1912,0,98116,47.5803,-122.39299999999999,1380,3750,4,29,2015,UNK,380,-1475
6385910260,9/10/2014,272750.0,4,1.5,1800,8786,1.0,0.0,0.0,3,7,1330,470,1966,0,98146,47.4982,-122.345,1780,8664,9,10,2014,UNK,20,122
5101402482,7/24/2014,520000.0,4,2.0,2000,6380,2.0,0.0,0.0,4,6,1860,140,1949,0,98115,47.6956,-122.303,1600,6380,7,24,2014,UNK,400,0
9353300140,6/18/2014,284950.0,3,1.0,990,10723,1.0,0.0,0.0,5,7,990,0,1960,0,98059,47.4887,-122.133,1460,10723,6,18,2014,UNK,-470,0
5379801600,4/24/2015,255000.0,2,1.5,1480,9660,1.0,0.0,0.0,3,7,1480,0,1949,0,98188,47.4577,-122.289,1990,9660,4,24,2015,UNK,-510,0
6082400260,11/12/2014,231500.0,2,1.0,1200,9488,1.0,0.0,0.0,5,7,1200,0,1941,0,98168,47.4832,-122.29899999999999,1200,9488,11,12,2014,UNK,0,0
2025079033,12/10/2014,415000.0,1,2.0,3000,204732,2.5,0.0,2.0,3,8,3000,0,1979,0,98014,47.6331,-121.945,2330,213008,12,10,2014,UNK,670,-8276
6181430800,1/5/2015,330000.0,4,2.5,3504,6000,2.0,0.0,0.0,3,7,3504,0,2006,0,98001,47.3012,-122.285,2790,5231,1,5,2015,N,714,769
3649100473,5/28/2014,365000.0,3,1.5,1300,12240,1.0,0.0,0.0,3,7,1300,0,1963,0,98028,47.736999999999995,-122.243,2040,9326,5,28,2014,UNK,-740,2914
2011400791,10/7/2014,425000.0,4,2.0,1330,9188,1.5,0.0,0.0,3,7,1330,0,1928,2004,98198,47.401,-122.319,1770,10419,10,7,2014,Y,-440,-1231
7549802030,11/4/2014,400000.0,4,1.75,1850,6480,1.0,0.0,0.0,4,7,1120,730,1958,0,98108,47.5525,-122.31299999999999,1610,5040,11,4,2014,UNK,240,1440
1898200030,9/22/2014,335000.0,4,2.5,2240,9701,2.0,0.0,0.0,3,9,2240,0,1989,0,98023,47.3086,-122.39200000000001,2240,9410,9,22,2014,UNK,0,291
567000672,9/30/2014,342000.0,3,3.0,1260,1251,2.0,0.0,0.0,3,7,1040,220,2003,0,98144,47.5943,-122.296,1780,7715,9,30,2014,UNK,-520,-6464
9126101740,12/4/2014,490000.0,8,5.0,2800,2580,2.0,0.0,0.0,3,8,1880,920,1997,0,98122,47.6086,-122.303,1800,2580,12,4,2014,UNK,1000,0
5127001600,11/6/2014,331500.0,4,1.75,1820,14319,1.0,0.0,0.0,4,7,1820,0,1969,0,98059,47.4757,-122.148,1440,10018,11,6,2014,UNK,380,4301
1925069121,3/30/2015,960000.0,3,2.5,1730,4102,3.0,1.0,4.0,3,8,1730,0,1996,0,98074,47.645,-122.084,2340,16994,3,30,2015,UNK,-610,-12892
7511210310,7/9/2014,720500.0,4,2.5,3350,35298,2.0,0.0,0.0,4,9,3350,0,1985,0,98053,47.6506,-122.036,2620,35604,7,9,2014,UNK,730,-306
65000260,8/20/2014,830000.0,3,2.5,3370,6550,2.0,0.0,2.0,4,8,2840,0,1912,2001,98126,47.5442,-122.38,1500,6550,8,20,2014,Y,1870,0
6372000060,5/23/2014,662990.0,3,1.75,1240,3600,1.5,0.0,0.0,5,7,1240,0,1926,0,98116,47.5797,-122.405,1660,3600,5,23,2014,UNK,-420,0
2005300140,3/30/2015,220000.0,4,2.0,2340,10507,1.5,0.0,0.0,4,6,2340,0,1959,0,98030,47.3578,-122.178,990,10507,3,30,2015,UNK,1350,0
5649600435,1/8/2015,349950.0,5,2.0,1880,4179,1.0,0.0,0.0,3,7,940,940,1952,2000,98118,47.5536,-122.28299999999999,1350,5150,1,8,2015,Y,530,-971
2249500059,1/7/2015,550000.0,3,2.0,1810,2159,1.0,0.0,0.0,3,7,1010,800,1922,0,98109,47.6273,-122.345,1810,2159,1,7,2015,UNK,0,0
1773100510,9/15/2014,396000.0,3,1.75,2340,5668,1.0,0.0,0.0,4,6,1200,1140,1941,0,98106,47.5588,-122.36399999999999,860,4800,9,15,2014,UNK,1480,868
9521100960,1/16/2015,635000.0,4,1.5,2820,4000,2.0,0.0,0.0,3,7,2820,0,1911,0,98103,47.6638,-122.348,1470,1627,1,16,2015,UNK,1350,2373
1785500132,11/18/2014,293000.0,3,1.0,1020,7650,1.0,0.0,0.0,3,7,1020,0,1940,0,98133,47.7198,-122.352,1440,7650,11,18,2014,UNK,-420,0
8645530060,7/11/2014,339000.0,3,2.25,2090,10120,1.0,0.0,0.0,4,7,1290,800,1979,0,98058,47.4654,-122.17399999999999,1820,7983,7,11,2014,UNK,270,2137
7697920060,6/30/2014,285000.0,4,2.25,1830,8734,2.0,0.0,0.0,4,7,1830,0,1991,0,98030,47.3679,-122.179,1870,7212,6,30,2014,UNK,-40,1522
9550202010,7/10/2014,775000.0,6,2.75,2980,5000,1.5,0.0,0.0,3,7,2480,500,1916,0,98103,47.6684,-122.331,1470,5000,7,10,2014,UNK,1510,0
1821059264,6/26/2014,224000.0,4,1.5,1600,9289,1.0,0.0,0.0,4,7,1600,0,1959,0,98002,47.3107,-122.212,1540,9918,6,26,2014,UNK,60,-629
5700003985,10/29/2014,2250000.0,4,3.5,4440,8125,2.0,0.0,3.0,5,10,3140,1300,1922,0,98144,47.5744,-122.28299999999999,3990,8505,10,29,2014,UNK,450,-380
2320069248,7/1/2014,165050.0,3,1.0,1200,8514,1.0,0.0,0.0,3,7,1200,0,1959,0,98022,47.2043,-122.008,1210,8985,7,1,2014,UNK,-10,-471
2658000335,10/27/2014,275000.0,3,1.25,1230,4500,1.5,0.0,0.0,4,7,1230,0,1913,0,98118,47.5301,-122.271,1310,5000,10,27,2014,UNK,-80,-500
1702901557,9/11/2014,445000.0,5,3.0,2930,5500,1.0,0.0,0.0,3,7,1750,1180,1951,0,98118,47.5572,-122.281,1400,5500,9,11,2014,UNK,1530,0
1774220350,4/1/2015,510000.0,3,2.25,2370,38639,1.0,0.0,0.0,3,8,1930,440,1978,0,98077,47.771,-122.09899999999999,2900,37452,4,1,2015,UNK,-530,1187
7355700171,6/10/2014,1230000.0,4,2.5,3040,7000,2.0,0.0,0.0,3,9,3040,0,2001,0,98040,47.5934,-122.244,2320,17511,6,10,2014,UNK,720,-10511
3971701922,10/29/2014,390000.0,3,1.5,1610,13500,1.0,0.0,0.0,3,7,1060,550,1970,0,98155,47.7674,-122.31,1540,11479,10,29,2014,UNK,70,2021
3583300135,5/13/2014,460000.0,3,2.25,2350,10450,1.0,0.0,0.0,3,8,1390,960,1977,0,98028,47.7433,-122.259,2250,10450,5,13,2014,UNK,100,0
9542000075,3/27/2015,700000.0,3,1.75,2000,14733,1.0,0.0,0.0,4,8,2000,0,1958,0,98005,47.6001,-122.178,2620,14733,3,27,2015,UNK,-620,0
4055700955,6/22/2014,874150.0,4,3.5,3530,14406,2.0,0.0,1.0,3,10,2570,960,1987,0,98034,47.7073,-122.244,3170,15181,6,22,2014,UNK,360,-775
4022902505,7/31/2014,470000.0,3,2.25,2220,9800,2.0,0.0,0.0,3,8,2220,0,1987,0,98155,47.7635,-122.286,2420,10232,7,31,2014,UNK,-200,-432
8680100030,5/21/2014,374000.0,3,1.75,2000,9416,1.0,0.0,0.0,4,6,2000,0,1961,0,98033,47.696999999999996,-122.175,1440,9555,5,21,2014,UNK,560,-139
2923039017,7/17/2014,510000.0,2,1.75,1210,131115,1.5,0.0,0.0,5,7,1210,0,1950,0,98070,47.4599,-122.45,2020,185565,7,17,2014,UNK,-810,-54450
2767604247,7/11/2014,467000.0,2,2.5,1140,1181,3.0,0.0,0.0,3,8,1140,0,2007,0,98107,47.6713,-122.383,1220,1189,7,11,2014,N,-80,-8
5631500505,6/16/2014,576000.0,4,2.5,2440,28405,2.0,0.0,0.0,3,8,2440,0,2002,0,98028,47.7386,-122.238,2480,11429,6,16,2014,UNK,-40,16976
3356406510,5/30/2014,196440.0,3,2.0,1560,7352,1.0,0.0,0.0,3,6,1560,0,1992,0,98001,47.2804,-122.251,1120,7950,5,30,2014,UNK,440,-598
7701990700,12/31/2014,825000.0,4,2.5,3210,18901,2.0,0.0,0.0,3,10,3210,0,1993,0,98077,47.708999999999996,-122.073,3330,18901,12,31,2014,UNK,-120,0
8835200800,4/8/2015,281000.0,2,1.0,930,2600,1.0,0.0,0.0,3,7,930,0,1981,0,98034,47.7242,-122.161,1370,3488,4,8,2015,UNK,-440,-888
8902500118,8/12/2014,326000.0,3,2.5,1782,1577,3.0,0.0,0.0,3,7,1782,0,2000,0,98125,47.7114,-122.301,1550,1744,8,12,2014,UNK,232,-167
2822079012,4/10/2015,340000.0,3,1.75,1740,46580,1.0,0.0,0.0,4,7,1740,0,1980,0,98010,47.3583,-121.927,1576,54685,4,10,2015,UNK,164,-8105
9485950060,12/8/2014,440000.0,5,1.75,3690,36036,1.0,0.0,0.0,3,9,1890,1800,1985,0,98042,47.3473,-122.085,2680,44131,12,8,2014,UNK,1010,-8095
424069264,5/22/2014,749000.0,4,2.5,2930,18199,2.0,0.0,0.0,3,9,2930,0,1998,0,98075,47.5937,-122.04700000000001,2930,33976,5,22,2014,UNK,0,-15777
3581000340,2/27/2015,340000.0,4,1.0,1230,8316,1.5,0.0,0.0,3,7,1230,0,1963,0,98034,47.7269,-122.24,1490,8316,2,27,2015,UNK,-260,0
7625704005,5/6/2014,561000.0,3,2.0,2000,7000,2.0,0.0,0.0,3,7,2000,0,1916,1986,98136,47.5452,-122.39299999999999,1840,7000,5,6,2014,Y,160,0
1545803240,10/31/2014,270000.0,3,2.25,1520,7930,1.0,0.0,0.0,3,7,1160,360,1988,0,98038,47.3605,-122.04899999999999,1530,7930,10,31,2014,UNK,-10,0
8080400045,6/20/2014,600000.0,2,1.0,1040,3600,1.0,0.0,0.0,4,7,1040,0,1919,1980,98112,47.619,-122.311,2250,4800,6,20,2014,Y,-1210,-1200
8651402920,5/5/2014,219900.0,4,1.5,1120,5427,1.0,0.0,0.0,3,6,1120,0,1969,0,98042,47.3628,-122.087,1150,5304,5,5,2014,UNK,-30,123
3121069036,12/8/2014,617000.0,3,1.75,3020,360241,2.0,0.0,0.0,3,8,3020,0,1992,0,98092,47.2662,-122.088,1890,209959,12,8,2014,UNK,1130,150282
2540800390,9/4/2014,469000.0,3,2.25,1820,8446,2.0,0.0,0.0,3,8,1820,0,1978,0,98034,47.7208,-122.236,1850,8437,9,4,2014,UNK,-30,9
7978800621,8/11/2014,229000.0,3,1.0,1370,56628,1.0,0.0,0.0,3,7,1370,0,1942,0,98003,47.3058,-122.306,1768,8702,8,11,2014,UNK,-398,47926
1336300445,4/22/2015,1270000.0,4,3.0,3130,2646,2.5,0.0,0.0,5,9,2290,840,1906,0,98102,47.6272,-122.316,2920,4500,4,22,2015,UNK,210,-1854
6159400060,8/5/2014,365000.0,3,1.5,1640,8301,1.0,0.0,0.0,3,7,1290,350,1958,0,98155,47.7443,-122.32700000000001,1640,8955,8,5,2014,UNK,0,-654
9510930350,12/12/2014,429000.0,4,2.5,2650,9301,2.0,0.0,0.0,3,9,2650,0,2001,0,98001,47.3477,-122.271,2730,8688,12,12,2014,UNK,-80,613
5535600520,12/8/2014,550000.0,4,2.5,2850,6809,2.0,0.0,0.0,3,9,2850,0,2003,0,98019,47.7353,-121.973,2820,7500,12,8,2014,UNK,30,-691
7634800070,1/16/2015,453000.0,3,2.5,1820,16300,1.0,0.0,0.0,4,7,1220,600,1955,0,98166,47.4582,-122.365,1870,16300,1,16,2015,UNK,-50,0
8581200350,6/17/2014,187500.0,3,1.5,1180,7000,1.0,0.0,0.0,4,7,1180,0,1977,0,98023,47.2966,-122.374,1180,7370,6,17,2014,UNK,0,-370
6190701146,4/15/2015,520500.0,6,2.5,1880,14350,1.0,0.0,0.0,5,7,1640,240,1955,0,98133,47.7556,-122.352,1510,9840,4,15,2015,UNK,370,4510
522059299,2/4/2015,300000.0,3,1.75,1280,12776,1.0,0.0,0.0,4,7,1280,0,1977,0,98031,47.4212,-122.199,1680,11704,2,4,2015,UNK,-400,1072
1513800036,5/16/2014,799000.0,4,3.25,3120,5000,2.0,0.0,0.0,3,9,2370,750,2005,0,98115,47.69,-122.29899999999999,2520,6000,5,16,2014,N,600,-1000
6699930550,2/3/2015,338000.0,3,2.5,2470,4948,2.0,0.0,0.0,3,8,2470,0,2003,0,98038,47.3438,-122.039,2500,4993,2,3,2015,UNK,-30,-45
9839300875,5/14/2014,800000.0,3,1.0,1700,4400,1.5,0.0,0.0,4,8,1700,0,1906,0,98122,47.611999999999995,-122.292,1610,4180,5,14,2014,UNK,90,220
2493200435,8/25/2014,360000.0,2,2.0,1180,3200,1.0,0.0,1.0,4,6,590,590,1945,0,98136,47.5275,-122.383,1350,4000,8,25,2014,UNK,-170,-800
226039282,7/28/2014,442500.0,6,2.5,2800,10490,1.0,0.0,0.0,3,7,1400,1400,1968,0,98177,47.7735,-122.37799999999999,2290,8716,7,28,2014,UNK,510,1774
1020069017,3/27/2015,700000.0,4,1.0,1300,1651359,1.0,0.0,3.0,4,6,1300,0,1920,0,98022,47.2313,-122.023,2560,425581,3,27,2015,UNK,-1260,1225778
5450900140,5/8/2014,830000.0,5,3.0,3040,9601,1.0,0.0,0.0,5,9,1970,1070,1968,0,98040,47.5562,-122.22,3180,12390,5,8,2014,UNK,-140,-2789
8093800200,11/18/2014,360400.0,3,2.5,1630,11592,2.0,0.0,0.0,3,8,1630,0,1987,0,98011,47.7574,-122.228,1700,8850,11,18,2014,UNK,-70,2742
3205000310,11/21/2014,345000.0,3,1.0,1340,9339,1.0,0.0,0.0,5,7,1340,0,1960,0,98056,47.5407,-122.177,1310,9350,11,21,2014,UNK,30,-11
7230000350,9/9/2014,300000.0,3,1.75,1830,51836,1.0,0.0,0.0,4,7,1430,400,1966,0,98059,47.4774,-122.098,1320,51400,9,9,2014,UNK,510,436
1066600045,9/4/2014,350000.0,3,1.0,1240,10800,1.0,0.0,0.0,5,7,1240,0,1959,0,98056,47.5233,-122.185,1810,10800,9,4,2014,UNK,-570,0
2822069078,10/8/2014,368000.0,4,2.0,2500,36900,1.0,0.0,0.0,3,7,1540,960,1972,0,98038,47.3708,-122.04899999999999,1960,36900,10,8,2014,UNK,540,0
8731900340,6/23/2014,264000.0,3,1.75,1760,7482,1.0,0.0,0.0,4,8,1760,0,1966,0,98023,47.3129,-122.369,2000,7500,6,23,2014,UNK,-240,-18
5088500310,3/12/2015,435000.0,3,2.0,2660,16677,1.0,0.0,0.0,3,9,2210,450,1990,0,98038,47.3689,-122.055,2660,11355,3,12,2015,UNK,0,5322
1823059205,6/4/2014,200000.0,3,1.5,2060,15837,1.5,0.0,0.0,3,6,2060,0,1903,0,98055,47.4819,-122.223,2190,8549,6,4,2014,UNK,-130,7288
225039082,5/14/2014,620000.0,5,2.5,2540,3832,2.0,0.0,0.0,5,8,1760,780,1929,0,98117,47.6848,-122.398,2000,5289,5,14,2014,UNK,540,-1457
5021900140,11/20/2014,1680000.0,5,4.25,4830,11466,2.0,0.0,0.0,3,10,3720,1110,2014,0,98040,47.5774,-122.22200000000001,2180,11017,11,20,2014,N,2650,449
7883603750,12/9/2014,337000.0,3,1.75,1400,6000,1.0,0.0,0.0,4,7,700,700,1919,0,98108,47.5283,-122.321,1030,6000,12,9,2014,UNK,370,0
8081500060,10/1/2014,1930000.0,4,3.25,4280,20296,2.0,0.0,0.0,4,11,4280,0,1984,0,98004,47.6377,-122.212,3420,16351,10,1,2014,UNK,860,3945
8099900260,5/28/2014,544500.0,4,2.5,2230,10414,1.0,0.0,0.0,5,7,1450,780,1974,0,98075,47.5816,-122.0,1960,10240,5,28,2014,UNK,270,174
913000340,1/2/2015,252000.0,1,1.0,680,1638,1.0,0.0,4.0,1,6,680,0,1910,1992,98116,47.5832,-122.399,1010,3621,1,2,2015,Y,-330,-1983
2115200160,6/5/2014,445000.0,4,2.5,2340,3784,2.0,0.0,0.0,3,8,2340,0,2008,0,98106,47.535,-122.348,1730,4000,6,5,2014,N,610,-216
5095600310,7/25/2014,379500.0,3,2.25,2070,14196,2.0,0.0,0.0,3,7,2070,0,1989,0,98059,47.4617,-122.07,1550,13860,7,25,2014,UNK,520,336
5402100045,3/11/2015,189950.0,4,2.0,1910,4225,1.0,0.0,0.0,4,6,910,1000,1919,0,98001,47.3084,-122.234,1060,4800,3,11,2015,UNK,850,-575
2258500049,6/2/2014,469000.0,3,1.0,950,4250,1.5,0.0,0.0,5,6,950,0,1948,0,98122,47.608999999999995,-122.307,2130,5120,6,2,2014,UNK,-1180,-870
626100023,6/11/2014,600000.0,5,2.75,2910,53898,1.0,0.0,0.0,5,7,1510,1400,1979,0,98077,47.7201,-122.06200000000001,3210,216928,6,11,2014,UNK,-300,-163030
4309720160,11/7/2014,785000.0,3,2.5,2930,33981,2.0,0.0,2.0,3,9,2930,0,2000,0,98059,47.5151,-122.12,3720,35230,11,7,2014,UNK,-790,-1249
1843100070,2/10/2015,372000.0,4,2.75,2610,8967,2.0,0.0,0.0,4,8,2610,0,1990,0,98042,47.3747,-122.124,2390,7852,2,10,2015,UNK,220,1115
4307350520,2/25/2015,445000.0,5,3.0,3880,7180,2.0,0.0,0.0,3,7,3880,0,2004,0,98056,47.4797,-122.179,2160,4793,2,25,2015,N,1720,2387
5561401260,10/14/2014,508000.0,4,2.25,3320,53392,2.0,0.0,0.0,4,8,2000,1320,1986,0,98027,47.4724,-122.014,3230,43129,10,14,2014,UNK,90,10263
2883200966,3/18/2015,780000.0,5,1.5,1940,4800,2.0,0.0,0.0,3,8,1940,0,1905,0,98103,47.6845,-122.33200000000001,1750,4800,3,18,2015,UNK,190,0
7214800240,3/16/2015,541100.0,4,2.25,2510,9800,2.0,0.0,0.0,3,9,2510,0,1978,0,98072,47.753,-122.145,2440,11000,3,16,2015,UNK,70,-1200
3629920860,1/5/2015,729000.0,4,2.5,2660,5608,2.0,0.0,0.0,3,9,2660,0,2003,0,98029,47.5449,-121.995,3010,5608,1,5,2015,UNK,-350,0
1320069179,11/4/2014,397000.0,3,2.0,1710,134489,1.0,0.0,2.0,5,7,1710,0,1952,0,98022,47.2207,-121.984,1700,63823,11,4,2014,UNK,10,70666
9424400200,5/15/2014,451555.0,2,1.0,1320,4520,1.0,0.0,1.0,3,6,1320,0,1912,1971,98116,47.5655,-122.39399999999999,1420,4560,5,15,2014,Y,-100,-40
3500100189,6/30/2014,300000.0,2,1.0,960,8153,1.0,0.0,0.0,3,6,960,0,1947,0,98155,47.7341,-122.3,1160,8199,6,30,2014,UNK,-200,-46
2787720140,4/7/2015,416000.0,3,2.5,1790,11542,1.0,0.0,0.0,5,7,1190,600,1969,0,98059,47.5124,-122.16,1790,9131,4,7,2015,UNK,0,2411
3856904740,10/21/2014,490000.0,2,1.0,950,3060,1.0,0.0,0.0,3,6,810,140,1925,0,98105,47.6698,-122.323,1510,3780,10,21,2014,UNK,-560,-720
254000445,1/29/2015,480000.0,6,3.75,2940,5054,2.0,0.0,0.0,3,7,2940,0,1942,2003,98146,47.5122,-122.385,1530,5320,1,29,2015,Y,1410,-266
6821101837,2/3/2015,368000.0,2,2.0,930,1662,1.0,0.0,0.0,3,7,670,260,2002,0,98199,47.6518,-122.4,1780,2343,2,3,2015,UNK,-850,-681
5608000700,9/18/2014,1040000.0,3,2.5,4570,10615,2.0,0.0,0.0,3,12,4570,0,1991,0,98027,47.5533,-122.09700000000001,3860,11576,9,18,2014,UNK,710,-961
7784400060,1/20/2015,545000.0,3,2.5,2370,9000,1.0,0.0,3.0,4,8,1570,800,1952,0,98146,47.4922,-122.365,2120,9500,1,20,2015,UNK,250,-500
3295610350,3/23/2015,850000.0,5,2.75,3430,15119,2.0,0.0,0.0,3,10,3430,0,1998,0,98075,47.5678,-122.03200000000001,3430,12045,3,23,2015,UNK,0,3074
3260570260,12/4/2014,550000.0,4,3.5,3540,4750,2.0,0.0,0.0,3,10,3540,0,2003,0,98055,47.473,-122.193,3310,5655,12,4,2014,UNK,230,-905
1592000260,2/17/2015,600000.0,3,2.25,2240,9314,2.0,0.0,0.0,3,9,2240,0,1984,0,98074,47.6216,-122.03200000000001,2240,9314,2,17,2015,UNK,0,0
8670000060,8/27/2014,535000.0,4,2.5,2710,12138,1.0,0.0,0.0,3,8,1700,1010,1968,0,98155,47.7657,-122.29,2390,10052,8,27,2014,UNK,320,2086
8113600004,5/20/2014,599950.0,3,2.5,2660,4975,2.0,0.0,0.0,3,8,2660,0,2014,0,98118,47.5487,-122.272,1840,6653,5,20,2014,N,820,-1678
235000075,7/18/2014,531000.0,5,2.75,2540,5022,1.0,0.0,0.0,4,8,1540,1000,1955,0,98108,47.5593,-122.3,2510,5182,7,18,2014,UNK,30,-160
1951700700,6/5/2014,530000.0,4,2.25,2210,7665,2.0,0.0,0.0,4,8,2210,0,1968,0,98006,47.5424,-122.16799999999999,1960,7903,6,5,2014,UNK,250,-238
1832100030,6/25/2014,597326.0,4,4.0,3570,8250,2.0,0.0,0.0,3,10,2860,710,2015,0,98040,47.5784,-122.226,2230,10000,6,25,2014,N,1340,-1750
8565000030,4/29/2015,805000.0,4,2.5,3450,33460,2.0,0.0,0.0,3,9,3450,0,1997,0,98077,47.7673,-122.1,2820,35250,4,29,2015,UNK,630,-1790
2473350710,10/27/2014,390000.0,4,1.75,2330,8364,1.0,0.0,0.0,4,8,2330,0,1968,0,98058,47.4568,-122.146,2180,9630,10,27,2014,UNK,150,-1266
9521101221,5/19/2014,487250.0,4,2.0,1690,3250,1.5,0.0,0.0,3,7,1550,140,1901,0,98103,47.6637,-122.346,1620,3250,5,19,2014,UNK,70,0
6152900273,9/9/2014,301000.0,3,1.5,1030,8414,1.0,0.0,0.0,4,7,1030,0,1967,0,98155,47.7654,-122.29700000000001,1750,8414,9,9,2014,UNK,-720,0
2721600125,2/5/2015,1180000.0,5,2.75,2560,5618,1.5,0.0,2.0,3,8,2220,340,1923,0,98109,47.6416,-122.355,2740,4000,2,5,2015,UNK,-180,1618
1180002378,9/26/2014,299000.0,4,2.5,1950,3000,2.0,0.0,0.0,3,7,1950,0,2002,0,98178,47.4977,-122.226,1170,6000,9,26,2014,UNK,780,-3000
625059051,9/3/2014,2350000.0,4,2.25,4370,22863,2.5,0.0,3.0,4,10,3670,0,1907,1994,98033,47.6878,-122.215,2980,22863,9,3,2014,Y,1390,0
2113700060,10/14/2014,400000.0,4,2.5,2350,3904,2.5,0.0,0.0,3,7,2350,0,1999,0,98106,47.5305,-122.351,1120,4000,10,14,2014,UNK,1230,-96
7016100570,12/1/2014,467500.0,4,2.5,3160,7210,1.0,0.0,0.0,4,7,1880,1280,1969,0,98034,47.7368,-122.18299999999999,2070,7560,12,1,2014,UNK,1090,-350
2944500710,2/20/2015,305000.0,4,2.5,2430,9103,2.0,0.0,0.0,3,8,2430,0,1990,0,98023,47.2939,-122.368,2260,8090,2,20,2015,UNK,170,1013
1549500370,5/5/2014,210000.0,3,1.0,1340,306848,1.0,0.0,0.0,3,5,1340,0,1953,0,98019,47.7534,-121.912,1800,128066,5,5,2014,UNK,-460,178782
7211340030,4/28/2015,300000.0,3,1.0,1010,10168,1.0,0.0,0.0,3,6,1010,0,1979,0,98014,47.6453,-121.912,1180,10318,4,28,2015,UNK,-170,-150
2473480520,9/8/2014,327500.0,3,2.25,1770,8755,1.0,0.0,0.0,3,8,1330,440,1981,0,98058,47.4464,-122.12299999999999,1910,8710,9,8,2014,UNK,-140,45
1722059326,8/5/2014,269000.0,3,2.0,1210,7136,1.0,0.0,0.0,3,7,1210,0,2003,0,98031,47.3996,-122.20299999999999,1210,5765,8,5,2014,UNK,0,1371
9414100030,3/31/2015,975000.0,4,3.25,3330,17533,1.0,0.0,2.0,3,9,1750,1580,1969,0,98033,47.652,-122.2,3340,12798,3,31,2015,UNK,-10,4735
8911000030,12/10/2014,355000.0,3,1.0,1240,5400,1.0,0.0,0.0,4,7,1060,180,1940,0,98133,47.7115,-122.355,1429,5400,12,10,2014,UNK,-189,0
2264500890,5/8/2014,712000.0,3,1.0,1250,4620,1.5,0.0,0.0,4,7,1150,100,1900,0,98103,47.651,-122.34100000000001,1900,4400,5,8,2014,UNK,-650,220
2481630200,6/14/2014,883000.0,4,2.5,2960,41656,2.0,0.0,0.0,3,10,2960,0,1985,0,98072,47.7319,-122.132,3900,35104,6,14,2014,UNK,-940,6552
7299500200,8/15/2014,190000.0,2,1.0,840,12252,1.0,0.0,0.0,3,6,840,0,1994,0,98010,47.3069,-122.01299999999999,1010,11876,8,15,2014,UNK,-170,376
8598900125,4/6/2015,443000.0,3,1.75,1530,8028,1.0,0.0,0.0,3,7,1200,330,1967,0,98177,47.7768,-122.361,1530,8028,4,6,2015,UNK,0,0
7504010560,5/9/2014,920000.0,4,3.0,3750,11025,2.0,0.0,0.0,3,10,3750,0,1976,0,98074,47.6367,-122.059,2930,12835,5,9,2014,UNK,820,-1810
8732130140,12/22/2014,285000.0,4,2.25,2150,8250,1.0,0.0,0.0,4,7,1240,910,1978,0,98023,47.3045,-122.37799999999999,2050,7875,12,22,2014,UNK,100,375
2492200335,4/23/2015,901000.0,4,3.25,1560,4080,1.0,0.0,0.0,3,7,1560,0,1916,0,98126,47.5347,-122.38,1370,4080,4,23,2015,UNK,190,0
2770606602,3/5/2015,552500.0,3,1.75,2040,5775,1.0,0.0,0.0,3,7,1410,630,1958,0,98199,47.6592,-122.39299999999999,1360,4400,3,5,2015,UNK,680,1375
7211400990,3/3/2015,256000.0,2,1.0,860,5000,1.0,0.0,0.0,3,6,860,0,1915,1945,98146,47.5133,-122.35600000000001,1220,5000,3,3,2015,Y,-360,0
7148700160,5/12/2014,341000.0,3,1.5,1720,7119,1.5,0.0,0.0,4,7,1720,0,1952,0,98155,47.7535,-122.314,1590,7616,5,12,2014,UNK,130,-497
984220370,3/26/2015,279000.0,4,2.25,2090,8941,2.0,0.0,0.0,3,7,2090,0,1975,0,98058,47.4332,-122.167,1890,7946,3,26,2015,UNK,200,995
2600000510,7/26/2014,686000.0,4,2.25,2130,10650,2.0,0.0,0.0,4,8,2130,0,1977,0,98006,47.5567,-122.15899999999999,3380,10050,7,26,2014,UNK,-1250,600
7123400045,5/23/2014,225000.0,2,1.0,1300,11867,1.5,0.0,0.0,4,6,1300,0,1975,0,98010,47.3221,-121.90299999999999,820,11867,5,23,2014,UNK,480,0
3751602329,6/27/2014,215500.0,2,1.75,1220,15600,1.0,0.0,0.0,3,6,1220,0,1972,0,98001,47.2853,-122.265,1510,17818,6,27,2014,UNK,-290,-2218
6819100310,4/14/2015,950000.0,4,3.0,2420,4800,1.5,0.0,0.0,3,7,1520,900,1919,0,98119,47.6453,-122.35799999999999,1090,3800,4,14,2015,UNK,1330,1000
2925079012,11/5/2014,503000.0,4,2.5,2940,156988,2.0,0.0,2.0,3,9,1870,1070,1996,0,98014,47.6214,-121.946,2940,71002,11,5,2014,UNK,0,85986
7202430060,1/22/2015,780000.0,3,2.5,2610,7567,2.0,0.0,0.0,3,9,2610,0,1997,0,98052,47.6654,-122.137,2610,8458,1,22,2015,UNK,0,-891
185000118,2/23/2015,212000.0,4,2.0,1880,7500,1.0,0.0,0.0,5,6,980,900,1946,0,98178,47.495,-122.266,1670,14350,2,23,2015,UNK,210,-6850
1139000685,7/29/2014,580000.0,4,2.75,2330,6703,1.5,0.0,0.0,3,7,1710,620,1983,0,98177,47.7066,-122.359,2060,7500,7,29,2014,UNK,270,-797
5312100060,11/11/2014,465000.0,4,2.5,2200,3141,2.0,0.0,0.0,3,7,2060,140,1994,0,98144,47.5726,-122.305,1660,3175,11,11,2014,UNK,540,-34
3356404330,11/19/2014,206000.0,4,2.0,1720,7560,1.0,0.0,0.0,3,7,1720,0,1959,0,98001,47.2845,-122.25,1750,7988,11,19,2014,UNK,-30,-428
7805460030,2/23/2015,615000.0,3,2.5,2250,10171,2.0,0.0,0.0,3,9,2250,0,1987,0,98006,47.5613,-122.11,2440,13390,2,23,2015,UNK,-190,-3219
1705400055,7/19/2014,519000.0,4,1.0,1640,6305,1.5,0.0,0.0,5,6,1640,0,1907,0,98118,47.5563,-122.28,1590,4816,7,19,2014,UNK,50,1489
3303980520,4/23/2015,1140000.0,4,3.25,4130,11444,2.0,0.0,0.0,3,11,4130,0,2001,0,98059,47.5208,-122.15,3720,11431,4,23,2015,UNK,410,13
2538410140,8/8/2014,330000.0,5,2.5,2600,3839,2.0,0.0,0.0,3,7,2600,0,2005,0,98058,47.4324,-122.145,2180,4800,8,8,2014,N,420,-961
3810000860,5/6/2015,240000.0,4,1.5,1920,7973,1.0,0.0,0.0,3,8,1920,0,1955,0,98178,47.4961,-122.235,2020,8840,5,6,2015,UNK,-100,-867
8079100370,11/7/2014,574000.0,3,2.0,2060,7000,1.0,0.0,0.0,4,9,2060,0,1988,0,98029,47.5644,-122.012,2110,7000,11,7,2014,UNK,-50,0
2025770560,11/3/2014,930000.0,4,4.25,5710,24663,2.0,0.0,0.0,3,11,5710,0,2007,0,98092,47.3065,-122.15799999999999,4060,23847,11,3,2014,N,1650,816
225069017,7/14/2014,850000.0,4,3.0,2720,183823,2.0,0.0,0.0,3,8,2720,0,1975,2007,98053,47.6749,-122.00200000000001,2140,173804,7,14,2014,Y,580,10019
1138010510,12/12/2014,415000.0,3,1.5,1490,7275,1.0,0.0,0.0,3,7,1090,400,1974,0,98034,47.7148,-122.213,1420,7330,12,12,2014,UNK,70,-55
4358700135,11/18/2014,480000.0,3,2.5,2360,9005,1.0,0.0,0.0,5,7,1340,1020,1929,0,98133,47.7076,-122.337,1520,9005,11,18,2014,UNK,840,0
4327100045,7/21/2014,300000.0,5,1.0,1940,8875,1.0,0.0,0.0,3,7,1940,0,1957,0,98188,47.4407,-122.275,1380,8875,7,21,2014,UNK,560,0
6804600550,7/8/2014,439000.0,4,2.25,2570,9503,2.0,0.0,0.0,3,8,2570,0,1980,0,98011,47.763999999999996,-122.167,1950,9600,7,8,2014,UNK,620,-97
5634500251,3/27/2015,450000.0,3,1.0,1160,36831,1.0,0.0,0.0,3,7,1160,0,1938,0,98028,47.7507,-122.23700000000001,1800,15640,3,27,2015,UNK,-640,21191
3125079062,4/26/2015,589000.0,3,2.5,2660,206480,1.0,0.0,0.0,3,8,2660,0,1989,0,98024,47.6042,-121.956,2660,206736,4,26,2015,UNK,0,-256
3629920140,4/7/2015,477000.0,3,2.25,1260,3000,2.0,0.0,0.0,3,7,1260,0,2003,0,98029,47.5459,-121.99700000000001,1630,3023,4,7,2015,UNK,-370,-23
6844703410,9/24/2014,587500.0,4,2.25,1780,6120,1.0,0.0,0.0,3,8,1310,470,1951,0,98115,47.6955,-122.287,1780,6120,9,24,2014,UNK,0,0
1337300070,9/24/2014,1320000.0,4,2.25,3180,6105,2.0,0.0,0.0,3,10,3180,0,1905,0,98112,47.6255,-122.314,3180,6029,9,24,2014,UNK,0,76
9290900160,9/11/2014,1430000.0,4,2.5,3380,27589,2.0,0.0,0.0,3,10,3380,0,1966,0,98004,47.6292,-122.225,3390,20075,9,11,2014,UNK,-10,7514
2251500270,4/13/2015,700000.0,4,2.25,2690,15000,2.0,0.0,0.0,3,9,1890,800,1978,0,98074,47.611999999999995,-122.064,2670,15030,4,13,2015,UNK,20,-30
414100295,6/23/2014,275000.0,2,1.0,1180,6552,1.0,0.0,0.0,4,6,1180,0,1949,0,98133,47.7477,-122.34200000000001,1070,7200,6,23,2014,UNK,110,-648
1771110640,6/24/2014,367500.0,3,1.0,1660,11783,1.0,0.0,0.0,4,7,1160,500,1978,0,98077,47.7563,-122.075,1320,10541,6,24,2014,UNK,340,1242
808300550,5/5/2015,453250.0,4,2.5,2260,6300,2.0,0.0,0.0,3,7,2260,0,2001,0,98019,47.7235,-121.958,2300,6300,5,5,2015,UNK,-40,0
4322500055,4/17/2015,607000.0,5,1.75,1910,5428,1.0,0.0,0.0,3,8,1390,520,1954,0,98136,47.5333,-122.39200000000001,1820,5900,4,17,2015,UNK,90,-472
3810000565,7/2/2014,255000.0,4,2.0,2430,8960,1.0,0.0,0.0,3,7,1430,1000,1960,0,98178,47.4979,-122.23200000000001,2430,8960,7,2,2014,UNK,0,0
461002025,5/1/2015,501000.0,2,2.0,1300,2500,1.0,0.0,0.0,4,7,770,530,1926,0,98117,47.6831,-122.37299999999999,1160,5000,5,1,2015,UNK,140,-2500
8559900140,3/31/2015,450000.0,3,1.0,1060,4650,1.0,0.0,0.0,3,7,910,150,1950,0,98116,47.5784,-122.39299999999999,1480,4750,3,31,2015,UNK,-420,-100
8899210320,8/20/2014,360000.0,3,2.25,2200,8000,2.0,0.0,0.0,3,8,2200,0,1981,0,98055,47.4522,-122.208,2170,8000,8,20,2014,UNK,30,0
952002765,11/14/2014,460000.0,4,1.75,1720,3050,1.5,0.0,0.0,5,7,1040,680,1929,0,98116,47.5654,-122.384,1570,6100,11,14,2014,UNK,150,-3050
7101100055,3/3/2015,753000.0,3,1.75,2360,8290,1.0,0.0,0.0,4,7,1180,1180,1950,0,98115,47.6738,-122.281,1880,7670,3,3,2015,UNK,480,620
3013300510,5/6/2015,389950.0,2,1.0,820,4234,1.0,0.0,1.0,3,6,820,0,1951,0,98136,47.5294,-122.38600000000001,1550,4236,5,6,2015,UNK,-730,-2
1623300765,5/6/2014,469000.0,2,1.0,1030,4400,1.0,0.0,0.0,3,7,1030,0,1924,0,98117,47.681000000000004,-122.361,1400,4200,5,6,2014,UNK,-370,200
9322800260,9/12/2014,550000.0,4,1.75,2030,5688,2.0,0.0,4.0,4,9,1730,300,1939,0,98146,47.5071,-122.387,2320,11107,9,12,2014,UNK,-290,-5419
6141600140,9/4/2014,565000.0,5,3.5,2700,11675,1.5,0.0,2.0,4,6,1950,750,1948,0,98133,47.7172,-122.34899999999999,2160,8114,9,4,2014,UNK,540,3561
9315300260,5/21/2014,189650.0,2,1.75,1100,7600,1.0,0.0,0.0,3,6,1100,0,1980,0,98198,47.4136,-122.318,1230,7350,5,21,2014,UNK,-130,250
7015200335,6/19/2014,1530000.0,4,3.25,3620,5131,2.0,0.0,3.0,4,11,2350,1270,1927,0,98119,47.6499,-122.37,2550,5174,6,19,2014,UNK,1070,-43
1545806510,8/20/2014,260000.0,3,1.75,1340,8000,1.0,0.0,0.0,3,7,1340,0,1980,0,98038,47.3651,-122.044,1690,8000,8,20,2014,UNK,-350,0
8643200055,6/1/2014,243000.0,3,1.75,1790,12000,1.0,0.0,0.0,3,7,1040,750,1960,0,98198,47.3945,-122.31299999999999,1840,12000,6,1,2014,UNK,-50,0
7855000550,12/1/2014,1100000.0,4,2.5,3830,13800,1.0,0.0,4.0,4,9,2030,1800,1969,0,98006,47.5671,-122.15700000000001,3460,9875,12,1,2014,UNK,370,3925
1313500070,8/20/2014,249000.0,3,1.5,1580,7200,1.0,0.0,0.0,4,7,1080,500,1976,0,98092,47.2761,-122.152,1580,7470,8,20,2014,UNK,0,-270
290000055,5/16/2014,720000.0,2,1.0,2020,7200,1.0,0.0,3.0,4,7,1700,320,1947,0,98146,47.506,-122.384,2020,7200,5,16,2014,UNK,0,0
4139460200,3/25/2015,905000.0,4,2.5,3330,9557,2.0,0.0,0.0,3,10,3330,0,1995,0,98006,47.5526,-122.102,3360,9755,3,25,2015,UNK,-30,-198
3931900295,4/23/2015,824500.0,4,2.5,2610,3500,1.5,0.0,0.0,5,7,1610,1000,1927,0,98115,47.6848,-122.32600000000001,1820,3900,4,23,2015,UNK,790,-400
7365600070,6/24/2014,762500.0,4,2.75,2610,8760,1.0,0.0,0.0,4,8,1760,850,1978,0,98040,47.5875,-122.229,2550,10376,6,24,2014,UNK,60,-1616
9274200320,4/13/2015,580000.0,3,2.5,1740,1280,3.0,0.0,2.0,3,8,1740,0,2008,0,98116,47.589,-122.387,1740,1308,4,13,2015,N,0,-28
8856920260,8/18/2014,380000.0,3,2.0,1840,8580,1.0,0.0,0.0,3,8,1840,0,1990,0,98058,47.4626,-122.132,2190,8580,8,18,2014,UNK,-350,0
4083306175,4/1/2015,805000.0,3,1.75,1080,3200,1.0,0.0,0.0,4,7,880,200,1926,0,98103,47.6503,-122.338,1780,5200,4,1,2015,UNK,-700,-2000
7588700204,7/16/2014,520000.0,4,1.75,1240,4532,1.5,0.0,0.0,4,7,1240,0,1944,0,98117,47.6892,-122.37799999999999,1260,4468,7,16,2014,UNK,-20,64
3271800295,2/3/2015,1570000.0,5,4.5,5620,5800,3.0,0.0,3.0,3,11,4700,920,1999,0,98199,47.6482,-122.412,2360,5800,2,3,2015,UNK,3260,0
6052400575,5/14/2014,175000.0,2,1.0,1170,8925,1.0,0.0,2.0,3,6,1170,0,1911,0,98198,47.4017,-122.321,1380,7440,5,14,2014,UNK,-210,1485
7861300140,6/16/2014,353500.0,4,2.25,1760,9602,2.0,0.0,0.0,3,7,1760,0,1987,0,98058,47.4248,-122.15799999999999,1860,9656,6,16,2014,UNK,-100,-54
6117501176,1/2/2015,500000.0,4,2.5,2230,26989,1.0,0.0,1.0,4,8,1400,830,1962,0,98166,47.4285,-122.345,2570,17702,1,2,2015,UNK,-340,9287
2592400140,2/11/2015,386500.0,3,1.75,1520,7350,1.0,0.0,0.0,4,7,1140,380,1972,0,98034,47.7167,-122.17,1380,7350,2,11,2015,UNK,140,0
7135300046,7/16/2014,210000.0,2,1.0,1450,4750,1.0,0.0,0.0,3,7,850,600,1950,0,98118,47.5293,-122.272,1190,5000,7,16,2014,UNK,260,-250
8665900295,4/23/2015,439500.0,3,2.5,1600,6510,1.0,0.0,0.0,3,7,940,0,1983,0,98155,47.7679,-122.30799999999999,1600,10507,4,23,2015,UNK,0,-3997
6699000810,8/13/2014,315000.0,5,2.5,3220,5751,2.0,0.0,0.0,3,8,3220,0,2002,0,98042,47.3717,-122.104,2740,5500,8,13,2014,UNK,480,251
5104510240,5/19/2014,339000.0,4,2.5,1830,8601,2.0,0.0,0.0,3,7,1830,0,2003,0,98038,47.3576,-122.016,1830,5184,5,19,2014,UNK,0,3417
7856700990,9/24/2014,655000.0,4,2.25,2200,9163,1.0,0.0,0.0,4,8,1430,770,1971,0,98006,47.5653,-122.146,2420,9163,9,24,2014,UNK,-220,0
8682300640,8/28/2014,740000.0,2,2.5,2170,8678,1.0,0.0,0.0,3,8,2170,0,2008,0,98053,47.7161,-122.014,2170,5890,8,28,2014,N,0,2788
6918700320,3/6/2015,685000.0,5,2.5,1900,7843,2.0,0.0,0.0,5,7,1900,0,1966,0,98008,47.6273,-122.12299999999999,1900,7350,3,6,2015,UNK,0,493
9560700055,3/10/2015,550000.0,5,2.5,2960,9877,1.0,0.0,0.0,4,7,1480,1480,1960,0,98005,47.5866,-122.171,1900,9877,3,10,2015,UNK,1060,0
3013300055,6/2/2014,405000.0,2,1.75,1710,4234,2.0,0.0,0.0,3,7,1330,380,1920,1979,98136,47.5319,-122.38600000000001,1530,4556,6,2,2014,Y,180,-322
9201000320,4/16/2015,765000.0,4,2.25,2620,17366,1.0,0.0,3.0,3,9,1430,1190,1984,0,98075,47.583999999999996,-122.07700000000001,2620,15335,4,16,2015,UNK,0,2031
9151600695,3/4/2015,625000.0,3,2.0,2140,3600,2.0,0.0,0.0,3,8,1680,460,1911,1997,98116,47.5846,-122.383,2340,5400,3,4,2015,Y,-200,-1800
2143700830,10/6/2014,207000.0,4,2.5,2100,19680,1.5,0.0,0.0,3,6,2100,0,1914,0,98055,47.4787,-122.23,1340,12300,10,6,2014,UNK,760,7380
2143700830,3/12/2015,370000.0,4,2.5,2100,19680,1.5,0.0,0.0,3,6,2100,0,1914,0,98055,47.4787,-122.23,1340,12300,3,12,2015,UNK,760,7380
2591020140,12/2/2014,475000.0,3,2.5,1460,4961,1.0,0.0,0.0,4,8,1150,310,1988,0,98033,47.6955,-122.18299999999999,1550,5449,12,2,2014,UNK,-90,-488
6414600262,8/29/2014,365000.0,2,1.0,990,8250,1.0,0.0,0.0,3,7,990,0,1955,0,98133,47.7252,-122.331,1080,8168,8,29,2014,UNK,-90,82
1387301360,12/22/2014,411800.0,4,2.25,2190,6800,1.0,0.0,0.0,5,7,1340,850,1969,0,98011,47.7367,-122.195,1560,7611,12,22,2014,UNK,630,-811
5561400260,7/21/2014,668000.0,5,3.5,3990,42436,2.0,0.0,0.0,3,9,2710,1280,2002,0,98027,47.46100000000001,-122.0,3030,41684,7,21,2014,UNK,960,752
7942601805,9/11/2014,618000.0,3,2.5,2340,3630,2.0,0.0,0.0,3,9,2340,0,1998,0,98122,47.6059,-122.307,1820,5120,9,11,2014,UNK,520,-1490
1887500045,12/26/2014,247500.0,4,2.0,2460,5921,1.0,0.0,0.0,4,7,1230,1230,1948,0,98002,47.308,-122.209,1260,6648,12,26,2014,UNK,1200,-727
5505700055,7/30/2014,345000.0,5,3.0,2080,6150,1.0,0.0,0.0,3,7,1040,1040,1950,0,98116,47.5707,-122.39399999999999,1420,6150,7,30,2014,UNK,660,0
3886902505,3/11/2015,616300.0,3,2.0,1700,8400,2.0,0.0,2.0,3,7,1700,0,1927,0,98033,47.6825,-122.19,1820,9000,3,11,2015,UNK,-120,-600
6703100135,1/16/2015,348000.0,3,1.5,1330,6768,1.0,0.0,0.0,4,7,1330,0,1952,0,98155,47.7366,-122.319,1320,6910,1,16,2015,UNK,10,-142
1552520070,12/2/2014,425000.0,3,2.5,1630,10762,1.0,0.0,0.0,3,7,1630,0,1994,0,98011,47.7508,-122.175,1770,10762,12,2,2014,UNK,-140,0
8163300320,6/14/2014,850000.0,5,2.75,2920,11880,1.0,0.0,0.0,5,8,1660,1260,1968,0,98027,47.5133,-122.031,3910,14491,6,14,2014,UNK,-990,-2611
1853081000,7/17/2014,820000.0,5,2.75,2830,6137,2.0,0.0,0.0,3,9,2830,0,2010,0,98074,47.5932,-122.05799999999999,3170,6285,7,17,2014,N,-340,-148
4403600240,1/13/2015,832000.0,4,2.25,3190,52953,2.0,0.0,0.0,4,10,3190,0,1980,0,98075,47.5933,-122.075,3190,51400,1,13,2015,UNK,0,1553
3885803625,12/3/2014,835000.0,3,1.75,1490,3840,2.0,0.0,0.0,3,8,1490,0,1984,2014,98033,47.6916,-122.214,3450,8500,12,3,2014,Y,-1960,-4660
869700370,4/10/2015,350000.0,3,2.5,1630,3425,2.0,0.0,0.0,3,8,1630,0,1999,0,98059,47.4913,-122.154,1420,3425,4,10,2015,UNK,210,0
4307301160,7/22/2014,349000.0,4,2.5,2280,4096,2.0,0.0,0.0,3,7,2280,0,2003,0,98056,47.4834,-122.182,2280,3600,7,22,2014,UNK,0,496
2402100575,6/13/2014,1130000.0,6,3.75,3010,4360,2.0,0.0,0.0,3,9,2000,1010,2014,0,98103,47.6873,-122.333,1600,5160,6,13,2014,N,1410,-800
4307350990,3/9/2015,320000.0,3,2.5,1590,3480,2.0,0.0,0.0,3,7,1590,0,2004,0,98056,47.4805,-122.178,1680,3480,3,9,2015,N,-90,0
2873000260,3/5/2015,150000.0,3,1.0,1250,7210,1.0,0.0,0.0,4,7,1250,0,1968,0,98031,47.4169,-122.16799999999999,1010,7210,3,5,2015,UNK,240,0
795001600,11/25/2014,340000.0,3,1.0,1710,10190,1.0,0.0,0.0,3,6,1310,400,1949,0,98168,47.506,-122.331,1200,6251,11,25,2014,UNK,510,3939
98030140,10/13/2014,785500.0,4,4.0,3280,8448,2.0,0.0,0.0,3,10,3280,0,2007,0,98075,47.5818,-121.973,3730,8030,10,13,2014,N,-450,418
5409800140,2/17/2015,410500.0,4,2.5,3362,8601,2.0,0.0,0.0,3,8,3362,0,2004,0,98003,47.2592,-122.304,2770,8601,2,17,2015,N,592,0
9253900354,7/1/2014,580000.0,3,2.5,2200,11000,2.0,0.0,2.0,3,9,2200,0,1978,0,98008,47.5916,-122.11200000000001,2200,12851,7,1,2014,UNK,0,-1851
3319500922,4/21/2015,345000.0,2,1.5,830,920,2.0,0.0,0.0,3,7,830,0,2005,0,98144,47.5998,-122.306,830,1200,4,21,2015,N,0,-280
3404700041,9/29/2014,550000.0,3,2.25,2160,37000,1.5,0.0,0.0,4,7,1760,400,1933,0,98052,47.7297,-122.139,2540,37000,9,29,2014,UNK,-380,0
2314300200,10/21/2014,449500.0,4,3.0,2580,7299,2.0,0.0,0.0,3,8,2580,0,1998,0,98058,47.4646,-122.15,2250,6165,10,21,2014,UNK,330,1134
9265700045,6/24/2014,300000.0,3,1.0,2150,7007,1.0,0.0,0.0,3,6,2150,0,1954,0,98177,47.7615,-122.36200000000001,1720,9000,6,24,2014,UNK,430,-1993
3528000260,11/11/2014,915000.0,4,2.5,3510,28052,2.0,0.0,0.0,3,10,3510,0,1988,0,98053,47.6671,-122.057,2890,28295,11,11,2014,UNK,620,-243
3066120030,1/27/2015,1580000.0,4,3.75,3810,9916,2.0,0.0,0.0,3,11,3810,0,1989,0,98040,47.5739,-122.234,3040,11250,1,27,2015,UNK,770,-1334
4278900055,5/28/2014,599000.0,4,2.75,2020,2750,1.0,0.0,0.0,3,8,1010,1010,1917,2014,98122,47.6053,-122.291,1840,4000,5,28,2014,Y,180,-1250
9512000140,5/5/2014,755000.0,4,2.5,2120,10202,1.0,0.0,0.0,4,7,1620,500,1960,0,98005,47.5858,-122.17,1570,10762,5,5,2014,UNK,550,-560
6381500505,4/2/2015,400000.0,3,1.0,1250,7157,1.0,0.0,0.0,3,7,1250,0,1944,2010,98125,47.7323,-122.304,1300,6796,4,2,2015,Y,-50,361
1697000400,3/30/2015,133000.0,3,1.0,980,9115,1.0,0.0,0.0,3,7,980,0,1968,0,98198,47.3737,-122.31200000000001,1470,8716,3,30,2015,UNK,-490,399
2548100140,1/16/2015,330000.0,4,1.5,1250,8400,1.0,0.0,0.0,3,7,960,290,1951,0,98155,47.7505,-122.315,1560,8400,1,16,2015,UNK,-310,0
7225000140,2/18/2015,330000.0,4,1.0,1100,5000,1.5,0.0,0.0,5,6,1100,0,1904,0,98055,47.4868,-122.204,1560,4838,2,18,2015,UNK,-460,162
2126049032,9/5/2014,375000.0,3,1.75,1330,9417,1.0,0.0,0.0,5,6,710,620,1936,0,98125,47.7231,-122.301,1690,7937,9,5,2014,UNK,-360,1480
3876300890,12/11/2014,485000.0,4,2.75,2560,8956,1.0,0.0,0.0,4,7,1500,1060,1968,0,98034,47.7278,-122.177,2280,9234,12,11,2014,UNK,280,-278
7715800710,7/22/2014,470000.0,4,2.5,1850,11250,1.5,0.0,0.0,3,7,1210,640,1981,0,98074,47.6264,-122.06200000000001,1650,7623,7,22,2014,UNK,200,3627
2397101200,12/21/2014,1050000.0,4,3.0,2790,3600,2.0,0.0,0.0,3,8,1880,910,1905,2013,98119,47.6362,-122.363,1360,3600,12,21,2014,Y,1430,0
5100401160,7/7/2014,548800.0,4,1.0,1660,4704,1.5,0.0,0.0,3,7,1260,400,1930,0,98115,47.6918,-122.32,1360,5413,7,7,2014,UNK,300,-709
2741100800,7/8/2014,315000.0,2,1.0,1080,2674,1.0,0.0,0.0,4,6,720,360,1919,0,98108,47.5595,-122.31700000000001,1250,5000,7,8,2014,UNK,-170,-2326
34001160,9/19/2014,590000.0,3,2.0,3030,9374,1.0,0.0,1.0,4,7,2100,930,1959,0,98136,47.5289,-122.391,1990,6012,9,19,2014,UNK,1040,3362
5637200200,5/23/2014,439950.0,4,2.5,2380,12067,2.0,0.0,0.0,3,7,2380,0,2002,0,98059,47.4873,-122.14399999999999,2330,8621,5,23,2014,UNK,50,3446
3410600335,6/3/2014,325000.0,3,1.75,2250,26337,1.0,0.0,0.0,3,8,2250,0,1980,0,98092,47.3032,-122.12299999999999,1830,26337,6,3,2014,UNK,420,0
8024201370,12/8/2014,400000.0,2,1.0,880,5111,1.0,0.0,0.0,3,6,880,0,1931,0,98115,47.6997,-122.314,1370,5111,12,8,2014,UNK,-490,0
3066410800,12/11/2014,685000.0,4,2.5,2770,10051,2.0,0.0,0.0,3,10,2770,0,1987,0,98074,47.6288,-122.04299999999999,2730,10675,12,11,2014,UNK,40,-624
5306100240,9/18/2014,339950.0,3,2.0,1340,10200,1.5,0.0,0.0,3,7,1340,0,1953,0,98133,47.7756,-122.351,1420,10200,9,18,2014,UNK,-80,0
9334800140,10/23/2014,315000.0,3,1.75,1660,8160,1.0,0.0,0.0,4,7,1660,0,1951,0,98166,47.4608,-122.35799999999999,1490,8100,10,23,2014,UNK,170,60
7203101260,2/11/2015,411753.0,3,2.5,1710,3795,2.0,0.0,0.0,3,7,1710,0,2009,0,98053,47.6968,-122.024,1600,3821,2,11,2015,N,110,-26
7577700070,8/28/2014,577000.0,2,1.75,1620,4879,1.0,0.0,0.0,3,7,1040,580,1924,2011,98116,47.5703,-122.385,1500,5000,8,28,2014,Y,120,-121
6072100140,10/17/2014,500000.0,3,1.75,1530,8829,1.0,0.0,0.0,5,8,1530,0,1972,0,98006,47.545,-122.171,2060,9226,10,17,2014,UNK,-530,-397
3874000240,12/2/2014,210000.0,3,2.0,1440,10111,1.0,0.0,0.0,3,7,1440,0,1963,0,98001,47.345,-122.28299999999999,1580,10200,12,2,2014,UNK,-140,-89
6151800135,8/27/2014,640000.0,4,1.75,2020,16120,1.0,0.0,0.0,3,7,2020,0,1969,0,98010,47.3413,-122.04799999999999,1940,16350,8,27,2014,UNK,80,-230
1826049225,4/17/2015,460000.0,4,1.75,1870,8663,1.0,0.0,0.0,5,7,1870,0,1949,0,98133,47.7366,-122.35,1560,7800,4,17,2015,UNK,310,863
8150100240,2/18/2015,265000.0,2,1.0,620,4760,1.0,0.0,0.0,3,6,620,0,1941,0,98126,47.5286,-122.376,620,4760,2,18,2015,UNK,0,0
5152960710,5/14/2014,740000.0,5,5.0,5774,31675,1.0,0.0,2.0,3,11,4490,1284,1984,0,98003,47.3466,-122.323,3260,13200,5,14,2014,UNK,2514,18475
4027701275,7/18/2014,230000.0,3,1.0,1240,6195,1.0,0.0,0.0,3,6,1240,0,1948,0,98028,47.7681,-122.266,1760,11080,7,18,2014,UNK,-520,-4885
1545807990,2/17/2015,315000.0,3,1.75,1890,10661,1.0,0.0,0.0,5,7,1460,430,1978,0,98038,47.3583,-122.056,1680,9604,2,17,2015,UNK,210,1057
1726069179,12/23/2014,432000.0,3,1.75,2410,51763,1.0,0.0,0.0,4,8,1410,1000,1981,0,98077,47.7429,-122.056,2410,49207,12,23,2014,UNK,0,2556
3905100070,2/3/2015,467000.0,3,2.5,1530,3984,2.0,0.0,0.0,3,8,1530,0,1995,0,98029,47.568999999999996,-122.007,1720,4005,2,3,2015,UNK,-190,-21
7316400070,9/25/2014,255000.0,5,3.75,2800,9900,1.0,0.0,0.0,3,7,2800,0,1964,0,98023,47.318999999999996,-122.344,1700,13200,9,25,2014,UNK,1100,-3300
2113700335,4/8/2015,316500.0,3,1.75,1460,6360,1.0,0.0,2.0,3,7,1010,450,1979,0,98106,47.5311,-122.353,1400,4240,4,8,2015,UNK,60,2120
3972900160,4/3/2015,190000.0,4,2.0,1580,6250,1.0,0.0,0.0,3,7,860,720,1977,0,98155,47.7659,-122.31,1580,6250,4,3,2015,UNK,0,0
2767603215,5/16/2014,490000.0,3,2.0,1450,2400,1.5,0.0,0.0,3,8,1450,0,1900,2003,98107,47.6726,-122.381,1450,4275,5,16,2014,Y,0,-1875
3664500041,4/17/2015,378000.0,4,1.75,1990,23200,1.0,0.0,0.0,4,7,1990,0,1976,0,98059,47.486000000000004,-122.12899999999999,1950,17040,4,17,2015,UNK,40,6160
5379804150,2/11/2015,598800.0,6,4.0,4470,17877,3.0,0.0,3.0,3,9,3230,1240,2013,0,98188,47.4514,-122.273,1790,18260,2,11,2015,N,2680,-383
9188200570,9/2/2014,333800.0,5,3.0,1980,3868,1.0,0.0,0.0,3,7,1220,760,1990,0,98118,47.5173,-122.275,1970,3868,9,2,2014,UNK,10,0
3905010140,5/29/2014,690000.0,4,2.5,2920,9904,2.0,0.0,0.0,4,9,2920,0,1990,0,98029,47.5759,-121.995,1810,5617,5,29,2014,UNK,1110,4287
5141000685,10/21/2014,320000.0,4,1.75,1660,6200,1.0,0.0,0.0,4,6,830,830,1948,0,98108,47.56,-122.316,1780,5968,10,21,2014,UNK,-120,232
6738700320,4/14/2015,1250000.0,4,3.5,3190,6000,1.5,0.0,3.0,4,9,2410,780,1912,0,98144,47.5846,-122.29,2840,4000,4,14,2015,UNK,350,2000
1246700152,7/21/2014,335000.0,3,1.5,1560,9600,1.0,0.0,0.0,4,7,1560,0,1961,0,98033,47.6918,-122.163,1520,10000,7,21,2014,UNK,40,-400
2926069062,8/11/2014,840000.0,3,2.5,3050,33920,1.0,0.0,0.0,3,8,3050,0,2004,0,98052,47.7034,-122.072,1970,60984,8,11,2014,N,1080,-27064
6114400136,7/14/2014,608250.0,4,2.75,3030,21780,2.0,0.0,0.0,3,8,3030,0,1986,0,98166,47.4481,-122.338,3020,28027,7,14,2014,UNK,10,-6247
6127010800,6/9/2014,550000.0,3,2.5,2260,4165,2.0,0.0,0.0,3,7,2260,0,2005,0,98075,47.5922,-122.008,2770,4566,6,9,2014,N,-510,-401
4222000320,4/22/2015,240000.0,3,1.0,1260,7920,1.0,0.0,0.0,3,7,1260,0,1966,0,98003,47.3452,-122.30799999999999,1300,7920,4,22,2015,UNK,-40,0
2600010070,4/14/2015,998000.0,3,2.25,3370,11757,2.0,0.0,2.0,4,9,3370,0,1980,0,98006,47.5573,-122.16,2690,10500,4,14,2015,UNK,680,1257
3826500570,8/29/2014,275000.0,3,1.75,1490,8000,1.0,0.0,0.0,3,8,1490,0,1978,0,98030,47.3817,-122.166,1740,8165,8,29,2014,UNK,-250,-165
8159620160,4/24/2015,284200.0,3,2.5,1570,9292,1.0,0.0,0.0,3,7,1110,460,1977,0,98001,47.3386,-122.272,1470,9222,4,24,2015,UNK,100,70
1118001805,7/24/2014,1720000.0,4,3.75,4490,7623,2.0,0.0,0.0,4,10,3090,1400,1941,0,98112,47.6315,-122.29,3760,7653,7,24,2014,UNK,730,-30
3398800055,11/19/2014,2400000.0,4,3.75,4090,24825,2.0,0.0,0.0,4,11,3400,690,1926,0,98102,47.6338,-122.319,3910,11500,11,19,2014,UNK,180,13325
3528000510,9/5/2014,930800.0,5,2.5,4150,96574,2.0,0.0,0.0,3,10,4150,0,1988,0,98053,47.6664,-122.045,3320,40803,9,5,2014,UNK,830,55771
627300105,7/29/2014,930000.0,4,3.0,2900,10400,1.0,0.0,3.0,5,8,1530,1370,1959,0,98008,47.5854,-122.11399999999999,2820,10400,7,29,2014,UNK,80,0
3279000070,8/28/2014,215000.0,4,1.5,1430,8775,1.0,0.0,0.0,3,7,1030,400,1979,0,98023,47.3034,-122.383,1390,7800,8,28,2014,UNK,40,975
1922039062,4/20/2015,480000.0,2,1.5,1008,26487,1.0,1.0,4.0,4,6,1008,0,1943,2002,98070,47.3853,-122.479,1132,24079,4,20,2015,Y,-124,2408
312000135,5/20/2014,483945.0,2,1.75,1480,5120,1.0,0.0,0.0,4,6,840,640,1951,0,98116,47.558,-122.39200000000001,1090,5120,5,20,2014,UNK,390,0
6054650510,6/9/2014,347000.0,3,1.75,1240,8050,1.0,0.0,0.0,4,7,1240,0,1978,0,98074,47.6108,-122.044,1370,9856,6,9,2014,UNK,-130,-1806
3279000240,3/30/2015,232500.0,3,2.0,1370,9760,1.0,0.0,0.0,4,7,1110,260,1979,0,98023,47.3009,-122.384,1640,9040,3,30,2015,UNK,-270,720
1402000070,5/20/2014,390000.0,4,2.25,1770,33132,1.0,0.0,0.0,4,8,1190,580,1965,0,98058,47.4413,-122.15100000000001,2490,20000,5,20,2014,UNK,-720,13132
1562200240,9/18/2014,550000.0,3,2.25,2160,15360,1.0,0.0,0.0,3,8,1410,750,1965,2000,98007,47.6232,-122.13799999999999,2180,8480,9,18,2014,Y,-20,6880
3904921070,8/12/2014,590000.0,4,2.5,2340,8971,2.0,0.0,0.0,3,9,2340,0,1987,0,98029,47.5679,-122.01100000000001,2510,9219,8,12,2014,UNK,-170,-248
4045500510,5/21/2014,420850.0,1,1.0,960,40946,1.0,0.0,0.0,5,5,960,0,1945,0,98014,47.6951,-121.86399999999999,1320,20350,5,21,2014,UNK,-360,20596
8849300160,2/5/2015,345000.0,4,2.5,2280,8190,1.0,0.0,3.0,3,7,1390,890,1983,0,98188,47.4414,-122.272,1990,9000,2,5,2015,UNK,290,-810
4123810140,2/27/2015,429800.0,3,2.0,1970,7000,1.0,0.0,0.0,3,8,1970,0,1986,0,98038,47.3744,-122.04299999999999,1970,7365,2,27,2015,UNK,0,-365
2473251170,6/26/2014,302000.0,4,1.75,1530,17664,1.5,0.0,0.0,3,7,1530,0,1968,0,98058,47.4549,-122.155,1530,11625,6,26,2014,UNK,0,6039
6430500186,11/4/2014,800000.0,4,1.5,1790,3952,1.5,0.0,0.0,4,8,1790,0,1932,0,98103,47.68899999999999,-122.352,1200,3876,11,4,2014,UNK,590,76
4136950140,12/15/2014,250000.0,3,2.5,1700,6000,2.0,0.0,0.0,3,8,1700,0,1997,0,98092,47.2615,-122.221,1940,6626,12,15,2014,UNK,-240,-626
1370802650,7/29/2014,605000.0,3,2.0,2660,4500,1.0,0.0,0.0,4,7,1330,1330,1922,0,98199,47.6391,-122.40299999999999,1790,5000,7,29,2014,UNK,870,-500
1721069036,5/29/2014,412000.0,3,1.75,1950,52256,1.0,0.0,0.0,4,8,1950,0,1985,0,98042,47.3133,-122.07799999999999,2450,51836,5,29,2014,UNK,-500,420
8637100370,11/12/2014,252000.0,3,2.0,1340,5670,2.0,0.0,0.0,3,6,1340,0,1994,0,98055,47.4498,-122.194,1290,4892,11,12,2014,UNK,50,778
8952900260,9/19/2014,375000.0,3,1.0,1130,12500,1.5,0.0,0.0,3,7,1130,0,1954,0,98118,47.5491,-122.26799999999999,2280,8750,9,19,2014,UNK,-1150,3750
1972202080,7/10/2014,725000.0,2,1.75,1950,2719,1.0,0.0,0.0,5,7,1010,940,1919,0,98103,47.6513,-122.346,1360,1256,7,10,2014,UNK,590,1463
9476200350,10/13/2014,471750.0,5,3.5,3790,8200,1.0,0.0,1.0,3,8,2120,1670,2001,0,98056,47.4891,-122.19,1740,8676,10,13,2014,UNK,2050,-476
1523069204,12/8/2014,490000.0,4,2.25,2020,85813,2.0,0.0,0.0,3,7,2020,0,1995,0,98027,47.483000000000004,-122.02600000000001,2120,85813,12,8,2014,UNK,-100,0
2856100125,10/1/2014,439000.0,2,1.0,800,5100,1.0,0.0,0.0,3,7,800,0,1945,0,98117,47.6775,-122.38799999999999,1330,5100,10,1,2014,UNK,-530,0
2968800626,8/22/2014,355000.0,4,2.0,1770,8890,1.0,0.0,0.0,5,6,1770,0,1949,0,98166,47.4589,-122.353,1010,7620,8,22,2014,UNK,760,1270
2129700320,5/5/2015,250000.0,1,0.75,940,87120,1.0,0.0,0.0,3,6,940,0,1944,0,98019,47.7182,-121.956,1930,165528,5,5,2015,UNK,-990,-78408
8965500320,3/26/2015,780000.0,4,2.25,2260,16188,1.0,0.0,0.0,3,10,2260,0,1984,0,98006,47.5637,-122.11200000000001,2840,10158,3,26,2015,UNK,-580,6030
952005224,11/5/2014,409000.0,2,1.0,890,3271,1.0,0.0,0.0,4,6,890,0,1918,0,98116,47.5631,-122.381,1190,5175,11,5,2014,UNK,-300,-1904
4443801160,6/10/2014,420000.0,2,1.0,860,3880,1.0,0.0,0.0,4,6,860,0,1916,0,98117,47.6862,-122.391,1230,4260,6,10,2014,UNK,-370,-380
5101404170,11/13/2014,200000.0,1,0.75,680,9600,1.0,0.0,0.0,3,5,680,0,1947,0,98115,47.6964,-122.306,1580,6624,11,13,2014,UNK,-900,2976
1241500350,1/5/2015,830000.0,2,1.5,2130,35679,1.0,0.0,0.0,4,7,2130,0,1963,0,98033,47.6638,-122.171,2670,35679,1,5,2015,UNK,-540,0
4379400560,5/29/2014,695000.0,3,2.5,2390,4555,2.0,0.0,0.0,3,9,2390,0,2006,0,98074,47.6199,-122.025,2540,4500,5,29,2014,N,-150,55
629810350,5/21/2014,815000.0,4,2.75,3488,9614,2.0,0.0,0.0,3,10,3488,0,1998,0,98074,47.6055,-122.01299999999999,3600,10891,5,21,2014,UNK,-112,-1277
5466400550,11/13/2014,210000.0,3,1.75,1260,6223,1.0,0.0,0.0,3,7,820,440,1983,0,98042,47.3574,-122.15799999999999,1260,6553,11,13,2014,UNK,0,-330
3619600132,9/15/2014,635000.0,3,1.75,2940,6000,1.0,0.0,2.0,4,8,1590,1350,1957,0,98177,47.7235,-122.369,2880,8100,9,15,2014,UNK,60,-2100
4113800550,7/21/2014,562500.0,4,2.5,2440,7322,2.0,0.0,0.0,3,9,2440,0,1991,0,98056,47.5357,-122.179,2590,9927,7,21,2014,UNK,-150,-2605
7298020240,5/9/2014,402500.0,4,2.5,2600,11951,2.0,0.0,0.0,3,10,2600,0,1988,0,98023,47.3053,-122.34,2820,12093,5,9,2014,UNK,-220,-142
434000030,12/19/2014,555000.0,3,2.0,2080,7020,1.0,0.0,0.0,4,7,1040,1040,1951,0,98115,47.6768,-122.285,1920,7000,12,19,2014,UNK,160,20
1138000830,9/9/2014,310000.0,3,1.0,1990,7173,1.0,0.0,0.0,3,7,1990,0,1972,0,98034,47.7116,-122.213,1320,7245,9,9,2014,UNK,670,-72
8568000070,9/5/2014,500000.0,4,2.5,2840,18001,2.0,0.0,0.0,3,9,2840,0,1994,0,98019,47.7359,-121.962,2500,18001,9,5,2014,UNK,340,0
8822901200,7/23/2014,430000.0,6,3.0,2630,8800,1.0,0.0,0.0,3,7,1610,1020,1959,0,98125,47.7166,-122.29299999999999,1220,1173,7,23,2014,UNK,1410,7627
1118002090,6/28/2014,1600000.0,3,4.25,2820,7200,2.0,0.0,0.0,4,10,2460,360,1930,0,98112,47.6298,-122.29,3300,7522,6,28,2014,UNK,-480,-322
3856901525,10/1/2014,627500.0,4,1.0,1560,4080,1.5,0.0,0.0,3,7,1560,0,1923,0,98103,47.6711,-122.331,1890,4080,10,1,2014,UNK,-330,0
1180500070,11/24/2014,335000.0,4,2.5,2330,7050,2.0,0.0,0.0,3,8,2330,0,1998,0,98178,47.5001,-122.23100000000001,1810,5424,11,24,2014,UNK,520,1626
7856560320,3/17/2015,962000.0,4,2.25,3320,20100,1.0,0.0,0.0,4,8,1810,1510,1981,0,98006,47.5566,-122.15299999999999,2450,9821,3,17,2015,UNK,870,10279
5103900045,7/25/2014,299000.0,3,1.75,1730,14270,1.0,0.0,0.0,3,7,1730,0,1959,0,98065,47.5318,-121.833,1600,11232,7,25,2014,UNK,130,3038
8562890370,4/14/2015,399950.0,4,2.5,3110,5868,2.0,0.0,0.0,3,8,3110,0,2001,0,98042,47.3781,-122.126,2950,5924,4,14,2015,UNK,160,-56
8807600340,3/25/2015,322000.0,3,1.0,1230,9660,1.0,0.0,0.0,3,7,1230,0,1968,0,98053,47.6829,-122.06,1380,10125,3,25,2015,UNK,-150,-465
993002325,6/23/2014,430000.0,2,1.5,950,4625,1.0,0.0,0.0,4,7,950,0,1949,0,98103,47.6912,-122.34,1440,4625,6,23,2014,UNK,-490,0
1022059082,5/8/2014,307000.0,3,1.75,1890,13860,1.0,0.0,0.0,5,7,1890,0,1966,0,98042,47.4156,-122.149,1500,14536,5,8,2014,UNK,390,-676
179000350,11/5/2014,194000.0,3,1.5,1010,5000,1.0,0.0,0.0,3,6,1010,0,1943,0,98178,47.4925,-122.27799999999999,980,5000,11,5,2014,UNK,30,0
3915500045,11/14/2014,180000.0,3,1.0,1010,8581,1.0,0.0,0.0,4,6,1010,0,1920,0,98002,47.3043,-122.21600000000001,1060,10354,11,14,2014,UNK,-50,-1773
3578400030,7/18/2014,465000.0,4,2.25,2340,13383,1.0,0.0,0.0,3,8,1170,1170,1983,0,98074,47.6211,-122.037,1810,12532,7,18,2014,UNK,530,851
9346700320,3/23/2015,722500.0,4,2.5,2460,9296,2.0,0.0,0.0,3,9,2460,0,1978,0,98007,47.6125,-122.152,2730,9900,3,23,2015,UNK,-270,-604
3856901715,9/24/2014,470450.0,2,1.0,1010,3400,1.0,0.0,0.0,3,7,1010,0,1921,0,98103,47.6711,-122.329,1800,3600,9,24,2014,UNK,-790,-200
8700120520,1/27/2015,280000.0,3,2.5,1650,6000,2.0,0.0,0.0,3,7,1650,0,1990,0,98030,47.36,-122.194,1750,6000,1,27,2015,UNK,-100,0
7335400400,4/10/2015,176250.0,4,2.0,1440,6702,1.0,0.0,0.0,4,7,1440,0,1966,0,98002,47.3056,-122.21700000000001,1030,6702,4,10,2015,UNK,410,0
4319200505,6/17/2014,560000.0,5,1.0,1710,9100,1.5,0.0,0.0,4,7,1320,390,1926,0,98126,47.5379,-122.37799999999999,1880,9100,6,17,2014,UNK,-170,0
1426049083,10/22/2014,830000.0,3,2.5,2760,11287,2.0,0.0,3.0,3,10,2000,760,1991,0,98028,47.739,-122.264,2760,13719,10,22,2014,UNK,0,-2432
7795400046,6/11/2014,276900.0,2,1.0,1350,10096,1.0,0.0,2.0,4,7,1350,0,1952,0,98045,47.4967,-121.77799999999999,1280,10095,6,11,2014,UNK,70,1
1337800045,10/1/2014,625000.0,3,1.75,1660,4800,2.0,0.0,0.0,3,7,1660,0,1906,0,98112,47.6296,-122.30799999999999,1660,4800,10,1,2014,UNK,0,0
2207500695,3/4/2015,1020000.0,4,2.5,2960,4760,2.0,0.0,0.0,3,8,2160,800,1900,0,98102,47.6367,-122.318,1600,4760,3,4,2015,UNK,1360,0
1112000125,9/30/2014,463500.0,1,1.0,1090,8750,1.0,0.0,0.0,4,6,1090,0,1924,0,98118,47.54,-122.26899999999999,1830,5000,9,30,2014,UNK,-740,3750
2472930270,9/5/2014,485000.0,3,2.5,3110,9015,2.0,0.0,0.0,3,9,3110,0,1990,0,98058,47.4369,-122.147,2650,8960,9,5,2014,UNK,460,55
5651500140,6/17/2014,272000.0,3,2.0,1380,7476,1.0,0.0,0.0,3,7,1380,0,1989,0,98001,47.3336,-122.272,1600,7227,6,17,2014,UNK,-220,249
7203102080,12/17/2014,305000.0,2,1.0,1290,3140,2.0,0.0,0.0,3,7,1290,0,2008,0,98053,47.6971,-122.02600000000001,1290,2628,12,17,2014,N,0,512
3626500045,6/26/2014,760000.0,3,2.5,1980,13964,1.0,0.0,0.0,5,7,1980,0,1959,0,98040,47.57100000000001,-122.227,2040,13964,6,26,2014,UNK,-60,0
3226049117,2/13/2015,387500.0,2,1.0,870,6126,1.0,0.0,0.0,4,7,870,0,1938,0,98125,47.7024,-122.322,1620,6126,2,13,2015,UNK,-750,0
6699940140,9/8/2014,352000.0,4,2.5,2470,5015,2.0,0.0,0.0,3,8,2470,0,2004,0,98038,47.3457,-122.041,2470,5100,9,8,2014,N,0,-85
7702600160,7/9/2014,507000.0,3,1.75,2140,40098,1.0,0.0,0.0,5,8,1490,650,1950,0,98058,47.4296,-122.111,2220,35371,7,9,2014,UNK,-80,4727
5379804730,7/18/2014,156000.0,3,1.0,770,9750,1.0,0.0,0.0,3,6,770,0,1941,0,98188,47.4509,-122.275,1560,10707,7,18,2014,UNK,-790,-957
3383900058,11/18/2014,580000.0,3,3.25,1490,857,3.0,0.0,0.0,3,8,1220,270,2001,0,98102,47.6357,-122.324,1550,1092,11,18,2014,UNK,-60,-235
629600030,7/14/2014,630000.0,4,2.5,2510,35020,1.0,0.0,0.0,4,8,1610,900,1977,0,98075,47.5834,-122.00299999999999,2080,34398,7,14,2014,UNK,430,622
1823049171,12/18/2014,275000.0,5,1.5,1950,9000,1.0,0.0,0.0,3,7,1130,820,1964,0,98146,47.4882,-122.339,1680,9526,12,18,2014,UNK,270,-526
3760500516,7/24/2014,835000.0,5,4.0,3600,14720,1.0,0.0,2.0,5,8,1800,1800,1960,0,98034,47.7022,-122.227,3600,15358,7,24,2014,UNK,0,-638
2641400160,12/5/2014,340000.0,4,2.5,2380,7850,2.0,0.0,0.0,3,8,2380,0,1995,0,98055,47.4356,-122.20100000000001,1940,7334,12,5,2014,UNK,440,516
534000075,5/6/2014,329350.0,2,1.0,720,6687,1.0,0.0,0.0,3,6,720,0,1942,0,98117,47.7001,-122.36200000000001,840,6687,5,6,2014,UNK,-120,0
3892500070,7/28/2014,1480000.0,3,3.5,4070,26000,2.0,0.0,0.0,3,11,4070,0,1991,0,98033,47.659,-122.17399999999999,3770,26000,7,28,2014,UNK,300,0
224069084,3/25/2015,475000.0,3,1.0,1250,150117,1.0,0.0,0.0,3,7,1250,0,1975,0,98075,47.5956,-122.009,3060,50055,3,25,2015,UNK,-1810,100062
2767600400,11/18/2014,719950.0,3,2.25,2190,2416,3.0,0.0,0.0,3,8,2190,0,2014,0,98117,47.6758,-122.38,1510,3615,11,18,2014,N,680,-1199
5347200160,5/12/2014,235000.0,1,1.0,810,2451,1.0,0.0,0.0,5,7,810,0,1941,0,98126,47.5188,-122.376,980,1198,5,12,2014,UNK,-170,1253
9553200125,3/31/2015,875000.0,3,1.5,2440,5750,1.0,0.0,0.0,3,8,1320,1120,1939,0,98115,47.6991,-122.296,2160,6820,3,31,2015,UNK,280,-1070
5379804888,4/21/2015,380000.0,4,1.75,1740,9150,1.0,0.0,0.0,3,7,1740,0,1974,0,98188,47.4498,-122.28,1540,9147,4,21,2015,UNK,200,3
421079105,3/9/2015,325000.0,3,2.25,1480,97138,1.5,0.0,0.0,3,7,1480,0,1984,0,98010,47.3317,-121.927,1730,176418,3,9,2015,UNK,-250,-79280
4215250030,8/19/2014,475000.0,4,2.5,2120,57050,2.0,0.0,0.0,3,9,2120,0,1989,0,98072,47.7611,-122.12799999999999,3320,39082,8,19,2014,UNK,-1200,17968
2420069017,3/24/2015,152900.0,1,1.0,900,4368,1.0,0.0,0.0,5,6,900,0,1915,1950,98022,47.2107,-121.99,1290,5000,3,24,2015,Y,-390,-632
2414600400,8/5/2014,210000.0,2,2.0,1190,7570,1.0,0.0,0.0,3,6,1190,0,1939,0,98146,47.5113,-122.338,1190,7635,8,5,2014,UNK,0,-65
2461900510,9/26/2014,350000.0,4,1.0,1010,6000,1.0,0.0,0.0,3,6,750,260,1925,0,98136,47.5518,-122.383,1450,6000,9,26,2014,UNK,-440,0
7695500200,3/23/2015,505000.0,3,2.5,2100,17882,2.0,0.0,0.0,4,8,2100,0,1985,0,98059,47.4754,-122.119,2080,16686,3,23,2015,UNK,20,1196
251200200,6/27/2014,464900.0,4,2.25,2020,8424,1.0,0.0,0.0,4,7,1380,640,1979,0,98034,47.7262,-122.23299999999999,2030,7236,6,27,2014,UNK,-10,1188
513000550,9/22/2014,650000.0,3,2.0,2520,5980,1.0,0.0,0.0,3,8,1790,730,1957,0,98116,47.5767,-122.383,1590,5750,9,22,2014,UNK,930,230
8730000260,5/4/2015,369950.0,2,2.75,1370,1140,2.0,0.0,0.0,3,8,1080,290,2009,0,98133,47.7053,-122.34200000000001,1370,1090,5,4,2015,N,0,50
3395040550,7/28/2014,250000.0,3,2.5,1530,2890,2.0,0.0,0.0,3,7,1530,0,2001,0,98108,47.5434,-122.29299999999999,1540,2890,7,28,2014,UNK,-10,0
3395040550,4/29/2015,320000.0,3,2.5,1530,2890,2.0,0.0,0.0,3,7,1530,0,2001,0,98108,47.5434,-122.29299999999999,1540,2890,4,29,2015,UNK,-10,0
9471200200,3/25/2015,2530000.0,4,4.25,5040,16048,1.0,0.0,3.0,3,10,3420,1620,1950,0,98105,47.6702,-122.26,3960,14000,3,25,2015,UNK,1080,2048
5469700260,9/3/2014,340000.0,4,2.25,2530,24700,2.0,0.0,0.0,3,7,2530,0,1974,0,98031,47.3939,-122.177,2650,24700,9,3,2014,UNK,-120,0
2767600171,5/19/2014,440000.0,2,1.5,1010,1968,1.5,0.0,0.0,5,5,1010,0,1906,0,98107,47.6757,-122.385,1760,4200,5,19,2014,UNK,-750,-2232
898000200,4/2/2015,219950.0,3,1.0,1200,7727,1.0,0.0,0.0,4,7,1200,0,1959,0,98022,47.2021,-121.999,1300,7718,4,2,2015,UNK,-100,9
5315100806,9/15/2014,940000.0,4,3.0,2720,11740,1.0,0.0,0.0,5,9,2720,0,1957,0,98040,47.5833,-122.242,2640,11740,9,15,2014,UNK,80,0
9269200786,7/22/2014,399950.0,4,1.5,1850,6125,1.5,0.0,0.0,3,6,1110,740,1945,0,98126,47.5352,-122.37,990,6125,7,22,2014,UNK,860,0
1118001370,1/2/2015,1570000.0,3,2.75,2340,8828,1.0,0.0,0.0,4,9,2340,0,1954,0,98112,47.632,-122.289,3480,8526,1,2,2015,UNK,-1140,302
3558910640,4/1/2015,528000.0,4,1.75,1860,9750,1.0,0.0,0.0,3,7,1460,400,1969,0,98034,47.7097,-122.20200000000001,1900,8913,4,1,2015,UNK,-40,837
3761100341,8/28/2014,545000.0,4,1.75,1940,8990,1.0,0.0,0.0,4,8,1560,380,1956,0,98034,47.7021,-122.241,2310,11745,8,28,2014,UNK,-370,-2755
8682261070,4/27/2015,575000.0,2,2.0,1680,6194,1.0,0.0,0.0,3,8,1680,0,2004,0,98053,47.7136,-122.03,1900,5850,4,27,2015,N,-220,344
8732040810,11/4/2014,235000.0,4,2.75,1770,10184,1.0,0.0,0.0,3,8,1250,520,1979,0,98023,47.3074,-122.385,2070,8320,11,4,2014,UNK,-300,1864
2991000400,7/23/2014,272000.0,3,2.5,1790,6371,2.0,0.0,0.0,3,8,1790,0,1998,0,98092,47.3291,-122.16799999999999,1850,6371,7,23,2014,UNK,-60,0
2155500030,4/28/2015,380000.0,4,1.75,1720,9600,1.0,0.0,0.0,4,8,1720,0,1969,0,98059,47.4764,-122.155,1660,10720,4,28,2015,UNK,60,-1120
5727500102,4/26/2015,195000.0,3,1.0,1280,6967,1.5,0.0,0.0,3,7,1280,0,1949,0,98155,47.7512,-122.329,1280,7245,4,26,2015,UNK,0,-278
5104510370,10/14/2014,297000.0,3,2.5,1690,4988,2.0,0.0,0.0,3,7,1690,0,2002,0,98038,47.3561,-122.015,1830,4733,10,14,2014,UNK,-140,255
1895450200,4/15/2015,349000.0,4,2.5,2190,7294,2.0,0.0,0.0,3,8,2190,0,2003,0,98023,47.2923,-122.35700000000001,2240,7379,4,15,2015,UNK,-50,-85
8122101146,9/29/2014,320000.0,2,1.0,710,5200,1.0,0.0,2.0,4,6,710,0,1942,0,98126,47.5376,-122.37100000000001,1610,5200,9,29,2014,UNK,-900,0
7789900030,7/25/2014,319990.0,4,1.5,1890,10707,1.0,0.0,0.0,3,7,1890,0,1962,0,98148,47.428000000000004,-122.32600000000001,1610,8827,7,25,2014,UNK,280,1880
6893300350,6/2/2014,439900.0,2,2.0,1410,12282,1.5,0.0,0.0,5,8,1410,0,1909,0,98024,47.5242,-121.926,1410,8931,6,2,2014,UNK,0,3351
4073800140,8/11/2014,429000.0,3,3.25,2210,3600,2.0,0.0,0.0,3,8,1820,390,1995,0,98125,47.7031,-122.279,2010,6690,8,11,2014,UNK,200,-3090
538000030,7/30/2014,272500.0,3,2.0,1540,6250,1.0,0.0,0.0,3,7,1540,0,1998,0,98038,47.3539,-122.025,2070,6250,7,30,2014,UNK,-530,0
6632300478,9/16/2014,400000.0,4,2.0,1350,7255,1.0,0.0,0.0,4,7,1350,0,1959,0,98125,47.7287,-122.31,1050,7288,9,16,2014,UNK,300,-33
4083800340,4/2/2015,462000.0,5,2.0,1380,4300,1.5,0.0,0.0,3,7,1380,0,1916,0,98103,47.6647,-122.337,1830,3800,4,2,2015,UNK,-450,500
9214400135,3/10/2015,510000.0,2,1.0,890,6095,1.0,0.0,0.0,3,7,890,0,1947,0,98115,47.6823,-122.29799999999999,1450,5985,3,10,2015,UNK,-560,110
8944600200,6/23/2014,550000.0,3,2.5,1900,3255,2.0,0.0,0.0,3,8,1900,0,1988,2000,98007,47.6075,-122.147,1880,3350,6,23,2014,Y,20,-95
8651430370,4/25/2015,150000.0,3,1.0,1240,5200,1.0,0.0,0.0,3,6,1240,0,1969,0,98042,47.3701,-122.079,870,5200,4,25,2015,UNK,370,0
2296700260,6/26/2014,460000.0,3,2.5,1730,8490,1.0,0.0,0.0,3,7,1210,520,1969,0,98034,47.7187,-122.219,1870,7400,6,26,2014,UNK,-140,1090
3066400140,6/20/2014,632500.0,4,2.5,2090,10306,2.0,0.0,0.0,3,10,2090,0,1986,0,98074,47.6304,-122.051,2660,11481,6,20,2014,UNK,-570,-1175
1771100240,9/25/2014,361000.0,3,1.75,1650,11220,1.0,0.0,0.0,4,7,1650,0,1969,0,98077,47.7567,-122.071,1340,10129,9,25,2014,UNK,310,1091
461003251,8/1/2014,437000.0,3,2.25,1130,1221,2.0,0.0,0.0,3,8,1030,100,2004,0,98117,47.6799,-122.375,1300,5000,8,1,2014,N,-170,-3779
8699100240,5/5/2015,370000.0,6,2.75,3240,5750,1.0,0.0,0.0,4,6,2160,1080,1950,0,98002,47.3054,-122.221,1230,5750,5,5,2015,UNK,2010,0
8691350200,4/17/2015,884250.0,4,2.5,3840,12151,2.0,0.0,0.0,3,10,3840,0,1998,0,98075,47.5953,-121.986,3560,11044,4,17,2015,UNK,280,1107
2525300550,6/3/2014,225000.0,3,1.0,1200,9936,1.0,0.0,0.0,4,6,1200,0,1969,0,98038,47.3609,-122.029,1200,10189,6,3,2014,UNK,0,-253
7452500045,8/5/2014,235000.0,2,1.0,870,5000,1.0,0.0,0.0,3,6,870,0,1949,0,98126,47.5186,-122.375,820,5000,8,5,2014,UNK,50,0
2489200070,7/20/2014,767500.0,6,3.5,2410,6000,2.0,0.0,4.0,3,9,2220,190,1916,1990,98136,47.54,-122.382,1980,6000,7,20,2014,Y,430,0
3623500260,5/12/2014,1200000.0,3,1.75,1560,8078,1.5,1.0,4.0,4,6,1560,0,1928,0,98040,47.5779,-122.24600000000001,2890,16710,5,12,2014,UNK,-1330,-8632
425069104,12/15/2014,715000.0,3,2.5,2410,46609,2.0,0.0,0.0,3,9,2410,0,1989,0,98053,47.6789,-122.04799999999999,3370,40072,12,15,2014,UNK,-960,6537
2239800070,6/27/2014,417000.0,4,2.25,2300,7700,1.0,0.0,0.0,3,7,1380,920,1959,0,98125,47.7137,-122.322,2010,8820,6,27,2014,UNK,290,-1120
2618300350,7/18/2014,199000.0,3,1.0,1390,12145,1.0,0.0,0.0,4,7,1390,0,1964,0,98042,47.4225,-122.15,1030,10800,7,18,2014,UNK,360,1345
1336800160,6/5/2014,875000.0,5,2.5,2920,5568,2.0,0.0,0.0,3,8,2320,600,1906,0,98112,47.6265,-122.31200000000001,2970,5568,6,5,2014,UNK,-50,0
7519000570,11/10/2014,545000.0,4,1.5,1370,3708,1.5,0.0,0.0,3,7,1370,0,1926,0,98117,47.6849,-122.363,2030,3708,11,10,2014,UNK,-660,0
257000105,5/20/2014,192500.0,2,1.0,950,7692,1.0,0.0,0.0,3,6,950,0,1926,0,98168,47.4909,-122.29799999999999,1820,8221,5,20,2014,UNK,-870,-529
4401200350,2/10/2015,822500.0,3,2.5,3090,7708,2.0,0.0,0.0,3,10,3090,0,1999,0,98052,47.6868,-122.10799999999999,3140,8592,2,10,2015,UNK,-50,-884
6402300070,12/8/2014,800000.0,4,2.5,2390,10000,1.0,0.0,0.0,3,9,1590,800,1975,0,98040,47.5801,-122.229,1900,9752,12,8,2014,UNK,490,248
5317100570,12/15/2014,1250000.0,3,2.5,2070,4944,2.0,0.0,0.0,3,9,2070,0,1930,0,98112,47.6256,-122.28399999999999,3300,6179,12,15,2014,UNK,-1230,-1235
8106100105,11/14/2014,3850000.0,4,4.25,5770,21300,2.0,1.0,4.0,4,11,5770,0,1980,0,98040,47.585,-122.22200000000001,4620,22748,11,14,2014,UNK,1150,-1448
9407150240,10/1/2014,295000.0,3,2.5,1460,7936,2.0,0.0,0.0,3,7,1460,0,1995,0,98038,47.3673,-122.01700000000001,1830,7936,10,1,2014,UNK,-370,0
8682291940,6/30/2014,419000.0,2,1.75,1510,4980,1.0,0.0,0.0,3,8,1510,0,2006,0,98053,47.7191,-122.023,1350,4157,6,30,2014,N,160,823
4139420070,9/10/2014,1200000.0,5,3.25,5180,19606,1.0,0.0,0.0,3,11,2610,2570,1993,0,98006,47.555,-122.11399999999999,4050,15296,9,10,2014,UNK,1130,4310
629400340,12/22/2014,750000.0,4,2.75,3430,13907,2.0,0.0,0.0,3,11,3430,0,1995,0,98075,47.5879,-121.993,3250,13851,12,22,2014,UNK,180,56
3380900160,4/28/2015,502000.0,4,1.5,1700,8400,1.0,0.0,0.0,3,7,1700,0,1953,0,98177,47.7677,-122.359,1750,8475,4,28,2015,UNK,-50,-75
2175100270,6/4/2014,1030000.0,3,1.75,2640,8000,1.0,0.0,3.0,4,9,1320,1320,1960,0,98040,47.5826,-122.24600000000001,2740,6000,6,4,2014,UNK,-100,2000
3448000270,3/13/2015,398500.0,3,1.0,1200,15960,1.5,0.0,0.0,3,6,1200,0,1945,0,98125,47.7163,-122.29899999999999,1120,7800,3,13,2015,UNK,80,8160
8701600510,4/14/2015,700000.0,2,1.5,1850,4945,1.5,0.0,2.0,4,7,1850,0,1907,1969,98126,47.5742,-122.37899999999999,1850,4950,4,14,2015,Y,0,-5
6083000083,6/11/2014,248000.0,5,1.5,1510,9078,1.0,0.0,0.0,4,7,1510,0,1959,0,98168,47.4852,-122.305,1480,9078,6,11,2014,UNK,30,0
9178600135,8/26/2014,800000.0,4,2.0,2130,2800,1.0,0.0,0.0,5,7,1070,1060,1922,0,98103,47.6545,-122.333,1990,3990,8,26,2014,UNK,140,-1190
1721059286,1/21/2015,383000.0,4,2.5,2640,8055,2.0,0.0,0.0,3,9,2640,0,2004,0,98092,47.315,-122.193,1650,8055,1,21,2015,N,990,0
8161600135,5/27/2014,688000.0,4,3.0,3000,4000,1.5,0.0,3.0,3,8,1970,1030,1913,2014,98144,47.5744,-122.307,1900,4000,5,27,2014,Y,1100,0
2568300132,10/8/2014,521000.0,3,2.0,1870,5455,1.0,0.0,0.0,5,7,1060,810,1926,0,98125,47.7029,-122.29700000000001,1870,7435,10,8,2014,UNK,0,-1980
6414100111,11/5/2014,365000.0,2,1.0,990,9223,1.0,0.0,0.0,3,7,990,0,1949,0,98125,47.72,-122.32,1230,7244,11,5,2014,UNK,-240,1979
9818700320,10/7/2014,491000.0,3,2.0,2005,7000,1.0,0.0,0.0,3,7,1605,400,1980,0,98122,47.6039,-122.29799999999999,1750,4500,10,7,2014,UNK,255,2500
686200510,11/22/2014,643000.0,3,2.75,2030,7700,1.0,0.0,0.0,5,8,1400,630,1965,0,98008,47.62600000000001,-122.11200000000001,1780,8160,11,22,2014,UNK,250,-460
3279000370,2/2/2015,279000.0,3,2.5,1500,7350,1.0,0.0,0.0,2,7,1060,440,1979,0,98023,47.3025,-122.382,1390,7770,2,2,2015,UNK,110,-420
2767601031,2/2/2015,583500.0,4,1.0,1530,3900,1.5,0.0,0.0,4,7,1530,0,1908,0,98107,47.6748,-122.37899999999999,1300,3900,2,2,2015,UNK,230,0
4142450510,7/23/2014,310000.0,3,2.5,1990,3600,2.0,0.0,0.0,3,7,1990,0,2004,0,98038,47.3841,-122.041,1790,3600,7,23,2014,N,200,0
3291800510,6/10/2014,310000.0,3,1.75,1420,7650,1.0,0.0,0.0,4,7,1100,320,1984,0,98056,47.4892,-122.182,1810,7650,6,10,2014,UNK,-390,0
7893203450,3/23/2015,280000.0,3,1.0,1400,13975,1.0,0.0,0.0,4,6,1400,0,1956,0,98198,47.4195,-122.33,1260,7500,3,23,2015,UNK,140,6475
908000260,11/17/2014,272000.0,4,2.5,1870,5692,2.0,0.0,0.0,3,7,1870,0,2004,0,98058,47.4334,-122.148,2390,5293,11,17,2014,N,-520,399
3225069239,7/7/2014,870000.0,4,3.0,3040,36246,1.5,0.0,0.0,3,9,2680,360,1923,2014,98074,47.6093,-122.07,3520,13178,7,7,2014,Y,-480,23068
8645540320,11/18/2014,307000.0,3,2.0,1790,7259,1.0,0.0,0.0,3,7,1390,400,1980,0,98058,47.4643,-122.171,1790,7700,11,18,2014,UNK,0,-441
9280200030,7/17/2014,490000.0,2,1.5,1590,4500,1.0,0.0,0.0,4,7,920,670,1946,0,98116,47.5831,-122.39200000000001,1900,4450,7,17,2014,UNK,-310,50
6159400030,10/8/2014,399950.0,3,2.0,2050,9396,1.0,0.0,0.0,5,7,1170,880,1960,0,98155,47.7447,-122.32799999999999,1680,9391,10,8,2014,UNK,370,5
7787400030,6/9/2014,1640000.0,5,3.5,4220,26784,1.0,0.0,0.0,3,10,2110,2110,1958,2006,98004,47.6003,-122.206,3450,33945,6,9,2014,Y,770,-7161
1888120140,7/9/2014,989000.0,5,4.5,4030,13474,2.0,0.0,0.0,3,11,4030,0,2000,0,98075,47.5812,-121.995,3860,12438,7,9,2014,UNK,170,1036
2916620240,6/18/2014,264950.0,4,1.75,1770,9011,1.0,0.0,0.0,5,7,1050,720,1983,0,98042,47.3646,-122.07600000000001,1410,8530,6,18,2014,UNK,360,481
251200240,7/25/2014,491500.0,4,2.75,2100,7236,1.0,0.0,0.0,3,8,1400,700,1979,0,98034,47.7267,-122.23200000000001,1900,7519,7,25,2014,UNK,200,-283
7695500240,5/14/2014,345000.0,3,2.25,2120,15003,2.0,0.0,0.0,3,7,2120,0,1984,0,98059,47.4745,-122.12,2070,15203,5,14,2014,UNK,50,-200
7749500070,1/19/2015,339900.0,4,1.75,2600,18042,1.0,0.0,0.0,4,8,2020,580,1969,0,98092,47.2969,-122.189,2200,9408,1,19,2015,UNK,400,8634
6762700340,4/27/2015,852000.0,3,3.0,2400,4000,2.0,0.0,0.0,3,7,1860,540,1905,0,98102,47.6288,-122.321,1750,3940,4,27,2015,UNK,650,60
824069121,12/22/2014,585000.0,5,3.5,3180,40946,1.0,0.0,3.0,3,7,1690,1490,1968,0,98075,47.5833,-122.073,2430,29620,12,22,2014,UNK,750,11326
2600100370,2/11/2015,723000.0,4,2.0,2790,8793,1.0,0.0,0.0,4,8,1640,1150,1977,0,98006,47.5509,-122.16,2400,9286,2,11,2015,UNK,390,-493
2326059082,1/26/2015,594000.0,3,2.25,2080,70567,2.0,0.0,0.0,3,8,2080,0,1990,0,98072,47.7221,-122.124,3730,43560,1,26,2015,UNK,-1650,27007
2591010240,12/1/2014,405000.0,2,1.5,1370,4102,2.0,0.0,0.0,4,7,1370,0,1987,0,98033,47.6943,-122.184,1380,3211,12,1,2014,UNK,-10,891
1085610030,8/1/2014,725500.0,4,2.5,2790,74495,2.0,0.0,0.0,3,9,2790,0,1997,0,98053,47.6628,-122.056,2790,24643,8,1,2014,UNK,0,49852
9551202025,6/25/2014,800000.0,2,1.0,1740,5719,1.0,0.0,0.0,3,8,1740,0,1955,0,98103,47.6729,-122.335,1980,5000,6,25,2014,UNK,-240,719
4379600030,7/29/2014,1330000.0,3,3.75,6400,76665,1.0,0.0,2.0,4,10,3810,0,1966,0,98177,47.7313,-122.37,3430,60548,7,29,2014,UNK,2970,16117
4345000510,10/15/2014,180500.0,3,2.5,1800,8518,2.0,0.0,0.0,3,7,1800,0,1996,0,98030,47.3643,-122.185,1770,7570,10,15,2014,UNK,30,948
4345000510,4/28/2015,325000.0,3,2.5,1800,8518,2.0,0.0,0.0,3,7,1800,0,1996,0,98030,47.3643,-122.185,1770,7570,4,28,2015,UNK,30,948
3327000140,6/17/2014,235000.0,3,1.75,1190,7280,1.0,0.0,0.0,4,7,1190,0,1968,0,98092,47.3151,-122.19,1250,7800,6,17,2014,UNK,-60,-520
7100000135,5/20/2014,330000.0,2,1.0,860,8308,1.0,0.0,0.0,4,7,860,0,1948,0,98146,47.5075,-122.37700000000001,1310,8308,5,20,2014,UNK,-450,0
2483200060,6/12/2014,678500.0,3,2.0,2460,6600,1.0,0.0,2.0,4,8,1370,1090,1952,0,98136,47.5215,-122.383,2150,6600,6,12,2014,UNK,310,0
2592400550,7/9/2014,463000.0,4,2.5,1980,6660,2.0,0.0,0.0,4,7,1980,0,1974,0,98034,47.7158,-122.167,1980,7150,7,9,2014,UNK,0,-490
2113701200,9/12/2014,250000.0,2,1.0,670,4640,1.0,0.0,0.0,3,6,670,0,1943,0,98106,47.53,-122.351,870,4501,9,12,2014,UNK,-200,139
5249804510,7/16/2014,655000.0,3,2.0,1410,4800,1.5,0.0,0.0,4,8,1410,0,1927,0,98118,47.5597,-122.26700000000001,1820,7200,7,16,2014,UNK,-410,-2400
9264901040,5/16/2014,239900.0,4,2.25,1860,7000,1.0,0.0,0.0,3,8,1120,740,1979,0,98023,47.3127,-122.339,1990,8937,5,16,2014,UNK,-130,-1937
7967600069,11/17/2014,185000.0,3,1.0,980,9135,1.0,0.0,0.0,3,7,980,0,1955,0,98001,47.3496,-122.289,1780,9135,11,17,2014,UNK,-800,0
4219400520,6/16/2014,1740000.0,4,2.25,3040,5000,2.0,0.0,3.0,4,9,2080,960,1926,0,98105,47.6565,-122.27799999999999,2870,5000,6,16,2014,UNK,170,0
3810000202,9/5/2014,251700.0,3,2.25,1810,11800,1.0,0.0,0.0,3,7,1240,570,1977,0,98178,47.4997,-122.23100000000001,1810,5641,9,5,2014,UNK,0,6159
1226039129,2/9/2015,400000.0,4,2.0,1560,8250,1.0,0.0,0.0,3,8,1320,240,1964,0,98177,47.7565,-122.35799999999999,1870,8258,2,9,2015,UNK,-310,-8
8146100370,9/4/2014,735000.0,4,1.75,2100,7960,1.0,0.0,0.0,3,8,1340,760,1955,0,98004,47.6079,-122.195,2060,7960,9,4,2014,UNK,40,0
1224059053,10/27/2014,1700000.0,5,2.0,2500,15250,2.0,1.0,4.0,5,8,2500,0,1942,0,98008,47.5883,-122.111,1880,18782,10,27,2014,UNK,620,-3532
1623049041,5/8/2014,82500.0,2,1.0,520,22334,1.0,0.0,0.0,2,5,520,0,1951,0,98168,47.4799,-122.296,1572,10570,5,8,2014,UNK,-1052,11764
98020140,7/8/2014,765000.0,4,4.0,3010,7221,2.0,0.0,0.0,3,10,3010,0,2004,0,98075,47.5833,-121.97,3490,7518,7,8,2014,N,-480,-297
9510900070,9/23/2014,292500.0,4,1.75,2140,8162,1.0,0.0,0.0,3,7,1420,720,1968,0,98023,47.3096,-122.37700000000001,2040,7632,9,23,2014,UNK,100,530
2473381090,3/25/2015,270000.0,3,2.25,2390,7000,1.0,0.0,0.0,4,7,1990,400,1970,0,98058,47.4568,-122.169,1610,7000,3,25,2015,UNK,780,0
6378500105,12/24/2014,415000.0,2,1.0,1510,6807,1.0,0.0,0.0,3,7,1090,420,1939,0,98133,47.71100000000001,-122.353,1460,6807,12,24,2014,UNK,50,0
3861400030,11/24/2014,950000.0,4,1.75,2210,19025,1.0,0.0,0.0,4,7,1460,750,1952,0,98004,47.5927,-122.20299999999999,2640,14999,11,24,2014,UNK,-430,4026
705700640,9/16/2014,353000.0,3,2.75,2170,8396,2.0,0.0,0.0,3,7,2170,0,1995,0,98038,47.3812,-122.023,2170,8378,9,16,2014,UNK,0,18
2767603210,12/10/2014,670950.0,3,2.5,1790,2375,3.0,0.0,0.0,3,8,1790,0,2007,0,98107,47.6726,-122.38,1450,2400,12,10,2014,N,340,-25
3294700030,5/9/2014,280950.0,3,1.75,1390,8700,1.0,0.0,3.0,4,7,840,550,1912,0,98055,47.4725,-122.20200000000001,1390,10875,5,9,2014,UNK,0,-2175
7524950830,5/27/2014,585000.0,3,1.75,1850,7735,1.0,0.0,0.0,4,8,1850,0,1983,0,98027,47.5608,-122.08200000000001,2220,7639,5,27,2014,UNK,-370,96
2124069078,12/11/2014,525000.0,2,1.5,1480,43645,1.0,0.0,0.0,3,8,1480,0,1974,0,98027,47.5484,-122.045,1600,34326,12,11,2014,UNK,-120,9319
5728000060,8/1/2014,605000.0,3,1.75,1850,8823,1.0,0.0,0.0,4,8,1370,480,1973,0,98008,47.6379,-122.11200000000001,1880,7580,8,1,2014,UNK,-30,1243
2880100160,11/19/2014,1010000.0,4,3.5,3350,3752,2.0,0.0,0.0,3,9,2550,800,2007,0,98117,47.6782,-122.365,1050,4960,11,19,2014,N,2300,-1208
4435000520,9/26/2014,245990.0,3,1.0,1040,8410,1.0,0.0,0.0,3,7,1040,0,1942,2014,98188,47.453,-122.289,1350,8410,9,26,2014,Y,-310,0
8856900310,2/3/2015,535000.0,4,2.25,2810,12607,2.0,0.0,0.0,3,10,2810,0,1985,0,98058,47.4585,-122.13,2810,17400,2,3,2015,UNK,0,-4793
4315700390,6/30/2014,410000.0,1,1.5,1010,5750,1.0,0.0,0.0,3,7,1010,0,1911,1948,98136,47.5411,-122.39200000000001,1230,5750,6,30,2014,Y,-220,0
2095800520,4/24/2015,550000.0,3,2.5,2250,7752,2.0,0.0,0.0,4,8,2250,0,1988,0,98011,47.7489,-122.185,2080,7033,4,24,2015,UNK,170,719
4193500140,9/11/2014,665000.0,3,1.75,1800,8000,1.0,0.0,0.0,3,8,1800,0,1972,0,98008,47.6357,-122.119,1950,8500,9,11,2014,UNK,-150,-500
3582200200,4/27/2015,455000.0,3,1.0,2400,17239,1.0,0.0,0.0,4,7,1890,510,1940,0,98028,47.75,-122.245,2390,7350,4,27,2015,UNK,10,9889
9521100106,8/26/2014,440000.0,4,1.0,1780,4000,1.5,0.0,0.0,3,7,1780,0,1922,0,98103,47.6624,-122.354,1750,4000,8,26,2014,UNK,30,0
7351000160,7/8/2014,332000.0,3,2.25,2120,14915,1.0,0.0,0.0,3,9,1720,400,1979,0,98001,47.3524,-122.285,2320,13100,7,8,2014,UNK,-200,1815
5422420140,6/11/2014,280000.0,3,2.5,1860,6607,2.0,0.0,0.0,3,7,1860,0,1989,0,98023,47.2891,-122.351,1760,6766,6,11,2014,UNK,100,-159
7234601162,9/15/2014,570000.0,3,3.5,1460,1021,2.0,0.0,0.0,3,8,1150,310,2006,0,98122,47.6169,-122.309,1460,1245,9,15,2014,N,0,-224
6623400217,5/15/2014,250000.0,3,1.0,1230,10350,1.0,0.0,0.0,4,7,1230,0,1957,0,98055,47.428000000000004,-122.199,1510,10427,5,15,2014,UNK,-280,-77
3354400060,5/1/2015,238000.0,2,1.0,1088,8453,1.0,0.0,0.0,3,6,1088,0,1952,2009,98001,47.2685,-122.23100000000001,1088,8016,5,1,2015,Y,0,437
408100105,11/3/2014,265000.0,3,1.0,800,5760,1.0,0.0,0.0,3,6,700,0,1949,0,98155,47.7505,-122.31700000000001,1060,6628,11,3,2014,UNK,-260,-868
7297700055,3/5/2015,306000.0,3,1.0,1190,10350,1.0,0.0,0.0,4,7,1190,0,1959,0,98028,47.7428,-122.244,1850,10500,3,5,2015,UNK,-660,-150
8029740060,5/7/2015,345000.0,5,2.75,1940,4182,1.0,0.0,0.0,3,7,1240,700,2002,0,98056,47.4911,-122.17,1950,4182,5,7,2015,UNK,-10,0
1355200060,9/4/2014,765000.0,4,2.5,3300,10764,1.0,0.0,0.0,4,9,1720,1580,1971,0,98177,47.7119,-122.365,2290,10975,9,4,2014,UNK,1010,-211
4136890560,4/30/2015,346300.0,4,2.5,2590,11018,2.0,0.0,0.0,3,8,2590,0,1998,0,98092,47.2634,-122.211,2400,8042,4,30,2015,UNK,190,2976
1320069271,6/12/2014,342500.0,3,2.0,2080,11375,1.0,0.0,0.0,3,8,2080,0,2002,0,98022,47.214,-121.993,1080,12899,6,12,2014,UNK,1000,-1524
9269260240,4/24/2015,501000.0,4,2.25,2680,5439,2.0,0.0,0.0,3,7,2680,0,2000,0,98011,47.7534,-122.21799999999999,2460,4473,4,24,2015,UNK,220,966
1796381070,6/25/2014,270000.0,3,2.5,1670,8364,1.0,0.0,0.0,4,7,1300,370,1990,0,98042,47.369,-122.084,1490,8143,6,25,2014,UNK,180,221
6840701125,4/22/2015,638000.0,3,1.0,1830,4400,1.5,0.0,0.0,4,8,1720,110,1930,0,98122,47.6052,-122.3,1650,4400,4,22,2015,UNK,180,0
7443000640,9/12/2014,460000.0,3,1.75,1400,2003,1.0,0.0,0.0,4,8,700,700,1908,2006,98119,47.6508,-122.368,1370,1281,9,12,2014,Y,30,722
6344000060,10/15/2014,760000.0,4,1.75,2770,8521,1.0,0.0,0.0,4,7,1470,1300,1953,0,98004,47.6255,-122.199,1910,9380,10,15,2014,UNK,860,-859
3317500030,3/16/2015,1090000.0,3,2.5,3630,11019,1.0,0.0,0.0,4,9,2150,1480,1972,0,98040,47.56100000000001,-122.226,3150,13555,3,16,2015,UNK,480,-2536
2130702270,6/28/2014,234000.0,3,1.0,1040,8128,1.0,0.0,0.0,3,6,1040,0,1983,0,98019,47.7425,-121.98100000000001,1520,7500,6,28,2014,UNK,-480,628
3343301920,3/2/2015,1650000.0,3,2.75,2690,8890,2.0,1.0,4.0,4,10,2690,0,1975,0,98006,47.5487,-122.197,2940,8890,3,2,2015,UNK,-250,0
2688100075,5/6/2014,488000.0,5,2.0,2020,5000,1.5,0.0,0.0,4,7,2020,0,1938,0,98117,47.6949,-122.37,1510,6600,5,6,2014,UNK,510,-1600
6448600060,2/26/2015,1550000.0,5,2.5,2450,20805,2.0,0.0,0.0,4,9,2450,0,1963,0,98004,47.6275,-122.227,3020,20324,2,26,2015,UNK,-570,481
6619510060,3/27/2015,499000.0,4,3.0,2030,12675,2.0,0.0,0.0,3,7,2030,0,1982,0,98177,47.7689,-122.37899999999999,1990,7705,3,27,2015,UNK,40,4970
4058802105,9/4/2014,150000.0,3,1.0,1450,6776,1.0,0.0,0.0,3,7,1450,0,1952,0,98178,47.5056,-122.244,1680,7200,9,4,2014,UNK,-230,-424
7212660640,3/26/2015,333000.0,4,2.5,2400,7270,2.0,0.0,0.0,3,8,2400,0,1993,0,98003,47.2697,-122.31200000000001,2150,6584,3,26,2015,UNK,250,686
8026700105,2/18/2015,700000.0,4,2.75,2870,8625,1.0,0.0,1.0,4,8,1860,1010,1959,0,98155,47.7425,-122.289,2430,8479,2,18,2015,UNK,440,146
8018600640,9/18/2014,275000.0,4,1.0,1340,22500,1.5,0.0,0.0,3,7,1340,0,1926,0,98168,47.489,-122.316,1620,10800,9,18,2014,UNK,-280,11700
623049315,7/1/2014,330000.0,3,2.5,1680,11312,1.0,0.0,0.0,3,7,1080,600,1959,0,98146,47.5051,-122.344,1390,10700,7,1,2014,UNK,290,612
6632900340,11/24/2014,360000.0,4,2.0,1850,8827,1.0,0.0,0.0,3,7,1850,0,1969,0,98155,47.7406,-122.31299999999999,1310,6901,11,24,2014,UNK,540,1926
6798100070,5/11/2015,467000.0,3,1.0,1220,8040,1.5,0.0,0.0,3,7,1220,0,1965,0,98125,47.7133,-122.30799999999999,1360,8040,5,11,2015,UNK,-140,0
8644400060,10/29/2014,568000.0,3,2.5,2320,57063,1.0,0.0,0.0,4,9,1790,530,1979,0,98074,47.6163,-122.056,3290,7314,10,29,2014,UNK,-970,49749
4388600030,11/3/2014,605000.0,5,2.25,3220,9603,2.0,0.0,0.0,3,8,3220,0,1972,0,98052,47.6474,-122.11,2260,10093,11,3,2014,UNK,960,-490
629420260,10/2/2014,750000.0,4,2.75,3190,9023,2.0,0.0,0.0,3,9,3190,0,2005,0,98075,47.5898,-121.98899999999999,3159,5615,10,2,2014,N,31,3408
1117200550,10/14/2014,760000.0,3,2.75,3530,69834,2.0,0.0,0.0,3,10,3530,0,1994,0,98053,47.6377,-121.995,3560,74256,10,14,2014,UNK,-30,-4422
7461420060,8/4/2014,265000.0,3,1.75,2050,10519,1.0,0.0,0.0,3,7,1240,810,1979,0,98058,47.4257,-122.146,1770,9605,8,4,2014,UNK,280,914
5566100060,7/18/2014,490000.0,3,1.75,1720,12540,1.0,0.0,0.0,4,7,1720,0,1956,0,98006,47.5699,-122.177,1440,11850,7,18,2014,UNK,280,690
7714000340,6/19/2014,360000.0,4,2.5,2850,4650,2.0,0.0,0.0,3,8,2850,0,2004,0,98038,47.3552,-122.02600000000001,2850,4650,6,19,2014,N,0,0
5149300400,2/6/2015,311750.0,4,2.25,2270,12000,1.0,0.0,0.0,4,7,1290,980,1976,0,98023,47.3287,-122.353,2030,23980,2,6,2015,UNK,240,-11980
3815500045,10/3/2014,399000.0,3,2.25,1880,12473,1.0,0.0,0.0,3,8,1420,460,1958,0,98028,47.7623,-122.256,2300,10469,10,3,2014,UNK,-420,2004
1843100520,7/25/2014,347000.0,4,2.5,2770,9751,2.0,0.0,0.0,3,8,2770,0,1989,0,98042,47.3739,-122.126,2370,6950,7,25,2014,UNK,400,2801
1329000030,9/4/2014,1680000.0,4,3.75,4490,34982,2.0,0.0,0.0,3,12,4490,0,1998,0,98005,47.6406,-122.156,4470,37525,9,4,2014,UNK,20,-2543
7853240560,9/3/2014,585000.0,4,2.5,3110,6479,2.0,0.0,0.0,3,9,3110,0,2005,0,98065,47.5408,-121.861,3110,7075,9,3,2014,N,0,-596
8078100260,9/12/2014,340000.0,4,2.5,2360,7475,2.0,0.0,0.0,3,8,2360,0,1992,0,98031,47.4052,-122.17,2280,7570,9,12,2014,UNK,80,-95
3905120830,4/15/2015,612000.0,3,2.5,2180,5496,2.0,0.0,0.0,3,8,2180,0,1994,0,98029,47.5723,-122.007,2120,5496,4,15,2015,UNK,60,0
1442800400,6/28/2014,230000.0,2,1.75,1910,3376,2.0,0.0,0.0,3,8,1910,0,1980,0,98038,47.3733,-122.057,1470,3623,6,28,2014,UNK,440,-247
3905000200,5/9/2014,604000.0,4,2.5,2260,7753,2.0,0.0,0.0,3,9,2260,0,1989,0,98029,47.5752,-121.995,2690,8924,5,9,2014,UNK,-430,-1171
4399200075,7/3/2014,250000.0,3,1.75,1770,8868,1.0,0.0,0.0,4,7,1770,0,1959,0,98002,47.3188,-122.212,1630,9706,7,3,2014,UNK,140,-838
1545802830,3/9/2015,258500.0,3,2.0,1460,7930,1.0,0.0,0.0,3,7,1460,0,1989,0,98038,47.358999999999995,-122.04899999999999,1630,7930,3,9,2015,UNK,-170,0
1370804100,3/24/2015,783000.0,4,2.75,2080,5000,1.0,0.0,0.0,5,8,1470,610,1940,0,98199,47.6422,-122.40299999999999,1970,5000,3,24,2015,UNK,110,0
269000240,10/30/2014,1050000.0,5,2.25,2960,7680,1.0,0.0,2.0,5,8,1550,1410,1958,0,98199,47.6456,-122.389,2860,7680,10,30,2014,UNK,100,0
2619920030,3/18/2015,760000.0,4,2.5,3220,4031,2.0,0.0,0.0,3,9,3220,0,2002,0,98033,47.688,-122.163,3150,5083,3,18,2015,UNK,70,-1052
3438500339,5/26/2014,276000.0,3,1.0,1140,5000,1.0,0.0,0.0,3,7,1140,0,1960,0,98106,47.5535,-122.36200000000001,1140,5000,5,26,2014,UNK,0,0
8563001070,3/23/2015,550000.0,4,2.0,1660,12377,1.0,0.0,0.0,3,8,1660,0,1966,0,98008,47.6231,-122.102,1820,8968,3,23,2015,UNK,-160,3409
4427100105,4/28/2015,398000.0,4,1.0,1430,6240,1.5,0.0,0.0,5,7,1430,0,1953,0,98125,47.7272,-122.311,1410,6240,4,28,2015,UNK,20,0
2767800140,3/13/2015,775000.0,3,3.0,1820,4300,1.5,0.0,0.0,4,8,1620,200,1914,1983,98107,47.6711,-122.36399999999999,1440,4300,3,13,2015,Y,380,0
2600140070,4/9/2015,1030000.0,4,3.0,3540,10202,2.0,0.0,0.0,3,8,2720,820,1988,0,98006,47.5471,-122.155,2780,10714,4,9,2015,UNK,760,-512
7231501610,10/23/2014,327000.0,4,1.0,1620,6000,1.5,0.0,0.0,5,7,1620,0,1905,0,98055,47.4763,-122.206,1310,6000,10,23,2014,UNK,310,0
2787250240,4/21/2015,564500.0,4,2.75,3100,14568,2.0,0.0,0.0,3,8,3100,0,1995,0,98019,47.7302,-121.97399999999999,2860,14396,4,21,2015,UNK,240,172
5309100295,10/17/2014,782000.0,4,1.75,1500,6820,1.5,0.0,0.0,5,7,1500,0,1905,0,98117,47.6794,-122.37,1360,4125,10,17,2014,UNK,140,2695
2781260370,1/28/2015,398000.0,4,2.5,2820,5510,2.0,0.0,0.0,3,9,2820,0,2005,0,98038,47.3477,-122.024,2820,5510,1,28,2015,N,0,0
1926059155,1/30/2015,257000.0,3,1.75,1850,10920,1.5,0.0,0.0,3,6,1850,0,1915,0,98034,47.7244,-122.22200000000001,1510,7871,1,30,2015,UNK,340,3049
7137900960,6/25/2014,235000.0,4,2.0,1570,9415,2.0,0.0,0.0,4,7,1570,0,1984,0,98092,47.3168,-122.17399999999999,1550,8978,6,25,2014,UNK,20,437
2817100570,6/27/2014,453000.0,4,2.75,2300,37533,1.0,0.0,3.0,5,8,1550,750,1979,0,98070,47.3714,-122.431,2130,10092,6,27,2014,UNK,170,27441
3886902445,3/16/2015,535000.0,2,1.0,920,9000,1.0,0.0,0.0,1,6,920,0,1954,0,98033,47.6831,-122.189,1760,8400,3,16,2015,UNK,-840,600
2215902010,5/7/2014,275000.0,3,2.5,1600,7000,2.0,0.0,0.0,4,8,1600,0,1993,0,98038,47.3534,-122.057,1700,7000,5,7,2014,UNK,-100,0
1778350270,9/15/2014,665000.0,3,2.5,2630,10047,2.0,0.0,0.0,3,9,2630,0,1996,0,98027,47.5515,-122.083,2640,10620,9,15,2014,UNK,-10,-573
1449000270,8/6/2014,670000.0,4,2.75,3020,13530,1.0,0.0,0.0,4,8,1540,1480,1977,0,98052,47.6299,-122.09899999999999,2230,11896,8,6,2014,UNK,790,1634
3755100520,4/27/2015,465000.0,3,1.75,1490,10757,1.0,0.0,0.0,3,7,1060,430,1966,0,98034,47.72,-122.229,1490,10609,4,27,2015,UNK,0,148
8651441620,10/23/2014,210000.0,3,1.5,1160,5200,1.0,0.0,0.0,5,7,1160,0,1970,0,98042,47.364,-122.094,1170,5200,10,23,2014,UNK,-10,0
1321970240,12/4/2014,265000.0,4,2.5,2040,4443,2.0,0.0,0.0,3,8,2040,0,2001,0,98092,47.3182,-122.189,2040,4637,12,4,2014,UNK,0,-194
6816300060,4/13/2015,426000.0,2,2.5,1550,2657,2.0,0.0,0.0,4,8,1550,0,1987,0,98033,47.7034,-122.18799999999999,1570,2442,4,13,2015,UNK,-20,215
8563000520,10/29/2014,529219.0,4,2.25,1990,7610,1.0,0.0,0.0,4,8,1290,700,1966,0,98008,47.6236,-122.103,1820,8198,10,29,2014,UNK,170,-588
3663000070,7/8/2014,600000.0,3,2.25,1900,46609,1.5,0.0,0.0,4,7,1440,460,1969,0,98072,47.7529,-122.116,2460,43560,7,8,2014,UNK,-560,3049
255400070,7/1/2014,875000.0,5,3.5,3840,8279,2.0,0.0,0.0,3,9,3840,0,2001,0,98074,47.6039,-122.059,3570,8279,7,1,2014,UNK,270,0
269000070,1/6/2015,608000.0,4,3.0,2400,7680,1.0,0.0,0.0,3,7,1200,1200,1956,0,98199,47.6466,-122.389,2670,6342,1,6,2015,UNK,-270,1338
1163400070,11/12/2014,220000.0,3,1.0,1660,21514,1.0,0.0,0.0,4,7,1660,0,1973,0,98022,47.2159,-121.964,1660,21600,11,12,2014,UNK,0,-86
4139420370,8/11/2014,1760000.0,4,5.0,6055,21630,1.0,0.0,3.0,4,12,3555,2500,1996,0,98006,47.5524,-122.11200000000001,4890,19223,8,11,2014,UNK,1165,2407
2599200160,8/18/2014,295450.0,3,2.0,2030,17120,1.0,0.0,2.0,4,8,1890,140,1966,0,98092,47.2953,-122.185,1870,13662,8,18,2014,UNK,160,3458
1704900135,11/11/2014,315000.0,2,1.0,840,5087,1.0,0.0,0.0,3,7,840,0,1925,0,98118,47.5557,-122.27799999999999,1590,5087,11,11,2014,UNK,-750,0
6648701420,2/13/2015,205000.0,4,2.0,1450,8175,1.0,0.0,0.0,4,7,1450,0,1967,0,98031,47.3933,-122.195,1570,9024,2,13,2015,UNK,-120,-849
6123000070,7/9/2014,310000.0,3,1.5,1460,9908,1.0,0.0,0.0,3,7,1460,0,1952,0,98148,47.4275,-122.331,1420,9582,7,9,2014,UNK,40,326
7015200136,5/3/2015,1000000.0,5,1.0,2010,5210,1.5,0.0,0.0,3,9,1890,120,1927,0,98119,47.6501,-122.37,2330,5000,5,3,2015,UNK,-320,210
5104531820,6/2/2014,525000.0,4,2.5,2910,7631,2.0,0.0,2.0,3,9,2910,0,2006,0,98038,47.3552,-122.001,3190,5552,6,2,2014,N,-280,2079
6620400631,7/9/2014,284000.0,4,1.75,1880,8800,1.0,0.0,0.0,3,7,1130,750,1960,0,98168,47.5137,-122.333,1340,8733,7,9,2014,UNK,540,67
3582500240,5/14/2014,510000.0,3,1.75,2170,26460,1.0,0.0,0.0,3,8,1450,720,1986,0,98074,47.6147,-122.045,2090,29075,5,14,2014,UNK,80,-2615
1529300160,6/19/2014,405000.0,2,1.0,1260,4377,1.0,0.0,0.0,4,7,1260,0,1947,0,98103,47.6988,-122.354,1420,6376,6,19,2014,UNK,-160,-1999
4027700844,9/16/2014,509950.0,3,2.5,1970,9153,2.0,0.0,0.0,3,8,1970,0,2007,0,98028,47.7698,-122.26799999999999,1800,9800,9,16,2014,N,170,-647
425069139,10/27/2014,600000.0,4,2.25,2090,45738,2.0,0.0,0.0,3,8,2090,0,1987,0,98053,47.6876,-122.04899999999999,3420,45738,10,27,2014,UNK,-1330,0
3047700105,4/23/2015,990000.0,4,3.75,3450,4940,2.0,0.0,0.0,3,10,2570,880,2006,0,98103,47.692,-122.338,1880,5387,4,23,2015,N,1570,-447
2976800550,4/14/2015,280005.0,3,1.5,1130,7200,1.0,0.0,0.0,3,7,1130,0,1954,0,98178,47.5041,-122.25299999999999,1130,7200,4,14,2015,UNK,0,0
6151800070,9/3/2014,700000.0,3,1.75,2600,7668,1.0,0.0,0.0,4,8,1300,1300,1968,0,98010,47.3402,-122.046,1980,13664,9,3,2014,UNK,620,-5996
4364700105,8/4/2014,330000.0,3,1.0,1030,7620,1.0,0.0,0.0,3,7,1030,0,1953,0,98126,47.5281,-122.375,1030,7560,8,4,2014,UNK,0,60
7893804845,2/23/2015,340000.0,2,1.0,1700,6718,1.0,0.0,2.0,3,7,1230,470,1956,0,98198,47.4131,-122.331,2040,7500,2,23,2015,UNK,-340,-782
7694800070,8/18/2014,468000.0,2,2.5,1480,2167,2.0,0.0,0.0,3,8,1390,90,2007,0,98052,47.6658,-122.132,2130,2556,8,18,2014,N,-650,-389
1922000070,6/9/2014,1340000.0,4,2.5,4250,19387,2.0,0.0,2.0,4,9,3260,990,1972,0,98040,47.5578,-122.212,3690,17024,6,9,2014,UNK,560,2363
4035900060,9/19/2014,515000.0,3,1.75,1600,20873,1.0,0.0,0.0,3,8,1600,0,1955,0,98006,47.5632,-122.182,2640,18364,9,19,2014,UNK,-1040,2509
8880600070,11/12/2014,245000.0,4,2.0,1870,8750,1.0,0.0,2.0,3,7,1870,0,1977,0,98022,47.1985,-122.001,1770,8207,11,12,2014,UNK,100,543
739800070,5/27/2014,265000.0,3,2.5,1440,7741,1.0,0.0,0.0,4,7,1000,440,1983,0,98031,47.4042,-122.194,1680,7316,5,27,2014,UNK,-240,425
1561910270,3/17/2015,372400.0,3,2.5,2720,11937,2.0,0.0,0.0,3,9,2720,0,1990,0,98031,47.4185,-122.212,2590,9683,3,17,2015,UNK,130,2254
7305300370,5/4/2015,390000.0,3,1.5,1240,8410,1.0,0.0,0.0,5,6,1240,0,1948,0,98155,47.753,-122.32799999999999,1630,8410,5,4,2015,UNK,-390,0
7345000340,2/3/2015,208000.0,3,1.0,1020,6120,1.0,0.0,0.0,4,7,1020,0,1967,0,98002,47.278,-122.205,1370,8000,2,3,2015,UNK,-350,-1880
3971701455,10/3/2014,273000.0,2,0.5,1180,7750,1.0,0.0,0.0,4,6,590,590,1945,0,98155,47.769,-122.316,1380,8976,10,3,2014,UNK,-200,-1226
8035350260,10/9/2014,455000.0,5,3.5,3080,7759,2.0,0.0,0.0,3,8,2310,770,2003,0,98019,47.7454,-121.977,2980,8223,10,9,2014,UNK,100,-464
104550520,3/30/2015,270000.0,4,2.5,1750,6397,2.0,0.0,0.0,3,7,1750,0,1988,0,98023,47.3082,-122.35799999999999,1940,6502,3,30,2015,UNK,-190,-105
4037400295,7/30/2014,618000.0,4,2.25,2530,8736,1.0,0.0,0.0,4,7,1210,1320,1958,0,98008,47.6049,-122.126,1720,8500,7,30,2014,UNK,810,236
5413200140,10/21/2014,213550.0,3,2.5,1580,8541,2.0,0.0,0.0,3,7,1580,0,1990,0,98001,47.3334,-122.289,1640,7542,10,21,2014,UNK,-60,999
522049104,7/29/2014,210000.0,5,1.75,2340,9148,2.0,0.0,0.0,3,7,2340,0,1957,0,98198,47.4232,-122.324,1390,10019,7,29,2014,UNK,950,-871
3859900060,1/12/2015,2750000.0,5,4.0,6300,16065,2.0,0.0,1.0,3,12,4360,1940,2004,0,98004,47.5922,-122.20700000000001,3260,17287,1,12,2015,N,3040,-1222
6145601715,12/15/2014,403500.0,4,2.75,2400,3844,1.0,0.0,0.0,5,7,1200,1200,1974,0,98133,47.7027,-122.34700000000001,1100,3844,12,15,2014,UNK,1300,0
1645000310,2/25/2015,235000.0,3,1.5,1300,7600,1.0,0.0,0.0,4,7,1300,0,1963,0,98022,47.2083,-122.005,1570,7600,2,25,2015,UNK,-270,0
7471900045,4/21/2015,287500.0,3,2.0,1760,7147,1.0,0.0,0.0,4,6,880,880,1936,0,98055,47.4799,-122.23200000000001,1720,7147,4,21,2015,UNK,40,0
7697100030,9/29/2014,546800.0,4,1.5,1520,5910,1.0,0.0,0.0,3,7,1020,500,1946,0,98115,47.6904,-122.295,1710,5910,9,29,2014,UNK,-190,0
3313600340,6/16/2014,183000.0,3,1.75,1070,8100,1.0,0.0,0.0,4,6,1070,0,1957,0,98002,47.2853,-122.22,1260,8100,6,16,2014,UNK,-190,0
1921069082,5/12/2014,560000.0,3,2.0,2560,216777,1.0,0.0,0.0,3,8,2560,0,1986,0,98092,47.295,-122.086,2360,108463,5,12,2014,UNK,200,108314
4263200030,12/5/2014,299500.0,3,1.0,1280,6726,1.0,0.0,0.0,3,6,1280,0,1958,0,98144,47.5724,-122.301,1630,5000,12,5,2014,UNK,-350,1726
6918700370,10/27/2014,610000.0,4,2.25,1660,7350,1.0,0.0,0.0,3,8,1660,0,1965,2014,98008,47.6263,-122.124,1790,7455,10,27,2014,Y,-130,-105
8125200483,6/9/2014,288350.0,3,1.5,1860,7963,1.0,0.0,0.0,3,7,1200,660,1963,0,98188,47.4513,-122.26799999999999,1800,10400,6,9,2014,UNK,60,-2437
1930301555,7/1/2014,500000.0,2,1.0,950,4500,1.0,0.0,2.0,3,7,850,100,1926,0,98103,47.6562,-122.354,1670,4000,7,1,2014,UNK,-720,500
7974200776,12/5/2014,625000.0,4,2.75,2140,4000,1.0,0.0,0.0,3,7,1190,950,1951,0,98115,47.6792,-122.287,2140,4770,12,5,2014,UNK,0,-770
2719100013,4/29/2015,418000.0,2,1.5,1480,1349,2.0,0.0,0.0,3,7,1240,240,2007,0,98136,47.5439,-122.38600000000001,1550,1349,4,29,2015,N,-70,0
7234601544,8/25/2014,660000.0,3,3.0,2260,1825,2.0,0.0,0.0,3,8,1660,600,2002,0,98122,47.6108,-122.30799999999999,2260,1834,8,25,2014,UNK,0,-9
5652601455,6/23/2014,775000.0,4,2.5,2300,6158,2.0,0.0,0.0,3,9,2300,0,1999,0,98115,47.6943,-122.29899999999999,2170,6434,6,23,2014,UNK,130,-276
2558600060,1/23/2015,429500.0,3,2.75,1650,7272,1.0,0.0,0.0,4,7,1230,420,1972,0,98034,47.7232,-122.17399999999999,1770,7272,1,23,2015,UNK,-120,0
5017000575,11/24/2014,569000.0,3,2.0,1990,3000,1.5,0.0,0.0,3,7,1230,760,1908,1970,98112,47.6272,-122.29,1600,4080,11,24,2014,Y,390,-1080
2796100160,5/20/2014,250000.0,4,2.0,1960,7560,1.0,0.0,0.0,5,7,1160,800,1978,0,98031,47.4081,-122.178,1950,7560,5,20,2014,UNK,10,0
5470100270,12/9/2014,225000.0,3,1.5,1310,10491,1.0,0.0,0.0,4,7,1310,0,1969,0,98042,47.3682,-122.148,1430,9664,12,9,2014,UNK,-120,827
6112300140,5/14/2014,530000.0,4,2.75,2450,15002,1.0,0.0,0.0,5,9,2450,0,1974,0,98166,47.4268,-122.34299999999999,2650,15055,5,14,2014,UNK,-200,-53
4024101715,9/5/2014,306000.0,3,1.0,910,8658,1.0,0.0,0.0,3,7,910,0,1955,0,98155,47.7586,-122.303,1170,10200,9,5,2014,UNK,-260,-1542
3205100060,4/13/2015,517100.0,3,1.75,1580,9719,1.0,0.0,0.0,5,7,1580,0,1962,0,98056,47.5396,-122.18,1760,8539,4,13,2015,UNK,-180,1180
4450700030,8/22/2014,354950.0,3,1.75,1780,9689,1.0,0.0,0.0,3,7,1130,650,1976,0,98072,47.7628,-122.163,1660,9786,8,22,2014,UNK,120,-97
7920100083,4/14/2015,348000.0,3,1.5,1040,1824,1.0,0.0,0.0,3,6,1040,0,1925,0,98115,47.6793,-122.3,1010,5100,4,14,2015,UNK,30,-3276
1774350160,7/18/2014,522250.0,4,2.5,2340,41600,1.0,0.0,0.0,3,8,1640,700,1977,0,98077,47.7466,-122.07700000000001,2340,34960,7,18,2014,UNK,0,6640
2115510340,6/4/2014,275000.0,3,2.5,1720,8755,1.0,0.0,0.0,3,8,1000,720,1983,0,98023,47.3186,-122.391,1720,8690,6,4,2014,UNK,0,65
8901000445,12/18/2014,390000.0,3,1.5,1600,10440,1.0,0.0,0.0,3,7,1600,0,1954,0,98125,47.7109,-122.311,1600,8816,12,18,2014,UNK,0,1624
6121800060,9/10/2014,260000.0,3,1.5,1320,9750,1.0,0.0,0.0,3,7,1320,0,1954,0,98148,47.4267,-122.331,1530,9750,9,10,2014,UNK,-210,0
8712100320,7/28/2014,585000.0,5,2.75,2350,4178,1.5,0.0,0.0,3,8,1520,830,1922,2015,98112,47.6388,-122.3,1920,4178,7,28,2014,Y,430,0
2979800520,6/3/2014,605000.0,5,2.75,2740,5616,1.5,0.0,0.0,5,7,1670,1070,1925,0,98115,47.6866,-122.31700000000001,1600,4592,6,3,2014,UNK,1140,1024
2331540070,7/3/2014,342000.0,4,2.5,2300,6448,2.0,0.0,0.0,3,8,2300,0,2001,0,98030,47.3813,-122.204,1860,5872,7,3,2014,UNK,440,576
6345000160,8/27/2014,900000.0,5,3.0,4350,37169,2.0,0.0,0.0,3,10,2950,1400,1972,0,98005,47.6518,-122.16,3280,41631,8,27,2014,UNK,1070,-4462
5126950340,3/30/2015,252000.0,3,1.75,1430,7700,1.0,0.0,0.0,4,7,980,450,1981,0,98031,47.3993,-122.18299999999999,1430,8625,3,30,2015,UNK,0,-925
5152100160,2/19/2015,357000.0,3,1.75,2400,14012,1.0,0.0,0.0,3,9,2400,0,1971,0,98003,47.3371,-122.325,2800,13988,2,19,2015,UNK,-400,24
3298201290,12/24/2014,370000.0,3,1.0,940,7910,1.0,0.0,0.0,4,6,940,0,1959,0,98008,47.6181,-122.117,1000,7700,12,24,2014,UNK,-60,210
428000055,4/6/2015,322500.0,3,1.0,1020,13504,1.0,0.0,0.0,5,7,1020,0,1959,0,98056,47.5121,-122.17,1110,11158,4,6,2015,UNK,-90,2346
8698600055,6/20/2014,210000.0,2,2.0,1680,5756,2.0,0.0,0.0,4,7,1680,0,1910,0,98002,47.3065,-122.22200000000001,1340,5447,6,20,2014,UNK,340,309
3034200885,12/8/2014,290000.0,2,1.0,1340,9840,1.0,0.0,0.0,3,7,1340,0,1949,0,98133,47.7202,-122.339,1610,8949,12,8,2014,UNK,-270,891
2538400060,6/12/2014,860000.0,4,3.25,3960,7012,2.0,0.0,0.0,3,10,3960,0,2005,0,98075,47.5854,-122.08,3680,8522,6,12,2014,N,280,-1510
3145600045,2/25/2015,302000.0,6,2.0,2650,4621,1.5,0.0,0.0,3,8,2650,0,1911,0,98118,47.5543,-122.275,1640,4879,2,25,2015,UNK,1010,-258
7183000070,8/21/2014,369160.0,4,2.25,2120,9680,2.0,0.0,2.0,4,8,2120,0,1965,0,98003,47.3367,-122.33200000000001,2360,9647,8,21,2014,UNK,-240,33
6788200800,5/7/2015,1190000.0,4,2.75,2850,3000,2.5,0.0,0.0,3,9,2530,320,2003,0,98112,47.6406,-122.304,2083,4500,5,7,2015,UNK,767,-1500
824059083,9/2/2014,993000.0,4,2.0,2850,14810,2.0,0.0,0.0,5,8,2490,360,1954,0,98004,47.5892,-122.20299999999999,2430,10454,9,2,2014,UNK,420,4356
2724069117,11/14/2014,380000.0,6,2.0,1870,6969,1.0,0.0,0.0,4,7,1870,0,1968,0,98027,47.5342,-122.036,1500,6969,11,14,2014,UNK,370,0
9157600060,9/10/2014,635000.0,4,2.0,2660,8160,1.0,0.0,0.0,4,7,1380,1280,1949,0,98177,47.7229,-122.359,1660,8160,9,10,2014,UNK,1000,0
943100262,10/30/2014,260000.0,3,1.0,1190,11120,1.0,0.0,0.0,3,6,1190,0,1947,0,98024,47.5687,-121.898,1230,12720,10,30,2014,UNK,-40,-1600
3810000465,5/20/2014,243000.0,2,1.0,1770,5522,1.5,0.0,0.0,4,7,960,810,1943,0,98178,47.4974,-122.23100000000001,1830,7378,5,20,2014,UNK,-60,-1856
2451000070,4/2/2015,1400000.0,4,2.5,2770,8879,2.0,0.0,0.0,3,9,2770,0,2001,0,98004,47.5831,-122.193,2770,8882,4,2,2015,UNK,0,-3
7640400070,9/15/2014,665000.0,4,2.5,2080,8100,1.0,0.0,2.0,5,8,1220,860,1952,0,98177,47.7228,-122.369,2090,8100,9,15,2014,UNK,-10,0
7732410370,9/9/2014,898000.0,5,2.25,2700,9000,2.0,0.0,0.0,5,9,2700,0,1987,0,98007,47.6599,-122.146,2630,9000,9,9,2014,UNK,70,0
3253500030,7/25/2014,583000.0,4,2.75,2200,9453,1.0,0.0,0.0,5,8,1100,1100,1955,0,98144,47.5744,-122.305,1390,5355,7,25,2014,UNK,810,4098
2128000160,12/4/2014,429000.0,4,1.75,2160,7700,2.0,0.0,0.0,2,8,2160,0,1977,0,98033,47.6976,-122.169,2080,7700,12,4,2014,UNK,80,0
3764650070,12/16/2014,471000.0,3,2.5,2010,4059,2.0,0.0,0.0,3,8,2010,0,1998,0,98034,47.7317,-122.197,2010,5779,12,16,2014,UNK,0,-1720
1118000465,3/12/2015,1810000.0,3,3.5,3780,8295,2.0,0.0,0.0,3,9,2430,1350,1951,0,98112,47.6394,-122.29,3780,9127,3,12,2015,UNK,0,-832
2622059062,10/15/2014,739500.0,3,3.25,4460,51177,2.0,0.0,0.0,3,9,4460,0,2005,0,98042,47.3648,-122.14299999999999,2670,38925,10,15,2014,N,1790,12252
2211700160,5/12/2014,450000.0,3,1.5,1770,17208,1.0,0.0,0.0,3,8,1160,610,1959,0,98006,47.5659,-122.117,2450,17118,5,12,2014,UNK,-680,90
9376301180,4/8/2015,552500.0,3,1.0,1430,5000,1.0,0.0,0.0,3,7,1430,0,1949,0,98117,47.6895,-122.37,1210,5000,4,8,2015,UNK,220,0
2203500570,2/17/2015,437000.0,4,1.75,1700,10642,1.0,0.0,0.0,4,7,850,850,1954,0,98006,47.5674,-122.14200000000001,1610,11200,2,17,2015,UNK,90,-558
3634100030,1/9/2015,270000.0,4,2.0,1830,5220,1.5,0.0,0.0,3,7,1830,0,1951,0,98118,47.5331,-122.27799999999999,1760,5757,1,9,2015,UNK,70,-537
2599200830,7/16/2014,226740.0,3,1.5,1410,8800,1.0,0.0,0.0,4,7,1410,0,1965,0,98092,47.2927,-122.18299999999999,2180,10108,7,16,2014,UNK,-770,-1308
4140090370,2/18/2015,446500.0,4,2.5,3060,7920,1.0,0.0,0.0,3,8,1810,0,1974,0,98028,47.7675,-122.26100000000001,2690,7767,2,18,2015,UNK,370,153
2320069083,11/25/2014,283000.0,3,2.0,1820,15068,2.0,0.0,2.0,3,7,1520,300,1920,0,98022,47.2103,-121.999,1490,9589,11,25,2014,UNK,330,5479
6893300295,7/15/2014,445000.0,4,1.75,2430,13211,1.5,0.0,0.0,4,7,2430,0,1909,1978,98024,47.5245,-121.926,1330,10500,7,15,2014,Y,1100,2711
7454000030,8/16/2014,250000.0,2,1.0,740,6840,1.0,0.0,0.0,5,6,740,0,1942,0,98126,47.5172,-122.375,740,6840,8,16,2014,UNK,0,0
7454001090,3/9/2015,307000.0,3,1.0,770,6552,1.0,0.0,0.0,3,6,670,100,1942,0,98146,47.5133,-122.37200000000001,920,7200,3,9,2015,UNK,-150,-648
2944500340,7/21/2014,315000.0,4,2.75,2200,8580,1.0,0.0,0.0,3,8,1860,340,1991,0,98023,47.295,-122.37,2290,7816,7,21,2014,UNK,-90,764
2346800270,1/6/2015,555000.0,3,3.0,2920,23085,1.5,0.0,2.0,3,7,1540,1380,1908,0,98136,47.5159,-122.395,2270,18180,1,6,2015,UNK,650,4905
2796100640,4/24/2015,264900.0,4,2.5,2040,7000,1.0,0.0,0.0,3,7,1250,790,1979,0,98031,47.4056,-122.176,1900,7378,4,24,2015,UNK,140,-378
993000046,9/22/2014,510000.0,3,2.0,1600,4510,1.0,0.0,0.0,3,7,990,610,1978,0,98103,47.6939,-122.34,1580,4561,9,22,2014,UNK,20,-51
2333230270,8/14/2014,328000.0,4,2.5,1990,3980,2.0,0.0,0.0,3,7,1990,0,2002,0,98058,47.4445,-122.17,1990,4373,8,14,2014,UNK,0,-393
5104510340,5/4/2015,358000.0,4,2.5,1830,7308,2.0,0.0,0.0,3,7,1830,0,2002,0,98038,47.3565,-122.015,1830,5692,5,4,2015,UNK,0,1616
2517000700,4/21/2015,325000.0,3,2.5,2540,4260,2.0,0.0,0.0,3,7,2540,0,2005,0,98042,47.3989,-122.164,2190,4260,4,21,2015,N,350,0
1724069062,7/14/2014,1370000.0,2,3.25,2700,3444,3.0,1.0,3.0,3,9,2700,0,1990,0,98075,47.5684,-122.06,2710,3444,7,14,2014,UNK,-10,0
5556800260,3/5/2015,230000.0,4,2.0,1440,10800,1.0,0.0,0.0,4,7,1440,0,1967,0,98001,47.3417,-122.28299999999999,1190,7380,3,5,2015,UNK,250,3420
2771603610,4/23/2015,545000.0,3,2.0,1550,4000,1.0,0.0,0.0,3,7,940,610,1955,0,98199,47.6379,-122.387,1880,4000,4,23,2015,UNK,-330,0
3629910240,5/5/2014,705380.0,3,2.5,2490,4343,2.0,0.0,0.0,3,9,2490,0,2003,0,98029,47.5493,-121.993,2130,4106,5,5,2014,UNK,360,237
5634500036,8/20/2014,459000.0,5,2.5,2650,12987,1.0,0.0,0.0,4,7,1350,1300,1979,0,98028,47.7482,-122.244,2160,12726,8,20,2014,UNK,490,261
2887703066,5/28/2014,815000.0,4,2.25,2000,3800,2.0,0.0,0.0,3,8,2000,0,2001,0,98115,47.6852,-122.311,1610,3800,5,28,2014,UNK,390,0
3185600055,6/11/2014,495000.0,6,5.0,3440,4500,2.0,0.0,0.0,3,8,3280,160,2007,0,98055,47.4871,-122.219,1400,5500,6,11,2014,N,2040,-1000
1421069159,11/10/2014,520000.0,3,2.5,2280,58712,2.5,0.0,3.0,3,9,2280,0,1987,0,98010,47.3053,-122.0,2240,24332,11,10,2014,UNK,40,34380
476000335,12/17/2014,430000.0,2,1.5,1320,1194,3.0,0.0,0.0,3,7,1320,0,2001,0,98107,47.6704,-122.39,1320,1250,12,17,2014,UNK,0,-56
251300260,5/15/2014,255000.0,4,2.5,2070,7800,2.0,0.0,0.0,3,8,2070,0,1989,0,98003,47.3487,-122.315,1950,7815,5,15,2014,UNK,120,-15
2887700140,7/7/2014,588000.0,3,2.0,1860,4777,2.0,0.0,0.0,5,7,1860,0,1908,0,98115,47.6892,-122.311,1580,3822,7,7,2014,UNK,280,955
3298201170,11/10/2014,350000.0,3,1.0,940,7811,1.0,0.0,0.0,3,6,940,0,1959,0,98008,47.6195,-122.118,1180,7490,11,10,2014,UNK,-240,321
2024059084,3/13/2015,625000.0,4,2.75,2290,21486,1.0,0.0,2.0,5,7,2290,0,1963,0,98006,47.5515,-122.189,2540,15936,3,13,2015,UNK,-250,5550
7229700105,4/24/2015,172500.0,2,2.0,1510,20685,1.0,0.0,0.0,2,6,1250,260,1958,0,98059,47.481,-122.116,1490,29527,4,24,2015,UNK,20,-8842
2313900560,8/25/2014,554000.0,3,2.0,1830,3500,1.5,0.0,0.0,5,7,1290,540,1909,0,98116,47.573,-122.383,1530,4000,8,25,2014,UNK,300,-500
6192400400,7/28/2014,775000.0,4,2.5,3090,7112,2.0,0.0,0.0,3,9,3090,0,2001,0,98052,47.705,-122.118,3050,6000,7,28,2014,UNK,40,1112
1425069116,11/7/2014,1190000.0,4,3.5,4340,217800,2.0,0.0,0.0,3,11,4340,0,2003,0,98053,47.6471,-122.01299999999999,3430,219106,11,7,2014,UNK,910,-1306
3582900200,10/28/2014,618000.0,3,2.75,3200,12682,2.0,0.0,1.0,3,9,3200,0,1977,0,98028,47.7443,-122.26,2880,10432,10,28,2014,UNK,320,2250
243000335,9/29/2014,305000.0,4,1.0,1560,8450,1.5,0.0,0.0,4,6,1560,0,1954,0,98166,47.4552,-122.354,1380,8100,9,29,2014,UNK,180,350
7760400350,12/5/2014,232000.0,3,2.0,1280,13356,1.0,0.0,0.0,3,7,1280,0,1994,0,98042,47.3715,-122.074,1590,8071,12,5,2014,UNK,-310,5285
128500260,5/8/2014,262000.0,4,2.5,2020,6236,2.0,0.0,0.0,3,7,2020,0,2002,0,98001,47.2796,-122.24700000000001,1940,5076,5,8,2014,UNK,80,1160
1697000370,3/25/2015,234000.0,3,1.0,1040,8122,1.0,0.0,0.0,5,7,1040,0,1971,0,98198,47.3731,-122.31200000000001,1470,8676,3,25,2015,UNK,-430,-554
8902000267,4/2/2015,500000.0,4,2.75,2260,7209,1.0,0.0,3.0,3,7,1330,930,2002,0,98125,47.7088,-122.302,1790,10860,4,2,2015,UNK,470,-3651
1218000030,8/27/2014,278000.0,3,1.0,860,7632,1.0,0.0,0.0,3,6,860,0,1920,0,98166,47.4623,-122.345,890,7632,8,27,2014,UNK,-30,0
6099400140,9/4/2014,230000.0,5,1.0,1920,19040,1.0,0.0,0.0,3,7,1160,760,1961,0,98168,47.4756,-122.294,1920,11520,9,4,2014,UNK,0,7520
5710600030,9/22/2014,500000.0,4,1.75,2290,9215,1.0,0.0,0.0,5,8,1270,1020,1969,0,98027,47.5328,-122.051,2290,10200,9,22,2014,UNK,0,-985
7304300570,5/19/2014,366500.0,4,2.75,2070,9300,1.0,0.0,0.0,5,7,1120,950,1945,0,98155,47.7416,-122.32,1010,8308,5,19,2014,UNK,1060,992
1702901180,6/11/2014,665000.0,6,3.0,4250,4400,2.5,0.0,0.0,4,7,3020,1230,1902,0,98118,47.5584,-122.28299999999999,1520,4950,6,11,2014,UNK,2730,-550
3508100135,3/16/2015,1100000.0,3,1.5,2220,4830,2.0,0.0,3.0,3,9,1790,430,1928,0,98116,47.5825,-122.4,1670,4830,3,16,2015,UNK,550,0
4443800030,12/1/2014,575000.0,2,1.75,1840,4076,1.0,0.0,0.0,3,8,1140,700,1957,0,98117,47.6875,-122.39299999999999,1540,4076,12,1,2014,UNK,300,0
2553300140,11/3/2014,674750.0,4,2.5,2590,9753,2.0,0.0,0.0,3,10,2590,0,1993,0,98075,47.5848,-122.027,2800,9917,11,3,2014,UNK,-210,-164
4154300465,9/16/2014,719000.0,5,2.0,3110,6131,1.0,0.0,0.0,5,7,1560,1550,1940,0,98118,47.5615,-122.279,1720,6600,9,16,2014,UNK,1390,-469
3623029045,9/25/2014,482000.0,3,1.75,2600,105587,1.0,0.0,0.0,4,7,1300,1300,1980,0,98070,47.4464,-122.49700000000001,1941,208438,9,25,2014,UNK,659,-102851
9371700125,5/28/2014,254000.0,2,1.0,1060,8187,1.0,0.0,0.0,4,6,1060,0,1952,0,98133,47.7508,-122.34899999999999,1260,8188,5,28,2014,UNK,-200,-1
4443800810,8/19/2014,443725.0,3,1.75,1250,3880,1.0,0.0,0.0,4,7,750,500,1944,0,98117,47.6869,-122.39200000000001,1240,3880,8,19,2014,UNK,10,0
1330900570,11/6/2014,575000.0,4,2.5,2520,35636,2.0,0.0,0.0,3,8,2520,0,1980,0,98053,47.652,-122.031,2230,35673,11,6,2014,UNK,290,-37
4017110200,1/27/2015,469000.0,3,2.25,2070,9957,1.0,0.0,0.0,3,8,1440,630,1977,0,98155,47.7766,-122.277,2070,10158,1,27,2015,UNK,0,-201
303000445,5/23/2014,175000.0,2,1.0,1300,44431,1.0,0.0,0.0,5,6,1300,0,1958,0,98001,47.327,-122.26700000000001,1470,14850,5,23,2014,UNK,-170,29581
7857003505,9/9/2014,437000.0,5,2.0,2190,8316,1.0,0.0,0.0,3,7,1390,800,1961,0,98108,47.5488,-122.29799999999999,2010,8316,9,9,2014,UNK,180,0
4027701291,8/20/2014,550000.0,4,3.0,2760,13113,1.0,0.0,0.0,4,8,1760,1000,1974,0,98028,47.7669,-122.26799999999999,1900,13113,8,20,2014,UNK,860,0
3831200200,4/20/2015,172040.0,3,2.25,1710,7134,1.0,0.0,0.0,4,7,1130,580,1979,0,98031,47.3911,-122.191,1790,7455,4,20,2015,UNK,-80,-321
4123830070,12/24/2014,363000.0,3,2.0,1750,7000,1.0,0.0,0.0,3,8,1750,0,1993,0,98038,47.3693,-122.041,1840,6969,12,24,2014,UNK,-90,31
8946750140,4/30/2015,282000.0,3,2.25,1552,3600,2.0,0.0,0.0,3,7,1552,0,2012,0,98092,47.3198,-122.178,1677,3600,4,30,2015,N,-125,0
7129300400,8/14/2014,400000.0,6,2.0,2350,6554,2.0,0.0,1.0,3,8,2000,350,1905,0,98178,47.5115,-122.256,1560,6554,8,14,2014,UNK,790,0
2126059234,9/24/2014,650000.0,5,3.5,5110,10018,2.0,0.0,0.0,3,10,3850,1260,2003,0,98034,47.7261,-122.17,1790,10018,9,24,2014,UNK,3320,0
621069074,6/3/2014,365000.0,3,2.5,1720,99916,2.0,0.0,0.0,4,7,1720,0,1990,0,98042,47.3391,-122.09299999999999,1340,73180,6,3,2014,UNK,380,26736
7879600070,10/24/2014,269950.0,4,2.5,1960,7230,2.0,0.0,0.0,3,8,1960,0,2002,0,98023,47.2855,-122.36,1850,7208,10,24,2014,UNK,110,22
6151800486,7/18/2014,260000.0,2,1.0,1270,19602,1.0,0.0,0.0,3,6,1270,0,1977,0,98010,47.3375,-122.04799999999999,1270,17699,7,18,2014,UNK,0,1903
8581200160,10/24/2014,193000.0,3,1.5,1180,7000,1.0,0.0,0.0,4,7,1180,0,1977,0,98023,47.2959,-122.37299999999999,1630,7500,10,24,2014,UNK,-450,-500
2395710070,7/25/2014,340000.0,4,2.25,2230,6791,2.0,0.0,0.0,3,8,2230,0,2005,0,98038,47.3769,-122.02799999999999,2420,6297,7,25,2014,N,-190,494
6669100070,5/12/2014,900000.0,4,3.25,4700,38412,2.0,0.0,0.0,3,10,3420,1280,1978,0,98005,47.6445,-122.167,3640,35571,5,12,2014,UNK,1060,2841
8856920070,10/21/2014,371000.0,3,2.5,2150,8361,2.0,0.0,0.0,3,8,2150,0,1991,0,98058,47.4627,-122.12899999999999,2150,9368,10,21,2014,UNK,0,-1007
323089084,8/27/2014,592000.0,3,2.5,2400,81892,2.0,0.0,0.0,3,8,2400,0,1985,0,98045,47.5028,-121.76899999999999,1370,37270,8,27,2014,UNK,1030,44622
798000342,8/15/2014,300000.0,3,2.5,1830,12750,2.0,0.0,0.0,3,7,1830,0,1991,0,98168,47.5003,-122.32799999999999,1610,10000,8,15,2014,UNK,220,2750
5104511840,8/27/2014,449950.0,4,3.0,2800,6977,2.0,0.0,0.0,3,8,2800,0,2003,0,98038,47.3542,-122.014,2800,6600,8,27,2014,UNK,0,377
5205000400,10/22/2014,299500.0,3,2.5,2090,7163,2.0,0.0,0.0,3,8,2090,0,1989,0,98003,47.2735,-122.295,2320,8634,10,22,2014,UNK,-230,-1471
8565900160,3/26/2015,995000.0,4,2.25,2340,13406,1.0,0.0,0.0,4,9,2340,0,1963,0,98040,47.5377,-122.221,2340,10743,3,26,2015,UNK,0,2663
4302700445,9/23/2014,335000.0,4,1.75,1670,9472,1.0,0.0,0.0,3,7,1100,570,1960,0,98106,47.5299,-122.35700000000001,1080,5195,9,23,2014,UNK,590,4277
2413300240,11/10/2014,280000.0,4,2.25,1990,7350,1.0,0.0,0.0,4,8,1180,810,1978,0,98003,47.3258,-122.32799999999999,2030,7210,11,10,2014,UNK,-40,140
9477201620,5/16/2014,446000.0,4,2.25,2270,7800,1.0,0.0,0.0,3,7,1290,980,1977,0,98034,47.7278,-122.19200000000001,1480,7280,5,16,2014,UNK,790,520
3395000070,9/27/2014,1540000.0,4,2.75,4910,15139,1.0,0.0,0.0,4,10,2560,2350,1964,0,98004,47.6444,-122.22,3980,15139,9,27,2014,UNK,930,0
3336000791,4/7/2015,325000.0,3,1.0,950,4500,1.0,0.0,0.0,4,6,950,0,1943,0,98118,47.5273,-122.265,1140,4500,4,7,2015,UNK,-190,0
1087700030,6/19/2014,450000.0,3,1.75,1610,11200,1.0,0.0,0.0,3,7,1610,0,1955,0,98033,47.6641,-122.176,1610,11200,6,19,2014,UNK,0,0
8856970570,10/27/2014,322500.0,4,2.5,1940,7107,2.0,0.0,0.0,3,7,1940,0,2000,0,98038,47.3843,-122.03200000000001,1850,5705,10,27,2014,UNK,90,1402
2206700295,9/15/2014,453000.0,3,1.0,1210,9473,1.0,0.0,0.0,5,7,1210,0,1955,0,98006,47.5637,-122.139,1700,11465,9,15,2014,UNK,-490,-1992
293910030,10/8/2014,655000.0,4,2.5,2570,4412,2.0,0.0,0.0,3,9,2570,0,2001,0,98034,47.7076,-122.23200000000001,2460,5470,10,8,2014,UNK,110,-1058
9547205660,5/4/2015,603000.0,3,2.25,1700,2800,2.0,0.0,0.0,5,7,1150,550,1926,0,98115,47.6819,-122.311,1500,3400,5,4,2015,UNK,200,-600
8856004400,9/2/2014,235000.0,4,1.0,1610,24000,1.5,0.0,0.0,3,6,1610,0,1947,0,98001,47.2751,-122.25200000000001,1270,9600,9,2,2014,UNK,340,14400
3888100128,7/28/2014,968933.0,4,3.5,4120,7304,2.0,0.0,0.0,3,11,3070,1050,2006,0,98033,47.681000000000004,-122.167,2470,9600,7,28,2014,N,1650,-2296
8562900240,11/14/2014,1020000.0,3,3.5,2880,11340,1.0,0.0,0.0,3,8,1690,1190,1980,0,98074,47.6113,-122.05799999999999,2530,11340,11,14,2014,UNK,350,0
1088000030,12/3/2014,435000.0,4,2.25,1990,8548,2.0,0.0,0.0,3,8,1990,0,1973,0,98033,47.667,-122.178,2320,8926,12,3,2014,UNK,-330,-378
1545800640,6/18/2014,242000.0,3,2.0,1260,8092,1.0,0.0,0.0,3,7,1260,0,1986,0,98038,47.3635,-122.054,1950,8092,6,18,2014,UNK,-690,0
3020079078,10/27/2014,487000.0,6,3.25,4750,248600,2.0,0.0,0.0,4,8,4750,0,1947,0,98022,47.1879,-121.973,2230,311610,10,27,2014,UNK,2520,-63010
11520640,8/1/2014,810000.0,4,2.75,3010,10450,2.0,0.0,0.0,3,9,3010,0,1996,0,98052,47.6979,-122.11200000000001,3010,10530,8,1,2014,UNK,0,-80
3407700046,6/24/2014,625000.0,3,2.5,2410,64073,1.0,0.0,0.0,4,8,1820,590,1976,0,98072,47.7457,-122.141,2980,48760,6,24,2014,UNK,-570,15313
7696600240,10/23/2014,165000.0,3,1.5,1280,7742,1.0,0.0,0.0,3,7,1280,0,1973,0,98001,47.3323,-122.27600000000001,1566,7696,10,23,2014,UNK,-286,46
3904100106,4/27/2015,335000.0,3,1.0,2320,6750,1.0,0.0,0.0,3,7,1160,1160,1960,0,98118,47.5327,-122.27600000000001,1230,6075,4,27,2015,UNK,1090,675
7849201600,7/24/2014,286700.0,3,1.0,1220,6600,1.0,0.0,0.0,3,6,1220,0,1958,0,98065,47.5297,-121.82700000000001,1100,6600,7,24,2014,UNK,120,0
8924100111,4/24/2015,699000.0,2,1.5,1400,4050,1.0,0.0,0.0,4,8,1400,0,1954,0,98115,47.6768,-122.26899999999999,1900,5940,4,24,2015,UNK,-500,-1890
2221000070,3/27/2015,280000.0,3,1.75,1590,7280,1.0,0.0,0.0,3,7,1140,450,1974,0,98058,47.4288,-122.15299999999999,1590,9634,3,27,2015,UNK,0,-2354
8078350030,6/2/2014,580000.0,4,2.5,2220,7064,2.0,0.0,0.0,3,8,2220,0,1988,0,98029,47.5716,-122.022,2220,7451,6,2,2014,UNK,0,-387
8682281710,6/20/2014,754800.0,2,2.5,2770,7781,2.0,0.0,0.0,3,8,2770,0,2006,0,98053,47.7072,-122.01700000000001,1870,5984,6,20,2014,N,900,1797
1383500070,2/10/2015,525000.0,4,2.5,2303,16801,2.0,0.0,0.0,3,8,2303,0,1995,0,98019,47.7266,-121.96600000000001,2080,14013,2,10,2015,UNK,223,2788
6744700181,2/17/2015,562000.0,3,1.75,1600,10530,1.0,0.0,2.0,3,8,1600,0,1962,0,98155,47.7437,-122.291,2590,8274,2,17,2015,UNK,-990,2256
6728700075,5/20/2014,575000.0,4,1.75,1280,6060,1.0,0.0,0.0,3,7,860,420,1926,0,98117,47.6805,-122.36399999999999,1490,4680,5,20,2014,UNK,-210,1380
3630180240,7/11/2014,808900.0,5,2.5,2900,5901,2.0,0.0,0.0,3,9,2900,0,2006,0,98027,47.5396,-121.99799999999999,3200,5775,7,11,2014,N,-300,126
2162000160,3/3/2015,992000.0,3,2.25,2950,15207,1.0,0.0,0.0,4,10,2070,880,1966,0,98040,47.5571,-122.21600000000001,2950,22000,3,3,2015,UNK,0,-6793
705700140,9/19/2014,335000.0,3,2.5,1700,6698,2.0,0.0,0.0,3,7,1700,0,1997,0,98038,47.3826,-122.02799999999999,2190,7346,9,19,2014,UNK,-490,-648
9423400193,12/26/2014,473000.0,3,2.75,1050,7200,1.0,0.0,0.0,3,7,1050,0,1985,0,98125,47.7163,-122.303,1860,9000,12,26,2014,UNK,-810,-1800
5137200140,3/25/2015,350000.0,4,2.75,2990,11210,1.0,0.0,1.0,4,8,1880,1110,1977,0,98023,47.3357,-122.336,2790,9858,3,25,2015,UNK,200,1352
5026900160,4/24/2015,1600000.0,5,2.5,3100,5374,2.5,0.0,0.0,4,9,3100,0,1906,0,98122,47.6154,-122.28299999999999,2180,5800,4,24,2015,UNK,920,-426
4024101052,12/17/2014,305500.0,3,1.0,1240,6090,1.0,0.0,0.0,4,7,1240,0,1950,0,98155,47.7542,-122.307,1550,9096,12,17,2014,UNK,-310,-3006
1726069051,5/23/2014,306000.0,2,1.0,780,13500,1.0,0.0,0.0,4,7,780,0,1946,1989,98077,47.7383,-122.074,2200,67518,5,23,2014,Y,-1420,-54018
6300000693,12/2/2014,233000.0,2,2.25,850,1656,2.0,0.0,0.0,3,8,850,0,2001,0,98133,47.7064,-122.344,850,1312,12,2,2014,UNK,0,344
6413100270,3/31/2015,490000.0,3,1.75,1540,9000,1.0,0.0,0.0,3,8,1540,0,1971,0,98125,47.7152,-122.322,1710,7488,3,31,2015,UNK,-170,1512
7215420160,7/1/2014,445000.0,4,2.5,2280,42077,2.0,0.0,0.0,3,8,2280,0,1994,0,98042,47.3424,-122.07700000000001,2280,36236,7,1,2014,UNK,0,5841
7878400135,11/20/2014,355000.0,3,2.25,2550,9674,1.0,0.0,0.0,3,7,1850,700,1959,0,98178,47.4856,-122.24700000000001,2240,9674,11,20,2014,UNK,310,0
2597710070,4/2/2015,360000.0,2,2.0,1770,7607,1.0,0.0,0.0,4,8,1770,0,1987,0,98058,47.4287,-122.163,2090,7109,4,2,2015,UNK,-320,498
9244900248,7/9/2014,737500.0,3,1.75,2320,10900,2.0,0.0,0.0,3,7,2320,0,1935,1974,98115,47.6877,-122.28299999999999,1610,5800,7,9,2014,Y,710,5100
824059277,12/15/2014,985000.0,3,3.5,2600,11920,2.0,0.0,0.0,5,8,2600,0,1969,0,98004,47.582,-122.194,2430,10050,12,15,2014,UNK,170,1870
3278601940,8/6/2014,349950.0,2,3.25,1570,2031,2.0,0.0,0.0,3,8,1310,260,2006,0,98126,47.548,-122.375,1570,2039,8,6,2014,N,0,-8
7853250160,2/20/2015,520000.0,4,2.5,3060,7161,2.0,0.0,0.0,3,8,2860,200,2005,0,98065,47.5383,-121.87899999999999,2950,6822,2,20,2015,N,110,339
1163100070,12/17/2014,355950.0,4,2.5,1960,8540,1.0,0.0,0.0,3,7,1220,740,1955,0,98177,47.7654,-122.359,1910,9120,12,17,2014,UNK,50,-580
8106300510,12/29/2014,485000.0,5,2.5,3270,6129,2.0,0.0,0.0,3,9,3270,0,2004,0,98055,47.4461,-122.208,2980,5928,12,29,2014,N,290,201
4239400960,12/12/2014,143000.0,3,1.0,1090,3315,1.0,0.0,0.0,4,6,1090,0,1969,0,98092,47.3159,-122.18299999999999,960,3120,12,12,2014,UNK,130,195
7524900003,12/10/2014,3280000.0,2,1.75,6840,10000,2.5,1.0,4.0,3,11,4350,2490,2001,0,98008,47.6042,-122.11200000000001,3120,12300,12,10,2014,UNK,3720,-2300
3893100327,7/23/2014,355000.0,3,1.0,940,8512,1.0,0.0,0.0,4,7,940,0,1967,0,98033,47.7002,-122.191,1060,8512,7,23,2014,UNK,-120,0
7856640560,6/4/2014,1130000.0,5,3.5,3880,13885,2.0,0.0,3.0,4,9,2540,1340,1979,0,98006,47.5696,-122.156,3690,13885,6,4,2014,UNK,190,0
7206900075,8/18/2014,200000.0,5,1.75,1770,15525,1.0,0.0,0.0,4,7,1770,0,1959,0,98059,47.5025,-122.14200000000001,1370,10395,8,18,2014,UNK,400,5130
8691310070,6/18/2014,913000.0,4,2.5,3640,10576,2.0,0.0,0.0,3,11,3640,0,1999,0,98075,47.5899,-121.979,3370,10351,6,18,2014,UNK,270,225
4389200796,5/22/2014,1600000.0,3,2.5,3160,12824,1.0,0.0,2.0,4,9,1820,1340,1966,0,98004,47.6151,-122.21600000000001,3390,11985,5,22,2014,UNK,-230,839
7436300160,6/25/2014,409900.0,2,2.5,1590,1845,2.0,0.0,0.0,3,9,1590,0,1997,0,98033,47.6897,-122.175,2320,3174,6,25,2014,UNK,-730,-1329
7896300070,5/1/2015,265000.0,4,1.0,1290,6034,1.0,0.0,0.0,3,6,1050,240,1950,0,98118,47.5223,-122.286,1060,6034,5,1,2015,UNK,230,0
2425059074,4/10/2015,740000.0,5,3.0,3655,51836,1.0,0.0,0.0,5,8,2174,1481,1955,0,98008,47.6434,-122.115,2530,8606,4,10,2015,UNK,1125,43230
2111010340,6/12/2014,306000.0,4,2.5,2490,8124,2.0,0.0,0.0,3,7,2490,0,2001,0,98092,47.3347,-122.17,2760,6300,6,12,2014,UNK,-270,1824
7852150140,10/7/2014,381000.0,3,2.5,1470,3999,2.0,0.0,0.0,3,7,1470,0,2003,0,98065,47.5328,-121.87100000000001,1960,4444,10,7,2014,UNK,-490,-445
1370800830,5/5/2015,1220000.0,3,3.25,3960,6132,2.0,0.0,3.0,3,10,2600,1360,1933,0,98199,47.6396,-122.40899999999999,2730,5221,5,5,2015,UNK,1230,911
7632400400,3/20/2015,1050000.0,3,3.5,3190,29982,1.0,0.0,3.0,4,8,2630,560,1941,0,98166,47.458,-122.368,2600,19878,3,20,2015,UNK,590,10104
5220300140,9/3/2014,408000.0,2,1.0,810,7440,1.0,0.0,0.0,5,6,810,0,1948,0,98133,47.7346,-122.352,830,7500,9,3,2014,UNK,-20,-60
2568200140,6/25/2014,739900.0,5,2.5,2980,5377,2.0,0.0,0.0,3,9,2980,0,2006,0,98052,47.7074,-122.101,3150,6593,6,25,2014,N,-170,-1216
1137300340,11/21/2014,674250.0,4,2.5,2780,35000,1.0,0.0,0.0,4,9,2780,0,1985,0,98072,47.7386,-122.09100000000001,2740,35072,11,21,2014,UNK,40,-72
7640400106,9/11/2014,438400.0,2,1.0,1340,8100,1.0,0.0,0.0,4,7,1340,0,1953,0,98177,47.7218,-122.37,1700,8100,9,11,2014,UNK,-360,0
2175100055,12/30/2014,1700000.0,5,5.0,4930,14649,2.0,0.0,3.0,3,11,4160,770,2000,0,98040,47.5829,-122.24700000000001,3030,8479,12,30,2014,UNK,1900,6170
9274200990,6/19/2014,703000.0,3,2.0,1360,5980,1.5,0.0,0.0,3,8,1360,0,1945,2008,98116,47.5852,-122.38799999999999,1520,4440,6,19,2014,Y,-160,1540
5028600550,12/29/2014,262000.0,3,1.75,1320,6530,1.0,0.0,0.0,4,7,1320,0,1989,0,98023,47.2871,-122.354,1620,6817,12,29,2014,UNK,-300,-287
1471630160,4/23/2015,353000.0,3,2.0,1210,14499,1.0,0.0,0.0,3,7,1210,0,1984,0,98045,47.4705,-121.75399999999999,1570,15360,4,23,2015,UNK,-360,-861
9430110030,1/14/2015,500000.0,4,2.5,1940,7607,2.0,0.0,0.0,3,8,1940,0,1995,0,98052,47.685,-122.15799999999999,2250,7600,1,14,2015,UNK,-310,7
9275700016,7/6/2014,1280000.0,4,2.5,3160,4620,1.5,0.0,4.0,3,9,2020,1140,1917,0,98116,47.5875,-122.382,2790,5308,7,6,2014,UNK,370,-688
6654700240,4/8/2015,332000.0,4,2.5,1980,6566,2.0,0.0,0.0,3,8,1980,0,2004,0,98042,47.3809,-122.09700000000001,2590,6999,4,8,2015,N,-610,-433
8563080270,8/21/2014,824000.0,4,2.5,2320,14240,1.0,0.0,0.0,4,9,1620,700,1974,0,98008,47.6269,-122.09,2810,13200,8,21,2014,UNK,-490,1040
7548300326,2/20/2015,290000.0,4,2.0,1660,4788,1.0,0.0,0.0,3,7,1660,0,1968,0,98144,47.5878,-122.31200000000001,1150,5000,2,20,2015,UNK,510,-212
5457300696,6/27/2014,700000.0,3,2.5,1660,1545,2.0,0.0,2.0,3,9,1400,260,2002,0,98109,47.6268,-122.353,1820,2570,6,27,2014,UNK,-160,-1025
1175001125,10/6/2014,550000.0,2,1.0,1080,3420,1.0,0.0,0.0,4,7,780,300,1922,0,98107,47.6715,-122.39299999999999,1380,3656,10,6,2014,UNK,-300,-236
3034200197,9/3/2014,549000.0,2,1.0,1510,11165,1.5,0.0,0.0,4,7,1510,0,1921,0,98133,47.7212,-122.331,2210,8851,9,3,2014,UNK,-700,2314
7787400105,3/6/2015,1870000.0,4,2.5,2950,43560,1.0,0.0,2.0,4,9,2550,400,1951,0,98004,47.5988,-122.20700000000001,3260,41016,3,6,2015,UNK,-310,2544
9346700270,3/2/2015,858000.0,4,2.25,3070,13720,2.0,0.0,0.0,3,9,3070,0,1978,0,98007,47.6133,-122.152,3010,9657,3,2,2015,UNK,60,4063
6414600260,10/30/2014,345000.0,2,1.0,970,10423,1.0,0.0,0.0,3,7,970,0,1947,0,98133,47.7252,-122.331,1200,7857,10,30,2014,UNK,-230,2566
2620069195,11/4/2014,340000.0,4,1.75,2140,11651,2.5,0.0,0.0,3,8,2140,0,1930,2001,98022,47.19600000000001,-122.006,2030,10978,11,4,2014,Y,110,673
1300301840,4/25/2015,1220000.0,4,2.25,2570,9600,2.5,0.0,0.0,4,9,2570,0,1962,0,98040,47.5791,-122.241,2570,13200,4,25,2015,UNK,0,-3600
4358700186,12/11/2014,275000.0,3,2.25,1260,1488,3.0,0.0,0.0,3,7,1260,0,2009,0,98133,47.7071,-122.336,1190,1095,12,11,2014,N,70,393
259600560,8/27/2014,405000.0,3,1.0,1220,7771,1.0,0.0,0.0,3,7,1220,0,1963,0,98008,47.6326,-122.119,1420,7674,8,27,2014,UNK,-200,97
2634500070,1/16/2015,432500.0,3,2.0,1720,8145,2.0,0.0,0.0,5,7,1720,0,1949,0,98155,47.7393,-122.325,1400,8138,1,16,2015,UNK,320,7
7186800105,1/12/2015,236500.0,4,1.0,2140,4217,1.5,0.0,0.0,3,6,1320,820,1925,0,98118,47.5484,-122.287,1720,5413,1,12,2015,UNK,420,-1196
4459800070,7/18/2014,679000.0,4,1.5,1420,4923,1.5,0.0,0.0,4,8,1420,0,1928,0,98103,47.6901,-122.339,1470,4923,7,18,2014,UNK,-50,0
3034200370,10/31/2014,543000.0,4,2.5,2060,8451,2.0,0.0,0.0,3,8,2060,0,1995,0,98133,47.7168,-122.333,2060,9460,10,31,2014,UNK,0,-1009
7887200390,9/26/2014,294000.0,3,1.0,1320,9520,1.0,0.0,0.0,3,7,990,330,1953,0,98178,47.4857,-122.25299999999999,1460,10610,9,26,2014,UNK,-140,-1090
2473390710,4/3/2015,340500.0,3,1.75,1810,10463,1.0,0.0,0.0,4,7,1810,0,1969,0,98058,47.4581,-122.162,1620,8551,4,3,2015,UNK,190,1912
2600140370,7/3/2014,1010000.0,4,2.5,2980,16263,2.0,0.0,0.0,3,9,2980,0,1989,0,98006,47.5457,-122.15299999999999,2730,10018,7,3,2014,UNK,250,6245
7525100520,5/2/2014,335000.0,2,2.0,1350,2560,1.0,0.0,0.0,3,8,1350,0,1976,0,98052,47.6344,-122.10700000000001,1790,2560,5,2,2014,UNK,-440,0
6204200560,7/23/2014,425000.0,3,2.0,1540,8011,1.0,0.0,0.0,3,7,1540,0,1988,0,98011,47.7342,-122.20200000000001,1630,7141,7,23,2014,UNK,-90,870
5416100160,2/10/2015,353000.0,3,2.5,2510,9240,2.0,0.0,0.0,4,8,2510,0,2001,0,98022,47.1896,-122.01299999999999,2690,9240,2,10,2015,UNK,-180,0
3905040070,5/4/2015,540000.0,3,2.5,1670,5146,2.0,0.0,0.0,3,8,1670,0,1991,0,98029,47.5707,-121.999,1940,5146,5,4,2015,UNK,-270,0
8562900520,6/12/2014,640000.0,5,3.5,3690,11928,2.0,0.0,0.0,3,9,2540,1150,2006,0,98074,47.6108,-122.06,2640,11928,6,12,2014,N,1050,0
4027701182,7/22/2014,339950.0,3,1.0,1320,11457,1.0,0.0,0.0,3,8,1320,0,1959,0,98028,47.7738,-122.26100000000001,1900,9800,7,22,2014,UNK,-580,1657
9407110710,11/7/2014,195000.0,3,1.75,1510,8400,1.0,0.0,0.0,2,7,980,530,1979,0,98045,47.4476,-121.771,1500,10125,11,7,2014,UNK,10,-1725
9407110710,2/26/2015,322000.0,3,1.75,1510,8400,1.0,0.0,0.0,2,7,980,530,1979,0,98045,47.4476,-121.771,1500,10125,2,26,2015,UNK,10,-1725
5160300030,4/1/2015,660000.0,4,1.75,1870,10450,1.0,0.0,0.0,3,8,1620,250,1978,0,98005,47.5938,-122.154,2060,10450,4,1,2015,UNK,-190,0
1000102,9/16/2014,280000.0,6,3.0,2400,9373,2.0,0.0,0.0,3,7,2400,0,1991,0,98002,47.3262,-122.214,2060,7316,9,16,2014,UNK,340,2057
1000102,4/22/2015,300000.0,6,3.0,2400,9373,2.0,0.0,0.0,3,7,2400,0,1991,0,98002,47.3262,-122.214,2060,7316,4,22,2015,UNK,340,2057
8945300200,8/15/2014,207500.0,3,1.0,1170,8816,1.0,0.0,0.0,4,6,1170,0,1966,0,98023,47.3059,-122.368,1200,9108,8,15,2014,UNK,-30,-292
7796600070,8/25/2014,195000.0,3,1.5,1190,8726,1.0,0.0,0.0,3,7,1190,0,1956,0,98146,47.4887,-122.34299999999999,1390,8741,8,25,2014,UNK,-200,-15
4443800765,6/10/2014,700000.0,3,2.0,2080,3880,1.0,0.0,0.0,5,7,1160,920,1954,0,98117,47.68600000000001,-122.391,1330,3880,6,10,2014,UNK,750,0
3298720030,4/17/2015,560000.0,4,1.75,2150,8555,1.0,0.0,2.0,4,7,1460,690,1982,0,98106,47.5344,-122.345,1480,7405,4,17,2015,UNK,670,1150
1781500435,8/20/2014,260000.0,3,1.75,1580,7344,1.0,0.0,0.0,5,7,1580,0,1911,0,98126,47.5256,-122.38,1580,6207,8,20,2014,UNK,0,1137
1781500435,2/25/2015,575000.0,3,1.75,1580,7344,1.0,0.0,0.0,5,7,1580,0,1911,0,98126,47.5256,-122.38,1580,6207,2,25,2015,UNK,0,1137
6979970140,4/17/2015,475000.0,3,2.5,2370,3239,2.0,0.0,0.0,3,8,1950,420,2006,0,98072,47.7515,-122.17399999999999,2520,3431,4,17,2015,N,-150,-192
1005000036,6/13/2014,285000.0,3,1.75,1840,8601,1.0,0.0,0.0,3,7,920,920,1905,2014,98118,47.5359,-122.27600000000001,1390,7452,6,13,2014,Y,450,1149
3629921160,5/8/2014,753888.0,4,2.5,2660,5500,2.0,0.0,2.0,3,9,2660,0,2003,0,98029,47.5439,-121.99600000000001,3620,5500,5,8,2014,UNK,-960,0
3629910370,4/10/2015,650000.0,3,2.5,2190,3600,2.0,0.0,0.0,3,9,2190,0,2003,0,98029,47.5506,-121.993,2300,3600,4,10,2015,UNK,-110,0
5200100105,8/7/2014,620000.0,3,2.25,1660,3478,1.5,0.0,0.0,4,7,1100,560,1929,0,98117,47.6773,-122.37200000000001,1610,3478,8,7,2014,UNK,50,0
1024069159,3/13/2015,526000.0,3,1.75,1780,37801,1.0,0.0,0.0,3,7,1300,480,1977,0,98075,47.5858,-122.015,2380,47480,3,13,2015,UNK,-600,-9679
418000310,5/14/2014,155000.0,2,1.0,700,5200,1.0,0.0,0.0,5,6,700,0,1952,0,98056,47.4924,-122.175,1030,5200,5,14,2014,UNK,-330,0
765000060,8/27/2014,342000.0,4,2.0,1570,11200,1.0,0.0,0.0,3,7,1120,450,1959,0,98011,47.7573,-122.21700000000001,1570,11200,8,27,2014,UNK,0,0
2126079046,4/7/2015,390000.0,3,1.75,1220,216332,1.0,0.0,0.0,3,7,1220,0,1981,0,98019,47.7224,-121.926,1540,61419,4,7,2015,UNK,-320,154913
2024079035,6/5/2014,685000.0,3,2.75,3150,219978,2.0,0.0,0.0,4,9,3000,150,1990,0,98024,47.553000000000004,-121.946,3180,218235,6,5,2014,UNK,-30,1743
7202270830,6/25/2014,608000.0,4,2.5,2690,4736,2.0,0.0,0.0,3,7,2690,0,2001,0,98053,47.6869,-122.036,2690,4791,6,25,2014,UNK,0,-55
133000070,9/16/2014,179900.0,2,1.0,680,6400,1.0,0.0,0.0,3,6,680,0,1943,0,98168,47.5136,-122.316,1240,7800,9,16,2014,UNK,-560,-1400
2818600060,9/4/2014,1250000.0,6,3.25,3750,14150,2.0,0.0,2.0,5,9,2750,1000,1936,1968,98117,47.6999,-122.39299999999999,2140,7968,9,4,2014,Y,1610,6182
6082400083,4/30/2015,166000.0,3,1.0,1010,11675,1.0,0.0,0.0,3,7,1010,0,1957,0,98168,47.4849,-122.301,1370,10042,4,30,2015,UNK,-360,1633
9412900045,5/19/2014,462000.0,3,1.5,1710,4500,1.5,0.0,0.0,3,8,1410,300,1928,0,98118,47.5366,-122.26799999999999,1860,6000,5,19,2014,UNK,-150,-1500
3905030140,6/22/2014,545000.0,4,2.5,2090,6023,2.0,0.0,0.0,3,8,2090,0,1990,0,98029,47.5713,-121.99700000000001,2090,6023,6,22,2014,UNK,0,0
7228501580,1/16/2015,415000.0,3,1.0,1560,4500,1.5,0.0,0.0,3,7,1560,0,1903,0,98122,47.6118,-122.306,1660,4500,1,16,2015,UNK,-100,0
6679000390,6/10/2014,269000.0,3,2.5,1560,4200,2.0,0.0,0.0,3,7,1560,0,2003,0,98038,47.3838,-122.02600000000001,1560,4200,6,10,2014,UNK,0,0
1822500160,12/12/2014,356500.0,4,2.5,2570,11473,2.0,0.0,0.0,3,8,2570,0,2008,0,98003,47.2809,-122.296,2430,5997,12,12,2014,N,140,5476
6889000060,12/23/2014,225000.0,3,1.0,1010,7633,1.0,0.0,0.0,4,6,1010,0,1961,0,98198,47.3781,-122.314,1190,8386,12,23,2014,UNK,-180,-753
835000055,6/20/2014,175000.0,2,1.0,1020,5130,1.0,0.0,0.0,4,6,1020,0,1948,0,98002,47.301,-122.226,1200,6497,6,20,2014,UNK,-180,-1367
7811210320,8/1/2014,549000.0,5,2.5,1710,9720,2.0,0.0,0.0,4,8,1710,0,1974,0,98005,47.5903,-122.15700000000001,2270,9672,8,1,2014,UNK,-560,48
3123049320,4/15/2015,535000.0,3,2.75,2300,12197,2.0,0.0,0.0,3,8,2300,0,1989,0,98166,47.4369,-122.338,1710,11220,4,15,2015,UNK,590,977
4123400320,5/5/2014,627000.0,4,2.25,1990,7712,1.0,0.0,0.0,3,8,1210,0,1973,0,98027,47.5688,-122.087,1720,7393,5,5,2014,UNK,270,319
4477000270,8/22/2014,565000.0,3,2.0,2730,15677,2.5,0.0,3.0,3,9,2730,0,1976,0,98166,47.4612,-122.365,2040,12209,8,22,2014,UNK,690,3468
3126049094,11/12/2014,392450.0,4,2.0,2195,2681,1.0,0.0,0.0,3,7,1060,1135,1912,0,98103,47.6965,-122.34200000000001,1710,1280,11,12,2014,UNK,485,1401
8682282180,9/23/2014,509000.0,2,2.0,1560,4675,1.0,0.0,0.0,3,8,1560,0,2006,0,98053,47.7086,-122.01899999999999,1870,6361,9,23,2014,N,-310,-1686
1232000810,9/12/2014,340000.0,3,2.5,1400,4800,1.0,0.0,0.0,3,7,1200,200,1921,0,98117,47.6865,-122.37899999999999,1440,3840,9,12,2014,UNK,-40,960
1232000810,3/26/2015,537000.0,3,2.5,1400,4800,1.0,0.0,0.0,3,7,1200,200,1921,0,98117,47.6865,-122.37899999999999,1440,3840,3,26,2015,UNK,-40,960
8691330310,5/5/2014,865000.0,4,3.0,3690,9892,2.0,0.0,0.0,3,10,3690,0,1998,0,98075,47.5937,-121.98200000000001,3430,11294,5,5,2014,UNK,260,-1402
3996900295,12/14/2014,358000.0,2,1.0,1140,8340,1.0,0.0,0.0,3,7,1140,0,1948,0,98155,47.7448,-122.3,1030,8149,12,14,2014,UNK,110,191
117000003,9/19/2014,595000.0,4,2.25,1920,3225,1.5,0.0,0.0,5,7,1300,620,1923,0,98116,47.5848,-122.384,1960,3750,9,19,2014,UNK,-40,-525
1471590060,6/19/2014,661000.0,4,2.5,2496,8058,2.0,0.0,0.0,3,9,2496,0,1998,0,98052,47.6791,-122.149,2496,7757,6,19,2014,UNK,0,301
2558650200,9/16/2014,419950.0,3,2.25,2280,8500,1.0,0.0,0.0,4,7,1680,600,1977,0,98034,47.7211,-122.166,1890,7700,9,16,2014,UNK,390,800
5104531580,4/16/2015,490000.0,4,3.5,3200,6420,2.0,0.0,0.0,3,9,3200,0,2006,0,98038,47.3545,-122.001,3200,6291,4,16,2015,N,0,129
6021503570,9/18/2014,525000.0,2,1.0,880,4000,1.0,0.0,0.0,3,7,880,0,1940,0,98117,47.6847,-122.387,1310,4000,9,18,2014,UNK,-430,0
1862400517,8/13/2014,350000.0,3,2.0,1320,1298,3.0,0.0,0.0,3,7,1320,0,1995,0,98117,47.6959,-122.376,1380,1503,8,13,2014,UNK,-60,-205
2738650030,5/11/2015,552500.0,3,2.5,2450,3582,2.0,0.0,0.0,3,9,2450,0,2008,0,98072,47.7749,-122.15899999999999,2490,5449,5,11,2015,N,-40,-1867
5560000710,3/27/2015,210000.0,3,1.0,1040,8970,1.0,0.0,0.0,4,6,1040,0,1961,0,98023,47.3283,-122.337,1040,8450,3,27,2015,UNK,0,520
7215410320,3/11/2015,390000.0,3,2.5,2480,53250,2.0,0.0,0.0,3,9,2480,0,1990,0,98042,47.3323,-122.079,2510,36549,3,11,2015,UNK,-30,16701
3971700510,1/29/2015,336800.0,5,1.75,1830,16650,1.5,0.0,0.0,3,7,1610,220,1958,0,98155,47.7734,-122.315,1790,12743,1,29,2015,UNK,40,3907
7202330270,3/3/2015,465000.0,3,2.5,1440,4473,2.0,0.0,0.0,3,7,1440,0,2003,0,98053,47.6825,-122.036,1650,3322,3,3,2015,UNK,-210,1151
9542830160,12/18/2014,299900.0,4,2.5,1580,3632,2.0,0.0,0.0,3,7,1580,0,2011,0,98038,47.3672,-122.01899999999999,1950,3800,12,18,2014,N,-370,-168
3630120960,7/18/2014,715000.0,3,3.25,3230,5000,2.0,0.0,0.0,3,9,3230,0,2006,0,98029,47.5558,-122.00200000000001,2670,3977,7,18,2014,N,560,1023
3622059155,5/23/2014,235000.0,4,2.5,1810,39639,1.0,0.0,0.0,3,7,1230,580,1970,0,98042,47.3472,-122.11,1810,44866,5,23,2014,UNK,0,-5227
1687000240,12/10/2014,276000.0,3,2.5,2495,4400,2.0,0.0,0.0,3,8,2495,0,2007,0,98001,47.2877,-122.28299999999999,2434,4400,12,10,2014,N,61,0
4322300340,1/12/2015,265000.0,4,1.5,1740,12728,1.0,0.0,0.0,4,7,1180,560,1964,0,98003,47.2808,-122.3,1830,11125,1,12,2015,UNK,-90,1603
3797000830,5/30/2014,425000.0,3,1.75,1680,3000,1.0,0.0,2.0,4,6,840,840,1900,0,98103,47.68600000000001,-122.346,1540,3700,5,30,2014,UNK,140,-700
4137060270,1/5/2015,313000.0,4,2.5,2460,10320,2.0,0.0,0.0,3,8,2460,0,1993,0,98092,47.2599,-122.215,2210,9024,1,5,2015,UNK,250,1296
7277100640,4/9/2015,715000.0,3,2.5,3050,6000,1.0,0.0,3.0,3,8,1720,1330,1984,0,98177,47.7701,-122.389,2340,7200,4,9,2015,UNK,710,-1200
1312920060,12/12/2014,265000.0,3,2.25,1630,10969,2.0,0.0,0.0,3,7,1630,0,1991,0,98001,47.3305,-122.285,1410,7920,12,12,2014,UNK,220,3049
1472330030,3/24/2015,646000.0,3,2.75,2460,6413,2.0,0.0,0.0,3,9,2460,0,2004,0,98028,47.7497,-122.245,2440,6092,3,24,2015,N,20,321
2973800030,7/21/2014,175000.0,3,1.0,1030,6600,1.0,0.0,0.0,3,7,1030,0,1954,0,98146,47.4941,-122.34,1220,9040,7,21,2014,UNK,-190,-2440
5152920070,7/31/2014,649000.0,3,2.5,3410,13809,1.0,0.0,3.0,4,10,2450,960,1973,0,98003,47.3424,-122.32600000000001,3410,14245,7,31,2014,UNK,0,-436
2021200058,4/23/2015,785000.0,3,2.75,2310,5200,1.0,0.0,0.0,4,7,1520,790,1940,0,98199,47.6357,-122.397,2310,5200,4,23,2015,UNK,0,0
9828202255,9/22/2014,890000.0,4,2.75,2610,4400,1.0,0.0,0.0,5,8,1260,1350,1920,0,98122,47.6158,-122.29299999999999,1770,4400,9,22,2014,UNK,840,0
2126059276,11/26/2014,612000.0,3,3.0,2330,10327,1.0,0.0,0.0,3,9,2330,0,1998,0,98034,47.7239,-122.164,2200,4629,11,26,2014,UNK,130,5698
7796450340,12/5/2014,330000.0,4,2.5,2980,5674,2.0,0.0,0.0,3,8,2980,0,2003,0,98023,47.277,-122.34700000000001,2610,5495,12,5,2014,UNK,370,179
1449000260,11/12/2014,493000.0,3,2.25,1790,11393,1.0,0.0,0.0,3,8,1790,0,1978,0,98052,47.6297,-122.09899999999999,2290,11894,11,12,2014,UNK,-500,-501
8722100570,4/3/2015,1600000.0,4,2.25,2940,5735,1.0,0.0,0.0,3,9,1470,1470,1957,0,98112,47.6381,-122.304,2230,5659,4,3,2015,UNK,710,76
7856400240,6/27/2014,1620000.0,4,3.0,3900,9750,1.0,0.0,4.0,5,10,2520,1380,1972,0,98006,47.5605,-122.15799999999999,3410,9450,6,27,2014,UNK,490,300
7856400240,2/11/2015,1650000.0,4,3.0,3900,9750,1.0,0.0,4.0,5,10,2520,1380,1972,0,98006,47.5605,-122.15799999999999,3410,9450,2,11,2015,UNK,490,300
3037200060,9/26/2014,499000.0,3,2.5,1750,2150,2.5,0.0,0.0,3,7,1230,520,1900,2014,98122,47.6037,-122.311,1410,3300,9,26,2014,Y,340,-1150
6071700160,6/23/2014,603500.0,6,2.75,2660,8400,1.0,0.0,0.0,5,8,1550,1110,1962,0,98006,47.549,-122.17299999999999,2280,8400,6,23,2014,UNK,380,0
7645900055,6/24/2014,530000.0,2,1.5,1580,3680,1.0,0.0,2.0,3,8,1280,300,1941,0,98126,47.5762,-122.37700000000001,1730,3680,6,24,2014,UNK,-150,0
292000070,4/6/2015,895000.0,5,2.5,2350,14197,1.0,0.0,0.0,4,8,1220,1130,1962,0,98004,47.6005,-122.204,2470,11629,4,6,2015,UNK,-120,2568
9510900710,5/13/2014,267345.0,4,2.25,2510,8165,1.0,0.0,0.0,4,7,1610,900,1972,0,98023,47.3092,-122.37200000000001,1940,8250,5,13,2014,UNK,570,-85
1471620240,5/16/2014,275000.0,3,2.5,1480,15639,2.0,0.0,0.0,3,8,1480,0,1987,0,98045,47.4723,-121.74600000000001,1480,16454,5,16,2014,UNK,0,-815
1626079012,2/25/2015,439950.0,3,1.75,1720,223377,1.0,0.0,0.0,3,7,1240,480,1950,0,98019,47.7329,-121.92,2530,221442,2,25,2015,UNK,-810,1935
3904901670,6/20/2014,455000.0,3,2.25,1470,4653,2.0,0.0,0.0,4,7,1470,0,1985,0,98029,47.5667,-122.01799999999999,1560,4119,6,20,2014,UNK,-90,534
8927600070,1/13/2015,630000.0,3,1.75,1540,6930,1.0,0.0,0.0,3,7,1250,290,1944,0,98115,47.6782,-122.27799999999999,1760,6930,1,13,2015,UNK,-220,0
3629970240,11/3/2014,690000.0,3,2.5,2820,5001,2.0,0.0,0.0,3,9,2820,0,2004,0,98029,47.5533,-121.992,2660,5001,11,3,2014,N,160,0
1099610260,8/26/2014,212000.0,4,1.75,1250,12705,1.0,0.0,0.0,4,7,1250,0,1971,0,98023,47.302,-122.382,1390,8550,8,26,2014,UNK,-140,4155
5420300270,8/13/2014,231500.0,4,2.25,2080,7526,1.0,0.0,0.0,4,7,1280,800,1985,0,98030,47.3762,-122.18299999999999,1200,7500,8,13,2014,UNK,880,26
2954400520,4/30/2015,1240000.0,4,3.25,5180,49936,2.0,0.0,0.0,4,10,5180,0,1991,0,98053,47.6676,-122.069,4240,35363,4,30,2015,UNK,940,14573
1121059105,7/8/2014,378500.0,3,2.5,2860,43821,2.0,0.0,0.0,4,9,2860,0,1990,0,98092,47.3163,-122.14200000000001,2370,65340,7,8,2014,UNK,490,-21519
2591720070,5/2/2014,482000.0,4,2.5,2710,35868,2.0,0.0,0.0,3,9,2710,0,1989,0,98038,47.375,-122.022,2780,36224,5,2,2014,UNK,-70,-356
9178600055,5/5/2015,695000.0,2,1.0,1140,3990,1.0,0.0,0.0,3,7,1140,0,1924,0,98103,47.6554,-122.333,1800,5700,5,5,2015,UNK,-660,-1710
9290850800,12/2/2014,965000.0,4,2.5,4070,57587,2.0,0.0,0.0,3,10,4070,0,1989,0,98052,47.6908,-122.052,3890,35960,12,2,2014,UNK,180,21627
5040800060,2/4/2015,675000.0,3,1.75,1710,5913,1.0,0.0,0.0,4,8,1120,590,1941,0,98199,47.6481,-122.406,2920,5922,2,4,2015,UNK,-1210,-9
1437900350,10/27/2014,387000.0,3,1.5,1340,6500,1.0,0.0,0.0,3,7,1340,0,1972,0,98034,47.7168,-122.19200000000001,1620,7107,10,27,2014,UNK,-280,-607
1328300810,3/30/2015,347500.0,4,2.75,2290,7000,2.0,0.0,0.0,3,8,2290,0,1977,0,98058,47.4442,-122.12899999999999,2000,7200,3,30,2015,UNK,290,-200
3990200125,7/11/2014,385000.0,3,2.0,1860,7400,1.0,0.0,0.0,3,8,930,0,1922,2004,98166,47.4598,-122.352,1640,8461,7,11,2014,Y,220,-1061
7452500340,12/4/2014,265000.0,3,1.0,1080,4930,1.0,0.0,0.0,3,6,1080,0,1950,0,98126,47.5209,-122.374,1100,5950,12,4,2014,UNK,-20,-1020
9215400075,4/22/2015,406000.0,3,1.0,960,5264,1.0,0.0,0.0,3,7,960,0,1953,0,98115,47.6805,-122.301,1140,5150,4,22,2015,UNK,-180,114
5061300030,5/8/2014,134000.0,2,1.5,980,5000,2.0,0.0,0.0,3,7,980,0,1922,2003,98014,47.7076,-121.359,1040,5000,5,8,2014,Y,-60,0
3362900696,10/20/2014,415000.0,3,1.0,1500,3399,2.0,0.0,0.0,5,7,1300,200,1926,0,98103,47.6838,-122.352,1360,3588,10,20,2014,UNK,140,-189
2558640340,5/27/2014,375000.0,3,1.75,1440,8775,1.0,0.0,0.0,3,7,1440,0,1973,0,98034,47.7231,-122.17,1790,7865,5,27,2014,UNK,-350,910
8078460810,12/10/2014,620000.0,4,2.5,2580,7465,2.0,0.0,0.0,3,8,2580,0,1993,0,98074,47.6319,-122.022,2350,7596,12,10,2014,UNK,230,-131
538000390,10/28/2014,337500.0,5,2.5,2070,4698,2.0,0.0,0.0,3,7,2070,0,1999,0,98038,47.3539,-122.024,2010,4698,10,28,2014,UNK,60,0
3584900160,9/22/2014,565000.0,3,2.5,1880,12368,1.0,0.0,0.0,4,7,1260,620,1967,0,98005,47.5901,-122.167,1950,11551,9,22,2014,UNK,-70,817
8572900135,5/23/2014,399500.0,3,1.75,2420,12676,2.0,0.0,0.0,3,7,2420,0,1911,1986,98045,47.4943,-121.789,1210,6769,5,23,2014,Y,1210,5907
8056000075,5/21/2014,1070000.0,2,1.75,1890,9466,2.0,0.0,0.0,3,8,1890,0,1987,0,98004,47.6144,-122.211,2180,12825,5,21,2014,UNK,-290,-3359
2972300140,8/21/2014,352500.0,3,2.0,1920,33630,1.0,0.0,0.0,3,8,1920,0,1992,0,98056,47.4983,-122.167,2080,7505,8,21,2014,UNK,-160,26125
7697870350,6/17/2014,259000.0,3,2.0,1870,5909,1.0,0.0,0.0,3,7,1270,600,1986,0,98030,47.3665,-122.18299999999999,1870,7887,6,17,2014,UNK,0,-1978
7972601710,4/15/2015,320000.0,2,1.0,900,7620,1.0,0.0,0.0,3,7,900,0,1971,0,98106,47.5268,-122.34299999999999,1520,7620,4,15,2015,UNK,-620,0
6421100342,8/11/2014,733000.0,3,2.5,2160,9888,2.0,0.0,0.0,4,9,2160,0,1989,0,98052,47.6712,-122.14200000000001,3060,7829,8,11,2014,UNK,-900,2059
2464400340,6/25/2014,381500.0,2,1.0,900,2910,1.0,0.0,0.0,5,7,900,0,1924,0,98115,47.6859,-122.322,1320,2910,6,25,2014,UNK,-420,0
8113101232,12/2/2014,343000.0,2,1.0,1180,9261,1.0,0.0,0.0,4,7,940,240,1957,0,98118,47.5492,-122.274,1700,6325,12,2,2014,UNK,-520,2936
5706500140,8/18/2014,205500.0,2,1.0,900,6400,1.0,0.0,0.0,5,6,900,0,1938,0,98022,47.2113,-121.992,1320,6400,8,18,2014,UNK,-420,0
1024069037,9/15/2014,525000.0,3,2.0,1600,16530,1.0,0.0,0.0,5,7,1600,0,1967,0,98075,47.5821,-122.016,1850,41006,9,15,2014,UNK,-250,-24476
9476700135,3/19/2015,300000.0,3,1.75,1500,8352,1.0,0.0,2.0,5,6,750,750,1943,0,98056,47.4883,-122.191,1500,8447,3,19,2015,UNK,0,-95
1926069035,7/22/2014,299000.0,2,1.0,1070,189486,1.0,0.0,0.0,3,6,1070,0,1942,0,98077,47.7199,-122.085,1970,60548,7,22,2014,UNK,-900,128938
3904990030,7/9/2014,561000.0,4,2.5,2570,5250,2.0,0.0,0.0,3,8,2570,0,1990,0,98029,47.5763,-122.0,2260,5392,7,9,2014,UNK,310,-142
7132300550,2/24/2015,450000.0,3,1.0,1210,4000,1.5,0.0,0.0,3,7,1090,120,1928,0,98144,47.5934,-122.30799999999999,1210,4000,2,24,2015,UNK,0,0
2193340140,8/14/2014,540000.0,4,2.5,1850,7850,2.0,0.0,0.0,3,8,1850,0,1985,0,98052,47.6914,-122.103,1830,8140,8,14,2014,UNK,20,-290
1422300160,6/24/2014,379000.0,3,2.5,1740,30886,2.0,0.0,0.0,3,8,1740,0,1992,0,98045,47.46,-121.70700000000001,1740,39133,6,24,2014,UNK,0,-8247
2946000751,7/24/2014,230000.0,3,1.0,1300,14000,1.0,0.0,0.0,4,7,1300,0,1958,0,98198,47.4213,-122.322,1390,8750,7,24,2014,UNK,-90,5250
1796250140,3/10/2015,399950.0,3,2.5,2000,30605,2.0,0.0,0.0,4,8,2000,0,1989,0,98042,47.3442,-122.06200000000001,1930,35350,3,10,2015,UNK,70,-4745
6699001200,5/7/2015,355000.0,5,2.5,3220,5806,2.0,0.0,0.0,3,8,3220,0,2002,0,98042,47.3714,-122.103,2760,5813,5,7,2015,UNK,460,-7
7525300310,6/19/2014,580000.0,4,2.25,2160,9593,1.0,0.0,0.0,3,8,2160,0,1969,0,98008,47.5883,-122.11200000000001,2820,9628,6,19,2014,UNK,-660,-35
5700000340,4/27/2015,700000.0,3,2.0,2130,4299,1.5,0.0,0.0,4,7,1680,450,1922,0,98144,47.5779,-122.294,2040,4548,4,27,2015,UNK,90,-249
3210400340,5/6/2014,279900.0,3,1.75,1580,8151,1.0,0.0,1.0,4,7,1100,480,1962,0,98198,47.3672,-122.31200000000001,1650,8151,5,6,2014,UNK,-70,0
179003055,11/13/2014,210000.0,3,1.0,1200,7500,1.0,0.0,0.0,3,6,1200,0,1905,1989,98178,47.4921,-122.275,1010,7000,11,13,2014,Y,190,500
9829200566,6/30/2014,1170000.0,3,3.0,3790,5001,2.0,0.0,0.0,3,10,2810,980,1989,0,98122,47.6035,-122.285,2500,6286,6,30,2014,UNK,1290,-1285
1723059050,6/11/2014,290300.0,2,1.0,860,3874,1.0,0.0,0.0,4,6,860,0,1931,0,98055,47.4836,-122.204,1400,5106,6,11,2014,UNK,-540,-1232
2624059036,10/3/2014,1600000.0,5,4.5,5130,43123,2.0,0.0,0.0,3,11,5130,0,1996,0,98006,47.544,-122.126,4670,43560,10,3,2014,UNK,460,-437
5101406441,4/16/2015,490000.0,3,1.0,1600,6380,1.5,0.0,0.0,3,7,1400,200,1939,0,98125,47.7015,-122.31700000000001,1760,6380,4,16,2015,UNK,-160,0
8582010240,5/6/2014,606000.0,4,2.5,2110,13850,2.0,0.0,0.0,3,9,2110,0,1987,0,98027,47.5497,-122.07700000000001,2520,10194,5,6,2014,UNK,-410,3656
6300500505,7/14/2014,359950.0,3,1.0,1400,4980,1.0,0.0,0.0,3,6,950,450,1943,0,98133,47.7041,-122.34,990,4980,7,14,2014,UNK,410,0
3275890310,2/12/2015,677100.0,3,2.0,2110,9199,1.0,0.0,0.0,3,10,2110,0,1993,0,98074,47.6496,-122.083,3130,8841,2,12,2015,UNK,-1020,358
7715801040,2/21/2015,465000.0,3,2.0,1430,7125,1.0,0.0,0.0,4,7,1430,0,1984,0,98074,47.6256,-122.059,1570,8075,2,21,2015,UNK,-140,-950
7738500731,8/15/2014,4500000.0,5,5.5,6640,40014,2.0,1.0,4.0,3,12,6350,290,2004,0,98155,47.7493,-122.28,3030,23408,8,15,2014,N,3610,16606
1822079046,5/4/2015,500000.0,3,2.0,3040,41072,1.0,0.0,0.0,4,8,1520,1520,1978,0,98038,47.3944,-121.97200000000001,2230,54014,5,4,2015,UNK,810,-12942
1062100075,5/3/2015,455000.0,2,1.0,980,5000,1.0,0.0,0.0,4,7,980,0,1950,0,98155,47.7518,-122.279,1600,5965,5,3,2015,UNK,-620,-965
8825900070,8/18/2014,705000.0,6,2.0,2570,4240,1.5,0.0,0.0,4,7,1970,600,1911,0,98115,47.6754,-122.307,2030,4240,8,18,2014,UNK,540,0
1158700135,8/12/2014,420000.0,3,2.5,2060,7020,1.0,0.0,0.0,4,8,1460,600,1967,0,98177,47.7575,-122.36399999999999,2150,8400,8,12,2014,UNK,-90,-1380
7983000200,10/5/2014,169575.0,3,1.0,1300,8284,1.0,0.0,0.0,3,7,1300,0,1968,0,98003,47.3327,-122.306,1360,7848,10,5,2014,UNK,-60,436
7983000200,2/25/2015,250000.0,3,1.0,1300,8284,1.0,0.0,0.0,3,7,1300,0,1968,0,98003,47.3327,-122.306,1360,7848,2,25,2015,UNK,-60,436
1727510030,3/12/2015,530000.0,3,2.25,1680,7262,1.0,0.0,0.0,5,7,1180,500,1973,0,98034,47.713,-122.225,1910,7405,3,12,2015,UNK,-230,-143
3286800370,2/6/2015,590000.0,5,3.25,4020,40341,1.0,0.0,0.0,5,8,2170,1850,1970,0,98027,47.4952,-122.068,2650,53437,2,6,2015,UNK,1370,-13096
6791400320,9/23/2014,257500.0,3,1.75,1530,14087,1.0,0.0,0.0,3,7,1070,460,1979,0,98042,47.3146,-122.04299999999999,1770,13660,9,23,2014,UNK,-240,427
3992700036,6/26/2014,415000.0,3,1.0,1170,6700,1.0,0.0,0.0,3,8,1170,0,1957,0,98125,47.7122,-122.29,2410,7620,6,26,2014,UNK,-1240,-920
1175000059,10/10/2014,536000.0,3,1.75,1580,3764,1.5,0.0,0.0,3,7,1280,300,1945,0,98107,47.672,-122.397,1560,3764,10,10,2014,UNK,20,0
8732000390,5/29/2014,246500.0,3,1.5,1270,11600,1.0,0.0,0.0,4,7,1270,0,1964,0,98031,47.4075,-122.196,1380,9945,5,29,2014,UNK,-110,1655
1441800030,7/6/2014,395000.0,3,1.75,1480,7700,1.0,0.0,0.0,3,8,1480,0,1975,0,98034,47.7225,-122.20200000000001,1930,8560,7,6,2014,UNK,-450,-860
4045800030,5/11/2015,739000.0,3,2.25,2220,10530,1.0,0.0,0.0,4,8,1700,520,1974,0,98052,47.6383,-122.098,2500,10014,5,11,2015,UNK,-280,516
1727850340,9/29/2014,1270000.0,4,2.75,3200,13729,2.0,0.0,0.0,3,11,3200,0,1984,0,98005,47.6402,-122.171,4050,16921,9,29,2014,UNK,-850,-3192
2268000370,7/8/2014,190000.0,3,1.0,910,10575,1.0,0.0,0.0,4,7,910,0,1968,0,98003,47.2741,-122.301,1470,10425,7,8,2014,UNK,-560,150
2023049350,4/10/2015,305000.0,3,1.5,1480,9086,1.0,0.0,0.0,3,7,1480,0,1962,0,98168,47.4717,-122.323,1540,9750,4,10,2015,UNK,-60,-664
7018000560,4/20/2015,925000.0,4,4.25,3770,13058,2.0,0.0,0.0,4,8,3770,0,1983,0,98028,47.7517,-122.225,2200,12255,4,20,2015,UNK,1570,803
4147200140,8/21/2014,895000.0,4,3.0,3500,13444,2.0,0.0,0.0,3,10,2360,1140,1977,0,98040,47.5468,-122.23100000000001,3140,12935,8,21,2014,UNK,360,509
3176600055,7/17/2014,656000.0,3,1.75,1480,7475,1.5,0.0,0.0,3,8,1480,0,1943,0,98115,47.6732,-122.272,2120,7216,7,17,2014,UNK,-640,259
7518500885,5/19/2014,560000.0,4,1.0,1660,4690,1.5,0.0,0.0,3,7,1260,400,1945,0,98117,47.6829,-122.37799999999999,1400,3876,5,19,2014,UNK,260,814
7504020810,10/20/2014,610000.0,5,2.25,2520,11700,2.0,0.0,0.0,3,9,2520,0,1977,0,98074,47.6322,-122.053,2530,12000,10,20,2014,UNK,-10,-300
3276930370,7/8/2014,645000.0,4,2.5,2850,37522,2.0,0.0,0.0,3,9,2850,0,1987,0,98075,47.5852,-121.992,2980,35280,7,8,2014,UNK,-130,2242
1687000200,4/10/2015,259000.0,3,2.5,2153,4400,2.0,0.0,0.0,3,8,2153,0,2007,0,98001,47.2872,-122.28299999999999,2434,4400,4,10,2015,N,-281,0
7501000340,8/18/2014,980000.0,4,2.5,3780,10962,2.0,0.0,0.0,3,10,3780,0,1990,0,98033,47.6533,-122.18299999999999,3310,11651,8,18,2014,UNK,470,-689
7611200136,7/23/2014,872000.0,4,4.0,3770,9750,1.0,0.0,0.0,4,9,1940,1830,1967,0,98177,47.7159,-122.367,2260,9878,7,23,2014,UNK,1510,-128
5459500125,8/5/2014,1000000.0,6,2.75,3600,9675,1.0,0.0,2.0,4,9,1940,1660,1977,0,98040,47.5726,-122.213,2990,9675,8,5,2014,UNK,610,0
825059271,9/10/2014,900000.0,3,2.75,2980,12600,1.5,0.0,0.0,3,8,1590,1390,1941,2012,98033,47.674,-122.196,1520,9660,9,10,2014,Y,1460,2940
9465200181,4/28/2015,475000.0,4,1.5,2320,5534,1.5,0.0,0.0,4,7,1540,780,1915,0,98103,47.6944,-122.355,1670,5913,4,28,2015,UNK,650,-379
5469502860,1/7/2015,350000.0,5,2.75,2980,13482,1.0,0.0,0.0,4,8,1730,1250,1975,0,98042,47.3774,-122.16,2900,14800,1,7,2015,UNK,80,-1318
486000565,5/15/2014,840000.0,4,1.75,2930,11562,1.0,0.0,3.0,3,9,1670,1260,1947,0,98117,47.6765,-122.404,2530,6517,5,15,2014,UNK,400,5045
6071900070,6/22/2014,500000.0,4,2.5,2040,8400,1.0,0.0,0.0,3,8,1420,620,1963,0,98006,47.5512,-122.17,2540,8925,6,22,2014,UNK,-500,-525
7957600075,4/6/2015,202500.0,3,1.5,1510,9898,1.0,0.0,0.0,3,7,1110,400,1954,0,98148,47.4303,-122.334,1420,9250,4,6,2015,UNK,90,648
823069074,12/23/2014,523000.0,4,2.5,2660,65340,2.0,0.0,0.0,3,8,2660,0,1988,0,98027,47.4969,-122.06,2850,74052,12,23,2014,UNK,-190,-8712
2366800055,12/3/2014,225000.0,3,2.5,1740,10050,2.0,0.0,0.0,3,7,1740,0,1989,0,98001,47.2671,-122.236,1300,10125,12,3,2014,UNK,440,-75
7272001805,3/9/2015,418200.0,3,2.25,2240,9542,1.0,0.0,1.0,3,7,1190,1050,1980,0,98198,47.3995,-122.318,2080,9542,3,9,2015,UNK,160,0
3582700070,12/5/2014,356500.0,4,1.75,1570,9670,1.0,0.0,0.0,3,7,1170,400,1959,0,98028,47.7432,-122.24799999999999,2080,9100,12,5,2014,UNK,-510,570
2402100055,7/16/2014,670000.0,4,3.0,2500,5000,1.5,0.0,0.0,4,7,1460,0,1926,0,98103,47.6895,-122.331,1720,4500,7,16,2014,UNK,780,500
5146000070,12/4/2014,456150.0,3,2.25,1750,12408,1.0,0.0,0.0,5,7,1150,600,1962,0,98155,47.7509,-122.3,1820,12977,12,4,2014,UNK,-70,-569
2607760890,6/3/2014,471000.0,4,2.5,3030,9687,2.0,0.0,0.0,3,8,2020,1010,1998,0,98045,47.485,-121.79899999999999,2050,10193,6,3,2014,UNK,980,-506
9274200316,4/9/2015,558000.0,3,2.5,1680,934,3.0,0.0,0.0,3,8,1680,0,2008,0,98116,47.5891,-122.387,1740,1280,4,9,2015,N,-60,-346
4139500200,3/5/2015,1380000.0,6,4.5,5740,10312,2.0,0.0,2.0,3,11,3610,2130,2000,0,98006,47.5533,-122.11,4350,11917,3,5,2015,UNK,1390,-1605
3021059155,12/12/2014,161500.0,3,1.0,1220,6000,1.0,0.0,0.0,5,7,1220,0,1961,0,98002,47.2811,-122.214,1420,13137,12,12,2014,UNK,-200,-7137
3580900160,10/10/2014,311000.0,3,1.0,1310,8370,1.5,0.0,0.0,3,7,1310,0,1962,0,98034,47.7284,-122.241,1310,8370,10,10,2014,UNK,0,0
3876000350,2/24/2015,470000.0,6,1.75,2490,8732,1.5,0.0,0.0,4,8,2490,0,1966,0,98034,47.7252,-122.18700000000001,1840,8024,2,24,2015,UNK,650,708
3959400400,7/9/2014,569000.0,3,3.25,2220,8227,1.5,0.0,0.0,5,8,1770,450,1929,0,98108,47.5665,-122.316,1750,4800,7,9,2014,UNK,470,3427
8079100700,3/18/2015,689000.0,4,2.5,2240,7350,2.0,0.0,0.0,3,9,2240,0,1989,0,98029,47.5652,-122.01299999999999,2200,8017,3,18,2015,UNK,40,-667
9407001610,7/15/2014,271900.0,3,1.75,1890,11875,1.0,0.0,0.0,3,7,1230,660,1979,0,98045,47.4472,-121.774,1580,10920,7,15,2014,UNK,310,955
8700120270,12/10/2014,278000.0,4,2.5,1850,6037,2.0,0.0,0.0,3,7,1850,0,1991,0,98030,47.358999999999995,-122.191,1860,6037,12,10,2014,UNK,-10,0
3204300860,7/23/2014,820000.0,2,2.5,2210,4440,2.0,0.0,0.0,4,8,1440,770,1931,0,98112,47.6305,-122.3,1560,4920,7,23,2014,UNK,650,-480
3204800520,2/25/2015,399500.0,3,1.75,1410,7700,1.0,0.0,0.0,4,7,1410,0,1967,0,98056,47.5375,-122.176,1560,7700,2,25,2015,UNK,-150,0
8857320260,11/5/2014,462000.0,3,2.75,1890,2614,2.0,0.0,0.0,4,9,1890,0,1979,0,98008,47.6102,-122.11399999999999,1800,2769,11,5,2014,UNK,90,-155
6791400800,4/13/2015,347500.0,3,1.0,1830,12036,1.0,0.0,0.0,3,7,1550,280,1977,0,98042,47.3126,-122.04299999999999,1810,12036,4,13,2015,UNK,20,0
2768000270,6/25/2014,562100.0,2,0.75,1440,3700,1.0,0.0,0.0,3,7,1200,240,1914,0,98107,47.6707,-122.36399999999999,1440,4300,6,25,2014,UNK,0,-600
1432400060,5/29/2014,230000.0,2,1.0,950,7560,1.0,0.0,0.0,3,6,950,0,1958,0,98058,47.4499,-122.176,1160,7560,5,29,2014,UNK,-210,0
2547200240,6/22/2014,687000.0,4,2.5,2370,10083,2.0,0.0,0.0,5,8,2370,0,1966,0,98033,47.6715,-122.166,2370,10133,6,22,2014,UNK,0,-50
6441800060,12/9/2014,725786.0,4,2.5,3070,5762,2.0,0.0,0.0,3,10,3070,0,2000,0,98075,47.5847,-122.08,3630,6500,12,9,2014,UNK,-560,-738
1775800710,1/26/2015,315500.0,3,1.0,1300,12600,1.0,0.0,0.0,4,7,1300,0,1969,0,98072,47.7422,-122.1,1480,13530,1,26,2015,UNK,-180,-930
7694600253,5/6/2014,312000.0,4,2.0,1300,7054,1.0,0.0,0.0,3,7,1300,0,1950,2013,98146,47.5071,-122.369,1560,7100,5,6,2014,Y,-260,-46
8910500238,11/6/2014,343000.0,3,3.25,1210,1173,2.0,0.0,0.0,3,8,1000,210,2002,0,98133,47.7114,-122.35600000000001,1650,1493,11,6,2014,UNK,-440,-320
3076500830,10/29/2014,385195.0,1,1.0,710,6000,1.5,0.0,0.0,3,6,710,0,2015,0,98144,47.5756,-122.316,1440,4800,10,29,2014,N,-730,1200
1072030510,8/29/2014,415000.0,4,2.25,2240,12650,1.0,0.0,0.0,4,8,1730,510,1981,0,98059,47.4777,-122.14200000000001,2150,12650,8,29,2014,UNK,90,0
3888100226,6/30/2014,461000.0,3,1.75,3600,8666,2.0,0.0,0.0,4,6,2400,1200,1948,0,98033,47.6893,-122.167,2290,8200,6,30,2014,UNK,1310,466
7227501369,6/10/2014,369990.0,4,2.5,1960,7133,2.0,0.0,0.0,3,7,1960,0,2002,0,98056,47.4941,-122.19,1960,6705,6,10,2014,UNK,0,428
3820350070,9/29/2014,349950.0,4,2.5,1820,3134,2.0,0.0,0.0,3,7,1820,0,1999,0,98019,47.7351,-121.985,1820,3751,9,29,2014,UNK,0,-617
7616800350,4/12/2015,285750.0,3,2.25,1960,17126,1.0,0.0,0.0,3,8,1400,560,1966,0,98055,47.4436,-122.21,2060,11466,4,12,2015,UNK,-100,5660
7811210200,4/20/2015,542500.0,4,2.25,1750,10160,1.0,0.0,0.0,3,8,1320,430,1972,0,98005,47.5909,-122.15799999999999,2170,11165,4,20,2015,UNK,-420,-1005
6891100260,11/11/2014,830000.0,5,3.5,3700,5400,2.0,0.0,0.0,3,9,2890,810,2011,0,98053,47.7085,-122.117,3620,5460,11,11,2014,N,80,-60
6076500160,12/23/2014,705000.0,4,2.5,2910,20946,2.0,0.0,0.0,4,8,2350,560,1976,0,98034,47.7085,-122.24,2020,11342,12,23,2014,UNK,890,9604
2872100445,6/24/2014,615000.0,2,1.0,1270,5000,1.0,0.0,0.0,3,8,1090,180,1949,0,98117,47.6828,-122.39299999999999,1640,5000,6,24,2014,UNK,-370,0
3352400004,1/29/2015,184500.0,2,1.0,720,5880,1.0,0.0,0.0,3,6,720,0,1940,0,98178,47.5056,-122.27,1440,7200,1,29,2015,UNK,-720,-1320
7942601200,10/1/2014,412000.0,2,1.0,1040,5120,1.0,0.0,0.0,3,7,1040,0,1901,0,98122,47.6048,-122.31200000000001,1250,4000,10,1,2014,UNK,-210,1120
985001266,12/15/2014,250000.0,3,1.5,2210,11111,1.5,0.0,0.0,3,7,2210,0,1934,0,98168,47.492,-122.309,1250,8422,12,15,2014,UNK,960,2689
2218000390,6/12/2014,580000.0,5,2.0,2060,6000,2.0,0.0,0.0,3,7,2060,0,1903,0,98105,47.6685,-122.305,1770,5000,6,12,2014,UNK,290,1000
7231502505,3/12/2015,220000.0,2,1.0,780,6000,1.0,0.0,0.0,5,6,780,0,1923,0,98055,47.4759,-122.208,1080,6000,3,12,2015,UNK,-300,0
7555220140,9/16/2014,675000.0,4,2.75,2240,8937,1.0,0.0,0.0,4,8,1460,780,1976,0,98033,47.6495,-122.194,2360,9038,9,16,2014,UNK,-120,-101
7445000105,5/22/2014,373500.0,2,1.0,800,3330,1.0,0.0,0.0,3,7,800,0,1918,0,98107,47.6566,-122.35799999999999,1300,4320,5,22,2014,UNK,-500,-990
5583200810,4/2/2015,662700.0,2,1.5,2440,6900,2.0,0.0,0.0,3,7,1590,850,1910,0,98118,47.5568,-122.271,1770,6900,4,2,2015,UNK,670,0
7340600827,5/16/2014,239950.0,5,1.0,1460,6032,2.0,0.0,0.0,4,6,1460,0,1941,0,98168,47.486999999999995,-122.28200000000001,1060,10300,5,16,2014,UNK,400,-4268
7436900045,9/25/2014,383000.0,3,1.0,1150,10196,1.0,0.0,0.0,4,7,1150,0,1957,0,98052,47.6788,-122.162,1410,8925,9,25,2014,UNK,-260,1271
4027701294,1/29/2015,485000.0,3,2.75,2650,12350,1.0,0.0,0.0,4,7,1470,1180,1975,0,98028,47.7669,-122.26799999999999,1950,14075,1,29,2015,UNK,700,-1725
3570000160,7/10/2014,610000.0,4,2.75,2600,36583,1.0,0.0,0.0,5,8,1580,1020,1976,0,98075,47.593,-122.054,2300,27820,7,10,2014,UNK,300,8763
9276202190,8/8/2014,545000.0,6,1.75,1820,6250,1.0,0.0,0.0,3,7,1130,690,1954,0,98116,47.57899999999999,-122.39,1820,5750,8,8,2014,UNK,0,500
5016002180,7/8/2014,780000.0,2,2.5,2560,2500,2.0,0.0,0.0,5,8,1690,870,1901,0,98112,47.6233,-122.3,1890,5000,7,8,2014,UNK,670,-2500
7300000550,4/24/2015,305000.0,3,2.5,1714,3240,2.0,0.0,0.0,3,8,1714,0,2005,0,98055,47.4288,-122.19,1714,3240,4,24,2015,N,0,0
6817810310,6/12/2014,405000.0,3,1.0,1330,15678,1.0,0.0,0.0,3,7,900,430,1984,0,98074,47.6355,-122.037,1330,12696,6,12,2014,UNK,0,2982
7851980260,7/30/2014,1110000.0,5,3.5,7350,12231,2.0,0.0,4.0,3,11,4750,2600,2001,0,98065,47.5373,-121.865,5380,12587,7,30,2014,UNK,1970,-356
1423400260,4/2/2015,273000.0,3,1.75,2050,9045,2.0,0.0,0.0,4,6,2050,0,1959,0,98058,47.4572,-122.18,1200,9045,4,2,2015,UNK,850,0
3876810140,5/27/2014,326500.0,3,1.0,1810,12375,2.0,0.0,0.0,3,7,1810,0,1970,0,98072,47.7427,-122.17200000000001,1420,9357,5,27,2014,UNK,390,3018
3276180140,4/24/2015,365000.0,3,1.75,1380,9134,1.0,0.0,0.0,5,7,880,500,1981,0,98056,47.5087,-122.193,1400,8190,4,24,2015,UNK,-20,944
9808590310,4/8/2015,1000000.0,3,2.75,3070,10739,2.0,0.0,0.0,3,10,2440,630,1987,0,98004,47.6444,-122.191,3490,11913,4,8,2015,UNK,-420,-1174
546000045,3/25/2015,422500.0,2,1.0,800,4046,1.0,0.0,0.0,3,7,800,0,1940,0,98117,47.6895,-122.382,1400,4046,3,25,2015,UNK,-600,0
2595650060,3/24/2015,354450.0,4,2.75,2140,9920,2.0,0.0,0.0,3,8,2140,0,1993,0,98001,47.3529,-122.274,2130,9920,3,24,2015,UNK,10,0
1771110550,12/4/2014,320000.0,3,1.0,1330,9540,1.0,0.0,0.0,4,7,1330,0,1971,0,98077,47.758,-122.075,1250,10350,12,4,2014,UNK,80,-810
5335700030,6/3/2014,223000.0,3,1.0,1030,9120,1.0,0.0,0.0,3,7,1030,0,1961,0,98032,47.3607,-122.291,1470,10220,6,3,2014,UNK,-440,-1100
7203101580,7/24/2014,410000.0,3,2.5,1740,4948,2.0,0.0,0.0,3,7,1740,0,2008,0,98053,47.6966,-122.025,1290,3383,7,24,2014,N,450,1565
272000125,8/29/2014,438000.0,3,1.0,1200,4000,1.5,0.0,0.0,4,6,1200,0,1923,0,98144,47.5881,-122.29899999999999,1390,4000,8,29,2014,UNK,-190,0
2770601741,11/6/2014,390000.0,3,3.0,1490,2944,2.0,0.0,0.0,3,7,960,530,1993,0,98199,47.6506,-122.384,1590,1600,11,6,2014,UNK,-100,1344
4250200140,2/19/2015,298500.0,4,2.5,1890,5954,2.0,0.0,0.0,3,7,1890,0,2004,0,98092,47.3293,-122.194,2030,5880,2,19,2015,N,-140,74
8965400390,9/5/2014,749999.0,5,2.25,3060,13630,2.0,0.0,0.0,3,10,3060,0,1989,0,98006,47.5585,-122.117,3430,10700,9,5,2014,UNK,-370,2930
5071401000,8/29/2014,779000.0,6,2.5,3250,12000,1.0,0.0,1.0,3,8,1800,1450,1966,0,98115,47.6935,-122.28,3490,10320,8,29,2014,UNK,-240,1680
3760500435,1/14/2015,570000.0,3,2.75,2730,11936,2.0,0.0,2.0,3,8,1530,1200,1978,0,98034,47.6987,-122.23100000000001,2810,12333,1,14,2015,UNK,-80,-397
5680000260,5/12/2015,385000.0,3,1.0,810,4600,1.0,0.0,0.0,3,6,810,0,1918,0,98144,47.5712,-122.316,1520,4800,5,12,2015,UNK,-710,-200
9170500060,8/18/2014,649000.0,4,2.0,2240,11040,1.0,0.0,0.0,5,8,1120,1120,1961,0,98033,47.69300000000001,-122.16799999999999,1790,11040,8,18,2014,UNK,450,0
795000885,10/1/2014,283000.0,3,1.0,1740,5247,1.0,0.0,0.0,3,7,1270,470,1947,0,98168,47.5049,-122.329,1070,5636,10,1,2014,UNK,670,-389
4038600260,9/22/2014,699900.0,4,2.25,2380,16236,1.0,0.0,0.0,3,7,1540,840,1961,0,98008,47.6126,-122.12,2230,8925,9,22,2014,UNK,150,7311
4406000560,2/20/2015,278500.0,4,1.0,1540,8400,1.0,0.0,0.0,3,7,770,770,1971,0,98058,47.4278,-122.152,1520,9891,2,20,2015,UNK,20,-1491
2260000340,11/15/2014,700000.0,4,1.75,2340,9100,1.0,0.0,0.0,3,8,1610,730,1975,0,98052,47.6401,-122.10799999999999,2470,11000,11,15,2014,UNK,-130,-1900
9510310030,7/28/2014,535000.0,4,2.75,2710,45963,2.0,0.0,0.0,3,9,2710,0,1995,0,98045,47.4745,-121.72399999999999,2710,33955,7,28,2014,UNK,0,12008
4245400045,9/23/2014,234500.0,3,1.75,1310,18400,1.0,0.0,0.0,3,7,870,440,1954,0,98168,47.5035,-122.302,1840,10790,9,23,2014,UNK,-530,7610
9371700132,8/6/2014,374150.0,3,1.75,1390,9585,1.0,0.0,0.0,4,7,1390,0,1973,0,98133,47.751999999999995,-122.35,1240,8188,8,6,2014,UNK,150,1397
7272001610,3/17/2015,397000.0,4,2.5,2201,9542,2.0,0.0,0.0,3,8,2201,0,2006,0,98198,47.4002,-122.31700000000001,1990,9542,3,17,2015,N,211,0
1324059139,9/18/2014,613000.0,3,2.25,1960,10385,1.0,0.0,0.0,3,8,1960,0,1988,0,98008,47.5736,-122.109,2800,12632,9,18,2014,UNK,-840,-2247
1552100135,6/9/2014,1150000.0,3,2.5,2850,10474,1.0,0.0,0.0,4,8,1730,1120,1954,0,98004,47.6218,-122.209,2820,10474,6,9,2014,UNK,30,0
1257200060,3/27/2015,595000.0,4,1.75,1880,4080,1.0,0.0,0.0,3,7,940,940,1924,0,98115,47.6754,-122.32700000000001,1410,4080,3,27,2015,UNK,470,0
2822059350,9/10/2014,340000.0,5,2.75,2440,6858,2.0,0.0,0.0,3,8,2440,0,2003,0,98030,47.3655,-122.17399999999999,2300,6858,9,10,2014,UNK,140,0
2781260070,1/8/2015,388000.0,4,2.5,2560,5800,2.0,0.0,0.0,3,9,2560,0,2005,0,98038,47.3474,-122.025,3040,5800,1,8,2015,N,-480,0
619000045,9/22/2014,404000.0,3,1.75,1410,15210,1.0,0.0,0.0,3,7,1410,0,1950,2014,98166,47.4181,-122.339,1970,16290,9,22,2014,Y,-560,-1080
8934100125,8/29/2014,810000.0,3,2.0,2870,6360,1.5,0.0,1.0,4,8,1790,1080,1946,0,98115,47.6813,-122.275,2310,6466,8,29,2014,UNK,560,-106
2472920140,4/3/2015,405000.0,4,2.5,2620,9359,2.0,0.0,0.0,3,9,2620,0,1987,0,98058,47.438,-122.152,2580,7433,4,3,2015,UNK,40,1926
7215730310,7/14/2014,726000.0,5,3.0,2970,10335,2.0,0.0,0.0,3,9,2970,0,2000,0,98075,47.598,-122.01899999999999,2970,10335,7,14,2014,UNK,0,0
7697870310,5/14/2014,266000.0,3,2.5,1780,7214,1.0,0.0,0.0,4,7,1400,380,1986,0,98030,47.3667,-122.182,1520,7228,5,14,2014,UNK,260,-14
2795000060,12/22/2014,722500.0,5,2.25,3700,7207,1.0,0.0,1.0,5,8,1850,1850,1970,0,98177,47.7736,-122.37100000000001,2340,7900,12,22,2014,UNK,1360,-693
2408600160,2/28/2015,352000.0,4,2.5,1252,25002,1.0,0.0,0.0,3,8,992,260,1996,0,98001,47.3216,-122.291,1860,25002,2,28,2015,UNK,-608,0
7888200240,3/19/2015,265000.0,4,1.5,1240,8158,1.0,0.0,0.0,4,7,1110,130,1961,0,98198,47.3716,-122.31,1520,8147,3,19,2015,UNK,-280,11
151000075,2/6/2015,856000.0,3,2.5,2160,3920,2.0,0.0,0.0,3,9,2160,0,2014,0,98116,47.5762,-122.415,1500,4920,2,6,2015,N,660,-1000
5104530240,7/24/2014,346950.0,3,2.5,2040,4348,2.0,0.0,0.0,4,8,2040,0,2006,0,98038,47.3517,-121.999,2380,4348,7,24,2014,N,-340,0
4139680070,6/17/2014,866059.0,5,3.5,3130,4797,2.0,0.0,0.0,3,9,2570,560,2014,0,98006,47.5664,-122.12899999999999,3440,5439,6,17,2014,N,-310,-642
7852180260,1/29/2015,410000.0,3,2.5,2350,4456,2.0,0.0,0.0,3,7,2350,0,2004,0,98065,47.5314,-121.854,2350,4456,1,29,2015,N,0,0
1471610060,7/8/2014,370000.0,3,1.75,1570,16817,2.0,0.0,0.0,3,7,1570,0,1982,0,98045,47.4716,-121.756,1600,16817,7,8,2014,UNK,-30,0
3520069033,6/23/2014,230000.0,3,1.0,1530,389126,1.5,0.0,0.0,4,7,1530,0,1919,0,98022,47.1776,-122.01100000000001,1768,42148,6,23,2014,UNK,-238,346978
9268200550,10/10/2014,400000.0,2,2.0,1520,5010,1.0,0.0,0.0,3,7,1520,0,1999,0,98117,47.6948,-122.36399999999999,1110,5040,10,10,2014,UNK,410,-30
1788700295,3/11/2015,172000.0,3,1.0,1350,9680,1.0,0.0,0.0,4,7,820,530,1959,0,98023,47.3274,-122.346,1320,9225,3,11,2015,UNK,30,455
7379600240,7/14/2014,615000.0,3,1.75,1950,8480,1.0,0.0,0.0,4,8,1250,700,1962,0,98007,47.5893,-122.15,1740,8480,7,14,2014,UNK,210,0
8691330060,4/7/2015,860000.0,4,3.5,3950,9600,2.0,0.0,0.0,3,10,3950,0,1998,0,98075,47.5945,-121.98100000000001,3110,10213,4,7,2015,UNK,840,-613
6384500581,6/18/2014,555000.0,3,1.75,2040,6000,1.0,0.0,0.0,5,7,1120,920,1958,0,98116,47.5688,-122.397,1530,6250,6,18,2014,UNK,510,-250
6690500070,7/21/2014,579000.0,3,2.5,1990,4040,1.5,0.0,0.0,5,8,1390,600,1926,0,98103,47.6867,-122.354,1180,3030,7,21,2014,UNK,810,1010
3205400140,6/30/2014,385000.0,3,1.75,1300,7030,1.0,0.0,0.0,3,7,1300,0,1968,0,98034,47.721000000000004,-122.179,1450,7650,6,30,2014,UNK,-150,-620
6662410070,4/14/2015,420000.0,4,2.25,2030,12000,2.0,0.0,0.0,3,7,2030,0,1977,0,98011,47.7699,-122.16799999999999,2190,9900,4,14,2015,UNK,-160,2100
1919800260,7/16/2014,645000.0,3,1.75,2340,6750,1.5,0.0,0.0,5,7,1620,720,1914,0,98103,47.6956,-122.335,1410,3388,7,16,2014,UNK,930,3362
7283900045,4/28/2015,549950.0,3,2.5,2160,6288,2.0,0.0,0.0,3,8,2160,0,1996,0,98133,47.7655,-122.35,1830,7600,4,28,2015,UNK,330,-1312
3756100160,9/23/2014,678000.0,3,2.75,2770,10000,1.0,0.0,1.0,5,8,1640,1130,1962,0,98033,47.7011,-122.206,2450,10000,9,23,2014,UNK,320,0
3352401981,5/21/2014,199000.0,4,2.0,2030,8120,2.0,0.0,0.0,3,7,2030,0,1950,0,98178,47.4994,-122.26100000000001,1520,9440,5,21,2014,UNK,510,-1320
5315100394,2/18/2015,604000.0,3,1.0,1440,13824,1.0,0.0,0.0,4,7,1440,0,1957,0,98040,47.5872,-122.241,2540,12092,2,18,2015,UNK,-1100,1732
3450300270,4/3/2015,268000.0,5,1.75,1730,10368,1.0,0.0,0.0,5,7,1010,720,1963,0,98059,47.5008,-122.162,1730,7728,4,3,2015,UNK,0,2640
2325069117,8/5/2014,960000.0,5,3.5,4510,16305,2.0,0.0,0.0,3,10,2820,1690,2003,0,98074,47.6346,-122.01100000000001,4330,18741,8,5,2014,UNK,180,-2436
7199340310,2/18/2015,509250.0,3,2.5,2100,7600,1.0,0.0,0.0,4,7,1450,650,1980,0,98052,47.6968,-122.12700000000001,2010,7600,2,18,2015,UNK,90,0
8663260030,11/18/2014,416000.0,3,2.5,1800,5372,2.0,0.0,0.0,3,8,1800,0,1987,0,98034,47.7188,-122.177,1650,6014,11,18,2014,UNK,150,-642
9315100030,5/15/2014,190000.0,3,1.0,1090,8520,1.0,0.0,0.0,3,7,1090,0,1967,0,98003,47.3364,-122.307,1190,8520,5,15,2014,UNK,-100,0
2190601049,4/29/2015,212000.0,3,1.5,1010,10000,1.0,0.0,0.0,4,7,1010,0,1973,0,98003,47.2881,-122.294,2420,34637,4,29,2015,UNK,-1410,-24637
9264930400,10/29/2014,325900.0,3,2.5,2040,9765,2.0,0.0,0.0,3,8,2040,0,1985,0,98023,47.309,-122.34899999999999,2350,10150,10,29,2014,UNK,-310,-385
2490200055,8/1/2014,560000.0,3,3.5,2270,4088,2.0,0.0,0.0,3,8,1880,390,1996,0,98136,47.5356,-122.384,1760,5425,8,1,2014,UNK,510,-1337
3830630140,9/24/2014,275000.0,3,2.5,1730,5799,2.0,0.0,0.0,4,7,1730,0,1987,0,98030,47.3499,-122.177,1710,6490,9,24,2014,UNK,20,-691
6385260160,3/9/2015,665000.0,4,2.5,2480,15411,2.0,0.0,2.0,3,8,2480,0,1994,0,98059,47.5379,-122.16,2940,14679,3,9,2015,UNK,-460,732
5701500030,6/1/2014,1510000.0,4,3.5,3480,7232,2.0,0.0,0.0,3,9,2580,0,1926,2010,98144,47.5859,-122.291,2380,5642,6,1,2014,Y,1100,1590
859000160,12/3/2014,375000.0,4,2.0,1720,2410,1.0,0.0,0.0,3,7,970,750,1930,2006,98106,47.5252,-122.361,1160,1404,12,3,2014,Y,560,1006
123039633,9/9/2014,359950.0,3,1.75,1570,6975,1.0,0.0,0.0,3,7,1040,530,1979,0,98126,47.5137,-122.37,1280,7813,9,9,2014,UNK,290,-838
3601200465,1/23/2015,340000.0,4,2.75,3527,7200,2.0,0.0,0.0,3,7,3527,0,2005,0,98198,47.3823,-122.3,2490,7200,1,23,2015,N,1037,0
106000320,10/31/2014,401000.0,2,1.0,840,8100,1.0,0.0,0.0,4,7,840,0,1948,0,98177,47.7019,-122.366,1100,8220,10,31,2014,UNK,-260,-120
7631200292,6/26/2014,669000.0,2,1.75,1950,10766,1.0,0.0,3.0,4,6,1160,790,1952,0,98166,47.4504,-122.37700000000001,1780,11721,6,26,2014,UNK,170,-955
2526059046,4/29/2015,638500.0,4,2.5,1980,6568,2.0,0.0,0.0,3,8,1980,0,2004,0,98052,47.70399999999999,-122.101,2310,6496,4,29,2015,N,-330,72
3416600111,3/23/2015,545000.0,2,1.5,1620,3760,2.0,0.0,0.0,5,7,1170,450,1924,0,98144,47.6012,-122.291,2130,4000,3,23,2015,UNK,-510,-240
3205500160,12/26/2014,524000.0,4,1.0,1980,7015,1.0,0.0,0.0,3,7,1260,720,1973,0,98034,47.7204,-122.18,1570,7626,12,26,2014,UNK,410,-611
824059331,11/8/2014,1610000.0,5,3.75,3530,13260,2.0,0.0,0.0,3,10,3530,0,2013,0,98040,47.5761,-122.205,3340,13260,11,8,2014,N,190,0
5347200060,9/9/2014,280000.0,2,1.0,1260,4800,1.0,0.0,0.0,3,6,1100,160,1947,0,98126,47.5196,-122.376,1260,2435,9,9,2014,UNK,0,2365
9323610260,8/25/2014,828000.0,4,2.5,2120,10841,1.0,0.0,0.0,4,8,1500,620,1979,0,98006,47.556000000000004,-122.156,3130,10950,8,25,2014,UNK,-1010,-109
8732160240,10/17/2014,223000.0,3,1.75,1360,10573,1.0,0.0,0.0,4,7,1360,0,1984,0,98023,47.2983,-122.374,1580,8280,10,17,2014,UNK,-220,2293
9808640320,1/2/2015,1290000.0,4,3.5,3100,2261,2.0,0.0,2.0,3,9,2250,850,1981,0,98033,47.6512,-122.20200000000001,2660,2000,1,2,2015,UNK,440,261
1326069050,5/4/2015,750000.0,2,2.0,2370,155130,1.0,0.0,0.0,3,7,2370,0,1970,0,98019,47.7388,-121.97200000000001,1860,14475,5,4,2015,UNK,510,140655
1454100267,4/17/2015,430000.0,2,1.0,1460,9207,1.0,0.0,0.0,3,7,1210,250,1947,0,98125,47.7195,-122.287,1500,6898,4,17,2015,UNK,-40,2309
5021900160,6/18/2014,711000.0,4,1.75,1980,10800,1.0,0.0,0.0,5,6,990,990,1948,0,98040,47.5768,-122.22200000000001,2180,10800,6,18,2014,UNK,-200,0
818100030,12/4/2014,310000.0,4,2.5,1930,7014,2.0,0.0,0.0,3,8,1930,0,1994,0,98042,47.3921,-122.163,1990,7920,12,4,2014,UNK,-60,-906
393000045,12/26/2014,415000.0,5,1.75,3700,9140,1.0,0.0,0.0,3,8,1850,1850,1957,0,98178,47.5086,-122.258,2190,6720,12,26,2014,UNK,1510,2420
8091411040,7/1/2014,274900.0,4,2.5,1970,6600,2.0,0.0,0.0,3,7,1970,0,1987,0,98030,47.3491,-122.16799999999999,1970,7682,7,1,2014,UNK,0,-1082
5561200310,6/9/2014,525000.0,3,3.0,2470,36445,2.0,0.0,0.0,4,8,2470,0,1980,0,98027,47.4661,-121.99700000000001,2310,35350,6,9,2014,UNK,160,1095
3204500340,12/19/2014,179500.0,3,1.0,1180,32214,1.0,0.0,0.0,3,7,1180,0,1952,0,98092,47.3313,-122.198,2300,13714,12,19,2014,UNK,-1120,18500
9222400935,5/23/2014,478000.0,3,1.0,1280,2580,1.5,0.0,0.0,3,8,1280,0,1910,2014,98115,47.6727,-122.32,1410,3150,5,23,2014,Y,-130,-570
1796350570,5/21/2014,195000.0,3,1.75,1380,7350,1.0,0.0,0.0,3,7,990,390,1981,0,98042,47.369,-122.09299999999999,1660,8400,5,21,2014,UNK,-280,-1050
2473450200,3/5/2015,385000.0,4,3.0,2740,10925,1.0,0.0,0.0,3,8,1670,1070,1980,0,98058,47.4538,-122.125,2330,9940,3,5,2015,UNK,410,985
1387300570,12/1/2014,401000.0,3,2.75,2020,9505,1.0,0.0,0.0,3,7,1260,760,1969,0,98011,47.7399,-122.197,2080,11901,12,1,2014,UNK,-60,-2396
8857640860,9/26/2014,522000.0,4,2.5,2835,6598,2.0,0.0,0.0,3,8,2835,0,2002,0,98038,47.3878,-122.03399999999999,2770,6969,9,26,2014,UNK,65,-371
5415000240,2/24/2015,330000.0,4,1.75,1520,14417,1.0,0.0,0.0,4,7,1520,0,1968,0,98065,47.526,-121.809,1600,10716,2,24,2015,UNK,-80,3701
2591760070,6/3/2014,503000.0,3,2.5,2190,4882,2.0,0.0,0.0,3,9,2190,0,1999,0,98155,47.7641,-122.306,2190,7055,6,3,2014,UNK,0,-2173
4131500140,2/12/2015,175000.0,5,1.75,1680,8400,1.0,0.0,0.0,4,7,1680,0,1979,0,98003,47.3035,-122.307,1800,8550,2,12,2015,UNK,-120,-150
7203220370,3/20/2015,963990.0,4,3.5,3915,6364,2.0,0.0,0.0,3,9,3915,0,2014,0,98053,47.6844,-122.016,3830,6507,3,20,2015,N,85,-143
1651500060,9/29/2014,845000.0,5,2.0,1720,9972,1.0,0.0,0.0,4,8,1720,0,1951,0,98004,47.6368,-122.21799999999999,2700,9023,9,29,2014,UNK,-980,949
7883600700,1/22/2015,157500.0,2,1.0,670,4500,1.0,0.0,0.0,3,5,670,0,1905,0,98108,47.5271,-122.32600000000001,1210,4500,1,22,2015,UNK,-540,0
567000755,12/5/2014,450000.0,2,3.0,1790,1709,2.0,0.0,0.0,3,7,1400,390,2001,0,98144,47.5926,-122.296,1460,1462,12,5,2014,UNK,330,247
9294300615,9/18/2014,925000.0,4,1.75,2440,11793,1.0,0.0,4.0,3,8,1420,1020,1950,0,98115,47.6807,-122.26700000000001,2500,8028,9,18,2014,UNK,-60,3765
3213200215,1/5/2015,600000.0,2,1.0,920,5029,1.0,0.0,0.0,4,7,920,0,1938,0,98115,47.6726,-122.265,1230,5029,1,5,2015,UNK,-310,0
9136101776,9/18/2014,709000.0,4,1.0,1680,4087,1.5,0.0,0.0,3,7,1680,0,1911,0,98103,47.6667,-122.337,1740,3745,9,18,2014,UNK,-60,342
5035300850,11/10/2014,1390000.0,5,3.75,3290,6480,2.0,0.0,0.0,5,10,2190,1100,1938,0,98199,47.653,-122.415,2010,7639,11,10,2014,UNK,1280,-1159
3668001080,9/11/2014,248000.0,3,2.5,2120,6840,1.0,0.0,0.0,3,7,1220,900,1984,0,98092,47.278,-122.145,1820,8200,9,11,2014,UNK,300,-1360
5540800100,5/11/2015,245000.0,3,1.0,910,6630,1.0,0.0,0.0,4,6,910,0,1912,0,98103,47.6947,-122.346,950,5100,5,11,2015,UNK,-40,1530
3679401110,5/30/2014,332000.0,2,1.0,1000,4776,1.0,0.0,0.0,4,6,1000,0,1942,0,98108,47.5619,-122.315,1500,4800,5,30,2014,UNK,-500,-24
7852130100,3/13/2015,459950.0,3,2.5,2340,4273,2.0,0.0,0.0,3,7,2340,0,2002,0,98065,47.5362,-121.87799999999999,2400,4624,3,13,2015,UNK,-60,-351
9828200147,4/10/2015,425000.0,3,2.0,1180,1800,2.0,0.0,2.0,3,8,1180,0,1994,0,98122,47.6168,-122.301,1500,1948,4,10,2015,UNK,-320,-148
826069085,9/3/2014,460000.0,3,2.25,2080,50965,1.0,0.0,0.0,3,8,1590,490,1979,0,98077,47.7506,-122.06299999999999,2270,51836,9,3,2014,UNK,-190,-871
6383900090,9/4/2014,838300.0,6,2.5,3760,12978,1.0,0.0,0.0,3,9,2360,1400,1967,0,98117,47.6976,-122.381,2300,7362,9,4,2014,UNK,1460,5616
8100000090,11/11/2014,256000.0,3,2.5,1480,7200,2.0,0.0,0.0,5,7,1480,0,1995,0,98010,47.3126,-122.023,1350,7200,11,11,2014,UNK,130,0
7805450750,1/20/2015,864000.0,3,2.75,3060,13554,2.0,0.0,0.0,3,10,3060,0,1984,0,98006,47.5609,-122.10600000000001,3060,11455,1,20,2015,UNK,0,2099
148000705,3/5/2015,900000.0,4,3.5,3070,4440,2.0,0.0,0.0,3,9,2030,1040,1922,2007,98116,47.5732,-122.411,1780,4800,3,5,2015,Y,1290,-360
1432400490,4/1/2015,145600.0,3,1.0,1170,7560,1.0,0.0,0.0,3,6,1170,0,1958,0,98058,47.4514,-122.178,1170,7560,4,1,2015,UNK,0,0
7974200820,8/21/2014,865000.0,5,3.0,2900,6730,1.0,0.0,0.0,5,8,1830,1070,1977,0,98115,47.6784,-122.285,2370,6283,8,21,2014,UNK,530,447
8731951130,6/9/2014,250250.0,3,2.25,2210,8000,2.0,0.0,0.0,4,8,2210,0,1969,0,98023,47.3085,-122.381,1990,8000,6,9,2014,UNK,220,0
7227801955,9/19/2014,162000.0,4,2.0,1440,7641,1.0,0.0,0.0,4,5,1440,0,1943,0,98056,47.508,-122.18299999999999,1440,7750,9,19,2014,UNK,0,-109
3558910490,7/31/2014,450000.0,4,1.75,1980,7350,1.0,0.0,0.0,3,7,1430,550,1973,0,98034,47.7088,-122.20200000000001,1870,7920,7,31,2014,UNK,110,-570
324059112,3/25/2015,675500.0,4,2.75,2060,21344,1.0,0.0,0.0,2,8,1460,600,1978,0,98005,47.5934,-122.154,2060,16088,3,25,2015,UNK,0,5256
2710600025,11/3/2014,697000.0,3,2.25,2420,5304,1.5,0.0,0.0,5,7,1640,780,1947,0,98115,47.6765,-122.285,1560,5304,11,3,2014,UNK,860,0
7582700100,11/11/2014,1320000.0,3,3.25,3440,4080,2.0,0.0,0.0,3,9,2560,880,2005,0,98105,47.6644,-122.28,3110,4080,11,11,2014,N,330,0
3882300100,12/1/2014,490000.0,3,1.75,1600,16510,1.0,0.0,0.0,3,8,1600,0,1984,0,98052,47.6601,-122.135,1510,10407,12,1,2014,UNK,90,6103
3735900590,10/21/2014,590000.0,3,2.25,2210,5742,1.0,0.0,0.0,3,8,1460,750,1951,0,98115,47.6891,-122.318,1900,4590,10,21,2014,UNK,310,1152
5153200356,5/12/2015,280000.0,4,1.75,2250,16000,1.0,0.0,0.0,3,8,1450,800,1957,0,98023,47.3303,-122.351,1930,16000,5,12,2015,UNK,320,0
7625702350,5/23/2014,515000.0,2,1.0,1680,6500,1.0,0.0,0.0,4,7,1140,540,1941,0,98136,47.55,-122.38799999999999,1610,6500,5,23,2014,UNK,70,0
2755200090,7/14/2014,576000.0,3,1.0,1140,5395,1.0,0.0,0.0,4,7,1010,130,1909,0,98115,47.6782,-122.306,1700,5376,7,14,2014,UNK,-560,19
626059317,11/20/2014,375000.0,3,1.75,1430,10574,2.0,0.0,0.0,3,7,1430,0,1981,0,98011,47.7668,-122.21799999999999,1900,10450,11,20,2014,UNK,-470,124
7199360090,3/20/2015,478000.0,3,1.0,1440,7107,1.0,0.0,0.0,4,7,1000,440,1980,0,98052,47.6968,-122.124,1540,7140,3,20,2015,UNK,-100,-33
8651443480,1/28/2015,282000.0,3,1.0,1670,5200,1.0,0.0,0.0,5,7,1030,640,1977,0,98042,47.3659,-122.09200000000001,1620,6696,1,28,2015,UNK,50,-1496
9359100750,10/31/2014,1400000.0,4,4.5,3080,10550,2.0,0.0,3.0,3,8,1940,1140,1976,2007,98040,47.5806,-122.244,2780,10550,10,31,2014,Y,300,0
5561400740,2/10/2015,593500.0,5,3.25,4300,50405,2.0,0.0,0.0,3,8,3220,1080,1972,0,98027,47.4615,-122.0,2680,41684,2,10,2015,UNK,1620,8721
1723099031,10/20/2014,724950.0,4,3.5,3010,174240,2.0,0.0,0.0,3,9,3010,0,2004,0,98045,47.4775,-121.691,2720,247856,10,20,2014,N,290,-73616
7236500025,8/29/2014,306000.0,3,1.75,1560,7500,1.0,0.0,0.0,4,8,1560,0,1966,0,98056,47.489,-122.18,1600,7904,8,29,2014,UNK,-40,-404
2473411080,6/9/2014,341000.0,4,1.75,1920,7665,1.0,0.0,0.0,4,8,1500,420,1975,0,98058,47.4476,-122.12799999999999,2100,7344,6,9,2014,UNK,-180,321
1773101335,11/3/2014,399950.0,3,2.5,1400,4400,1.0,0.0,0.0,3,7,1400,0,1930,2014,98106,47.553000000000004,-122.365,1060,4400,11,3,2014,Y,340,0
9126100850,11/20/2014,534000.0,5,2.0,2280,3600,2.0,0.0,0.0,3,7,2280,0,1992,0,98122,47.6056,-122.305,1740,1800,11,20,2014,UNK,540,1800
7202331220,7/21/2014,635000.0,6,2.5,3880,5700,2.0,0.0,0.0,3,7,3880,0,2003,0,98053,47.6816,-122.038,2620,5070,7,21,2014,UNK,1260,630
5511600245,3/24/2015,350000.0,2,1.0,1350,3880,1.0,0.0,0.0,3,6,950,400,1927,0,98103,47.6842,-122.344,1670,3920,3,24,2015,UNK,-320,-40
1344300090,2/17/2015,856000.0,3,1.5,1480,2700,1.5,0.0,0.0,3,7,1480,0,1928,0,98112,47.62300000000001,-122.304,1970,4200,2,17,2015,UNK,-490,-1500
9828702812,9/23/2014,582000.0,4,3.0,1670,1189,3.0,0.0,0.0,3,8,1427,243,2000,0,98122,47.6182,-122.302,1700,1401,9,23,2014,UNK,-30,-212
3825310820,7/29/2014,799000.0,4,2.5,3400,6742,2.0,0.0,0.0,3,9,3400,0,2004,0,98052,47.7067,-122.12899999999999,2970,6909,7,29,2014,N,430,-167
7852040110,9/8/2014,423700.0,3,2.5,2070,3986,2.0,0.0,0.0,3,8,2070,0,1999,0,98065,47.5348,-121.87700000000001,2090,3986,9,8,2014,UNK,-20,0
6752500090,1/27/2015,1840000.0,4,3.5,4870,39190,2.0,0.0,0.0,3,12,4870,0,1995,0,98006,47.5447,-122.124,5000,33880,1,27,2015,UNK,-130,5310
3222079162,8/13/2014,322000.0,3,2.0,1760,43575,1.0,0.0,0.0,3,7,1160,600,1988,0,98010,47.3565,-121.94,1760,46038,8,13,2014,UNK,0,-2463
1025069192,11/5/2014,929000.0,4,3.25,4030,57499,2.0,0.0,0.0,3,9,4030,0,2002,0,98053,47.6617,-122.02600000000001,3470,57499,11,5,2014,UNK,560,0
5101404608,12/1/2014,443000.0,2,1.0,1130,5413,1.0,0.0,0.0,3,7,880,250,1939,0,98115,47.6971,-122.315,1250,5413,12,1,2014,UNK,-120,0
9477100490,4/24/2015,441500.0,3,1.75,1510,7700,1.0,0.0,0.0,3,7,1510,0,1968,0,98034,47.7283,-122.194,1440,7416,4,24,2015,UNK,70,284
324069015,7/8/2014,875000.0,4,3.5,3110,108464,2.0,0.0,2.0,4,8,3110,0,1979,0,98075,47.592,-122.01799999999999,2340,4938,7,8,2014,UNK,770,103526
4114601570,11/18/2014,3600000.0,3,3.25,5020,12431,2.0,1.0,4.0,3,10,3420,1600,1941,2002,98144,47.5925,-122.287,3680,12620,11,18,2014,Y,1340,-189
7920100025,4/27/2015,450000.0,2,1.0,740,5100,1.0,0.0,0.0,4,7,740,0,1947,0,98115,47.6787,-122.301,920,5100,4,27,2015,UNK,-180,0
3275730110,9/8/2014,425000.0,3,2.25,1630,10500,1.0,0.0,0.0,3,7,1100,530,1974,0,98034,47.7176,-122.236,1640,9794,9,8,2014,UNK,-10,706
7504030090,6/1/2014,660000.0,4,1.75,2780,9900,2.0,0.0,0.0,4,10,2780,0,1978,0,98074,47.6348,-122.06,2600,12000,6,1,2014,UNK,180,-2100
8813400405,6/16/2014,763101.0,3,1.75,1990,5560,1.0,0.0,0.0,4,7,1100,890,1939,0,98105,47.663999999999994,-122.287,1460,3706,6,16,2014,UNK,530,1854
1313300300,4/7/2015,499000.0,4,2.75,2250,14149,2.0,0.0,0.0,3,9,2250,0,1992,0,98019,47.7353,-121.962,2450,14027,4,7,2015,UNK,-200,122
8121610110,3/3/2015,521000.0,3,1.75,1720,37363,1.0,0.0,0.0,4,8,1350,370,1974,0,98053,47.6608,-122.035,2740,40635,3,3,2015,UNK,-1020,-3272
1820069019,5/29/2014,302000.0,2,1.0,900,423838,1.0,0.0,2.0,5,6,900,0,1925,0,98022,47.228,-122.088,1810,94960,5,29,2014,UNK,-910,328878
9406450090,4/8/2015,293000.0,4,2.25,2360,6260,2.0,0.0,0.0,3,7,2360,0,1998,0,98038,47.3882,-122.053,2144,6773,4,8,2015,UNK,216,-513
2619950490,7/12/2014,335000.0,3,2.25,1530,4580,2.0,0.0,0.0,3,7,1530,0,2011,0,98019,47.7342,-121.96799999999999,2110,4094,7,12,2014,N,-580,486
1646500785,12/15/2014,499000.0,2,1.0,1450,3090,2.0,0.0,0.0,3,7,1450,0,1919,1987,98103,47.6853,-122.35600000000001,1450,4635,12,15,2014,Y,0,-1545
1868901690,5/5/2015,600000.0,3,1.75,2040,5000,1.5,0.0,0.0,3,7,1780,260,1924,0,98115,47.6756,-122.29899999999999,1690,5000,5,5,2015,UNK,350,0
9542400025,9/16/2014,720000.0,4,1.75,2620,11041,1.5,0.0,0.0,4,9,2620,0,1962,0,98005,47.5975,-122.17399999999999,2230,11041,9,16,2014,UNK,390,0
2781270090,2/25/2015,195000.0,2,2.0,1180,2553,2.0,0.0,0.0,3,6,1180,0,2005,0,98038,47.3501,-122.02,1310,2687,2,25,2015,N,-130,-134
1665400165,5/7/2014,249000.0,3,1.0,1110,8423,1.0,0.0,0.0,3,7,1110,0,1952,0,98166,47.4718,-122.34200000000001,1140,9083,5,7,2014,UNK,-30,-660
1326069191,2/2/2015,334000.0,3,2.25,1840,9781,2.0,0.0,0.0,3,7,1840,0,1989,0,98019,47.7347,-121.976,1490,10101,2,2,2015,UNK,350,-320
381000110,11/7/2014,599950.0,4,1.75,2720,7810,1.0,0.0,0.0,3,8,1510,1210,1952,0,98115,47.6788,-122.28299999999999,2120,7315,11,7,2014,UNK,600,495
3530530110,2/17/2015,149900.0,2,1.75,1090,1950,1.0,0.0,0.0,4,8,1090,0,1982,0,98198,47.3782,-122.319,1360,3426,2,17,2015,UNK,-270,-1476
5210200107,11/25/2014,700000.0,4,1.75,1730,6500,1.0,0.0,0.0,3,7,1250,480,1945,0,98115,47.6982,-122.28200000000001,1910,8100,11,25,2014,UNK,-180,-1600
1574100025,8/7/2014,525000.0,4,1.5,1170,6240,1.0,0.0,0.0,4,6,1170,0,1960,0,98040,47.5495,-122.23200000000001,2380,8846,8,7,2014,UNK,-1210,-2606
2523069192,7/8/2014,1050000.0,4,3.75,4740,126759,2.0,0.0,0.0,4,10,4740,0,1991,0,98027,47.4449,-121.979,3060,118047,7,8,2014,UNK,1680,8712
6706600090,5/8/2014,402000.0,3,2.5,1960,8000,1.0,0.0,0.0,4,7,1290,670,1977,0,98034,47.7249,-122.178,1960,8000,5,8,2014,UNK,0,0
1994200031,6/20/2014,450000.0,3,2.0,1430,3480,1.0,0.0,0.0,3,7,980,450,1947,0,98103,47.6874,-122.336,1450,4650,6,20,2014,UNK,-20,-1170
2523069156,12/3/2014,520000.0,3,2.25,2510,43995,2.0,0.0,0.0,3,8,2510,0,1981,0,98027,47.4545,-121.988,2470,48351,12,3,2014,UNK,40,-4356
5029450850,12/4/2014,205000.0,3,1.75,1420,6980,1.0,0.0,0.0,5,7,820,600,1980,0,98023,47.2873,-122.367,1470,7319,12,4,2014,UNK,-50,-339
2723069147,9/2/2014,635000.0,3,2.25,2680,175982,1.0,0.0,0.0,3,9,2680,0,2004,0,98038,47.4487,-122.03299999999999,3170,215186,9,2,2014,N,-490,-39204
3750605349,3/4/2015,210500.0,3,1.0,1220,9600,1.0,0.0,0.0,5,7,1220,0,1958,0,98001,47.2622,-122.28200000000001,1310,9600,3,4,2015,UNK,-90,0
9285800735,8/12/2014,406650.0,2,1.0,1070,6100,1.0,0.0,0.0,3,6,1070,0,1940,0,98126,47.5698,-122.37700000000001,1770,5695,8,12,2014,UNK,-700,405
7574000100,4/8/2015,350000.0,3,1.75,1580,19998,1.0,0.0,0.0,4,7,1580,0,1968,0,98010,47.3299,-122.046,1860,19998,4,8,2015,UNK,-280,0
9212900100,4/23/2015,425000.0,4,1.75,1820,6000,1.0,0.0,0.0,3,7,930,890,1942,0,98115,47.6872,-122.296,1590,6000,4,23,2015,UNK,230,0
8651611130,6/5/2014,798000.0,3,3.5,3590,6402,2.0,0.0,0.0,3,10,3590,0,1999,0,98074,47.6336,-122.06299999999999,3230,7305,6,5,2014,UNK,360,-903
423059184,12/1/2014,180000.0,3,1.0,1960,9583,2.0,0.0,0.0,2,5,1960,0,1908,0,98056,47.505,-122.171,1850,8324,12,1,2014,UNK,110,1259
5451200600,6/2/2014,1250000.0,5,3.25,3160,13238,2.0,0.0,0.0,5,8,3160,0,1972,0,98040,47.5373,-122.22399999999999,2360,12042,6,2,2014,UNK,800,1196
6300000378,3/3/2015,435000.0,4,2.0,2030,4033,2.0,0.0,0.0,4,7,1630,400,1925,0,98133,47.7056,-122.34200000000001,1350,1340,3,3,2015,UNK,680,2693
2570300090,11/26/2014,355000.0,3,1.5,1240,15867,1.0,0.0,0.0,3,7,1240,0,1962,0,98034,47.7167,-122.20200000000001,1570,9600,11,26,2014,UNK,-330,6267
9808100100,2/2/2015,3000000.0,5,3.25,5370,14091,2.0,0.0,0.0,3,10,3850,1520,1918,2008,98004,47.6499,-122.21600000000001,2410,12047,2,2,2015,Y,2960,2044
4019300906,7/24/2014,685000.0,5,2.5,2670,14455,2.0,0.0,0.0,5,9,2670,0,1958,0,98155,47.7565,-122.28399999999999,1810,14455,7,24,2014,UNK,860,0
1023059223,7/25/2014,311000.0,3,1.0,1640,12060,1.0,0.0,0.0,4,7,1640,0,1960,0,98059,47.4941,-122.15100000000001,1680,9147,7,25,2014,UNK,-40,2913
9320700090,9/11/2014,305000.0,4,2.25,2130,9600,1.0,0.0,0.0,4,7,2130,0,1966,0,98031,47.4119,-122.211,1710,9600,9,11,2014,UNK,420,0
5700002460,7/25/2014,675000.0,3,2.5,2550,4954,1.5,0.0,0.0,4,7,1850,700,1924,0,98144,47.5758,-122.287,1700,4954,7,25,2014,UNK,850,0
7598100735,8/29/2014,769000.0,4,2.75,3630,15405,1.0,0.0,2.0,4,8,1850,1780,1968,0,98040,47.566,-122.225,3380,11184,8,29,2014,UNK,250,4221
2202500110,8/5/2014,430000.0,3,1.5,1690,9708,1.5,0.0,0.0,5,7,1690,0,1954,0,98006,47.5732,-122.13600000000001,1570,9858,8,5,2014,UNK,120,-150
726059395,9/23/2014,516250.0,6,2.0,2390,8660,1.5,0.0,0.0,4,7,2390,0,1925,0,98011,47.7589,-122.21600000000001,2250,12942,9,23,2014,UNK,140,-4282
1455600015,12/12/2014,760000.0,3,3.5,2350,10739,1.0,0.0,2.0,5,7,1340,1010,1940,0,98125,47.7288,-122.28399999999999,2580,11026,12,12,2014,UNK,-230,-287
9528101224,10/7/2014,579950.0,3,3.5,1420,1217,2.0,0.0,0.0,3,8,1180,240,2003,0,98115,47.6827,-122.324,1494,1264,10,7,2014,UNK,-74,-47
6713100031,2/11/2015,476000.0,3,2.25,1570,7187,1.0,0.0,0.0,4,8,1170,400,1980,0,98133,47.7604,-122.35600000000001,1660,8775,2,11,2015,UNK,-90,-1588
8677900123,6/12/2014,510000.0,3,1.75,1600,19200,1.0,0.0,0.0,4,7,1600,0,1967,0,98034,47.7202,-122.249,2010,14850,6,12,2014,UNK,-410,4350
4302201130,5/8/2014,205000.0,2,1.0,720,5040,1.0,0.0,0.0,3,6,720,0,1955,0,98106,47.5267,-122.36,1357,5120,5,8,2014,UNK,-637,-80
1310800090,10/7/2014,240000.0,3,1.0,1470,7350,1.0,0.0,0.0,3,7,1470,0,1969,0,98032,47.3616,-122.286,1720,8050,10,7,2014,UNK,-250,-700
6117502727,9/2/2014,738000.0,5,3.5,2790,16952,2.0,0.0,2.0,3,10,1970,820,1991,0,98166,47.4384,-122.34700000000001,2980,17281,9,2,2014,UNK,-190,-329
9324800110,7/28/2014,420000.0,3,1.75,1720,8102,1.0,0.0,0.0,5,6,860,860,1940,0,98125,47.7336,-122.29,1440,8106,7,28,2014,UNK,280,-4
8965000110,11/14/2014,455000.0,3,1.75,1300,9600,1.0,0.0,0.0,4,7,1300,0,1969,0,98052,47.6388,-122.103,2070,9775,11,14,2014,UNK,-770,-175
5700001055,9/15/2014,765000.0,4,1.0,2520,5500,1.5,0.0,0.0,5,8,1820,700,1912,0,98144,47.5785,-122.292,2350,5000,9,15,2014,UNK,170,500
49500090,12/5/2014,372000.0,4,1.5,1780,7914,1.5,0.0,0.0,4,7,1780,0,1962,0,98059,47.5142,-122.163,1350,8069,12,5,2014,UNK,430,-155
3812400657,12/4/2014,160000.0,3,1.0,1200,8360,1.0,0.0,0.0,2,6,1200,0,1948,0,98118,47.5414,-122.281,1570,6823,12,4,2014,UNK,-370,1537
2725069162,8/15/2014,772000.0,4,2.5,2990,9643,2.0,0.0,0.0,3,9,2990,0,2003,0,98074,47.6292,-122.024,2990,8666,8,15,2014,UNK,0,977
4232400110,11/11/2014,1130000.0,5,1.75,1910,5640,2.0,0.0,0.0,4,9,1910,0,1906,0,98112,47.6249,-122.311,2050,5400,11,11,2014,UNK,-140,240
9521100586,5/24/2014,479000.0,3,1.0,1370,3000,1.5,0.0,0.0,3,7,1370,0,1924,0,98103,47.6619,-122.351,1510,2151,5,24,2014,UNK,-140,849
7215721570,5/5/2015,570000.0,3,2.5,1910,4941,2.0,0.0,0.0,3,8,1910,0,1999,0,98075,47.5989,-122.016,1910,4941,5,5,2015,UNK,0,0
3834000805,7/10/2014,350000.0,4,1.0,1170,8147,1.5,0.0,0.0,3,6,1170,0,1959,0,98125,47.7281,-122.289,1260,8147,7,10,2014,UNK,-90,0
2274000026,11/1/2014,353000.0,3,2.5,1250,864,3.0,0.0,0.0,3,8,1250,0,2004,0,98115,47.6978,-122.318,1330,2298,11,1,2014,N,-80,-1434
5103300090,8/1/2014,699000.0,5,2.5,3340,24755,2.0,0.0,0.0,3,10,3340,0,2002,0,98038,47.4565,-122.066,3420,23274,8,1,2014,UNK,-80,1481
9558200025,7/30/2014,265000.0,3,2.0,1380,8536,2.0,0.0,0.0,4,7,1380,0,1955,0,98148,47.4374,-122.335,1260,8750,7,30,2014,UNK,120,-214
8649401270,4/30/2015,167000.0,1,1.0,780,10235,1.5,0.0,0.0,3,6,780,0,1989,0,98014,47.713,-121.315,930,10165,4,30,2015,UNK,-150,70
686200740,10/20/2014,500000.0,4,2.25,2080,8000,1.0,0.0,0.0,3,8,1390,690,1964,0,98008,47.6264,-122.113,1800,7700,10,20,2014,UNK,280,300
7658600025,7/9/2014,700000.0,3,1.0,1410,7200,2.0,0.0,0.0,4,6,1410,0,1901,0,98144,47.5924,-122.302,1640,7200,7,9,2014,UNK,-230,0
3702900165,11/4/2014,295000.0,1,1.0,520,5600,1.0,0.0,0.0,3,6,520,0,1918,0,98116,47.5579,-122.395,1030,5265,11,4,2014,UNK,-510,335
7977201240,3/11/2015,1010000.0,4,3.5,3500,4080,2.0,0.0,2.0,3,9,2590,910,2004,0,98115,47.6834,-122.292,2430,5100,3,11,2015,N,1070,-1020
8651410090,5/8/2015,209000.0,2,1.0,840,5265,1.0,0.0,0.0,5,6,840,0,1969,0,98042,47.3644,-122.08200000000001,920,5100,5,8,2015,UNK,-80,165
3750603732,1/28/2015,276000.0,3,1.75,2240,9200,1.0,0.0,0.0,4,7,1440,800,1968,0,98001,47.2635,-122.28399999999999,1740,9600,1,28,2015,UNK,500,-400
1023059429,1/22/2015,380000.0,4,2.5,2100,5857,2.0,0.0,0.0,3,8,2100,0,2002,0,98059,47.4956,-122.163,2090,7779,1,22,2015,UNK,10,-1922
2412100025,6/6/2014,315000.0,3,1.5,1750,12500,1.0,0.0,0.0,3,7,1150,600,1954,0,98024,47.5666,-121.902,1680,13000,6,6,2014,UNK,70,-500
203600600,3/10/2015,685530.0,4,2.5,3130,60467,2.0,0.0,0.0,3,9,3130,0,1996,0,98014,47.6618,-121.962,2780,44224,3,10,2015,UNK,350,16243
2021069059,6/26/2014,254600.0,3,2.0,1470,20000,1.0,0.0,0.0,4,7,1470,0,1968,0,98002,47.2973,-122.08,1390,30056,6,26,2014,UNK,80,-10056
7227501645,6/3/2014,230000.0,3,2.0,1440,5600,1.0,0.0,0.0,4,6,720,720,1942,0,98056,47.4947,-122.185,1120,5700,6,3,2014,UNK,320,-100
4310702787,7/17/2014,335000.0,3,3.0,1430,1249,3.0,0.0,0.0,3,8,1430,0,2003,0,98103,47.6971,-122.34,1020,1112,7,17,2014,UNK,410,137
1494300110,6/3/2014,550000.0,4,2.5,2170,9600,1.0,0.0,0.0,3,7,1460,710,1980,0,98052,47.6789,-122.116,1940,8400,6,3,2014,UNK,230,1200
1950900245,12/26/2014,123300.0,3,1.0,1150,8050,1.5,0.0,0.0,4,7,1150,0,1956,0,98032,47.373999999999995,-122.296,1360,8050,12,26,2014,UNK,-210,0
3512100110,9/2/2014,275436.0,4,2.75,2170,9658,1.5,0.0,0.0,3,7,2170,0,1966,0,98030,47.3741,-122.189,1490,9731,9,2,2014,UNK,680,-73
8732750100,5/25/2014,325000.0,4,3.5,2630,3435,1.5,0.0,3.0,3,7,1640,990,1984,0,98188,47.4355,-122.272,1920,2435,5,25,2014,UNK,710,1000
1332000110,7/25/2014,635000.0,4,2.5,2490,40608,2.0,0.0,0.0,3,9,2490,0,1997,0,98053,47.6507,-122.00399999999999,3170,45441,7,25,2014,UNK,-680,-4833
2768100690,4/23/2015,513000.0,3,1.75,1710,5000,1.0,0.0,0.0,4,7,1110,600,1944,0,98107,47.6689,-122.37,920,5000,4,23,2015,UNK,790,0
7525410090,7/8/2014,580000.0,4,2.5,2130,35752,1.0,0.0,0.0,3,8,1490,640,1980,0,98075,47.5748,-122.031,3030,34000,7,8,2014,UNK,-900,1752
9558800025,4/29/2015,225000.0,3,1.0,940,9272,1.0,0.0,0.0,3,7,940,0,1954,0,98148,47.4353,-122.335,1270,9375,4,29,2015,UNK,-330,-103
2788400315,9/22/2014,265000.0,3,1.0,1400,9460,1.0,0.0,0.0,3,7,1060,340,1961,0,98168,47.5119,-122.321,1570,7700,9,22,2014,UNK,-170,1760
7128300855,10/14/2014,313000.0,4,1.75,1630,3000,1.0,0.0,0.0,3,7,930,700,1978,0,98144,47.5961,-122.305,1630,3000,10,14,2014,UNK,0,0
7655900038,4/14/2015,296000.0,2,1.0,1370,8400,1.0,0.0,0.0,3,7,1370,0,1948,0,98133,47.7344,-122.336,1330,8396,4,14,2015,UNK,40,4
7923500090,10/20/2014,655500.0,4,2.75,2380,15800,1.0,0.0,0.0,3,8,1680,700,1957,0,98007,47.5929,-122.133,1950,11751,10,20,2014,UNK,430,4049
3339900096,12/10/2014,250750.0,5,1.75,2140,12058,1.0,0.0,0.0,4,8,2140,0,1951,0,98002,47.3167,-122.214,1640,10125,12,10,2014,UNK,500,1933
5214500690,9/4/2014,438000.0,4,2.5,1970,8545,2.0,0.0,0.0,3,8,1970,0,2004,0,98059,47.4893,-122.13799999999999,2590,7200,9,4,2014,N,-620,1345
4045900147,8/1/2014,590000.0,3,2.75,2550,54014,2.0,0.0,0.0,4,8,1980,570,1967,0,98072,47.7596,-122.117,2180,21600,8,1,2014,UNK,370,32414
6450302900,10/6/2014,329500.0,3,1.0,1080,5250,1.0,0.0,0.0,4,7,1080,0,1947,0,98133,47.7309,-122.336,1100,5250,10,6,2014,UNK,-20,0
2597460090,3/16/2015,1200000.0,3,2.25,3070,9645,2.0,0.0,0.0,3,10,2110,960,1987,0,98006,47.5522,-122.14399999999999,3130,9450,3,16,2015,UNK,-60,195
2770601595,3/20/2015,415000.0,2,1.0,1470,6000,1.0,0.0,0.0,3,6,900,570,1944,0,98199,47.6527,-122.38600000000001,1670,6000,3,20,2015,UNK,-200,0
4188000490,9/22/2014,900000.0,4,2.5,3620,42580,2.0,0.0,0.0,3,10,3620,0,1984,0,98052,47.7204,-122.115,2950,33167,9,22,2014,UNK,670,9413
1324079085,5/4/2015,378000.0,3,1.5,1050,57499,1.0,0.0,0.0,3,7,1050,0,1975,0,98024,47.5602,-121.86,1460,42688,5,4,2015,UNK,-410,14811
1720069006,8/12/2014,474000.0,2,1.0,1050,403365,1.0,0.0,3.0,5,6,1050,0,1905,0,98022,47.2221,-122.059,1760,108900,8,12,2014,UNK,-710,294465
1947300115,6/19/2014,464000.0,3,1.0,1320,3625,2.0,0.0,0.0,3,7,1320,0,1900,0,98122,47.6049,-122.288,1660,5438,6,19,2014,UNK,-340,-1813
5490700100,12/8/2014,310000.0,3,1.0,1210,7649,1.0,0.0,0.0,4,7,1210,0,1956,0,98155,47.7693,-122.32,1210,6760,12,8,2014,UNK,0,889
7278100690,9/18/2014,580000.0,3,1.5,1860,7190,2.0,0.0,1.0,5,7,1860,0,1952,0,98177,47.7716,-122.39200000000001,1670,5525,9,18,2014,UNK,190,1665
2322029048,11/19/2014,999000.0,3,2.75,2830,505166,1.0,1.0,3.0,4,8,1830,1000,1962,0,98070,47.3782,-122.514,2120,21988,11,19,2014,UNK,710,483178
6821102100,3/17/2015,510000.0,2,1.0,810,6480,1.0,0.0,0.0,5,6,810,0,1942,0,98199,47.6493,-122.398,1920,6000,3,17,2015,UNK,-1110,480
3176100110,5/6/2014,650000.0,3,1.5,1630,7475,1.0,0.0,1.0,3,7,1160,470,1940,0,98115,47.6725,-122.272,2320,7475,5,6,2014,UNK,-690,0
2188200785,9/12/2014,196000.0,3,1.0,880,19600,1.0,0.0,0.0,4,7,880,0,1978,0,98023,47.2707,-122.34,880,10500,9,12,2014,UNK,0,9100
1446801030,8/22/2014,220000.0,4,1.75,1660,11664,1.0,0.0,0.0,3,6,1010,650,1952,0,98168,47.4943,-122.331,1670,9975,8,22,2014,UNK,-10,1689
8965520100,10/8/2014,855000.0,3,2.25,3440,10628,2.0,0.0,2.0,3,10,3440,0,1985,0,98006,47.5647,-122.10799999999999,3170,11434,10,8,2014,UNK,270,-806
3649100586,8/29/2014,483000.0,3,1.75,2110,10454,1.0,0.0,0.0,4,8,1440,670,1978,0,98028,47.7344,-122.24600000000001,1990,10890,8,29,2014,UNK,120,-436
7283900153,4/7/2015,400000.0,3,1.0,1060,12000,1.0,0.0,0.0,3,7,1060,0,1952,0,98133,47.7703,-122.35,1550,10500,4,7,2015,UNK,-490,1500
1036100100,7/2/2014,435000.0,3,2.5,1900,7984,2.0,0.0,0.0,3,8,1900,0,1993,0,98011,47.7433,-122.194,2650,9352,7,2,2014,UNK,-750,-1368
3278602670,9/30/2014,219500.0,1,1.0,820,1060,1.0,0.0,0.0,3,8,760,60,2007,0,98126,47.5473,-122.37100000000001,1770,1924,9,30,2014,N,-950,-864
3625049014,8/29/2014,2950000.0,4,3.5,4860,23885,2.0,0.0,0.0,3,12,4860,0,1996,0,98039,47.6172,-122.23,3580,16054,8,29,2014,UNK,1280,7831
7276100165,9/16/2014,427000.0,3,2.5,2050,3218,3.0,0.0,0.0,3,7,2050,0,2008,0,98133,47.7612,-122.344,2050,7200,9,16,2014,N,0,-3982
9136103130,12/1/2014,430000.0,2,1.5,1090,4013,1.5,0.0,0.0,3,7,1090,0,1900,0,98103,47.6652,-122.338,1390,4013,12,1,2014,UNK,-300,0
9136103130,5/12/2015,685000.0,2,1.5,1090,4013,1.5,0.0,0.0,3,7,1090,0,1900,0,98103,47.6652,-122.338,1390,4013,5,12,2015,UNK,-300,0
1193000025,9/3/2014,495000.0,2,1.5,1920,6250,1.0,0.0,0.0,3,7,1060,860,1937,0,98199,47.6497,-122.39299999999999,2070,6250,9,3,2014,UNK,-150,0
2744000100,6/25/2014,299950.0,3,2.5,1870,7942,2.0,0.0,0.0,3,7,1870,0,1990,0,98001,47.342,-122.279,1870,7392,6,25,2014,UNK,0,550
3744600028,11/21/2014,390000.0,4,1.75,2690,46609,1.5,0.0,0.0,3,7,2690,0,1940,0,98146,47.4951,-122.352,1920,7302,11,21,2014,UNK,770,39307
3679400025,8/12/2014,385000.0,3,1.75,2160,5863,1.5,0.0,0.0,4,7,1260,900,1928,0,98144,47.5729,-122.315,1590,3000,8,12,2014,UNK,570,2863
9545260100,6/25/2014,740000.0,4,2.5,3000,10392,2.0,0.0,0.0,3,9,3000,0,1995,0,98027,47.535,-122.04899999999999,3140,9213,6,25,2014,UNK,-140,1179
375000165,7/23/2014,991700.0,4,3.0,2290,2350,2.0,0.0,1.0,3,9,1610,680,1924,0,98116,47.574,-122.415,1610,3820,7,23,2014,UNK,680,-1470
4003000053,8/13/2014,765000.0,3,2.75,2250,9600,2.5,0.0,0.0,4,9,1830,420,1909,1991,98122,47.6033,-122.287,2060,4980,8,13,2014,Y,190,4620
7855600820,9/4/2014,802000.0,4,2.25,2130,8734,2.0,0.0,2.0,4,8,2130,0,1961,0,98006,47.5672,-122.161,2550,8800,9,4,2014,UNK,-420,-66
3860400100,11/21/2014,950000.0,4,2.75,2500,20000,1.0,0.0,0.0,4,8,1700,800,1969,0,98004,47.5901,-122.198,2650,20000,11,21,2014,UNK,-150,0
121059147,11/4/2014,392000.0,4,2.5,2300,41167,2.0,0.0,0.0,3,7,2300,0,1988,0,98042,47.3412,-122.10799999999999,2300,21765,11,4,2014,UNK,0,19402
825079019,12/3/2014,590000.0,3,2.5,3360,218235,1.0,0.0,0.0,3,8,3360,0,1989,0,98014,47.6601,-121.946,2650,220849,12,3,2014,UNK,710,-2614
123039313,4/10/2015,425000.0,4,2.5,1920,9000,2.0,0.0,0.0,2,7,1920,0,1989,0,98126,47.5153,-122.37,1530,10474,4,10,2015,UNK,390,-1474
7784000110,7/22/2014,765000.0,5,1.75,2440,15143,1.5,0.0,4.0,4,8,1740,700,1944,0,98146,47.4948,-122.37,2390,10907,7,22,2014,UNK,50,4236
8835220090,8/7/2014,313500.0,3,2.25,1440,3488,2.0,0.0,0.0,4,7,1440,0,1983,0,98034,47.7257,-122.162,1390,3488,8,7,2014,UNK,50,0
6381501636,8/20/2014,320000.0,3,1.0,1780,6840,2.0,0.0,0.0,4,6,1780,0,1947,0,98125,47.727,-122.3,1410,7200,8,20,2014,UNK,370,-360
1370804446,2/10/2015,604000.0,4,1.75,1490,4485,1.0,0.0,0.0,3,8,1350,140,1960,0,98199,47.6388,-122.399,1380,4846,2,10,2015,UNK,110,-361
9828701871,2/12/2015,570000.0,3,2.0,1400,1657,2.0,0.0,0.0,3,8,1060,340,2004,0,98112,47.6196,-122.29799999999999,1540,2275,2,12,2015,N,-140,-618
3396200090,5/20/2014,639000.0,4,2.5,2150,12028,2.0,0.0,0.0,4,8,2150,0,1982,0,98052,47.7224,-122.101,1800,11777,5,20,2014,UNK,350,251
1463400047,8/22/2014,335000.0,4,2.0,1910,10200,1.0,0.0,0.0,4,7,1910,0,1963,0,98059,47.4804,-122.133,1820,15600,8,22,2014,UNK,90,-5400
8825900855,10/14/2014,896000.0,4,1.75,2660,3520,2.0,0.0,0.0,4,8,2080,580,1917,0,98115,47.6743,-122.30799999999999,2100,4080,10,14,2014,UNK,560,-560
7147600245,6/27/2014,259500.0,3,1.75,1650,12349,1.0,0.0,0.0,3,7,1650,0,1957,0,98188,47.442,-122.28200000000001,1470,10763,6,27,2014,UNK,180,1586
5071400485,8/7/2014,637000.0,3,2.0,1980,6000,1.0,0.0,0.0,4,7,1380,600,1958,0,98115,47.6921,-122.28299999999999,1260,6000,8,7,2014,UNK,720,0
8732040090,5/6/2015,307450.0,4,2.75,2690,8874,1.0,0.0,0.0,3,8,1370,1320,1980,0,98023,47.3078,-122.383,1990,7875,5,6,2015,UNK,700,999
8082400100,8/25/2014,535000.0,3,1.75,1380,3561,1.0,0.0,0.0,4,7,860,520,1925,0,98117,47.6822,-122.399,1820,4593,8,25,2014,UNK,-440,-1032
546000930,6/30/2014,669500.0,4,2.25,2500,4046,1.5,0.0,0.0,4,7,1520,980,1940,0,98117,47.6882,-122.382,1410,4046,6,30,2014,UNK,1090,0
1665400025,10/28/2014,259000.0,3,1.75,1590,7148,1.0,0.0,0.0,3,7,1590,0,1952,0,98166,47.4713,-122.344,1150,7280,10,28,2014,UNK,440,-132
9187200245,12/31/2014,441000.0,4,1.5,1100,3300,1.0,0.0,0.0,1,7,1100,0,1919,0,98122,47.6033,-122.295,2020,4000,12,31,2014,UNK,-920,-700
2123700015,5/12/2015,228800.0,4,2.5,1470,1612,2.0,0.0,0.0,3,7,980,490,2003,0,98118,47.5275,-122.271,1460,5027,5,12,2015,UNK,10,-3415
8682291730,5/13/2014,530000.0,2,2.0,1680,4950,1.0,0.0,0.0,3,8,1680,0,2006,0,98053,47.7194,-122.022,1570,4800,5,13,2014,N,110,150
5318100504,7/28/2014,524000.0,2,2.0,1450,2272,1.0,0.0,0.0,4,6,750,700,1924,0,98112,47.633,-122.28200000000001,2170,4370,7,28,2014,UNK,-720,-2098
9297800165,12/11/2014,430000.0,4,2.25,2020,4840,1.5,0.0,0.0,5,8,1200,820,1925,0,98126,47.5576,-122.376,1410,4840,12,11,2014,UNK,610,0
1342300265,10/1/2014,1330000.0,4,3.25,2470,4760,1.5,0.0,0.0,5,9,1890,580,1906,0,98112,47.6331,-122.31,2470,4760,10,1,2014,UNK,0,0
2212901130,11/3/2014,210000.0,3,1.0,1230,12201,1.0,0.0,0.0,3,7,1230,0,1969,0,98042,47.3285,-122.134,1230,10780,11,3,2014,UNK,0,1421
8122100690,6/23/2014,449000.0,4,2.5,1850,5040,1.0,0.0,0.0,3,7,1230,620,1930,0,98126,47.5386,-122.37299999999999,1010,5040,6,23,2014,UNK,840,0
148000375,6/19/2014,945000.0,2,2.5,2540,7089,2.0,0.0,0.0,3,9,2540,0,2004,0,98116,47.5747,-122.414,1330,7089,6,19,2014,N,1210,0
3423049209,3/18/2015,200450.0,3,1.0,970,9130,1.0,0.0,0.0,3,6,970,0,1957,0,98188,47.4369,-122.272,1000,8886,3,18,2015,UNK,-30,244
16000015,4/17/2015,219950.0,3,1.5,1070,6601,1.0,0.0,0.0,3,6,1070,0,1985,0,98002,47.3115,-122.209,1030,6614,4,17,2015,UNK,40,-13
4035900015,6/19/2014,659500.0,4,3.0,2620,18362,1.0,0.0,0.0,4,8,1870,750,1956,0,98006,47.5646,-122.184,2630,16792,6,19,2014,UNK,-10,1570
8563010300,11/26/2014,746000.0,4,2.75,2110,8190,1.5,0.0,0.0,5,8,2110,0,1966,0,98008,47.6269,-122.1,2420,8400,11,26,2014,UNK,-310,-210
3396200300,3/31/2015,540000.0,3,1.75,2110,7129,1.0,0.0,0.0,3,8,1280,830,1982,0,98052,47.7219,-122.102,1810,8674,3,31,2015,UNK,300,-1545
2291401425,9/10/2014,485000.0,5,2.0,1910,5508,1.0,0.0,0.0,3,7,1020,890,1968,0,98133,47.7074,-122.34899999999999,1030,7440,9,10,2014,UNK,880,-1932
7454000110,1/27/2015,202000.0,2,1.0,670,7844,1.0,0.0,0.0,3,6,670,0,1942,0,98126,47.5165,-122.37200000000001,740,7218,1,27,2015,UNK,-70,626
3377900195,9/29/2014,2530000.0,4,5.5,6930,45100,1.0,0.0,0.0,4,11,4310,0,1950,1991,98006,47.5547,-122.14399999999999,2560,37766,9,29,2014,Y,4370,7334
3824100082,4/1/2015,502000.0,3,2.75,2010,11200,1.0,0.0,0.0,3,8,1360,650,1979,0,98028,47.7728,-122.25299999999999,2200,10640,4,1,2015,UNK,-190,560
3751604169,2/24/2015,279000.0,2,2.75,1770,10534,1.0,0.0,0.0,3,8,1210,560,2003,0,98001,47.2773,-122.27600000000001,1600,17400,2,24,2015,UNK,170,-6866
6431500283,11/17/2014,409500.0,3,1.0,1340,4120,1.0,0.0,0.0,4,7,1040,300,1921,0,98103,47.6916,-122.352,1270,4635,11,17,2014,UNK,70,-515
6647400090,7/2/2014,453000.0,3,2.0,1660,15050,1.0,0.0,0.0,3,7,1260,400,1983,0,98034,47.7203,-122.194,1660,7320,7,2,2014,UNK,0,7730
7387500195,2/27/2015,367000.0,4,1.0,1820,5500,1.5,0.0,0.0,3,6,1820,0,1947,0,98106,47.5185,-122.363,1140,5500,2,27,2015,UNK,680,0
3342101785,5/23/2014,550000.0,3,2.5,2510,5400,2.0,0.0,0.0,3,9,2510,0,1992,0,98056,47.5204,-122.206,1840,5400,5,23,2014,UNK,670,0
9320600090,1/27/2015,273500.0,3,1.5,1560,8314,1.0,0.0,0.0,3,7,1560,0,1962,0,98031,47.4117,-122.209,1820,8925,1,27,2015,UNK,-260,-611
8901001185,10/7/2014,505000.0,4,3.0,2280,7400,1.0,0.0,0.0,3,7,1340,0,1978,0,98125,47.71100000000001,-122.306,1540,7500,10,7,2014,UNK,740,-100
825069097,6/19/2014,770000.0,3,2.5,2650,40705,2.0,0.0,0.0,3,9,2650,0,1994,0,98053,47.668,-122.06299999999999,2550,42625,6,19,2014,UNK,100,-1920
7745000090,5/9/2014,565000.0,4,2.25,2470,7447,2.0,0.0,0.0,3,8,2470,0,1984,0,98155,47.7514,-122.286,2270,7400,5,9,2014,UNK,200,47
1771110090,8/20/2014,316000.0,3,0.75,1270,10092,1.0,0.0,0.0,5,7,1270,0,1971,0,98077,47.7567,-122.073,1300,10375,8,20,2014,UNK,-30,-283
7888100090,9/25/2014,160000.0,4,1.0,1520,7298,1.5,0.0,0.0,3,7,1520,0,1960,0,98198,47.3706,-122.31,1520,7298,9,25,2014,UNK,0,0
5083000375,10/27/2014,170000.0,3,1.0,1310,9529,1.0,0.0,0.0,3,7,1310,0,1956,0,98198,47.4105,-122.295,1330,9529,10,27,2014,UNK,-20,0
5083000375,3/19/2015,235000.0,3,1.0,1310,9529,1.0,0.0,0.0,3,7,1310,0,1956,0,98198,47.4105,-122.295,1330,9529,3,19,2015,UNK,-20,0
1329000090,12/19/2014,1800000.0,4,3.5,3930,39098,2.0,0.0,0.0,3,12,3930,0,1999,0,98005,47.6399,-122.15799999999999,4250,38682,12,19,2014,UNK,-320,416
8143000600,9/18/2014,310000.0,3,1.0,990,7050,1.0,0.0,0.0,3,7,990,0,1967,0,98034,47.7274,-122.20200000000001,1200,8125,9,18,2014,UNK,-210,-1075
2144800215,5/19/2014,285000.0,4,1.75,2080,13629,1.0,0.0,0.0,4,7,1040,1040,1955,0,98178,47.4866,-122.23200000000001,1780,14659,5,19,2014,UNK,300,-1030
9268200658,6/4/2014,280000.0,2,1.0,960,4920,1.0,0.0,0.0,3,6,960,0,1942,0,98117,47.6946,-122.36200000000001,1010,5040,6,4,2014,UNK,-50,-120
5452301785,2/18/2015,2300000.0,4,4.25,4070,13860,2.0,0.0,3.0,3,10,4070,0,2004,0,98040,47.59,-122.229,3430,9240,2,18,2015,N,640,4620
1137500090,8/14/2014,763776.0,4,2.5,2750,16139,2.0,0.0,0.0,3,9,2750,0,1989,0,98075,47.5843,-122.06,2810,13093,8,14,2014,UNK,-60,3046
6117500025,2/17/2015,530000.0,5,2.75,3230,13572,1.0,0.0,2.0,3,8,1880,1350,1965,0,98166,47.4393,-122.34700000000001,2910,15292,2,17,2015,UNK,320,-1720
2326079039,2/11/2015,362000.0,1,1.0,890,211576,1.5,0.0,0.0,3,7,890,0,1996,0,98019,47.7216,-121.883,1670,217364,2,11,2015,UNK,-780,-5788
7595700025,7/25/2014,430000.0,2,1.0,990,4920,1.0,0.0,0.0,3,6,990,0,1931,0,98117,47.6939,-122.368,990,4960,7,25,2014,UNK,0,-40
4443800110,7/25/2014,456500.0,3,1.0,1290,3880,1.5,0.0,0.0,4,7,1290,0,1919,0,98117,47.6879,-122.39200000000001,1290,4850,7,25,2014,UNK,0,-970
5101405265,9/11/2014,445000.0,4,2.5,2170,5257,2.0,0.0,0.0,3,7,2170,0,1989,0,98115,47.6999,-122.305,1430,7528,9,11,2014,UNK,740,-2271
9206200110,3/10/2015,386900.0,3,1.0,1330,10500,1.0,0.0,0.0,3,7,960,370,1963,0,98034,47.7204,-122.196,1460,11550,3,10,2015,UNK,-130,-1050
2205700405,7/8/2014,479000.0,3,1.0,1340,13750,1.0,0.0,0.0,4,7,1340,0,1955,0,98006,47.5771,-122.15100000000001,1430,11400,7,8,2014,UNK,-90,2350
7852020300,3/13/2015,525000.0,3,2.5,2200,4544,2.0,0.0,0.0,3,8,2200,0,2000,0,98065,47.5319,-121.867,2400,5431,3,13,2015,UNK,-200,-887
5559200051,1/6/2015,272000.0,4,1.75,2520,10890,1.0,0.0,0.0,3,7,1260,1260,1979,0,98023,47.3224,-122.34299999999999,2090,12375,1,6,2015,UNK,430,-1485
2826049165,2/26/2015,517000.0,4,1.0,1180,13500,1.5,0.0,0.0,3,7,1180,0,1950,0,98125,47.7165,-122.30799999999999,1580,8976,2,26,2015,UNK,-400,4524
2675600028,2/26/2015,615000.0,3,1.75,2660,7800,1.0,0.0,0.0,4,8,1330,1330,1951,0,98117,47.6993,-122.37799999999999,1950,6240,2,26,2015,UNK,710,1560
259801110,8/28/2014,439000.0,3,1.75,1250,7030,1.0,0.0,0.0,3,7,1250,0,1965,0,98008,47.6285,-122.118,1460,7210,8,28,2014,UNK,-210,-180
1150001270,7/24/2014,716000.0,3,2.5,2270,7866,1.0,0.0,0.0,4,10,2270,0,1988,0,98029,47.5622,-122.022,2580,8132,7,24,2014,UNK,-310,-266
7130300690,10/28/2014,308000.0,2,1.0,1080,6250,1.0,0.0,2.0,4,7,1080,0,1942,1968,98118,47.5128,-122.251,2100,6875,10,28,2014,Y,-1020,-625
2652500015,6/10/2014,800000.0,3,2.25,1620,4500,2.0,0.0,0.0,4,8,1620,0,1926,0,98119,47.643,-122.361,1210,4320,6,10,2014,UNK,410,180
3693901801,5/5/2015,575000.0,3,2.0,940,5000,1.0,0.0,0.0,3,7,880,60,1941,0,98117,47.6771,-122.398,1420,5000,5,5,2015,UNK,-480,0
8092501240,7/1/2014,219950.0,3,1.5,1620,9310,1.0,0.0,0.0,4,7,1620,0,1967,0,98042,47.3665,-122.10700000000001,1610,10640,7,1,2014,UNK,10,-1330
9552701030,5/22/2014,770000.0,4,2.5,2350,8001,2.0,0.0,0.0,4,8,2350,0,1987,0,98006,47.5478,-122.15299999999999,2460,8001,5,22,2014,UNK,-110,0
9477101280,12/30/2014,424950.0,3,1.75,2090,7505,1.0,0.0,0.0,3,7,2090,0,1967,0,98034,47.7326,-122.194,1510,7416,12,30,2014,UNK,580,89
7462900015,1/8/2015,387000.0,3,2.25,1760,45133,2.0,0.0,0.0,3,7,1760,0,1984,0,98065,47.5124,-121.866,1910,51773,1,8,2015,UNK,-150,-6640
6744700302,6/20/2014,790000.0,4,1.75,2050,10920,1.0,0.0,3.0,3,8,1450,600,1974,0,98155,47.7431,-122.286,2440,10920,6,20,2014,UNK,-390,0
3163600015,1/28/2015,156000.0,2,1.0,600,4000,1.0,0.0,0.0,3,5,600,0,1933,0,98146,47.5065,-122.339,1290,6973,1,28,2015,UNK,-690,-2973
6896300375,5/5/2014,580000.0,2,1.0,2540,7000,1.0,0.0,0.0,5,8,1320,1220,1942,0,98118,47.5259,-122.26100000000001,2160,6000,5,5,2014,UNK,380,1000
7419700015,9/19/2014,490000.0,4,2.25,2090,10869,2.0,0.0,0.0,3,8,2090,0,1970,0,98033,47.6715,-122.164,1800,17788,9,19,2014,UNK,290,-6919
4473400195,7/16/2014,950000.0,5,3.25,2700,3650,2.0,0.0,2.0,3,9,2070,630,1926,2014,98144,47.5959,-122.291,1940,4000,7,16,2014,Y,760,-350
9358001566,2/13/2015,400000.0,2,2.5,1410,1281,2.0,0.0,0.0,3,8,1090,320,2008,0,98126,47.5659,-122.37,1410,2550,2,13,2015,N,0,-1269
6145600900,5/13/2015,325000.0,2,2.5,1170,1638,2.0,0.0,0.0,3,8,1170,0,2008,0,98133,47.7041,-122.351,1350,1407,5,13,2015,N,-180,231
1865000110,9/29/2014,365000.0,4,2.5,2540,6688,2.0,0.0,0.0,3,9,2540,0,2002,0,98092,47.3314,-122.18,2810,6776,9,29,2014,UNK,-270,-88
8698100115,4/7/2015,255000.0,3,1.75,2190,6000,1.5,0.0,0.0,4,7,2190,0,1920,0,98002,47.3063,-122.223,1610,6000,4,7,2015,UNK,580,0
1454600038,3/23/2015,985000.0,5,3.5,3890,13261,2.0,0.0,1.0,3,9,2870,1020,1984,0,98125,47.7246,-122.28399999999999,3080,13261,3,23,2015,UNK,810,0
5652601425,4/23/2015,595000.0,4,2.5,2030,10722,1.0,0.0,0.0,3,7,1100,930,1967,0,98115,47.6955,-122.301,1610,9134,4,23,2015,UNK,420,1588
6381500690,7/16/2014,427500.0,3,1.0,1350,7085,1.0,0.0,0.0,5,7,1350,0,1944,0,98125,47.7318,-122.305,1350,7085,7,16,2014,UNK,0,0
1778500015,10/16/2014,728000.0,3,1.5,1940,4000,1.5,0.0,0.0,3,8,1310,630,1915,0,98112,47.6205,-122.291,1940,4000,10,16,2014,UNK,0,0
6021500245,9/10/2014,549950.0,2,1.0,1260,4000,1.0,0.0,0.0,3,7,1000,260,1940,0,98117,47.6898,-122.384,1780,4000,9,10,2014,UNK,-520,0
2926049382,12/8/2014,650000.0,3,2.0,2800,10501,1.0,0.0,0.0,3,7,1400,1400,1954,0,98125,47.7055,-122.315,2260,6534,12,8,2014,UNK,540,3967
1692900110,3/20/2015,1130000.0,5,3.25,3080,13394,1.0,0.0,2.0,4,9,2230,0,1968,0,98033,47.6651,-122.19,2810,10720,3,20,2015,UNK,270,2674
8651401270,5/4/2015,203000.0,3,1.0,840,6500,1.0,0.0,0.0,5,6,840,0,1969,0,98042,47.3637,-122.083,920,4680,5,4,2015,UNK,-80,1820
3332500265,8/7/2014,311000.0,2,1.0,860,3300,1.0,0.0,0.0,5,6,860,0,1903,0,98118,47.5496,-122.279,1380,4400,8,7,2014,UNK,-520,-1100
4027700853,4/28/2015,387500.0,6,2.0,2400,7684,1.0,0.0,0.0,3,6,1200,1200,1932,2005,98028,47.7705,-122.26899999999999,1290,9800,4,28,2015,Y,1110,-2116
7301300215,3/18/2015,370000.0,4,2.0,1640,7200,1.0,0.0,0.0,3,7,1640,0,1963,0,98155,47.7471,-122.324,1500,9000,3,18,2015,UNK,140,-1800
7663700792,7/24/2014,228000.0,2,1.0,1060,6100,1.0,0.0,0.0,3,6,1060,0,1951,0,98125,47.7317,-122.296,1550,9150,7,24,2014,UNK,-490,-3050
2919702235,5/28/2014,740000.0,2,1.75,2080,4800,1.0,0.0,0.0,5,7,1080,1000,1923,0,98117,47.6896,-122.36200000000001,1310,4800,5,28,2014,UNK,770,0
5476200123,7/10/2014,200000.0,4,2.0,2090,6630,1.0,0.0,0.0,3,7,1070,1020,1974,0,98178,47.5077,-122.26799999999999,1550,7980,7,10,2014,UNK,540,-1350
3797002585,7/9/2014,660000.0,3,1.0,1240,3500,1.0,0.0,0.0,4,7,1240,0,1927,0,98103,47.6835,-122.34700000000001,1650,3360,7,9,2014,UNK,-410,140
8864000735,7/9/2014,275000.0,4,2.0,2030,8426,2.0,0.0,0.0,3,7,2030,0,1944,0,98168,47.4806,-122.287,1190,7007,7,9,2014,UNK,840,1419
1193000115,4/29/2015,708000.0,2,1.0,1120,5250,1.0,0.0,0.0,3,7,950,170,1938,0,98199,47.6496,-122.39200000000001,1510,5250,4,29,2015,UNK,-390,0
7334501240,5/19/2014,280000.0,3,2.5,1270,9675,2.0,0.0,0.0,3,8,1270,0,1993,0,98045,47.4639,-121.744,1270,11700,5,19,2014,UNK,0,-2025
7885801460,1/6/2015,325000.0,4,2.5,2260,5702,2.0,0.0,0.0,3,8,2260,0,2002,0,98042,47.3488,-122.15100000000001,2450,6381,1,6,2015,UNK,-190,-679
1823099076,8/20/2014,495000.0,3,2.5,1780,47480,2.0,0.0,0.0,3,7,1780,0,1995,0,98045,47.4723,-121.70700000000001,1890,51836,8,20,2014,UNK,-110,-4356
8900000110,9/22/2014,691000.0,2,2.0,1780,3810,1.5,0.0,0.0,3,7,980,800,1922,0,98119,47.6474,-122.36200000000001,1690,3810,9,22,2014,UNK,90,0
251620110,7/2/2014,2290000.0,4,2.5,4080,18362,2.0,0.0,2.0,4,11,4080,0,1983,0,98004,47.6344,-122.214,4080,19991,7,2,2014,UNK,0,-1629
221049191,4/28/2015,329500.0,3,2.5,2120,22482,1.0,0.0,0.0,5,7,1360,760,1979,0,98001,47.341,-122.265,2330,16016,4,28,2015,UNK,-210,6466
9264950940,8/5/2014,348000.0,3,2.5,2060,7458,2.0,0.0,0.0,3,9,2060,0,1989,0,98023,47.3045,-122.351,2480,7743,8,5,2014,UNK,-420,-285
8820902540,11/14/2014,425000.0,2,1.0,1670,6212,1.0,0.0,0.0,4,7,1670,0,1947,0,98125,47.7152,-122.28200000000001,1670,7272,11,14,2014,UNK,0,-1060
3438500625,5/19/2014,210000.0,3,1.0,1080,21043,1.0,0.0,0.0,3,6,1080,0,1942,0,98106,47.5515,-122.35700000000001,1380,7620,5,19,2014,UNK,-300,13423
7452500315,12/20/2014,285000.0,2,1.0,1210,4895,1.0,0.0,0.0,3,6,710,500,1951,0,98126,47.5202,-122.37299999999999,1100,6000,12,20,2014,UNK,110,-1105
8945200750,4/30/2015,222000.0,3,1.0,990,8840,1.0,0.0,0.0,3,6,990,0,1966,0,98023,47.3074,-122.37100000000001,1120,8625,4,30,2015,UNK,-130,215
2599001240,5/27/2014,200000.0,4,2.5,1720,9600,1.0,0.0,0.0,3,7,1120,600,1961,0,98092,47.2917,-122.18799999999999,1520,9400,5,27,2014,UNK,200,200
5360200054,10/2/2014,247500.0,3,2.0,1530,8749,1.0,0.0,0.0,3,7,1530,0,1995,0,98023,47.2974,-122.37200000000001,1750,8749,10,2,2014,UNK,-220,0
622069006,8/20/2014,1500000.0,4,5.5,6550,217374,1.0,0.0,0.0,3,11,5400,1150,2006,0,98058,47.4302,-122.095,4110,50378,8,20,2014,N,2440,166996
84000245,11/20/2014,190000.0,3,1.75,1100,9452,1.0,0.0,0.0,3,6,1100,0,1942,0,98146,47.4864,-122.337,1350,9452,11,20,2014,UNK,-250,0
5605000590,12/15/2014,975000.0,4,2.5,3020,4950,1.5,0.0,0.0,4,9,2020,1000,1921,0,98112,47.6467,-122.304,2300,5450,12,15,2014,UNK,720,-500
6613000015,12/23/2014,1130000.0,4,3.0,3180,4649,2.0,0.0,0.0,4,9,2070,1110,1925,0,98105,47.6583,-122.273,2720,5980,12,23,2014,UNK,460,-1331
5151600195,5/4/2015,283200.0,4,1.75,1830,12540,1.0,0.0,0.0,4,8,1130,700,1958,0,98003,47.3348,-122.324,2020,12540,5,4,2015,UNK,-190,0
7308900490,7/14/2014,650000.0,3,2.5,2540,8073,1.0,0.0,0.0,4,8,1880,660,1937,0,98177,47.7176,-122.36,2110,7702,7,14,2014,UNK,430,371
2222900082,5/13/2014,449500.0,3,2.0,1770,6610,1.0,0.0,0.0,4,7,960,810,1954,0,98133,47.7703,-122.34299999999999,2010,4361,5,13,2014,UNK,-240,2249
3574801720,10/22/2014,400000.0,3,1.75,1470,6682,1.0,0.0,0.0,3,7,1470,0,1987,0,98034,47.7315,-122.226,1790,7379,10,22,2014,UNK,-320,-697
1721801591,2/19/2015,89950.0,1,1.0,570,4080,1.0,0.0,0.0,3,5,570,0,1942,0,98146,47.5098,-122.334,890,5100,2,19,2015,UNK,-320,-1020
2641800015,11/24/2014,158800.0,3,1.0,960,8291,1.0,0.0,0.0,3,6,960,0,1950,0,98146,47.5006,-122.334,1110,8231,11,24,2014,UNK,-150,60
7625703885,9/17/2014,870000.0,4,3.0,2940,7108,2.0,0.0,1.0,3,9,2220,720,2011,0,98136,47.5437,-122.395,2240,7950,9,17,2014,N,700,-842
3751600176,3/6/2015,196000.0,3,1.5,1000,18568,1.0,0.0,0.0,3,6,1000,0,1989,0,98001,47.2976,-122.271,1610,17420,3,6,2015,UNK,-610,1148
5035300750,7/31/2014,850000.0,3,1.75,2450,8603,1.0,0.0,0.0,5,8,1340,1110,1940,0,98199,47.6536,-122.414,2280,5779,7,31,2014,UNK,170,2824
9510970300,9/23/2014,775000.0,4,2.5,3310,5101,2.0,0.0,0.0,3,9,3310,0,2005,0,98052,47.6649,-122.08,3010,5176,9,23,2014,N,300,-75
9286100300,8/1/2014,483500.0,3,2.5,1670,4308,2.0,0.0,0.0,3,8,1670,0,2001,0,98027,47.5307,-122.04700000000001,1670,2897,8,1,2014,UNK,0,1411
4047200850,4/2/2015,387000.0,3,1.5,1620,21929,2.0,0.0,0.0,3,7,1620,0,1990,0,98019,47.766999999999996,-121.90299999999999,1600,21679,4,2,2015,UNK,20,250
4019300195,1/24/2015,900000.0,3,3.0,2990,30869,2.0,0.0,0.0,3,10,2990,0,1951,2003,98155,47.7602,-122.27799999999999,1750,15802,1,24,2015,Y,1240,15067
7891600590,4/7/2015,336000.0,3,1.5,1240,5000,1.0,0.0,2.0,3,7,1240,0,1964,0,98106,47.5659,-122.36,1050,5000,4,7,2015,UNK,190,0
5249802424,4/17/2015,415000.0,2,1.0,670,6000,1.0,0.0,0.0,5,6,670,0,1949,0,98118,47.56100000000001,-122.275,1240,5040,4,17,2015,UNK,-570,960
9209900315,8/11/2014,350000.0,3,1.5,1320,4400,1.0,0.0,0.0,3,6,1320,0,1909,0,98112,47.6231,-122.292,1350,4400,8,11,2014,UNK,-30,0
7237500590,11/17/2014,1320000.0,4,5.25,6110,10369,2.0,0.0,0.0,3,11,6110,0,2005,0,98059,47.5285,-122.135,4190,10762,11,17,2014,N,1920,-393
3271800850,8/6/2014,765000.0,3,1.75,2440,5800,1.0,0.0,3.0,4,8,1320,1120,1945,0,98199,47.6474,-122.412,2530,5800,8,6,2014,UNK,-90,0
1023059511,10/20/2014,527000.0,4,2.5,2900,6736,2.0,0.0,0.0,3,8,2900,0,2013,0,98059,47.4954,-122.152,2900,6736,10,20,2014,N,0,0
4109600195,7/18/2014,524000.0,4,2.75,2310,5000,1.5,0.0,0.0,5,8,1480,830,1908,0,98118,47.5502,-122.26799999999999,1100,5000,7,18,2014,UNK,1210,0
5100401468,7/15/2014,448000.0,2,1.0,1110,5413,1.0,0.0,0.0,3,6,890,220,1937,0,98115,47.6925,-122.32,1300,5413,7,15,2014,UNK,-190,0
1926069137,7/7/2014,775000.0,4,3.25,4100,241322,2.0,0.0,0.0,3,9,2500,1600,1981,0,98072,47.7302,-122.096,3770,87821,7,7,2014,UNK,330,153501
3828000405,1/16/2015,176500.0,3,1.0,930,9900,1.5,0.0,0.0,4,5,930,0,1910,0,98032,47.3745,-122.23100000000001,930,7200,1,16,2015,UNK,0,2700
7773800015,4/16/2015,750000.0,4,2.25,2420,11120,1.0,0.0,2.0,4,8,1620,800,1952,0,98146,47.4954,-122.366,2210,8497,4,16,2015,UNK,210,2623
1084000107,12/2/2014,1270000.0,4,2.25,2870,6000,1.0,0.0,0.0,5,8,1730,1140,1951,0,98112,47.6362,-122.28200000000001,2370,5500,12,2,2014,UNK,500,500
7832800015,2/26/2015,250000.0,3,1.0,1480,6750,1.0,0.0,0.0,3,7,1480,0,1958,0,98146,47.505,-122.366,1480,7594,2,26,2015,UNK,0,-844
9829200590,10/28/2014,759000.0,3,2.75,1960,6390,1.5,0.0,2.0,5,8,1960,0,1900,0,98122,47.6032,-122.285,2440,5870,10,28,2014,UNK,-480,520
8127700820,12/11/2014,640000.0,3,2.0,1470,4640,1.5,0.0,0.0,4,7,1470,0,1926,0,98199,47.6398,-122.39299999999999,1700,5000,12,11,2014,UNK,-230,-360
9547202265,4/27/2015,990000.0,3,3.25,2460,4182,2.0,0.0,0.0,5,8,2100,360,1910,0,98115,47.6782,-122.311,2370,4284,4,27,2015,UNK,90,-102
7663700261,10/8/2014,395000.0,4,1.75,1960,7945,1.0,0.0,0.0,4,7,980,980,1946,0,98125,47.7326,-122.291,1290,7945,10,8,2014,UNK,670,0
1445200110,4/21/2015,275000.0,2,1.5,1160,1103,2.0,0.0,0.0,3,7,890,270,2006,0,98133,47.7677,-122.315,1160,1086,4,21,2015,N,0,17
1023059313,2/5/2015,390000.0,3,2.5,1910,4755,2.0,0.0,0.0,3,8,1910,0,1997,0,98059,47.4956,-122.162,2460,6099,2,5,2015,UNK,-550,-1344
170000215,3/24/2015,752500.0,5,2.75,2720,4680,1.5,0.0,0.0,4,8,1710,0,1913,0,98107,47.6612,-122.363,1670,4800,3,24,2015,UNK,1050,-120
7550801220,2/27/2015,450000.0,2,1.0,1020,5000,1.5,0.0,0.0,4,6,1020,0,1906,0,98107,47.6725,-122.396,1490,5000,2,27,2015,UNK,-470,0
7518501390,6/17/2014,473000.0,2,1.0,900,5100,1.0,0.0,0.0,4,7,900,0,1909,0,98117,47.6804,-122.37799999999999,1400,5100,6,17,2014,UNK,-500,0
9407102460,3/23/2015,178500.0,3,1.75,1120,10450,1.0,0.0,0.0,3,7,1120,0,1973,0,98045,47.4418,-121.772,1250,10414,3,23,2015,UNK,-130,36
8567300110,6/4/2014,485000.0,3,2.5,2340,59058,1.0,0.0,0.0,3,8,2340,0,1985,0,98038,47.4052,-122.02799999999999,2700,37263,6,4,2014,UNK,-360,21795
5029450110,3/27/2015,215000.0,3,1.5,1410,8415,1.0,0.0,0.0,4,7,780,630,1982,0,98023,47.2914,-122.368,1440,7361,3,27,2015,UNK,-30,1054
7915100490,8/12/2014,589000.0,4,1.75,1920,4862,1.0,0.0,0.0,5,7,1060,860,1919,0,98116,47.5747,-122.384,1840,4862,8,12,2014,UNK,80,0
114101500,4/17/2015,325000.0,4,1.75,1370,9993,1.0,0.0,0.0,3,6,1370,0,1918,0,98028,47.7572,-122.228,1650,11592,4,17,2015,UNK,-280,-1599
9274201807,8/20/2014,580000.0,3,2.5,1590,1937,2.5,0.0,0.0,3,8,1590,0,2004,0,98116,47.5903,-122.38799999999999,1620,2022,8,20,2014,N,-30,-85
7893206095,7/16/2014,181100.0,4,1.75,1850,7500,1.0,0.0,0.0,3,7,1850,0,1954,0,98198,47.4217,-122.333,1460,7500,7,16,2014,UNK,390,0
2770602265,2/24/2015,345000.0,3,2.0,1430,4200,1.0,0.0,0.0,4,7,830,600,1908,0,98199,47.6462,-122.384,1540,5000,2,24,2015,UNK,-110,-800
5418200245,3/30/2015,781000.0,3,1.75,1940,8729,1.0,0.0,0.0,3,8,1460,480,1960,0,98125,47.7027,-122.28200000000001,2250,9165,3,30,2015,UNK,-310,-436
7228502150,10/23/2014,402500.0,4,1.0,1270,3630,1.5,0.0,0.0,3,7,1270,0,1903,0,98122,47.6135,-122.307,1420,4848,10,23,2014,UNK,-150,-1218
7972601030,4/20/2015,426000.0,3,1.5,1380,7200,1.0,0.0,0.0,3,7,1080,300,1948,0,98106,47.5292,-122.348,1220,7200,4,20,2015,UNK,160,0
7853270940,9/5/2014,389000.0,3,2.5,1720,4515,2.0,0.0,0.0,3,7,1720,0,2005,0,98065,47.5426,-121.87899999999999,2220,4618,9,5,2014,N,-500,-103
5561401220,7/7/2014,670000.0,6,3.0,4050,36171,2.0,0.0,0.0,4,8,2620,1430,1970,0,98027,47.4708,-122.015,3660,42874,7,7,2014,UNK,390,-6703
1336800015,5/21/2014,1510000.0,4,3.25,3660,5800,2.5,0.0,0.0,3,10,3360,300,1909,1995,98112,47.6283,-122.31200000000001,3240,5800,5,21,2014,Y,420,0
8944750850,5/21/2014,288400.0,3,2.25,1870,3230,2.0,0.0,0.0,3,7,1870,0,1997,0,98056,47.4915,-122.167,1620,3363,5,21,2014,UNK,250,-133
3362400590,2/19/2015,700000.0,4,2.0,2230,4635,1.5,0.0,0.0,5,7,1510,720,1908,0,98103,47.681999999999995,-122.34899999999999,1520,4635,2,19,2015,UNK,710,0
6821100195,3/31/2015,830000.0,4,3.0,2020,6000,1.0,0.0,0.0,3,8,1220,800,1968,2015,98199,47.6563,-122.40100000000001,1400,6000,3,31,2015,Y,620,0
1827200265,9/11/2014,1900000.0,2,2.75,3690,32044,2.0,1.0,4.0,3,12,3690,0,1989,0,98166,47.4485,-122.369,2310,26988,9,11,2014,UNK,1380,5056
5100401429,10/9/2014,350500.0,2,1.0,1450,6380,1.0,0.0,0.0,3,7,1450,0,1967,0,98115,47.6924,-122.321,1240,6380,10,9,2014,UNK,210,0
6116500028,5/3/2015,431000.0,3,1.75,1630,9000,1.0,0.0,0.0,4,7,1630,0,1956,0,98166,47.4521,-122.36,1600,11120,5,3,2015,UNK,30,-2120
2759800110,10/31/2014,485000.0,3,2.5,1840,8250,1.0,0.0,1.0,3,8,1340,500,1958,0,98177,47.7767,-122.37799999999999,1970,7920,10,31,2014,UNK,-130,330
579000096,10/10/2014,780000.0,3,1.5,1620,7500,1.0,0.0,2.0,4,8,1620,0,1949,0,98117,47.7014,-122.381,2440,7800,10,10,2014,UNK,-820,-300
9169600096,8/1/2014,720000.0,2,1.5,1840,9000,1.0,0.0,2.0,3,8,1340,500,1957,0,98136,47.5281,-122.38799999999999,1880,7560,8,1,2014,UNK,-40,1440
1226059112,2/20/2015,415000.0,3,1.0,1360,73616,1.0,0.0,0.0,3,7,1360,0,1971,0,98072,47.7528,-122.119,2040,50965,2,20,2015,UNK,-680,22651
6021503830,6/20/2014,480000.0,4,1.0,2080,5500,1.0,0.0,0.0,3,7,1040,1040,1941,0,98117,47.6838,-122.38600000000001,1280,4000,6,20,2014,UNK,800,1500
3824100291,9/16/2014,452250.0,4,2.25,2550,10000,1.0,0.0,0.0,4,7,1560,990,1979,0,98028,47.77,-122.259,2440,10000,9,16,2014,UNK,110,0
9264921030,4/6/2015,316000.0,3,2.5,2550,8170,2.0,0.0,0.0,3,8,2550,0,1985,0,98023,47.31100000000001,-122.345,1840,8823,4,6,2015,UNK,710,-653
8073000495,10/10/2014,700000.0,2,1.0,1160,17635,1.0,1.0,4.0,3,6,1160,0,1945,0,98178,47.5117,-122.24799999999999,1510,13122,10,10,2014,UNK,-350,4513
7129304105,7/29/2014,285000.0,4,2.0,1760,5500,1.0,0.0,1.0,3,7,780,980,1925,2004,98118,47.5183,-122.265,1510,5500,7,29,2014,Y,250,0
525049085,9/18/2014,575000.0,3,1.75,1720,4050,1.0,0.0,0.0,5,7,860,860,1906,0,98115,47.6782,-122.314,1720,4410,9,18,2014,UNK,0,-360
6117500785,7/22/2014,590000.0,3,2.25,2300,12430,1.0,0.0,2.0,4,8,1580,720,1960,0,98166,47.435,-122.34700000000001,2500,12430,7,22,2014,UNK,-200,0
6115400008,2/26/2015,587500.0,4,1.75,2500,20868,1.0,0.0,2.0,3,8,1600,900,1956,0,98166,47.431000000000004,-122.338,2170,15026,2,26,2015,UNK,330,5842
4024101545,9/22/2014,364000.0,4,2.25,1750,10270,1.5,0.0,0.0,4,8,1750,0,1968,0,98155,47.7612,-122.31,1750,10127,9,22,2014,UNK,0,143
8651511220,12/17/2014,490000.0,3,2.5,1890,10190,2.0,0.0,0.0,3,8,1890,0,1986,0,98074,47.6478,-122.061,2080,9794,12,17,2014,UNK,-190,396
5561301280,5/5/2014,410000.0,3,2.25,1800,36704,1.0,0.0,0.0,4,8,1360,440,1978,0,98027,47.4688,-122.01299999999999,2730,36404,5,5,2014,UNK,-930,300
3629800100,10/28/2014,520000.0,3,2.5,2160,4297,2.0,0.0,0.0,3,9,2160,0,1999,0,98029,47.5476,-122.012,2160,3968,10,28,2014,UNK,0,329
6141100750,10/8/2014,389000.0,3,1.0,1380,6591,1.0,0.0,0.0,4,7,1380,0,1947,0,98133,47.7164,-122.351,1610,6594,10,8,2014,UNK,-230,-3
2770605065,11/18/2014,450000.0,2,1.0,1180,6000,1.0,0.0,0.0,3,7,1180,0,1910,0,98119,47.6531,-122.37299999999999,1600,6000,11,18,2014,UNK,-420,0
2517100490,12/5/2014,325000.0,3,2.5,2550,4240,2.0,0.0,0.0,3,7,2550,0,2006,0,98031,47.3986,-122.169,2550,4240,12,5,2014,N,0,0
4083801785,3/13/2015,660000.0,2,1.0,1070,5000,1.0,0.0,0.0,3,7,1070,0,1924,0,98103,47.6631,-122.337,1400,4000,3,13,2015,UNK,-330,1000
4318200405,6/20/2014,850000.0,3,2.25,2870,8170,2.0,0.0,0.0,3,10,2250,620,1995,0,98136,47.5363,-122.385,1310,8170,6,20,2014,UNK,1560,0
2329810590,8/6/2014,285000.0,3,2.5,1940,9874,2.0,0.0,0.0,3,7,1940,0,1990,0,98042,47.3794,-122.113,1860,8875,8,6,2014,UNK,80,999
2768301214,12/11/2014,395000.0,2,1.0,870,3121,1.0,0.0,0.0,4,7,870,0,1923,0,98107,47.6659,-122.369,1570,1777,12,11,2014,UNK,-700,1344
1931301105,7/17/2014,440000.0,3,2.0,1550,2401,2.0,0.0,0.0,3,7,1550,0,1996,0,98103,47.6545,-122.348,1550,3446,7,17,2014,UNK,0,-1045
3343903640,3/13/2015,249000.0,3,1.75,1400,5648,1.5,0.0,0.0,5,6,1400,0,1917,0,98056,47.5133,-122.196,2320,9420,3,13,2015,UNK,-920,-3772
8813400245,2/27/2015,635000.0,3,1.75,1210,4400,1.5,0.0,0.0,4,8,1210,0,1930,0,98105,47.6621,-122.288,2020,3750,2,27,2015,UNK,-810,650
3521049048,8/11/2014,515000.0,3,2.5,3430,48993,2.0,0.0,0.0,3,9,3430,0,2001,0,98001,47.2609,-122.27,2460,36256,8,11,2014,UNK,970,12737
1118001645,1/30/2015,1400000.0,3,3.25,3020,6073,2.0,0.0,0.0,4,9,3020,0,1954,0,98112,47.6332,-122.29,3020,7700,1,30,2015,UNK,0,-1627
2968801105,3/4/2015,200000.0,2,1.0,950,8100,1.0,0.0,0.0,3,6,950,0,1955,0,98166,47.4572,-122.351,1620,7630,3,4,2015,UNK,-670,470
3524039209,5/6/2014,1140000.0,4,2.75,3370,8103,1.0,0.0,3.0,3,9,1970,1400,1970,2014,98136,47.5232,-122.383,2120,6360,5,6,2014,Y,1250,1743
952003480,11/17/2014,445000.0,4,1.0,1460,4600,1.0,0.0,2.0,3,6,780,680,1946,0,98126,47.566,-122.38,1560,4600,11,17,2014,UNK,-100,0
2877102670,7/7/2014,555000.0,3,1.5,1740,4200,1.5,0.0,0.0,4,7,1640,100,1920,0,98117,47.6782,-122.361,1660,3750,7,7,2014,UNK,80,450
5014000100,9/24/2014,537000.0,4,2.0,1720,6413,1.0,0.0,0.0,4,7,860,860,1950,0,98116,47.5734,-122.395,1280,6413,9,24,2014,UNK,440,0
7399301050,1/27/2015,315000.0,3,1.75,1480,7500,1.0,0.0,0.0,4,7,1480,0,1968,0,98055,47.4629,-122.18700000000001,1480,7500,1,27,2015,UNK,0,0
6979940100,1/29/2015,805000.0,5,2.5,3320,7266,2.0,0.0,0.0,3,9,3320,0,2000,0,98075,47.5862,-122.054,3060,10269,1,29,2015,UNK,260,-3003
8731982840,8/26/2014,414000.0,4,2.5,3490,9030,1.5,0.0,0.0,4,8,3490,0,1969,0,98023,47.3198,-122.38600000000001,2540,8400,8,26,2014,UNK,950,630
6909200037,8/15/2014,375000.0,2,1.5,1160,1648,2.0,0.0,0.0,3,7,1160,0,2002,0,98144,47.5916,-122.29299999999999,1458,2351,8,15,2014,UNK,-298,-703
1160000115,3/4/2015,401000.0,4,1.75,3010,12523,1.0,0.0,0.0,3,8,1780,1230,1952,0,98125,47.707,-122.316,2040,7560,3,4,2015,UNK,970,4963
7893207665,1/28/2015,210000.0,3,1.0,1030,4583,1.0,0.0,0.0,3,7,1030,0,1967,0,98198,47.4231,-122.329,1730,8023,1,28,2015,UNK,-700,-3440
8024201270,7/22/2014,365000.0,2,1.0,980,5110,1.0,0.0,0.0,4,7,780,200,1939,0,98115,47.7002,-122.314,1430,5110,7,22,2014,UNK,-450,0
3800008,2/24/2015,178000.0,5,1.5,1990,18200,1.0,0.0,0.0,3,7,1990,0,1960,0,98178,47.4938,-122.262,1860,8658,2,24,2015,UNK,130,9542
6788200931,5/20/2014,710000.0,2,1.0,1790,4000,1.0,0.0,0.0,4,7,1040,750,1923,0,98112,47.6405,-122.301,1310,4000,5,20,2014,UNK,480,0
723049596,5/9/2014,255000.0,2,1.0,810,7980,1.0,0.0,0.0,1,6,810,0,1928,0,98146,47.489,-122.337,1440,7980,5,9,2014,UNK,-630,0
7214711270,12/4/2014,528000.0,5,2.25,2940,38009,1.0,0.0,0.0,3,8,1700,1240,1977,0,98077,47.7653,-122.07700000000001,2620,38300,12,4,2014,UNK,320,-291
4136980090,4/7/2015,537000.0,4,4.25,4883,26040,2.0,0.0,3.0,3,10,3859,1024,2006,0,98092,47.26300000000001,-122.21600000000001,3736,9870,4,7,2015,N,1147,16170
9278200131,8/4/2014,442000.0,4,1.5,1360,6110,1.0,0.0,0.0,3,7,1010,350,1955,0,98116,47.5755,-122.396,1520,6110,8,4,2014,UNK,-160,0
4046600750,4/14/2015,375000.0,3,1.75,1370,19550,1.0,0.0,0.0,3,7,1370,0,1978,0,98014,47.7002,-121.912,1430,17550,4,14,2015,UNK,-60,2000
9510970090,11/21/2014,637250.0,4,2.5,2120,3220,2.0,0.0,0.0,3,9,2120,0,2005,0,98052,47.6662,-122.083,2120,3547,11,21,2014,N,0,-327
2594200375,3/30/2015,427500.0,3,1.75,1240,7200,1.0,0.0,0.0,5,7,1240,0,1942,0,98136,47.5142,-122.389,1640,7200,3,30,2015,UNK,-400,0
1125069064,3/31/2015,700000.0,4,2.5,2770,89298,2.0,0.0,0.0,3,8,2770,0,2004,0,98053,47.6624,-122.01,2650,89298,3,31,2015,N,120,0
117000100,3/19/2015,680000.0,3,1.75,1660,5750,1.0,0.0,0.0,4,7,1080,580,1909,0,98116,47.5843,-122.385,2060,5560,3,19,2015,UNK,-400,190
9212900820,8/28/2014,393820.0,2,2.0,1170,8251,1.0,0.0,0.0,3,7,1170,0,1941,0,98115,47.6873,-122.291,1360,6798,8,28,2014,UNK,-190,1453
3959400855,8/20/2014,525000.0,4,2.75,2470,7200,1.0,0.0,0.0,5,7,1350,1120,1940,0,98108,47.5631,-122.31700000000001,1500,6000,8,20,2014,UNK,970,1200
2028700265,1/15/2015,505000.0,2,1.75,1310,3816,1.0,0.0,0.0,2,7,1110,200,1929,0,98117,47.678999999999995,-122.368,1510,3816,1,15,2015,UNK,-200,0
3041700090,11/11/2014,555565.0,3,2.0,1670,11337,1.0,0.0,1.0,4,7,1670,0,1959,0,98033,47.6602,-122.18799999999999,2210,11337,11,11,2014,UNK,-540,0
868001295,10/29/2014,650000.0,3,1.75,1660,10819,1.0,0.0,0.0,4,7,1240,420,1942,0,98177,47.7045,-122.37899999999999,3110,11853,10,29,2014,UNK,-1450,-1034
7853270740,9/17/2014,632500.0,5,3.25,3500,7254,2.0,0.0,0.0,3,8,2760,740,2005,0,98065,47.5444,-121.881,2820,6317,9,17,2014,N,680,937
5416500090,7/24/2014,269000.0,3,2.5,1440,3800,2.0,0.0,0.0,3,7,1440,0,2005,0,98038,47.3606,-122.039,1890,3819,7,24,2014,N,-450,-19
3574801110,11/25/2014,405000.0,4,2.75,2360,7716,1.0,0.0,0.0,3,7,1390,970,1978,0,98034,47.7301,-122.223,2160,8794,11,25,2014,UNK,200,-1078
624110930,7/24/2014,845000.0,3,3.5,3460,15745,2.0,0.0,0.0,3,10,3460,0,1986,0,98077,47.7262,-122.06,3350,14825,7,24,2014,UNK,110,920
5335700110,7/25/2014,234000.0,3,1.0,1750,8820,1.0,0.0,0.0,4,7,1750,0,1961,0,98032,47.3608,-122.29,1400,9600,7,25,2014,UNK,350,-780
1176000964,4/22/2015,638000.0,4,1.75,1470,4236,1.5,0.0,0.0,4,7,1470,0,1946,0,98107,47.6692,-122.399,1480,5400,4,22,2015,UNK,-10,-1164
7334602070,8/4/2014,290000.0,3,1.75,1710,10950,1.0,0.0,0.0,3,7,1060,650,1967,0,98045,47.4678,-121.745,1180,10950,8,4,2014,UNK,530,0
2420069251,2/25/2015,262000.0,1,0.75,520,12981,1.0,0.0,0.0,5,3,520,0,1920,0,98022,47.2082,-121.995,1340,12233,2,25,2015,UNK,-820,748
7885800740,2/18/2015,270000.0,4,2.5,2350,5835,2.0,0.0,0.0,3,8,2350,0,2003,0,98042,47.3494,-122.15299999999999,3010,5772,2,18,2015,UNK,-660,63
8082400076,11/18/2014,875000.0,4,2.25,2380,4876,2.0,0.0,0.0,4,9,2240,140,1948,0,98117,47.6822,-122.4,1780,4559,11,18,2014,UNK,600,317
1310980110,7/17/2014,299000.0,3,2.25,1920,7840,2.0,0.0,0.0,4,8,1920,0,1982,0,98032,47.3631,-122.27600000000001,2170,7210,7,17,2014,UNK,-250,630
2354300740,3/3/2015,551000.0,3,1.0,1580,6000,1.0,0.0,0.0,5,7,1580,0,1947,0,98027,47.5286,-122.03200000000001,1580,6000,3,3,2015,UNK,0,0
3023049236,9/16/2014,350000.0,3,2.75,3070,5280,2.0,0.0,1.0,3,7,2360,710,1950,1986,98166,47.4486,-122.353,2570,18983,9,16,2014,Y,500,-13703
9808700405,6/4/2014,1900000.0,3,2.5,2660,13367,2.0,0.0,2.0,3,10,2660,0,1992,0,98004,47.6501,-122.21700000000001,2660,13367,6,4,2014,UNK,0,0
2877102345,10/27/2014,511718.0,2,1.75,1700,5000,1.0,0.0,0.0,3,6,850,850,1915,0,98117,47.6787,-122.363,1690,5000,10,27,2014,UNK,10,0
1924069058,10/10/2014,965000.0,4,3.25,5010,49222,2.0,0.0,0.0,5,9,3710,1300,1978,0,98027,47.5489,-122.09200000000001,3140,54014,10,10,2014,UNK,1870,-4792
9269260100,12/16/2014,475000.0,4,2.25,2680,4673,2.0,0.0,0.0,3,7,2680,0,1999,0,98011,47.7539,-122.219,2460,4645,12,16,2014,UNK,220,28
2877104265,4/15/2015,1060000.0,4,2.75,2720,4000,1.5,0.0,2.0,5,8,1840,880,1928,0,98117,47.6797,-122.359,1600,4000,4,15,2015,UNK,1120,0
3123039089,7/15/2014,252000.0,2,1.0,940,15450,1.0,0.0,0.0,4,6,940,0,1926,0,98070,47.4408,-122.461,1370,34820,7,15,2014,UNK,-430,-19370
8576400110,3/17/2015,580000.0,6,2.5,3596,13700,1.0,0.0,0.0,5,8,1798,1798,1964,0,98166,47.4388,-122.339,1894,10500,3,17,2015,UNK,1702,3200
7660600131,10/20/2014,374950.0,2,2.25,1240,1172,2.0,0.0,0.0,3,8,1000,240,2008,0,98144,47.5877,-122.316,1260,1111,10,20,2014,N,-20,61
2296500131,12/16/2014,739000.0,5,4.0,4660,9900,2.0,0.0,2.0,4,9,2600,2060,1979,0,98056,47.5135,-122.2,3380,9900,12,16,2014,UNK,1280,0
1761300850,12/17/2014,271000.0,4,1.75,1710,7200,1.0,0.0,0.0,5,7,910,800,1975,0,98031,47.3967,-122.17399999999999,1730,7200,12,17,2014,UNK,-20,0
6083000037,6/13/2014,230000.0,2,1.0,930,7550,1.0,0.0,0.0,3,6,930,0,1986,0,98168,47.4866,-122.303,1370,10176,6,13,2014,UNK,-440,-2626
5259800090,4/27/2015,210000.0,3,2.25,1430,9150,1.0,0.0,0.0,3,7,1070,360,1984,0,98023,47.3239,-122.35,1430,6364,4,27,2015,UNK,0,2786
2968801366,2/24/2015,350000.0,3,2.75,1650,5700,2.0,0.0,0.0,4,7,1650,0,1988,0,98166,47.4563,-122.348,1320,7620,2,24,2015,UNK,330,-1920
2126059172,5/6/2015,491500.0,3,2.25,1560,12000,1.0,0.0,0.0,4,7,1110,450,1968,0,98034,47.7256,-122.166,2190,4612,5,6,2015,UNK,-630,7388
7334501250,9/9/2014,325000.0,3,2.5,1870,9825,1.0,0.0,0.0,4,7,1250,620,1994,0,98045,47.4639,-121.744,1380,11475,9,9,2014,UNK,490,-1650
1545805490,10/6/2014,190000.0,3,2.0,1320,7625,1.0,0.0,0.0,3,7,1320,0,1987,0,98038,47.3635,-122.045,1420,7500,10,6,2014,UNK,-100,125
7518500855,5/4/2015,658600.0,4,2.0,1400,4690,1.5,0.0,0.0,4,7,1400,0,1945,0,98117,47.6826,-122.37799999999999,1400,4690,5,4,2015,UNK,0,0
4171200025,3/27/2015,299950.0,3,1.5,1940,8951,1.0,0.0,0.0,3,7,1300,640,1958,0,98168,47.473,-122.32799999999999,2000,8319,3,27,2015,UNK,-60,632
9818700215,3/30/2015,464000.0,5,2.0,2000,3000,1.5,0.0,0.0,3,6,1200,800,1931,0,98122,47.6028,-122.29799999999999,1330,4000,3,30,2015,UNK,670,-1000
798000535,6/25/2014,308000.0,3,1.0,1640,18144,1.5,0.0,0.0,3,6,1640,0,1942,0,98168,47.5027,-122.33,1500,9065,6,25,2014,UNK,140,9079
3900100265,1/29/2015,625000.0,3,1.0,1020,7650,1.0,0.0,0.0,3,6,1020,0,1919,0,98033,47.6795,-122.20200000000001,1870,5500,1,29,2015,UNK,-850,2150
1951100110,2/5/2015,240000.0,3,1.75,1630,9450,1.0,0.0,0.0,4,7,1080,550,1977,0,98032,47.3729,-122.295,1280,9100,2,5,2015,UNK,350,350
7215420590,5/4/2015,530000.0,4,2.5,2940,35996,2.0,0.0,0.0,3,9,2940,0,1995,0,98042,47.3401,-122.06700000000001,2890,35089,5,4,2015,UNK,50,907
3343301910,10/20/2014,1000000.0,5,4.5,2120,8944,2.0,1.0,4.0,5,8,2120,0,1939,1963,98006,47.5488,-122.197,2870,8944,10,20,2014,Y,-750,0
9828702095,9/25/2014,439000.0,1,1.0,790,2400,1.0,0.0,0.0,3,7,790,0,1918,0,98122,47.6178,-122.29899999999999,1580,2566,9,25,2014,UNK,-790,-166
2917200645,5/11/2015,575000.0,4,1.75,2020,6200,1.0,0.0,0.0,4,6,1010,1010,1948,0,98133,47.7013,-122.35,1440,4158,5,11,2015,UNK,580,2042
6163900501,10/21/2014,418000.0,3,1.75,1530,7238,1.0,0.0,0.0,3,7,1530,0,1959,0,98155,47.7629,-122.315,1580,7238,10,21,2014,UNK,-50,0
540100057,4/28/2015,1210000.0,4,3.75,3250,10949,2.0,0.0,0.0,4,9,2940,310,1930,0,98004,47.638999999999996,-122.219,2340,15234,4,28,2015,UNK,910,-4285
2652500300,6/3/2014,1100000.0,4,3.75,2930,3200,1.5,0.0,0.0,5,9,2130,800,1925,0,98119,47.643,-122.359,1900,4320,6,3,2014,UNK,1030,-1120
1330300300,4/15/2015,1900000.0,3,3.75,3150,8550,2.0,0.0,0.0,3,10,3150,0,2007,0,98112,47.6387,-122.28399999999999,2510,8550,4,15,2015,N,640,0
1137301780,11/26/2014,580000.0,3,2.5,2180,40278,2.0,0.0,0.0,3,9,2180,0,1985,0,98072,47.733000000000004,-122.09,2630,40000,11,26,2014,UNK,-450,278
9842300485,3/11/2015,380000.0,2,1.0,1040,7372,1.0,0.0,0.0,5,7,840,200,1939,0,98126,47.5285,-122.37799999999999,1930,5150,3,11,2015,UNK,-890,2222
7224000315,7/23/2014,256000.0,3,1.0,880,5375,1.0,0.0,0.0,4,5,880,0,1924,0,98055,47.4858,-122.20200000000001,980,4838,7,23,2014,UNK,-100,537
6161000015,5/15/2014,349950.0,3,1.0,1400,7066,1.0,0.0,0.0,3,8,1400,0,1957,0,98125,47.7127,-122.325,1400,7320,5,15,2014,UNK,0,-254
5207200195,7/1/2014,691500.0,4,2.5,2600,7200,2.0,0.0,0.0,3,7,2600,0,1962,2002,98115,47.6944,-122.274,1790,6175,7,1,2014,Y,810,1025
9191201790,10/31/2014,556000.0,3,1.75,1590,2500,1.5,0.0,0.0,4,7,1190,400,1908,0,98105,47.6668,-122.29899999999999,1420,3800,10,31,2014,UNK,170,-1300
8731902680,11/20/2014,218000.0,3,2.25,1610,7084,1.0,0.0,0.0,4,8,1280,330,1968,0,98023,47.3146,-122.384,2170,8505,11,20,2014,UNK,-560,-1421
9448300115,12/5/2014,425000.0,4,2.0,1390,4500,1.5,0.0,0.0,5,7,1390,0,1908,0,98108,47.5552,-122.311,1900,5460,12,5,2014,UNK,-510,-960
4045500625,8/22/2014,935000.0,3,3.25,3710,38509,2.0,0.0,0.0,3,10,3710,0,1998,0,98014,47.69300000000001,-121.868,1680,25865,8,22,2014,UNK,2030,12644
5603700025,10/7/2014,732000.0,4,1.75,2360,11300,1.0,0.0,0.0,4,9,2360,0,1974,0,98006,47.5728,-122.163,2290,11951,10,7,2014,UNK,70,-651
1266200015,1/27/2015,805500.0,3,1.0,1440,10330,1.0,0.0,0.0,4,7,1440,0,1952,0,98004,47.6245,-122.193,2080,10327,1,27,2015,UNK,-640,3
952003350,2/4/2015,507250.0,3,1.75,1400,5750,1.0,0.0,2.0,3,6,1100,300,1915,0,98126,47.5659,-122.38,1500,5175,2,4,2015,UNK,-100,575
2386000300,12/2/2014,800000.0,4,2.5,4600,67369,2.0,0.0,0.0,3,10,4600,0,1990,0,98053,47.6417,-121.992,4600,67369,12,2,2014,UNK,0,0
3625059143,9/3/2014,600000.0,3,2.25,2100,8276,2.0,0.0,1.0,4,8,2100,0,1979,0,98008,47.6068,-122.11200000000001,2420,18135,9,3,2014,UNK,-320,-9859
8651500850,3/17/2015,627800.0,4,1.75,2010,12044,1.0,0.0,0.0,3,9,2010,0,1982,0,98074,47.6446,-122.068,2200,11144,3,17,2015,UNK,-190,900
3359500110,6/24/2014,660000.0,2,2.25,2550,6000,2.0,0.0,0.0,5,7,1860,690,1902,0,98115,47.6739,-122.323,2010,4000,6,24,2014,UNK,540,2000
818500490,10/9/2014,153503.0,2,2.5,1240,3649,2.0,0.0,0.0,3,7,1240,0,1986,0,98003,47.3241,-122.322,1400,3721,10,9,2014,UNK,-160,-72
3876311390,1/20/2015,456500.0,3,2.25,2090,9163,1.0,0.0,0.0,3,7,1460,630,1975,0,98034,47.7334,-122.167,1960,7713,1,20,2015,UNK,130,1450
8085400490,8/1/2014,1310000.0,5,2.5,2770,8100,2.0,0.0,0.0,3,9,2770,0,2002,0,98004,47.6341,-122.208,2070,8100,8,1,2014,UNK,700,0
2355010090,12/7/2014,843500.0,3,2.5,3560,11448,2.0,0.0,0.0,3,11,3560,0,1997,0,98052,47.7126,-122.104,3290,11506,12,7,2014,UNK,270,-58
9550200265,8/18/2014,625000.0,3,1.0,1240,4080,1.0,0.0,0.0,3,7,1240,0,1925,0,98103,47.667,-122.333,2060,4080,8,18,2014,UNK,-820,0
8818400490,6/11/2014,527000.0,2,1.75,1640,4080,1.0,0.0,0.0,3,7,840,800,1921,0,98105,47.6645,-122.32600000000001,1980,4080,6,11,2014,UNK,-340,0
8964800025,2/26/2015,1970000.0,5,3.75,3940,13738,1.5,0.0,3.0,4,9,3940,0,1951,0,98004,47.6203,-122.212,2370,13320,2,26,2015,UNK,1570,418
2125059112,3/26/2015,1000000.0,5,2.5,3150,50094,2.0,0.0,0.0,4,9,3150,0,1969,0,98005,47.6387,-122.177,3600,48787,3,26,2015,UNK,-450,1307
2028700535,2/25/2015,855000.0,4,3.0,2550,5300,2.0,0.0,0.0,3,8,1720,830,1908,2013,98117,47.6786,-122.367,1590,4505,2,25,2015,Y,960,795
4309710100,6/20/2014,725000.0,4,3.25,3940,27591,2.0,0.0,3.0,3,9,3440,500,2000,0,98059,47.5157,-122.116,3420,29170,6,20,2014,UNK,520,-1579
4364700805,10/15/2014,315000.0,1,1.0,580,7200,1.0,0.0,0.0,3,6,580,0,2000,0,98126,47.5249,-122.37299999999999,1360,7560,10,15,2014,UNK,-780,-360
3356407665,9/24/2014,180000.0,3,1.75,1330,16000,1.0,0.0,0.0,3,7,1330,0,1978,0,98001,47.28,-122.257,1330,14374,9,24,2014,UNK,0,1626
9238900855,3/13/2015,700000.0,2,1.0,930,5000,1.0,0.0,3.0,3,7,930,0,1926,2013,98136,47.5333,-122.38799999999999,1760,5228,3,13,2015,Y,-830,-228
1086100100,8/11/2014,476500.0,3,1.0,1060,8625,2.0,0.0,0.0,4,7,1060,0,1962,1997,98033,47.6615,-122.179,2010,8901,8,11,2014,Y,-950,-276
6121000110,6/3/2014,193000.0,3,1.5,1180,9048,1.0,0.0,0.0,3,7,1180,0,1960,0,98148,47.4327,-122.32799999999999,1460,8942,6,3,2014,UNK,-280,106
8700100100,8/19/2014,295000.0,4,2.5,1850,6663,2.0,0.0,0.0,3,7,1850,0,1990,0,98030,47.3618,-122.195,1850,6417,8,19,2014,UNK,0,246
9417400215,7/31/2014,363000.0,2,1.0,820,4880,1.0,0.0,0.0,4,6,820,0,1925,0,98136,47.5483,-122.39399999999999,1320,4880,7,31,2014,UNK,-500,0
7701961030,1/29/2015,875000.0,4,2.5,3600,21794,2.0,0.0,0.0,4,11,3600,0,1990,0,98077,47.7121,-122.072,3410,19864,1,29,2015,UNK,190,1930
2149800148,5/14/2014,257200.0,3,2.0,1850,8250,1.0,0.0,0.0,4,7,1150,700,1952,0,98002,47.3066,-122.209,1580,7153,5,14,2014,UNK,270,1097
686450490,9/29/2014,555000.0,3,2.0,2240,11250,1.0,0.0,0.0,3,8,2240,0,1968,0,98008,47.6371,-122.119,2200,12500,9,29,2014,UNK,40,-1250
9413400165,6/24/2014,380000.0,3,2.25,1860,15559,2.0,0.0,0.0,4,7,1860,0,1963,0,98022,47.1559,-121.646,1110,11586,6,24,2014,UNK,750,3973
104550690,7/25/2014,282000.0,4,2.75,2390,7330,2.0,0.0,0.0,3,7,2390,0,1989,0,98023,47.3061,-122.359,1980,6735,7,25,2014,UNK,410,595
1995200245,6/6/2014,545000.0,4,2.5,2040,6034,2.0,0.0,0.0,3,7,2040,0,1990,0,98115,47.6952,-122.323,1380,5986,6,6,2014,UNK,660,48
7409700215,6/6/2014,550000.0,3,1.5,1900,5000,1.5,0.0,0.0,3,7,1640,260,1926,0,98115,47.6779,-122.294,2090,5000,6,6,2014,UNK,-190,0
7409700215,3/13/2015,921500.0,3,1.5,1900,5000,1.5,0.0,0.0,3,7,1640,260,1926,0,98115,47.6779,-122.294,2090,5000,3,13,2015,UNK,-190,0
1337800855,5/12/2015,885000.0,3,1.5,2200,2880,2.0,0.0,0.0,5,7,1440,760,1904,0,98112,47.6308,-122.31200000000001,2440,4640,5,12,2015,UNK,-240,-1760
7015200615,5/29/2014,820000.0,4,2.25,2280,6660,1.5,0.0,2.0,3,8,1960,320,1940,0,98119,47.6503,-122.368,1720,5336,5,29,2014,UNK,560,1324
8805400090,5/13/2014,289000.0,3,1.0,1090,7315,1.0,0.0,0.0,5,6,1090,0,1981,0,98056,47.494,-122.165,1090,5800,5,13,2014,UNK,0,1515
2391602350,2/13/2015,334000.0,1,1.0,670,5750,1.0,0.0,0.0,3,7,670,0,1942,2011,98116,47.5624,-122.39399999999999,1170,5750,2,13,2015,Y,-500,0
844001140,10/28/2014,206000.0,3,1.0,1050,5233,1.0,0.0,0.0,5,5,1050,0,1906,0,98010,47.3106,-121.999,970,7500,10,28,2014,UNK,80,-2267
5210200131,6/30/2014,491950.0,3,2.25,2090,10733,1.0,0.0,0.0,3,7,1440,650,1958,0,98115,47.6971,-122.281,1740,8100,6,30,2014,UNK,350,2633
6893300110,11/13/2014,430000.0,3,2.5,2030,7770,2.0,0.0,0.0,3,8,2030,0,2003,0,98024,47.5253,-121.93,1360,10782,11,13,2014,UNK,670,-3012
1796351080,7/18/2014,208000.0,3,2.0,1250,7995,1.0,0.0,0.0,4,7,1250,0,1980,0,98042,47.3684,-122.09200000000001,1540,7650,7,18,2014,UNK,-290,345
1938400300,7/8/2014,245000.0,4,2.25,2600,6390,1.0,0.0,0.0,3,8,1390,1210,1978,0,98023,47.3174,-122.366,2110,6700,7,8,2014,UNK,490,-310
2877101340,3/18/2015,426000.0,2,1.0,640,2500,1.0,0.0,0.0,4,6,640,0,1918,0,98117,47.6776,-122.361,1460,4200,3,18,2015,UNK,-820,-1700
6084200100,8/1/2014,400000.0,3,2.5,2120,3742,2.0,0.0,0.0,3,7,2120,0,2006,0,98059,47.4787,-122.12899999999999,2250,4696,8,1,2014,N,-130,-954
7977201910,4/14/2015,553000.0,3,1.0,1330,5100,1.0,0.0,0.0,3,7,900,430,1942,0,98115,47.6837,-122.291,1500,5100,4,14,2015,UNK,-170,0
6638900115,3/31/2015,296000.0,2,1.0,750,4680,1.0,0.0,0.0,3,5,750,0,1948,0,98117,47.6919,-122.37100000000001,1450,4400,3,31,2015,UNK,-700,280
2587920110,2/17/2015,428000.0,3,2.5,2230,32660,1.0,0.0,0.0,4,8,2230,0,1977,0,98042,47.3321,-122.105,2400,33120,2,17,2015,UNK,-170,-460
3438500714,5/6/2014,325000.0,4,2.5,1890,6156,1.0,0.0,0.0,3,7,980,910,1980,0,98106,47.551,-122.35600000000001,1590,6954,5,6,2014,UNK,300,-798
726049184,7/21/2014,294000.0,2,1.0,820,6366,1.0,0.0,0.0,5,6,820,0,1952,0,98133,47.7512,-122.34,1580,10169,7,21,2014,UNK,-760,-3803
2787720300,3/19/2015,410000.0,3,1.75,1880,8424,1.0,0.0,0.0,4,7,1380,500,1977,0,98059,47.5116,-122.161,1970,8523,3,19,2015,UNK,-90,-99
2821049048,6/3/2014,590000.0,4,4.25,2360,57514,2.0,0.0,0.0,4,8,2360,0,1939,0,98003,47.2843,-122.294,2037,35733,6,3,2014,UNK,323,21781
3904901450,11/20/2014,445000.0,3,2.25,1850,4050,2.0,0.0,0.0,4,7,1850,0,1985,0,98029,47.5669,-122.01700000000001,1650,4468,11,20,2014,UNK,200,-418
9829200495,3/25/2015,921000.0,4,2.5,2310,5362,2.0,0.0,4.0,4,8,2010,300,1928,0,98122,47.6044,-122.28399999999999,2530,5960,3,25,2015,UNK,-220,-598
1523089097,3/4/2015,496000.0,3,1.5,2520,37616,1.0,0.0,0.0,3,8,2520,0,1955,0,98045,47.4777,-121.76299999999999,1470,33750,3,4,2015,UNK,1050,3866
2724200705,12/12/2014,95000.0,2,1.0,800,8550,1.0,0.0,0.0,3,7,800,0,1947,0,98198,47.4075,-122.294,1490,8550,12,12,2014,UNK,-690,0
8122600245,9/25/2014,359000.0,4,1.75,1580,6396,1.0,0.0,0.0,4,6,790,790,1945,0,98126,47.5378,-122.369,1180,6396,9,25,2014,UNK,400,0
1323089184,5/2/2014,452500.0,3,2.5,2430,88426,1.0,0.0,0.0,4,7,1570,860,1985,0,98045,47.4828,-121.71799999999999,1560,56827,5,2,2014,UNK,870,31599
2600300110,12/2/2014,555000.0,4,1.75,2350,6200,1.5,0.0,0.0,4,7,1410,940,1946,0,98116,47.559,-122.397,1800,6150,12,2,2014,UNK,550,50
9485951030,9/24/2014,549900.0,5,3.0,3800,42316,1.5,0.0,0.0,4,9,3800,0,1984,0,98042,47.3488,-122.095,2580,35775,9,24,2014,UNK,1220,6541
4021700025,6/10/2014,569000.0,5,3.0,3670,10583,1.0,0.0,0.0,5,8,2060,1610,1952,0,98155,47.7589,-122.277,2720,13865,6,10,2014,UNK,950,-3282
2473250850,7/16/2014,318500.0,4,2.0,1780,7350,1.0,0.0,0.0,5,7,900,880,1974,0,98058,47.4562,-122.15799999999999,1480,7350,7,16,2014,UNK,300,0
9828702310,6/11/2014,487028.0,2,1.5,1295,1093,2.0,0.0,0.0,3,9,1105,190,2007,0,98112,47.6192,-122.29899999999999,1295,1413,6,11,2014,N,0,-320
7523700245,10/15/2014,240000.0,3,1.0,1350,7560,1.0,0.0,0.0,4,7,950,400,1959,0,98032,47.3784,-122.303,1470,7560,10,15,2014,UNK,-120,0
1765100025,2/2/2015,253000.0,3,2.25,1440,9806,1.0,0.0,0.0,3,7,1440,0,1965,0,98030,47.3857,-122.212,1590,9782,2,2,2015,UNK,-150,24
2011400405,8/31/2014,380000.0,5,1.75,1320,38125,1.0,0.0,0.0,4,7,1120,200,1947,0,98198,47.3937,-122.323,2360,15070,8,31,2014,UNK,-1040,23055
3410600015,4/6/2015,250000.0,2,0.75,700,16828,1.0,0.0,0.0,4,6,700,0,1958,0,98092,47.3009,-122.125,2010,29316,4,6,2015,UNK,-1310,-12488
3276050110,10/10/2014,368500.0,2,1.75,2510,19141,2.0,0.0,0.0,3,9,2510,0,1977,0,98092,47.3103,-122.199,2400,13030,10,10,2014,UNK,110,6111
7792000025,2/11/2015,340000.0,3,1.0,3180,27586,1.0,0.0,0.0,3,8,1400,1780,1969,0,98022,47.1986,-121.96700000000001,2180,27586,2,11,2015,UNK,1000,0
2810600015,4/27/2015,400000.0,2,1.0,910,4000,1.0,0.0,0.0,3,7,910,0,1918,0,98136,47.5427,-122.38799999999999,1060,1346,4,27,2015,UNK,-150,2654
8081900011,9/16/2014,835000.0,3,2.0,1570,4625,1.5,0.0,0.0,5,8,1570,0,1927,0,98117,47.68,-122.399,1760,4625,9,16,2014,UNK,-190,0
104550740,12/1/2014,299000.0,3,2.5,2450,7062,2.0,0.0,0.0,3,8,2450,0,1993,0,98023,47.3061,-122.36,1960,7200,12,1,2014,UNK,490,-138
1959701745,11/7/2014,1680000.0,6,2.25,4910,6600,2.5,0.0,0.0,5,10,3580,1330,1910,0,98102,47.6458,-122.32,3280,5500,11,7,2014,UNK,1630,1100
8078520090,5/14/2014,265000.0,3,2.0,1570,5706,1.0,0.0,0.0,3,7,1570,0,1998,0,98092,47.3156,-122.18799999999999,1570,5706,5,14,2014,UNK,0,0
6403510090,11/11/2014,437500.0,4,2.5,2680,7513,2.0,0.0,0.0,3,8,2680,0,1998,0,98059,47.4956,-122.161,2640,7243,11,11,2014,UNK,40,270
2326300090,6/4/2014,865000.0,3,1.75,2090,4725,2.0,0.0,0.0,3,7,1610,480,1947,2013,98199,47.657,-122.39399999999999,1280,4725,6,4,2014,Y,810,0
8078380090,3/11/2015,626000.0,3,2.0,2150,7200,1.0,0.0,0.0,3,8,2150,0,1988,0,98029,47.5709,-122.01799999999999,2510,7222,3,11,2015,UNK,-360,-22
7132300042,10/28/2014,247300.0,2,2.0,1140,1118,2.0,0.0,0.0,3,7,1040,100,2009,0,98144,47.596000000000004,-122.311,1140,1118,10,28,2014,N,0,0
3861470110,6/23/2014,2080000.0,4,3.5,4230,20377,2.0,0.0,0.0,3,11,4230,0,1997,0,98004,47.5954,-122.206,3980,20489,6,23,2014,UNK,250,-112
2734101055,10/1/2014,425000.0,3,1.0,1790,6000,1.5,0.0,0.0,2,8,1790,0,1937,0,98108,47.5448,-122.32,1060,4000,10,1,2014,UNK,730,2000
4039701080,6/25/2014,905000.0,5,3.5,3100,10200,1.0,0.0,4.0,3,9,1660,1440,1970,0,98008,47.6134,-122.11200000000001,2700,10455,6,25,2014,UNK,400,-255
464000600,8/27/2014,641250.0,3,2.5,2220,2550,3.0,0.0,2.0,3,10,2220,0,1990,0,98117,47.6963,-122.39299999999999,2200,5610,8,27,2014,UNK,20,-3060
5437400100,3/31/2015,675000.0,4,2.5,2370,9679,2.0,0.0,0.0,3,8,2370,0,1984,0,98027,47.5631,-122.085,2290,7944,3,31,2015,UNK,80,1735
1423089055,6/13/2014,845000.0,4,2.75,4070,115434,2.0,0.0,0.0,3,9,4070,0,2002,0,98045,47.4843,-121.75200000000001,2970,95832,6,13,2014,UNK,1100,19602
6713700100,9/7/2014,401500.0,4,1.0,1790,8400,1.0,0.0,0.0,4,7,1260,530,1954,0,98133,47.7627,-122.353,1470,8400,9,7,2014,UNK,320,0
339600110,9/23/2014,395000.0,3,2.5,1610,3755,2.0,0.0,0.0,3,7,1610,0,1987,0,98052,47.6825,-122.09700000000001,1300,3823,9,23,2014,UNK,310,-68
5021900090,3/6/2015,1100000.0,5,2.75,2830,18050,1.0,0.0,0.0,5,7,1630,1200,1958,0,98040,47.5773,-122.226,2370,14250,3,6,2015,UNK,460,3800
6099400053,5/29/2014,145000.0,3,1.0,1010,5490,1.0,0.0,0.0,3,6,1010,0,1954,0,98168,47.4762,-122.29299999999999,1740,10658,5,29,2014,UNK,-730,-5168
7518508625,4/16/2015,900000.0,3,1.0,1560,3825,1.5,0.0,0.0,3,8,1390,170,1930,0,98117,47.6803,-122.387,1700,5100,4,16,2015,UNK,-140,-1275
8143000490,1/12/2015,374500.0,3,1.5,1330,8636,1.0,0.0,0.0,4,7,1330,0,1968,0,98034,47.7289,-122.20299999999999,1370,7475,1,12,2015,UNK,-40,1161
3260000300,11/18/2014,850000.0,4,2.25,2330,10451,2.0,0.0,0.0,4,8,2330,0,1965,0,98005,47.6044,-122.16799999999999,1880,8400,11,18,2014,UNK,450,2051
5742600090,4/25/2015,490000.0,3,1.0,960,5750,1.0,0.0,0.0,3,7,960,0,1951,0,98116,47.5689,-122.39299999999999,1520,5750,4,25,2015,UNK,-560,0
7212650850,4/27/2015,304000.0,3,2.5,1710,6773,2.0,0.0,0.0,3,8,1710,0,1993,0,98003,47.2635,-122.31200000000001,2220,7551,4,27,2015,UNK,-510,-778
9158800090,7/3/2014,400000.0,4,2.25,2230,7200,1.0,0.0,0.0,4,7,1300,930,1963,0,98133,47.7648,-122.33,2010,7752,7,3,2014,UNK,220,-552
7820000038,11/14/2014,454000.0,3,2.0,1700,10000,2.0,0.0,0.0,3,8,1700,0,1992,0,98011,47.7661,-122.205,1460,9621,11,14,2014,UNK,240,379
7135300026,12/24/2014,160000.0,2,2.0,1040,4750,1.0,0.0,0.0,2,6,850,190,1950,0,98118,47.5293,-122.272,1350,5000,12,24,2014,UNK,-310,-250
8562700300,7/8/2014,542000.0,3,1.75,1070,8030,1.0,0.0,0.0,3,7,1070,0,1966,2014,98052,47.67,-122.155,1540,7875,7,8,2014,Y,-470,155
6114400028,6/18/2014,403500.0,5,2.5,3600,17300,1.0,0.0,0.0,4,8,2410,1190,1968,0,98166,47.4468,-122.34100000000001,2620,30200,6,18,2014,UNK,980,-12900
3793501130,3/16/2015,418000.0,4,2.5,2750,8471,2.0,0.0,0.0,3,7,2750,0,2003,0,98038,47.3671,-122.029,2610,7482,3,16,2015,UNK,140,989
6052400625,3/26/2015,406000.0,4,1.5,1920,6000,2.0,0.0,1.0,3,7,1920,0,1951,0,98198,47.4029,-122.321,1920,6000,3,26,2015,UNK,0,0
2560805630,9/23/2014,242500.0,3,2.25,1770,10000,1.0,0.0,0.0,3,7,1340,430,1978,0,98198,47.3814,-122.322,1270,5055,9,23,2014,UNK,500,4945
9558020600,4/7/2015,425000.0,4,2.5,2460,5440,2.0,0.0,0.0,3,9,2460,0,2003,0,98058,47.448,-122.12100000000001,2460,5124,4,7,2015,UNK,0,316
9136101335,5/15/2014,613000.0,4,2.0,1550,4815,1.5,0.0,0.0,3,7,1550,0,1909,0,98103,47.667,-122.336,1680,4013,5,15,2014,UNK,-130,802
9407101380,12/30/2014,189000.0,3,2.0,1460,11481,1.0,0.0,0.0,2,7,1170,290,1995,0,98045,47.4493,-121.777,1540,9680,12,30,2014,UNK,-80,1801
8901500178,10/30/2014,700000.0,4,2.25,2440,9450,1.5,0.0,0.0,3,7,2440,0,1947,0,98125,47.7061,-122.307,1720,7503,10,30,2014,UNK,720,1947
9551201250,9/2/2014,750000.0,3,1.0,1640,6516,1.5,0.0,0.0,4,7,1440,200,1935,0,98103,47.6693,-122.339,1770,4000,9,2,2014,UNK,-130,2516
3544400236,7/7/2014,494000.0,2,1.0,1290,4650,1.0,0.0,0.0,4,7,1290,0,1906,0,98115,47.6877,-122.325,1640,3900,7,7,2014,UNK,-350,750
7215730090,6/9/2014,700000.0,4,3.0,3150,7778,2.0,0.0,0.0,3,9,3150,0,2000,0,98075,47.5972,-122.01799999999999,2970,6500,6,9,2014,UNK,180,1278
8682291390,4/3/2015,705000.0,2,2.5,2305,5580,1.0,0.0,0.0,3,8,2305,0,2007,0,98077,47.7203,-122.024,1440,5748,4,3,2015,N,865,-168
1770000490,5/22/2014,356000.0,2,1.75,1060,16470,1.0,0.0,0.0,3,7,1060,0,1977,0,98072,47.7409,-122.089,1790,16748,5,22,2014,UNK,-730,-278
2935400100,5/22/2014,625000.0,3,1.75,2060,12558,1.0,0.0,0.0,4,7,1350,710,1984,0,98052,47.6659,-122.14399999999999,1850,8722,5,22,2014,UNK,210,3836
7686205020,3/12/2015,144975.0,2,1.0,900,7500,1.0,0.0,0.0,3,5,900,0,1940,0,98198,47.4177,-122.319,1350,7500,3,12,2015,UNK,-450,0
3629921240,7/28/2014,970000.0,4,4.5,3890,5906,2.0,0.0,3.0,3,11,3060,0,2004,0,98029,47.5426,-121.995,4170,6052,7,28,2014,N,-280,-146
1775801340,6/6/2014,415000.0,3,1.75,1910,12596,1.0,0.0,0.0,3,7,1340,570,1977,0,98072,47.7399,-122.09899999999999,1550,13310,6,6,2014,UNK,360,-714
3574801780,5/5/2014,485000.0,4,3.0,2340,7048,1.0,0.0,0.0,4,8,1340,1000,1979,0,98034,47.7306,-122.227,1440,8088,5,5,2014,UNK,900,-1040
7854800090,11/7/2014,799950.0,3,3.0,2900,11769,2.0,0.0,0.0,3,10,2900,0,1997,0,98052,47.6993,-122.118,2900,9611,11,7,2014,UNK,0,2158
4054530090,4/29/2015,783350.0,4,2.5,3290,35001,2.0,0.0,0.0,3,10,3290,0,1991,0,98077,47.7231,-122.038,4090,40371,4,29,2015,UNK,-800,-5370
8807900236,12/19/2014,430000.0,1,1.0,630,1362,1.0,0.0,0.0,3,7,630,0,1943,0,98109,47.6342,-122.34200000000001,1090,1376,12,19,2014,UNK,-460,-14
1118001408,11/24/2014,2540000.0,5,4.75,5410,13431,2.0,0.0,0.0,4,10,5050,360,1941,0,98112,47.6306,-122.288,3750,11596,11,24,2014,UNK,1660,1835
9290850740,6/18/2014,975000.0,4,2.5,4270,43386,1.0,0.0,0.0,3,10,2680,1590,1991,0,98053,47.6915,-122.053,3630,36180,6,18,2014,UNK,640,7206
3025059089,5/5/2015,950000.0,3,1.5,1700,8050,1.0,0.0,0.0,3,7,1130,570,1950,0,98004,47.6304,-122.21799999999999,2920,12239,5,5,2015,UNK,-1220,-4189
923000265,8/6/2014,350000.0,2,1.0,1430,8157,1.5,0.0,0.0,3,7,1150,280,1944,0,98177,47.7256,-122.361,1820,8157,8,6,2014,UNK,-390,0
8901001335,11/3/2014,637000.0,4,2.75,2850,7510,2.0,0.0,0.0,3,8,2850,0,2008,0,98125,47.7097,-122.305,1510,8833,11,3,2014,N,1340,-1323
1523059066,2/19/2015,895000.0,3,2.0,2160,105415,1.0,0.0,0.0,3,10,2160,0,1991,0,98059,47.4806,-122.152,2760,9620,2,19,2015,UNK,-600,95795
5249801785,12/5/2014,579000.0,2,2.0,1760,7200,1.0,0.0,0.0,5,7,880,880,1946,0,98118,47.5658,-122.27600000000001,1760,7200,12,5,2014,UNK,0,0
2190601055,6/24/2014,314900.0,4,1.75,2700,27072,1.0,0.0,0.0,3,7,1380,1320,1958,0,98003,47.2877,-122.29299999999999,2460,34850,6,24,2014,UNK,240,-7778
1917300025,1/27/2015,122000.0,2,1.0,860,6000,1.0,0.0,0.0,3,6,860,0,1945,0,98022,47.2109,-121.985,1300,6000,1,27,2015,UNK,-440,0
3797000300,8/8/2014,405000.0,2,1.0,880,3000,1.0,0.0,0.0,5,7,880,0,1927,0,98103,47.6868,-122.34899999999999,1300,3000,8,8,2014,UNK,-420,0
5332200026,5/8/2014,553650.0,2,2.5,1360,1349,2.0,0.0,0.0,3,8,1050,310,1997,0,98112,47.6254,-122.292,1430,4400,5,8,2014,UNK,-70,-3051
3278602760,2/3/2015,369900.0,2,2.5,1770,1853,3.0,0.0,0.0,3,8,1770,0,2007,0,98126,47.5472,-122.37100000000001,1770,1924,2,3,2015,N,0,-71
2721049059,5/28/2014,225000.0,3,2.0,2030,24829,1.0,0.0,0.0,4,7,1220,810,1979,0,98001,47.2718,-122.291,1980,15204,5,28,2014,UNK,50,9625
2172000750,5/27/2014,160000.0,2,1.0,1180,9350,1.0,0.0,0.0,3,6,1180,0,1918,0,98178,47.4889,-122.259,1780,9306,5,27,2014,UNK,-600,44
1022069058,10/9/2014,449500.0,4,2.0,2430,199940,1.0,0.0,0.0,3,8,1310,1120,1961,0,98038,47.4116,-122.029,2220,150282,10,9,2014,UNK,210,49658
249000115,8/28/2014,650000.0,3,1.0,1300,8266,1.0,0.0,0.0,4,7,1300,0,1953,0,98004,47.6337,-122.199,1300,8707,8,28,2014,UNK,0,-441
7214710300,7/16/2014,542126.0,4,2.5,2360,43088,2.0,0.0,0.0,3,8,2360,0,1977,0,98077,47.7661,-122.071,2850,39216,7,16,2014,UNK,-490,3872
192450300,9/19/2014,309950.0,3,1.5,1200,15606,1.0,0.0,0.0,3,7,1200,0,1985,0,98045,47.4752,-121.755,1210,15606,9,19,2014,UNK,-10,0
3356403820,12/5/2014,115000.0,2,1.0,1000,16524,1.0,0.0,0.0,3,5,1000,0,1913,0,98001,47.2841,-122.255,1350,10208,12,5,2014,UNK,-350,6316
8075400100,12/31/2014,221700.0,2,1.5,1556,20000,1.0,0.0,0.0,4,7,1556,0,1957,0,98032,47.3891,-122.28200000000001,2250,17286,12,31,2014,UNK,-694,2714
1982200245,1/27/2015,726000.0,3,2.5,1890,3880,1.5,0.0,0.0,4,8,1460,430,1915,0,98107,47.6642,-122.36200000000001,1010,3880,1,27,2015,UNK,880,0
7905200037,11/19/2014,515000.0,3,1.75,1810,5733,1.0,0.0,0.0,4,7,1010,800,1926,0,98116,47.5709,-122.38799999999999,1260,4680,11,19,2014,UNK,550,1053
2597531030,8/26/2014,756000.0,4,2.5,2730,10753,2.0,0.0,0.0,3,9,2730,0,1991,0,98006,47.5414,-122.133,3090,10740,8,26,2014,UNK,-360,13
5318100645,5/27/2014,1570000.0,4,3.75,3070,5850,2.0,0.0,0.0,5,9,2400,670,1927,0,98112,47.633,-122.28299999999999,2940,5573,5,27,2014,UNK,130,277
7504400850,5/21/2014,442000.0,4,2.25,2080,12007,1.0,0.0,0.0,4,8,1220,860,1979,0,98074,47.6259,-122.051,2110,12459,5,21,2014,UNK,-30,-452
1761300110,7/2/2014,260000.0,4,2.0,1620,7992,2.0,0.0,0.0,4,7,1620,0,1975,0,98031,47.395,-122.176,1710,7500,7,2,2014,UNK,-90,492
9390700100,9/10/2014,390000.0,2,1.75,1150,2723,1.0,0.0,0.0,4,7,770,380,1923,0,98102,47.6357,-122.322,1440,4000,9,10,2014,UNK,-290,-1277
7518503200,7/1/2014,459500.0,2,1.0,1250,3825,1.0,0.0,0.0,3,7,850,400,1929,0,98117,47.6805,-122.38,1370,4998,7,1,2014,UNK,-120,-1173
3971700940,9/30/2014,330000.0,3,1.5,1430,8000,1.0,0.0,0.0,5,7,1430,0,1948,0,98155,47.772,-122.322,1410,9820,9,30,2014,UNK,20,-1820
1446403835,11/3/2014,189000.0,2,1.0,790,7128,1.0,0.0,0.0,3,6,790,0,1944,0,98168,47.4873,-122.324,1110,7150,11,3,2014,UNK,-320,-22
9183702251,12/11/2014,280000.0,3,1.0,1200,9322,1.5,0.0,0.0,4,7,1200,0,1954,0,98030,47.3749,-122.225,1540,9677,12,11,2014,UNK,-340,-355
5589900590,5/5/2014,400000.0,2,1.75,2110,9519,1.0,0.0,0.0,2,7,2110,0,1948,0,98155,47.7504,-122.306,1480,9519,5,5,2014,UNK,630,0
7227501745,3/25/2015,368000.0,4,2.0,3160,11193,1.0,0.0,0.0,5,6,2410,750,1942,0,98056,47.4937,-122.184,1020,5940,3,25,2015,UNK,2140,5253
2473350930,6/9/2014,390000.0,4,1.75,2700,7875,1.5,0.0,0.0,4,8,2700,0,1968,0,98058,47.45399999999999,-122.14399999999999,2220,7875,6,9,2014,UNK,480,0
6450303820,9/30/2014,245000.0,2,1.0,820,7475,1.0,0.0,0.0,3,6,820,0,1945,0,98133,47.7321,-122.34100000000001,1030,5720,9,30,2014,UNK,-210,1755
5469000100,8/6/2014,375000.0,4,2.5,1800,8432,1.0,0.0,0.0,4,7,1200,600,1960,0,98133,47.7463,-122.336,1780,8432,8,6,2014,UNK,20,0
8679600100,1/30/2015,465000.0,5,1.5,1750,12491,1.0,0.0,0.0,3,6,1390,360,1961,0,98033,47.6995,-122.17399999999999,1560,12473,1,30,2015,UNK,190,18
638100015,3/12/2015,445000.0,3,2.0,1540,67953,1.0,0.0,0.0,3,7,1540,0,1997,0,98059,47.5018,-122.126,1250,9100,3,12,2015,UNK,290,58853
3241600015,3/5/2015,250000.0,3,1.0,1130,7800,1.0,0.0,0.0,3,7,1130,0,1952,0,98118,47.5239,-122.288,1170,7800,3,5,2015,UNK,-40,0
6411600026,10/3/2014,475500.0,3,1.0,1500,9416,1.0,0.0,0.0,4,8,1500,0,1952,0,98133,47.7135,-122.33200000000001,1440,7200,10,3,2014,UNK,60,2216
3179101050,8/4/2014,672324.0,2,1.75,1600,5795,1.5,0.0,0.0,3,8,1600,0,1940,0,98105,47.6709,-122.27600000000001,2310,6301,8,4,2014,UNK,-710,-506
5363200266,6/23/2014,420000.0,3,2.0,1200,5029,1.0,0.0,0.0,3,6,880,320,1937,0,98115,47.6936,-122.294,1510,5854,6,23,2014,UNK,-310,-825
7518502490,12/29/2014,515000.0,3,2.0,1690,5100,1.5,0.0,0.0,5,7,1690,0,1907,0,98117,47.6801,-122.38,1690,5100,12,29,2014,UNK,0,0
7732400490,11/5/2014,732350.0,4,2.5,2270,7665,2.0,0.0,0.0,3,9,2270,0,1986,0,98052,47.6612,-122.148,2450,8706,11,5,2014,UNK,-180,-1041
5416510110,6/5/2014,297500.0,4,2.5,1910,5000,2.0,0.0,0.0,3,7,1910,0,2005,0,98038,47.3608,-122.036,2020,5000,6,5,2014,N,-110,0
8604900017,10/8/2014,475000.0,3,1.5,1640,2720,1.5,0.0,0.0,3,8,1640,0,1929,0,98115,47.6869,-122.31700000000001,1490,4375,10,8,2014,UNK,150,-1655
808300490,5/5/2015,414000.0,4,2.5,2120,6497,2.0,0.0,0.0,3,7,2120,0,2003,0,98019,47.7241,-121.95700000000001,2230,6300,5,5,2015,UNK,-110,197
6855700115,6/26/2014,357250.0,3,1.5,1400,8840,1.0,0.0,0.0,4,6,1400,0,1952,0,98125,47.7273,-122.309,1260,8840,6,26,2014,UNK,140,0
9325800110,10/30/2014,289950.0,2,1.0,760,6000,1.0,0.0,0.0,4,6,760,0,1950,0,98133,47.7168,-122.34,950,6000,10,30,2014,UNK,-190,0
8121100015,5/5/2015,550000.0,3,1.0,1070,3713,1.0,0.0,0.0,4,6,1070,0,1917,0,98118,47.5683,-122.285,1290,3960,5,5,2015,UNK,-220,-247
8568700015,4/23/2015,446000.0,3,1.75,1460,9998,1.0,0.0,0.0,3,7,960,500,1958,0,98028,47.7434,-122.242,1460,9998,4,23,2015,UNK,0,0
6399600115,10/15/2014,279000.0,3,1.5,1280,16738,1.5,0.0,0.0,4,5,1280,0,1932,0,98038,47.3895,-122.023,1590,16317,10,15,2014,UNK,-310,421
5651010300,8/21/2014,370000.0,3,2.25,1650,4859,2.0,0.0,0.0,3,7,1650,0,1988,0,98011,47.7729,-122.17200000000001,1890,5018,8,21,2014,UNK,-240,-159
3423049311,10/17/2014,216000.0,3,2.0,1260,4125,1.0,0.0,0.0,3,6,1260,0,1998,0,98188,47.4401,-122.279,1300,9091,10,17,2014,UNK,-40,-4966
7000100711,6/21/2014,1100000.0,3,2.5,2200,20000,1.0,0.0,1.0,3,7,1400,800,1952,0,98004,47.5809,-122.191,3050,11775,6,21,2014,UNK,-850,8225
5482700115,10/20/2014,1280000.0,4,2.5,3560,15450,1.0,0.0,1.0,5,8,2060,1500,1977,0,98040,47.5657,-122.23,3680,17314,10,20,2014,UNK,-120,-1864
9349900110,2/17/2015,355000.0,2,1.5,1140,2500,1.0,0.0,1.0,3,7,630,510,1988,0,98106,47.5707,-122.359,1500,5000,2,17,2015,UNK,-360,-2500
9328510100,9/11/2014,699000.0,4,2.5,2550,7312,2.0,0.0,0.0,3,9,2550,0,1988,0,98008,47.6441,-122.113,2330,7480,9,11,2014,UNK,220,-168
6300500475,9/2/2014,412000.0,3,2.5,1553,1991,3.0,0.0,0.0,3,8,1553,0,2014,0,98133,47.7049,-122.34,1509,2431,9,2,2014,N,44,-440
7849200315,2/5/2015,276000.0,2,1.0,1140,7200,1.0,0.0,0.0,3,6,1140,0,1923,1951,98065,47.5265,-121.823,1110,7200,2,5,2015,Y,30,0
7813200115,9/4/2014,100000.0,2,1.0,790,6426,1.0,0.0,0.0,3,6,790,0,1944,0,98178,47.4933,-122.245,1380,6946,9,4,2014,UNK,-590,-520
2851200100,7/1/2014,955500.0,4,1.75,2130,5080,1.5,0.0,0.0,3,8,2130,0,1914,0,98119,47.6427,-122.363,1900,5080,7,1,2014,UNK,230,0
2823059055,3/29/2015,199000.0,3,1.0,1390,21262,1.0,0.0,0.0,3,7,1390,0,1958,0,98058,47.4454,-122.185,1560,10800,3,29,2015,UNK,-170,10462
7853301560,6/25/2014,762000.0,4,3.5,4000,15253,2.0,0.0,0.0,3,9,4000,0,2007,0,98065,47.5433,-121.887,3550,8747,6,25,2014,N,450,6506
9477001280,5/6/2014,425000.0,4,2.0,1520,7983,1.0,0.0,0.0,5,7,1520,0,1967,0,98034,47.7357,-122.193,1520,7783,5,6,2014,UNK,0,200
7905200147,11/4/2014,546000.0,2,1.0,1657,5031,2.0,0.0,0.0,3,7,1657,0,1910,0,98116,47.5699,-122.389,2050,6201,11,4,2014,UNK,-393,-1170
6190701110,4/20/2015,419600.0,3,1.75,1680,8460,1.0,0.0,0.0,3,7,1180,500,1976,0,98133,47.7554,-122.353,1890,9529,4,20,2015,UNK,-210,-1069
871001500,6/23/2014,735000.0,4,2.25,2270,5102,1.0,0.0,0.0,5,8,1340,930,1954,0,98199,47.6528,-122.40799999999999,1800,5102,6,23,2014,UNK,470,0
2559950110,4/22/2015,1230000.0,2,2.5,2470,609,3.0,0.0,0.0,3,11,1910,560,2011,0,98112,47.6182,-122.31200000000001,2440,1229,4,22,2015,N,30,-620
3693900245,7/7/2014,445000.0,2,2.0,1240,2500,2.0,0.0,0.0,3,7,1240,0,1985,0,98117,47.6793,-122.395,1660,5000,7,7,2014,UNK,-420,-2500
1023089140,1/6/2015,665000.0,3,2.0,1740,41275,1.0,0.0,0.0,3,8,1740,0,1974,1989,98045,47.4914,-121.76299999999999,2630,41275,1,6,2015,Y,-890,0
3026059085,3/17/2015,1290000.0,5,3.5,4090,290980,1.0,0.0,0.0,3,11,2920,1170,2002,0,98034,47.7161,-122.219,1880,9255,3,17,2015,UNK,2210,281725
3575302345,12/8/2014,508500.0,4,2.75,2520,12500,2.0,0.0,0.0,3,8,1720,800,1979,0,98074,47.6225,-122.064,2520,13000,12,8,2014,UNK,0,-500
1568100076,12/10/2014,345950.0,5,1.0,1340,11198,1.5,0.0,0.0,3,8,1340,0,1934,0,98155,47.736000000000004,-122.295,1390,8020,12,10,2014,UNK,-50,3178
6600400090,1/13/2015,207500.0,3,1.0,1640,9750,1.0,0.0,0.0,3,7,1640,0,1968,0,98042,47.3256,-122.141,1200,9750,1,13,2015,UNK,440,0
5451200110,12/4/2014,1080000.0,4,2.5,3000,10920,1.0,0.0,0.0,4,8,1550,1450,1969,0,98040,47.5347,-122.227,2380,10920,12,4,2014,UNK,620,0
3204300090,11/10/2014,640000.0,3,1.0,1210,3720,2.0,0.0,0.0,4,8,1210,0,1930,0,98112,47.6317,-122.301,1560,6000,11,10,2014,UNK,-350,-2280
3023039066,3/23/2015,329500.0,3,1.0,1810,13068,1.0,0.0,0.0,4,7,1360,450,1941,0,98070,47.4482,-122.462,1400,13068,3,23,2015,UNK,410,0
3824100246,10/21/2014,460000.0,4,2.75,2200,9676,1.0,0.0,0.0,3,8,1500,700,1979,0,98028,47.7713,-122.259,2120,9585,10,21,2014,UNK,80,91
7768700315,6/30/2014,1230000.0,3,1.75,2200,14630,1.5,0.0,1.0,3,8,2200,0,1948,2003,98004,47.6074,-122.213,2850,15803,6,30,2014,Y,-650,-1173
4154305290,11/20/2014,805000.0,5,3.0,2350,6480,2.0,0.0,3.0,4,7,1650,700,1924,1962,98118,47.558,-122.266,1840,7200,11,20,2014,Y,510,-720
621069113,12/18/2014,200000.0,3,1.5,1090,10454,1.0,0.0,0.0,3,6,1090,0,1963,0,98042,47.3425,-122.08200000000001,1230,12196,12,18,2014,UNK,-140,-1742
1523059201,2/17/2015,749700.0,3,1.75,2280,77972,1.0,0.0,0.0,3,8,1460,820,1977,0,98059,47.4804,-122.15100000000001,2460,14430,2,17,2015,UNK,-180,63542
7518504291,12/15/2014,535000.0,2,1.0,1520,3360,1.0,0.0,0.0,4,7,830,690,1927,0,98117,47.6815,-122.382,1470,3774,12,15,2014,UNK,50,-414
4058801240,10/28/2014,330000.0,3,2.25,1620,7150,1.0,0.0,2.0,4,7,1280,340,1950,0,98178,47.5048,-122.241,1620,6930,10,28,2014,UNK,0,220
2313900165,7/30/2014,479200.0,3,2.0,1510,3750,1.5,0.0,0.0,4,7,1510,0,1928,0,98116,47.5737,-122.383,1500,5000,7,30,2014,UNK,10,-1250
2122059206,5/13/2014,373000.0,5,2.5,3001,5710,2.0,0.0,0.0,3,8,3001,0,2006,0,98042,47.3727,-122.177,2340,5980,5,13,2014,N,661,-270
9282801720,3/19/2015,355000.0,4,1.5,2020,6000,1.0,0.0,0.0,4,7,1010,1010,1953,0,98178,47.5019,-122.235,1710,6000,3,19,2015,UNK,310,0
9542840590,6/2/2014,275000.0,3,2.0,1380,4500,1.0,0.0,0.0,3,7,1380,0,2008,0,98038,47.3661,-122.021,1620,4000,6,2,2014,N,-240,500
2493200015,6/20/2014,380000.0,3,1.5,1520,4288,1.0,0.0,0.0,3,7,1020,500,1949,0,98136,47.5284,-122.387,1660,4288,6,20,2014,UNK,-140,0
9550202870,2/9/2015,417000.0,2,1.75,1090,4590,1.0,0.0,0.0,4,7,790,300,1915,0,98105,47.6677,-122.324,1390,4080,2,9,2015,UNK,-300,510
98000750,10/21/2014,1170000.0,5,3.75,4220,15959,2.0,0.0,0.0,3,11,4220,0,2004,0,98075,47.5869,-121.96700000000001,4630,16531,10,21,2014,N,-410,-572
7504010900,9/26/2014,598500.0,3,2.25,2520,12000,1.0,0.0,0.0,3,10,2520,0,1978,0,98074,47.6381,-122.06200000000001,2510,12000,9,26,2014,UNK,10,0
1370803820,6/2/2014,629000.0,3,2.0,1760,5000,1.0,0.0,0.0,5,7,960,800,1920,0,98199,47.6408,-122.40299999999999,1380,5000,6,2,2014,UNK,380,0
1446401220,10/9/2014,226950.0,2,1.0,930,6600,1.0,0.0,0.0,3,6,930,0,1957,0,98168,47.4868,-122.33,1250,6600,10,9,2014,UNK,-320,0
868000615,12/31/2014,1230000.0,4,2.5,2600,11542,1.5,0.0,0.0,4,9,2200,400,1939,0,98177,47.7076,-122.37700000000001,2840,10960,12,31,2014,UNK,-240,582
6625910100,2/3/2015,415000.0,3,2.25,2180,11100,1.0,0.0,0.0,5,8,1700,480,1979,0,98056,47.5162,-122.176,2350,11397,2,3,2015,UNK,-170,-297
3629870110,4/22/2015,595000.0,3,2.5,1910,3075,2.0,0.0,0.0,3,8,1910,0,2001,0,98029,47.5491,-122.005,1940,3485,4,22,2015,UNK,-30,-410
8651400750,10/28/2014,209950.0,3,1.75,1100,5525,1.0,0.0,0.0,5,6,1100,0,1968,0,98042,47.3625,-122.084,1050,5200,10,28,2014,UNK,50,325
925069111,5/7/2015,568000.0,3,1.75,1760,235224,1.0,0.0,0.0,3,7,1760,0,1973,0,98053,47.6735,-122.041,2320,87120,5,7,2015,UNK,-560,148104
3352402250,10/21/2014,119900.0,2,1.0,700,3180,1.0,0.0,0.0,3,6,480,220,1951,0,98178,47.4976,-122.262,1760,6360,10,21,2014,UNK,-1060,-3180
4168000110,8/26/2014,207000.0,3,1.0,1080,10200,1.0,0.0,0.0,4,7,1080,0,1962,0,98023,47.3215,-122.351,1230,10400,8,26,2014,UNK,-150,-200
5647900930,12/15/2014,195000.0,3,1.0,1070,22489,1.0,0.0,0.0,3,7,1070,0,1967,0,98001,47.3278,-122.262,1880,20250,12,15,2014,UNK,-810,2239
2523039278,6/24/2014,324950.0,3,1.5,1460,8710,1.0,0.0,0.0,3,7,1460,0,1955,0,98166,47.4561,-122.35700000000001,1400,8645,6,24,2014,UNK,60,65
6149700405,12/22/2014,210000.0,1,1.0,1050,7583,1.0,0.0,0.0,4,6,1050,0,1947,0,98133,47.7294,-122.34100000000001,1420,7560,12,22,2014,UNK,-370,23
203100690,4/25/2015,1080000.0,4,2.75,3160,42733,2.0,0.0,0.0,3,9,3160,0,1995,0,98053,47.6367,-121.958,1890,24000,4,25,2015,UNK,1270,18733
4410600100,12/4/2014,325088.0,4,1.0,1400,6739,1.0,0.0,0.0,3,7,1000,400,1954,0,98108,47.5402,-122.29799999999999,1500,6380,12,4,2014,UNK,-100,359
3223059303,1/16/2015,790000.0,4,3.0,3120,157875,2.0,0.0,0.0,4,8,3120,0,1977,0,98058,47.443999999999996,-122.18700000000001,1580,7050,1,16,2015,UNK,1540,150825
522069097,11/25/2014,150000.0,2,1.0,720,212137,1.0,0.0,0.0,3,5,720,0,1982,0,98058,47.422,-122.066,2010,109642,11,25,2014,UNK,-1290,102495
2023069059,10/30/2014,790000.0,3,3.0,2840,206910,2.0,0.0,0.0,3,10,2840,0,1999,0,98059,47.468999999999994,-122.06299999999999,2070,25067,10,30,2014,UNK,770,181843
7987400356,5/12/2014,255000.0,2,1.0,1220,2500,1.0,0.0,0.0,3,6,770,450,1910,0,98126,47.5727,-122.37200000000001,1540,3000,5,12,2014,UNK,-320,-500
461005360,11/7/2014,697000.0,4,3.0,2820,2850,1.5,0.0,0.0,5,7,1860,960,1928,0,98117,47.6813,-122.367,1570,4500,11,7,2014,UNK,1250,-1650
461004195,11/4/2014,457500.0,2,1.0,840,5000,1.0,0.0,0.0,4,7,840,0,1908,0,98117,47.6803,-122.37100000000001,1240,5000,11,4,2014,UNK,-400,0
9547204350,5/19/2014,690000.0,3,2.0,1610,5100,1.5,0.0,0.0,5,8,1610,0,1940,0,98115,47.6825,-122.307,1740,5100,5,19,2014,UNK,-130,0
2331300025,3/11/2015,967000.0,4,3.25,1860,4356,2.0,0.0,0.0,3,9,1860,0,1917,2005,98103,47.6785,-122.351,1860,4356,3,11,2015,Y,0,0
2288000090,4/29/2015,980000.0,4,1.75,2260,17711,1.0,0.0,1.0,4,9,2260,0,1968,0,98040,47.5498,-122.214,2880,16594,4,29,2015,UNK,-620,1117
5525400300,5/21/2014,619420.0,4,2.75,2450,14803,2.0,0.0,0.0,4,9,2450,0,1988,0,98059,47.5261,-122.162,2330,14803,5,21,2014,UNK,120,0
9523103001,10/13/2014,389000.0,2,1.0,850,3276,1.0,0.0,0.0,3,6,850,0,1910,0,98103,47.6742,-122.35,1460,4100,10,13,2014,UNK,-610,-824
5249802460,12/10/2014,500000.0,3,1.0,1800,7200,1.0,0.0,0.0,3,7,1020,780,1964,0,98118,47.5616,-122.275,1740,5475,12,10,2014,UNK,60,1725
7000100850,9/26/2014,569000.0,4,1.75,1230,7890,1.0,0.0,1.0,4,7,1090,140,1950,0,98004,47.5808,-122.189,2380,13176,9,26,2014,UNK,-1150,-5286
9477000300,7/28/2014,425000.0,4,2.25,2060,8540,1.0,0.0,0.0,4,7,1540,520,1967,0,98034,47.733999999999995,-122.19,1560,7700,7,28,2014,UNK,500,840
8121100265,5/21/2014,635000.0,4,2.25,2750,6180,1.0,0.0,0.0,4,8,1500,1250,1948,0,98118,47.5691,-122.28399999999999,1740,6180,5,21,2014,UNK,1010,0
2817100900,5/19/2014,256500.0,2,1.0,1120,9912,1.0,0.0,0.0,4,6,1120,0,1980,0,98070,47.3735,-122.43,1540,9750,5,19,2014,UNK,-420,162
3578700017,1/23/2015,695000.0,4,2.5,3010,11393,2.0,0.0,0.0,3,8,3010,0,2005,0,98028,47.7389,-122.221,2810,11282,1,23,2015,N,200,111
7550800195,7/30/2014,535000.0,4,1.5,1580,5000,1.5,0.0,0.0,3,7,1390,190,1945,0,98107,47.6735,-122.39299999999999,1580,5000,7,30,2014,UNK,0,0
3449900090,4/10/2015,454200.0,4,2.5,2630,5379,2.0,0.0,0.0,3,8,2630,0,2004,0,98059,47.4977,-122.163,2630,5379,4,10,2015,N,0,0
9232900165,1/23/2015,418500.0,2,1.0,790,5800,1.0,0.0,0.0,3,6,790,0,1943,0,98117,47.6973,-122.36,1460,5800,1,23,2015,UNK,-670,0
1137300900,6/5/2014,749950.0,4,2.75,3110,35235,2.0,0.0,0.0,4,9,3110,0,1983,0,98072,47.7355,-122.095,2790,35445,6,5,2014,UNK,320,-210
2617370090,10/19/2014,338500.0,3,1.75,2130,5489,1.0,0.0,0.0,3,8,1370,760,1999,0,98070,47.4489,-122.456,1750,7200,10,19,2014,UNK,380,-1711
5452301800,7/22/2014,1250000.0,4,3.75,4520,9240,1.5,0.0,2.0,3,10,3270,1250,1992,0,98040,47.5897,-122.229,3380,9240,7,22,2014,UNK,1140,0
6648760100,7/11/2014,299950.0,3,2.5,1600,9830,2.0,0.0,0.0,4,8,1600,0,1993,0,98001,47.339,-122.266,1890,8910,7,11,2014,UNK,-290,920
798000337,7/31/2014,325000.0,4,1.75,1950,12500,1.0,0.0,0.0,3,7,1330,620,1963,0,98168,47.4999,-122.32700000000001,1760,11520,7,31,2014,UNK,190,980
1737300110,8/26/2014,434000.0,4,3.0,2010,8171,2.0,0.0,0.0,3,8,2010,0,1973,0,98011,47.7688,-122.21799999999999,2090,8203,8,26,2014,UNK,-80,-32
2817800100,7/1/2014,328950.0,4,1.75,2550,8976,1.0,0.0,0.0,5,7,1300,1250,1978,0,98058,47.4286,-122.179,2220,9477,7,1,2014,UNK,330,-501
5700003640,5/19/2014,2100000.0,5,3.75,5340,10655,2.5,0.0,3.0,4,10,3740,1600,1912,0,98144,47.5795,-122.285,3910,9418,5,19,2014,UNK,1430,1237
824069156,4/29/2015,570000.0,4,2.0,2000,46902,2.0,0.0,0.0,3,8,2000,0,1978,0,98075,47.5851,-122.072,2420,38130,4,29,2015,UNK,-420,8772
1997200165,9/16/2014,802000.0,3,2.25,2170,5001,2.0,0.0,0.0,3,8,2170,0,2014,0,98103,47.6937,-122.338,1700,6991,9,16,2014,N,470,-1990
4083301645,10/24/2014,525000.0,3,1.0,1550,6840,1.5,0.0,0.0,3,7,1550,0,1918,0,98103,47.6572,-122.335,2370,4560,10,24,2014,UNK,-820,2280
3880900245,2/2/2015,700000.0,6,3.0,2790,4550,2.5,0.0,0.0,4,8,2790,0,1907,0,98119,47.626999999999995,-122.361,2590,4550,2,2,2015,UNK,200,0
1322059002,3/19/2015,350000.0,3,1.75,1980,273556,1.0,0.0,0.0,3,6,1040,940,1956,1999,98042,47.4012,-122.11,2180,217799,3,19,2015,Y,-200,55757
2426039313,2/18/2015,277500.0,2,1.5,1190,1236,3.0,0.0,0.0,3,7,1190,0,2005,0,98133,47.7274,-122.35700000000001,1390,1756,2,18,2015,N,-200,-520
6448000090,5/12/2014,1580000.0,5,2.75,3650,20150,1.0,0.0,0.0,4,10,2360,1290,1975,0,98004,47.6215,-122.22399999999999,3220,19800,5,12,2014,UNK,430,350
8005100025,9/19/2014,195000.0,3,1.0,1510,4350,1.5,0.0,0.0,5,6,1510,0,1913,0,98022,47.2052,-121.98700000000001,1210,5500,9,19,2014,UNK,300,-1150
2891000750,8/21/2014,222000.0,3,2.0,1200,6074,1.0,0.0,0.0,3,7,1200,0,1968,0,98002,47.325,-122.205,1430,6338,8,21,2014,UNK,-230,-264
5456000110,4/16/2015,865000.0,5,3.0,2830,8854,1.0,0.0,0.0,4,8,1500,1330,1979,0,98040,47.5743,-122.209,2260,8604,4,16,2015,UNK,570,250
5393601050,5/9/2014,445000.0,4,2.0,1650,6000,1.0,0.0,0.0,5,7,1000,650,1959,0,98144,47.5834,-122.307,1540,6000,5,9,2014,UNK,110,0
2979801095,12/9/2014,495800.0,4,1.5,1710,4600,1.5,0.0,0.0,3,7,1710,0,1924,0,98115,47.6847,-122.318,1740,4455,12,9,2014,UNK,-30,145
6840701095,4/3/2015,548500.0,3,1.0,1740,4400,1.5,0.0,0.0,3,7,1740,0,1924,0,98122,47.6059,-122.3,1720,4400,4,3,2015,UNK,20,0
2221000100,5/7/2014,310000.0,3,1.75,1840,10723,1.0,0.0,0.0,4,7,1220,620,1974,0,98058,47.428999999999995,-122.154,1590,9820,5,7,2014,UNK,250,903
5070000100,7/11/2014,205000.0,3,1.5,1820,8585,1.0,0.0,0.0,4,7,1820,0,1962,0,98055,47.4479,-122.213,1740,10088,7,11,2014,UNK,80,-1503
3793501450,9/10/2014,470000.0,5,3.75,3860,6901,2.0,0.0,0.0,3,7,3860,0,2003,0,98038,47.3694,-122.03200000000001,3000,8584,9,10,2014,UNK,860,-1683
321079066,4/23/2015,430000.0,3,1.5,1810,349351,1.5,0.0,0.0,3,7,1810,0,2002,0,98010,47.3392,-121.897,2480,339332,4,23,2015,UNK,-670,10019
2026049125,5/1/2015,310000.0,2,2.0,1030,2271,3.0,0.0,0.0,3,7,1030,0,1999,0,98125,47.7263,-122.314,1439,1387,5,1,2015,UNK,-409,884
1844500025,3/25/2015,355000.0,4,1.0,1410,7693,1.5,0.0,0.0,4,7,1410,0,1953,0,98133,47.7604,-122.331,1330,8395,3,25,2015,UNK,80,-702
3541600405,1/27/2015,621500.0,5,2.5,2140,15950,1.0,0.0,2.0,4,8,1370,770,1968,0,98166,47.4797,-122.35799999999999,2600,14273,1,27,2015,UNK,-460,1677
1823049202,6/10/2014,175000.0,6,1.5,1930,8400,1.0,0.0,0.0,3,7,1030,900,1971,0,98146,47.4869,-122.34,1780,9520,6,10,2014,UNK,150,-1120
1823049202,1/7/2015,326000.0,6,1.5,1930,8400,1.0,0.0,0.0,3,7,1030,900,1971,0,98146,47.4869,-122.34,1780,9520,1,7,2015,UNK,150,-1120
1563100705,9/12/2014,690000.0,4,3.5,1930,5400,1.5,0.0,2.0,3,7,1930,0,1920,0,98116,47.5679,-122.40899999999999,1500,3340,9,12,2014,UNK,430,2060
7968200090,8/19/2014,335000.0,4,2.5,2210,7214,2.0,0.0,0.0,3,8,2210,0,2003,0,98003,47.3554,-122.29799999999999,2270,7246,8,19,2014,UNK,-60,-32
5379802816,2/24/2015,197000.0,4,1.0,1360,11175,1.0,0.0,0.0,3,7,1360,0,1961,0,98188,47.4551,-122.272,1340,9702,2,24,2015,UNK,20,1473
3340401570,7/3/2014,312500.0,3,1.75,1830,7969,1.0,0.0,0.0,3,7,930,900,1950,2008,98055,47.4667,-122.214,1790,7425,7,3,2014,Y,40,544
7300700056,10/29/2014,436000.0,3,2.25,2120,6710,1.0,0.0,0.0,5,7,1420,700,1959,0,98155,47.7461,-122.324,1880,6960,10,29,2014,UNK,240,-250
1257201130,10/1/2014,1020000.0,4,2.5,2700,4590,2.0,0.0,0.0,3,8,2700,0,2002,0,98103,47.6734,-122.329,2080,3570,10,1,2014,UNK,620,1020
7526400100,8/26/2014,805000.0,4,2.5,3160,35225,2.0,0.0,1.0,3,9,2250,910,1992,0,98006,47.5672,-122.111,3460,17223,8,26,2014,UNK,-300,18002
7504400750,1/5/2015,652427.0,4,2.25,2770,13129,2.0,0.0,0.0,4,8,2770,0,1979,0,98074,47.6268,-122.05,2400,13129,1,5,2015,UNK,370,0
1525059112,10/18/2014,1010000.0,3,2.5,2240,41339,1.0,0.0,0.0,4,9,2240,0,1945,1992,98005,47.6483,-122.163,2900,45738,10,18,2014,Y,-660,-4399
7300410300,11/6/2014,355000.0,4,2.5,2570,6466,2.0,0.0,0.0,3,9,2570,0,1999,0,98092,47.3324,-122.17,2520,6667,11,6,2014,UNK,50,-201
1326039039,7/29/2014,334550.0,2,1.0,880,12000,1.0,0.0,0.0,3,7,880,0,1939,0,98133,47.7436,-122.35600000000001,1960,9395,7,29,2014,UNK,-1080,2605
8100400110,7/8/2014,557500.0,3,2.25,1820,9670,2.0,0.0,0.0,3,8,1820,0,1984,0,98052,47.6382,-122.11,2160,11424,7,8,2014,UNK,-340,-1754
6385900090,11/3/2014,277500.0,4,2.25,1660,7184,1.0,0.0,0.0,3,7,1110,550,1963,0,98188,47.4678,-122.294,1640,7200,11,3,2014,UNK,20,-16
7229000025,7/7/2014,300000.0,4,3.0,2200,10800,1.0,0.0,0.0,3,6,2200,0,1960,0,98058,47.4476,-122.169,1430,10800,7,7,2014,UNK,770,0
6145602355,2/25/2015,325000.0,4,1.0,1640,3844,1.5,0.0,0.0,4,7,1460,180,1928,0,98133,47.7017,-122.354,1230,3844,2,25,2015,UNK,410,0
3600057,3/19/2015,402500.0,4,2.0,1650,3504,1.0,0.0,0.0,3,7,760,890,1951,2013,98144,47.5803,-122.294,1480,3504,3,19,2015,Y,170,0
4040200490,8/20/2014,461000.0,3,1.75,1420,5170,1.0,0.0,0.0,4,7,1420,0,1963,0,98007,47.6151,-122.145,2250,7700,8,20,2014,UNK,-830,-2530
2919201095,3/27/2015,540000.0,3,1.0,1270,3840,1.5,0.0,0.0,3,7,1270,0,1926,0,98103,47.6896,-122.35700000000001,1270,4175,3,27,2015,UNK,0,-335
5248800625,3/16/2015,385000.0,3,1.0,1070,4000,1.0,0.0,0.0,4,7,1070,0,1971,0,98108,47.5529,-122.305,1090,4000,3,16,2015,UNK,-20,0
1257201295,7/8/2014,480000.0,2,1.0,1060,3040,1.0,0.0,0.0,3,7,860,200,1924,0,98103,47.6725,-122.329,1470,3814,7,8,2014,UNK,-410,-774
3342700371,6/9/2014,539950.0,3,2.25,2190,7149,1.0,0.0,1.0,4,8,1240,950,1963,0,98056,47.5243,-122.204,3500,7149,6,9,2014,UNK,-1310,0
1724079013,7/18/2014,529000.0,3,2.25,1940,217800,2.0,0.0,0.0,3,9,1940,0,1990,0,98024,47.5636,-121.932,2580,83558,7,18,2014,UNK,-640,134242
2770606822,8/20/2014,417000.0,3,2.5,1300,877,2.0,0.0,0.0,3,7,1060,240,2008,0,98199,47.6591,-122.39200000000001,1320,1414,8,20,2014,N,-20,-537
5706201930,2/17/2015,405000.0,3,1.5,1330,12500,1.0,0.0,0.0,3,7,1330,0,1966,0,98027,47.5263,-122.051,2310,12500,2,17,2015,UNK,-980,0
8731800300,7/23/2014,299000.0,3,2.25,1940,9100,1.0,0.0,0.0,4,8,1630,310,1966,0,98023,47.3133,-122.36399999999999,2080,9100,7,23,2014,UNK,-140,0
3751600457,8/13/2014,299000.0,3,1.75,2100,15480,1.0,0.0,0.0,3,7,2100,0,1983,0,98001,47.2924,-122.271,1330,15657,8,13,2014,UNK,770,-177
9169100214,5/14/2014,372220.0,3,1.0,1290,5500,1.0,0.0,0.0,3,7,980,310,1951,0,98136,47.5266,-122.39200000000001,1680,5000,5,14,2014,UNK,-390,500
809000820,5/22/2014,494400.0,2,1.75,1560,1750,1.0,0.0,0.0,4,6,780,780,1904,0,98109,47.6347,-122.355,1850,3600,5,22,2014,UNK,-290,-1850
9460000110,9/24/2014,280000.0,3,1.75,2630,6500,1.0,0.0,0.0,3,7,1330,1300,1958,0,98055,47.4878,-122.221,2520,6500,9,24,2014,UNK,110,0
7888780090,11/21/2014,277950.0,3,2.5,2100,6021,2.0,0.0,0.0,3,7,2100,0,1992,0,98023,47.2917,-122.375,2091,7547,11,21,2014,UNK,9,-1526
2423059067,12/19/2014,770000.0,3,2.75,2070,54557,2.0,0.0,0.0,3,8,2070,0,1996,0,98058,47.4659,-122.116,2190,49658,12,19,2014,UNK,-120,4899
1331900110,10/8/2014,760000.0,4,2.5,2960,28005,2.0,0.0,0.0,3,10,2960,0,1989,0,98072,47.7477,-122.117,3510,35248,10,8,2014,UNK,-550,-7243
6600490300,1/26/2015,230000.0,2,2.0,1300,3608,1.0,0.0,0.0,3,7,1300,0,2004,0,98198,47.3623,-122.309,1510,3608,1,26,2015,N,-210,0
6042000090,10/2/2014,525000.0,4,2.5,2520,7731,2.0,0.0,0.0,3,9,2520,0,1994,0,98155,47.7709,-122.29700000000001,2000,7704,10,2,2014,UNK,520,27
7846700850,7/1/2014,307000.0,3,1.0,1150,6000,1.5,0.0,0.0,3,7,1150,0,1927,0,98045,47.4963,-121.787,1210,7700,7,1,2014,UNK,-60,-1700
5381600110,6/18/2014,253779.0,4,2.0,2030,9600,1.5,0.0,0.0,3,6,1430,600,1947,0,98188,47.4459,-122.272,1820,14600,6,18,2014,UNK,210,-5000
3459100300,6/17/2014,405000.0,3,1.5,1880,7400,1.0,0.0,0.0,3,8,1480,400,1968,0,98155,47.7743,-122.27,1820,8660,6,17,2014,UNK,60,-1260
8151600590,3/12/2015,360000.0,2,1.0,2320,11250,2.0,0.0,0.0,4,6,2320,0,1942,0,98146,47.504,-122.36200000000001,1620,11250,3,12,2015,UNK,700,0
7936000252,5/11/2015,521000.0,2,1.0,1050,7500,1.5,0.0,3.0,4,6,1050,0,1910,0,98116,47.5577,-122.399,2540,13680,5,11,2015,UNK,-1490,-6180
2825059256,9/26/2014,680000.0,4,2.5,3030,13068,2.0,0.0,0.0,3,9,3030,0,1978,0,98005,47.6313,-122.17200000000001,2940,11999,9,26,2014,UNK,90,1069
1925069006,12/3/2014,355000.0,1,0.75,530,33278,1.0,0.0,2.0,4,4,530,0,1950,0,98074,47.6412,-122.079,2830,14311,12,3,2014,UNK,-2300,18967
1274500300,6/23/2014,200000.0,3,1.5,1090,9600,1.0,0.0,0.0,4,7,1090,0,1968,0,98042,47.3639,-122.109,1240,9620,6,23,2014,UNK,-150,-20
7129304085,7/8/2014,330000.0,3,2.25,2220,4060,1.0,0.0,0.0,3,7,1330,890,1993,0,98118,47.5188,-122.265,1930,5625,7,8,2014,UNK,290,-1565
104540820,8/12/2014,221000.0,3,2.25,1430,5999,2.0,0.0,0.0,3,7,1430,0,1987,0,98023,47.3116,-122.35799999999999,1600,5999,8,12,2014,UNK,-170,0
9272200090,2/4/2015,1600000.0,4,4.5,3780,6000,2.0,0.0,4.0,4,11,2770,1010,1910,1977,98116,47.5922,-122.38799999999999,2660,6000,2,4,2015,Y,1120,0
1787600164,7/23/2014,310000.0,2,1.0,1560,4920,1.0,0.0,0.0,4,6,780,780,1947,0,98125,47.7248,-122.325,1760,7510,7,23,2014,UNK,-200,-2590
8127700215,4/9/2015,862000.0,4,2.25,2220,4200,1.5,0.0,0.0,5,8,1310,910,1932,0,98199,47.6418,-122.39399999999999,2020,4940,4,9,2015,UNK,200,-740
7348200115,6/19/2014,200000.0,3,1.5,1140,8340,1.0,0.0,0.0,3,7,1140,0,1960,0,98168,47.4773,-122.28,1140,8340,6,19,2014,UNK,0,0
7752200100,9/30/2014,630000.0,4,2.5,2540,11100,1.0,0.0,0.0,5,7,2540,0,1957,0,98008,47.6317,-122.124,1560,11100,9,30,2014,UNK,980,0
3904901570,3/20/2015,432250.0,3,2.25,1440,6232,2.0,0.0,0.0,3,7,1440,0,1985,0,98029,47.5658,-122.01799999999999,1740,5999,3,20,2015,UNK,-300,233
1238501116,1/23/2015,478000.0,3,2.25,1570,9500,1.0,0.0,0.0,4,7,1070,500,1977,0,98033,47.6843,-122.185,2250,9583,1,23,2015,UNK,-680,-83
9392500100,7/23/2014,249000.0,4,2.25,1860,9576,1.0,0.0,0.0,3,7,1400,460,1962,0,98032,47.3612,-122.28399999999999,1860,9576,7,23,2014,UNK,0,0
7857003465,6/5/2014,495000.0,5,3.0,2440,4750,1.0,0.0,0.0,3,9,1450,990,2006,0,98108,47.5485,-122.302,1420,5940,6,5,2014,N,1020,-1190
4038700930,11/13/2014,630000.0,4,2.5,2100,8800,1.0,0.0,2.0,4,7,1240,860,1960,0,98008,47.6146,-122.11399999999999,2000,8800,11,13,2014,UNK,100,0
6979920090,6/26/2014,550000.0,4,2.5,2150,27540,2.0,0.0,0.0,3,8,2150,0,1997,0,98053,47.637,-121.969,2150,27540,6,26,2014,UNK,0,0
1515920090,9/19/2014,350000.0,3,2.5,2440,18674,2.0,0.0,0.0,4,8,2440,0,1994,0,98042,47.3672,-122.126,2530,10603,9,19,2014,UNK,-90,8071
2473100090,12/2/2014,270000.0,5,1.5,1930,7480,2.0,0.0,0.0,3,7,1930,0,1966,0,98058,47.4503,-122.15700000000001,1480,7705,12,2,2014,UNK,450,-225
6402700100,10/7/2014,488250.0,4,2.0,1830,9610,1.0,0.0,0.0,3,7,1830,0,1963,0,98033,47.695,-122.176,1970,10754,10,7,2014,UNK,-140,-1144
104530490,5/16/2014,248000.0,4,3.5,1850,6519,2.0,0.0,0.0,3,7,1130,720,1986,0,98023,47.3087,-122.354,1280,6664,5,16,2014,UNK,570,-145
2487200940,8/14/2014,889000.0,4,3.5,3210,5000,3.0,0.0,0.0,3,9,3210,0,2014,0,98136,47.5203,-122.39299999999999,1360,5000,8,14,2014,N,1850,0
6132600315,8/27/2014,375000.0,1,1.0,1090,5250,1.0,0.0,0.0,3,6,980,110,1927,0,98117,47.6999,-122.391,2160,5250,8,27,2014,UNK,-1070,0
6848200475,11/26/2014,933000.0,3,1.5,1870,3300,2.0,0.0,2.0,3,7,1870,0,1906,0,98102,47.6221,-122.325,1820,2460,11,26,2014,UNK,50,840
2141310490,1/2/2015,625000.0,3,2.25,1920,8412,1.0,0.0,2.0,3,8,1460,460,1977,0,98006,47.5578,-122.132,2490,8700,1,2,2015,UNK,-570,-288
7571200110,7/28/2014,328000.0,2,1.0,700,4350,1.0,0.0,0.0,3,6,700,0,1943,0,98116,47.5577,-122.391,1620,5100,7,28,2014,UNK,-920,-750
5072300100,7/18/2014,470000.0,4,2.25,3380,9900,1.0,0.0,2.0,4,8,1690,1690,1969,0,98166,47.4438,-122.34,2390,9900,7,18,2014,UNK,990,0
3342103148,2/13/2015,502500.0,5,2.5,2430,6168,2.0,0.0,0.0,3,8,2430,0,2007,0,98056,47.5237,-122.199,2150,8400,2,13,2015,N,280,-2232
1770000090,4/7/2015,484000.0,3,1.75,1950,17400,1.0,0.0,0.0,3,7,1210,740,1976,0,98072,47.7424,-122.09100000000001,1900,17250,4,7,2015,UNK,50,150
8658303585,8/7/2014,252500.0,2,1.0,900,7500,1.0,0.0,0.0,4,6,900,0,1961,0,98014,47.6481,-121.916,1190,10000,8,7,2014,UNK,-290,-2500
1115400090,8/21/2014,610000.0,3,2.5,2060,8893,2.0,0.0,0.0,3,8,2060,0,1987,0,98006,47.5615,-122.165,2650,8500,8,21,2014,UNK,-590,393
4400800061,7/25/2014,419000.0,4,2.0,2180,10447,1.0,0.0,0.0,4,8,1280,900,1969,0,98155,47.7675,-122.279,2190,10987,7,25,2014,UNK,-10,-540
4137000590,7/17/2014,322500.0,4,2.25,2140,9377,2.0,0.0,0.0,4,8,2140,0,1986,0,98092,47.2649,-122.21799999999999,2030,7846,7,17,2014,UNK,110,1531
809000945,1/6/2015,563000.0,6,1.0,1730,2760,1.5,0.0,0.0,3,7,1250,480,1918,0,98109,47.6342,-122.353,1630,3200,1,6,2015,UNK,100,-440
4397000100,3/24/2015,464000.0,4,2.5,3140,12591,2.0,0.0,0.0,3,9,3140,0,1993,0,98042,47.3826,-122.146,2650,11720,3,24,2015,UNK,490,871
3426049031,6/17/2014,870000.0,4,4.25,3010,4887,2.0,0.0,3.0,4,10,1940,1070,1951,0,98115,47.6933,-122.272,2540,9375,6,17,2014,UNK,470,-4488
4310702775,2/3/2015,280000.0,2,1.5,800,1196,2.0,0.0,0.0,3,8,800,0,2003,0,98103,47.6972,-122.34100000000001,1020,1087,2,3,2015,UNK,-220,109
8965450110,9/12/2014,850000.0,3,2.5,3300,11570,2.0,0.0,0.0,3,9,3300,0,1994,0,98006,47.5599,-122.12100000000001,3280,11446,9,12,2014,UNK,20,124
2887700805,10/22/2014,458950.0,2,1.0,1530,4370,1.0,0.0,0.0,3,7,1130,400,1946,0,98115,47.6888,-122.30799999999999,1580,4275,10,22,2014,UNK,-50,95
1446401460,4/22/2015,122000.0,2,1.0,760,5280,1.0,0.0,0.0,3,6,760,0,1946,0,98168,47.483000000000004,-122.33,1710,6594,4,22,2015,UNK,-950,-1314
225039175,5/13/2014,525000.0,5,3.0,2450,4591,2.0,0.0,0.0,3,7,2450,0,1994,0,98117,47.6828,-122.38799999999999,1060,5500,5,13,2014,UNK,1390,-909
1151100165,7/16/2014,286300.0,2,1.0,1000,31838,1.0,0.0,0.0,3,7,1000,0,1962,0,98045,47.4789,-121.779,1490,39747,7,16,2014,UNK,-490,-7909
4330600301,7/18/2014,218450.0,2,1.0,840,7425,1.0,0.0,0.0,4,6,840,0,1952,0,98166,47.4749,-122.339,1300,11674,7,18,2014,UNK,-460,-4249
2767602141,9/5/2014,525000.0,3,1.5,1380,4290,1.0,0.0,0.0,3,7,1080,300,1955,0,98107,47.674,-122.37899999999999,1510,3900,9,5,2014,UNK,-130,390
2767602141,12/22/2014,650000.0,3,1.5,1380,4290,1.0,0.0,0.0,3,7,1080,300,1955,0,98107,47.674,-122.37899999999999,1510,3900,12,22,2014,UNK,-130,390
2223089048,6/25/2014,356000.0,4,2.0,2020,48693,1.5,0.0,0.0,3,7,2020,0,1949,0,98045,47.4646,-121.759,1610,34900,6,25,2014,UNK,410,13793
3693900985,5/29/2014,436500.0,2,1.0,1260,5000,1.0,0.0,0.0,3,7,1040,220,1951,0,98117,47.6782,-122.397,1510,5000,5,29,2014,UNK,-250,0
3574801790,8/7/2014,410000.0,3,1.75,1440,7112,1.0,0.0,0.0,3,7,1180,260,1979,0,98034,47.7304,-122.227,1570,9152,8,7,2014,UNK,-130,-2040
2568800121,9/11/2014,512500.0,4,1.75,1540,8311,1.0,0.0,0.0,4,7,1540,0,1950,0,98125,47.7046,-122.29299999999999,1890,7996,9,11,2014,UNK,-350,315
5249804560,8/18/2014,510000.0,4,1.0,1060,7200,1.0,0.0,1.0,3,6,880,180,1925,0,98118,47.5591,-122.26799999999999,1910,7200,8,18,2014,UNK,-850,0
7811100100,9/18/2014,566000.0,4,1.75,1900,10297,1.0,0.0,0.0,4,8,1900,0,1966,0,98005,47.5944,-122.155,2220,9612,9,18,2014,UNK,-320,685
6116500300,9/10/2014,525000.0,3,1.75,2870,26500,1.5,0.0,1.0,3,8,2870,0,1948,1981,98166,47.4485,-122.355,2420,20500,9,10,2014,Y,450,6000
2489200165,8/7/2014,435000.0,3,1.0,1050,5500,1.0,0.0,0.0,3,6,930,120,1920,0,98126,47.5402,-122.38,1410,5834,8,7,2014,UNK,-360,-334
425079100,12/31/2014,406500.0,3,2.75,1840,68479,1.0,0.0,2.0,3,8,1340,500,1989,0,98014,47.6802,-121.90799999999999,2060,61903,12,31,2014,UNK,-220,6576
1828001220,10/7/2014,550000.0,5,2.75,3000,9473,1.0,0.0,0.0,3,8,1500,1500,1966,0,98052,47.6567,-122.13,2050,8820,10,7,2014,UNK,950,653
5602000025,2/26/2015,251000.0,3,2.0,1200,10212,1.5,0.0,0.0,5,6,1200,0,1949,0,98022,47.206,-121.99799999999999,1280,10212,2,26,2015,UNK,-80,0
191101015,12/11/2014,830000.0,3,1.5,1840,10125,1.0,0.0,0.0,4,8,1220,620,1959,0,98040,47.5607,-122.21700000000001,2320,10160,12,11,2014,UNK,-480,-35
4249000100,4/14/2015,803000.0,4,2.5,2790,7673,2.0,0.0,0.0,3,9,2790,0,1989,0,98052,47.6692,-122.13600000000001,2740,7837,4,14,2015,UNK,50,-164
7877400266,4/7/2015,206000.0,3,1.0,970,9360,1.0,0.0,0.0,4,5,970,0,1942,0,98002,47.2808,-122.225,1050,11348,4,7,2015,UNK,-80,-1988
7657000165,7/30/2014,200000.0,4,1.0,1070,7467,1.5,0.0,0.0,3,7,1070,0,1944,0,98178,47.4942,-122.235,1160,7467,7,30,2014,UNK,-90,0
4302200535,5/6/2014,219000.0,2,1.0,900,5160,1.0,0.0,0.0,3,6,900,0,1952,0,98106,47.525,-122.35600000000001,900,5160,5,6,2014,UNK,0,0
369000881,9/5/2014,777000.0,4,4.0,2680,6000,1.0,0.0,0.0,3,7,1380,1300,1962,2014,98199,47.6557,-122.38799999999999,1930,6000,9,5,2014,Y,750,0
7527200110,2/18/2015,593700.0,3,2.5,2000,22000,2.0,0.0,0.0,3,8,2000,0,1979,0,98075,47.59,-122.081,2180,19800,2,18,2015,UNK,-180,2200
1561600025,6/3/2014,712500.0,3,1.5,1660,8797,1.0,0.0,0.0,4,7,1660,0,1956,0,98004,47.5892,-122.20200000000001,2350,10053,6,3,2014,UNK,-690,-1256
2813100100,7/14/2014,600000.0,4,1.5,1770,6014,1.5,0.0,0.0,4,7,1240,530,1946,0,98116,47.5773,-122.39299999999999,1740,6014,7,14,2014,UNK,30,0
3179100755,3/30/2015,554663.0,3,2.0,1230,6802,1.5,0.0,0.0,3,7,1230,0,1940,0,98105,47.6712,-122.279,1850,6398,3,30,2015,UNK,-620,404
1422700110,7/3/2014,267000.0,3,1.0,1740,10875,1.0,0.0,0.0,4,7,1020,720,1962,0,98188,47.4682,-122.28299999999999,1470,8532,7,3,2014,UNK,270,2343
1075100090,9/24/2014,390000.0,3,2.0,1710,8910,1.0,0.0,0.0,5,7,1710,0,1953,0,98133,47.7719,-122.338,1430,8493,9,24,2014,UNK,280,417
7338402690,4/1/2015,335000.0,6,2.0,2020,7071,1.0,0.0,0.0,3,7,1010,1010,1979,0,98108,47.5329,-122.294,2020,5000,4,1,2015,UNK,0,2071
5451210100,4/23/2015,938000.0,4,2.5,2410,9886,1.0,0.0,0.0,5,8,1990,420,1975,0,98040,47.5351,-122.223,2530,10658,4,23,2015,UNK,-120,-772
7523900300,4/7/2015,370000.0,4,2.75,2310,14745,1.0,0.0,0.0,3,7,1410,900,1993,0,98198,47.376999999999995,-122.31,2060,9678,4,7,2015,UNK,250,5067
7237300090,4/2/2015,335000.0,5,2.5,2400,4548,2.0,0.0,0.0,3,7,2400,0,2003,0,98042,47.371,-122.12700000000001,2200,4465,4,2,2015,UNK,200,83
4083303815,4/21/2015,695000.0,5,2.0,3160,3990,1.5,0.0,0.0,3,7,1870,1290,1923,0,98103,47.653999999999996,-122.337,1780,4240,4,21,2015,UNK,1380,-250
6117501015,6/6/2014,387500.0,3,1.0,1560,14333,1.0,0.0,0.0,4,7,1560,0,1953,0,98166,47.431999999999995,-122.348,1640,14333,6,6,2014,UNK,-80,0
6700390100,3/18/2015,245000.0,3,2.5,1770,6187,2.0,0.0,0.0,3,7,1770,0,1992,0,98031,47.4034,-122.189,1650,7200,3,18,2015,UNK,120,-1013
7334401450,7/29/2014,308550.0,3,2.0,1600,13200,1.0,0.0,0.0,3,7,1600,0,1990,0,98045,47.4656,-121.756,1360,11520,7,29,2014,UNK,240,1680
8588000315,6/24/2014,225000.0,3,1.75,1330,13102,1.0,0.0,0.0,3,7,1330,0,1968,0,98003,47.3172,-122.322,1270,11475,6,24,2014,UNK,60,1627
3121500100,9/3/2014,715000.0,4,2.5,2970,29163,2.0,0.0,0.0,3,9,2970,0,1993,0,98053,47.6717,-122.025,3100,31105,9,3,2014,UNK,-130,-1942
726049202,5/6/2015,335000.0,3,1.0,1020,10200,1.0,0.0,0.0,4,7,1020,0,1954,0,98133,47.7503,-122.348,1170,8188,5,6,2015,UNK,-150,2012
3629760110,8/21/2014,634000.0,3,2.5,2490,4904,2.0,0.0,0.0,3,9,2490,0,2003,0,98029,47.5451,-122.014,2370,4050,8,21,2014,UNK,120,854
8692800025,5/14/2014,337500.0,5,2.0,1700,7314,1.0,0.0,0.0,3,7,1000,700,1956,0,98108,47.549,-122.305,2000,7176,5,14,2014,UNK,-300,138
4392200165,9/4/2014,440000.0,1,1.0,850,6567,1.0,0.0,0.0,4,6,850,0,1940,0,98010,47.327,-122.039,2160,9794,9,4,2014,UNK,-1310,-3227
1023089228,7/17/2014,350000.0,3,1.75,1250,13775,1.0,0.0,2.0,3,7,1250,0,1990,0,98045,47.4981,-121.772,1260,13707,7,17,2014,UNK,-10,68
7625702615,1/14/2015,400000.0,2,1.0,610,4560,1.0,0.0,0.0,3,5,610,0,1918,0,98136,47.5498,-122.383,930,1392,1,14,2015,UNK,-320,3168
8081030090,8/15/2014,1290000.0,4,3.5,3700,13175,2.0,0.0,0.0,4,11,3700,0,1989,0,98006,47.5471,-122.133,3880,15508,8,15,2014,UNK,-180,-2333
2201500490,4/6/2015,435000.0,3,1.0,950,10080,1.0,0.0,0.0,4,7,950,0,1954,0,98006,47.571999999999996,-122.139,1060,10000,4,6,2015,UNK,-110,80
7853250090,9/29/2014,681000.0,4,2.5,3860,5130,2.0,0.0,0.0,3,8,2930,930,2004,0,98065,47.5387,-121.87899999999999,3130,6163,9,29,2014,N,730,-1033
7133300044,6/29/2014,397000.0,3,3.5,1360,1275,2.0,0.0,0.0,3,8,1240,120,2007,0,98144,47.5904,-122.315,1360,1275,6,29,2014,N,0,0
293700110,9/26/2014,775000.0,4,2.5,3890,34513,2.0,0.0,0.0,3,10,3890,0,1996,0,98077,47.7749,-122.04799999999999,3600,28435,9,26,2014,UNK,290,6078
4038100110,7/7/2014,480000.0,3,2.25,1680,9090,1.0,0.0,0.0,4,7,1130,550,1959,0,98008,47.6068,-122.13,1960,9090,7,7,2014,UNK,-280,0
7697870600,9/9/2014,158000.0,3,2.5,1520,7200,2.0,0.0,0.0,4,7,1520,0,1985,0,98030,47.3679,-122.182,1780,7210,9,9,2014,UNK,-260,-10
8847400115,7/23/2014,590000.0,3,2.0,2420,208652,1.5,0.0,0.0,3,8,2420,0,2005,0,98010,47.3666,-121.978,3180,212137,7,23,2014,N,-760,-3485
7853240100,9/2/2014,772500.0,5,2.75,3890,9130,2.0,0.0,0.0,3,9,3890,0,2004,0,98065,47.5407,-121.86,3450,8361,9,2,2014,N,440,769
326049058,2/17/2015,464500.0,5,1.5,2940,13425,1.0,0.0,0.0,3,8,1470,1470,1955,0,98155,47.7632,-122.29,1580,8200,2,17,2015,UNK,1360,5225
8732800090,4/24/2015,281000.0,3,1.75,1350,8737,1.0,0.0,0.0,3,7,1350,0,1966,0,98188,47.4378,-122.279,1600,8928,4,24,2015,UNK,-250,-191
2526059086,7/22/2014,620000.0,3,2.25,2190,45738,1.0,0.0,0.0,3,8,2190,0,1990,0,98052,47.7108,-122.12,2970,4496,7,22,2014,UNK,-780,41242
2391600165,6/17/2014,475000.0,3,2.25,2280,5750,1.0,0.0,1.0,4,7,1150,1130,1985,0,98116,47.5641,-122.39299999999999,1500,5060,6,17,2014,UNK,780,690
7225000090,10/17/2014,245000.0,2,2.0,1070,4500,1.0,0.0,0.0,4,6,910,160,1932,0,98055,47.4896,-122.204,1280,4500,10,17,2014,UNK,-210,0
1868901295,7/29/2014,660000.0,5,2.25,2540,3750,1.5,0.0,0.0,4,7,1510,1030,1925,0,98115,47.6729,-122.29899999999999,1780,3750,7,29,2014,UNK,760,0
6072100490,12/4/2014,527500.0,4,2.25,2270,8480,1.0,0.0,0.0,5,8,1310,960,1973,0,98006,47.5448,-122.17399999999999,1910,9050,12,4,2014,UNK,360,-570
2522069064,10/27/2014,135000.0,2,1.0,1220,7250,1.0,0.0,0.0,4,6,1220,0,1914,0,98010,47.3585,-121.975,1350,20250,10,27,2014,UNK,-130,-13000
806800090,5/6/2015,275000.0,3,1.75,1890,5000,1.0,0.0,0.0,3,7,1890,0,2003,0,98092,47.3357,-122.175,2960,5421,5,6,2015,UNK,-1070,-421
7228500375,2/10/2015,430000.0,4,2.0,1990,4740,1.0,0.0,0.0,3,7,1080,910,1926,0,98122,47.6112,-122.303,1560,2370,2,10,2015,UNK,430,2370
2891100820,8/25/2014,213500.0,3,1.0,1220,6000,1.0,0.0,0.0,4,7,1220,0,1968,0,98002,47.3245,-122.209,1420,6000,8,25,2014,UNK,-200,0
8564850300,9/12/2014,535000.0,3,3.0,2640,5978,2.0,0.0,0.0,3,9,2640,0,2012,0,98045,47.4759,-121.735,2680,6060,9,12,2014,N,-40,-82
3861400061,2/13/2015,641000.0,3,1.75,1480,9603,1.0,0.0,0.0,3,7,1480,0,1952,0,98004,47.5915,-122.20200000000001,2660,10766,2,13,2015,UNK,-1180,-1163
3343903647,10/28/2014,436300.0,3,2.0,2320,9420,1.0,0.0,0.0,5,7,2320,0,1952,0,98056,47.5133,-122.196,2030,9420,10,28,2014,UNK,290,0
809002680,10/14/2014,1440000.0,4,1.75,2410,6000,1.5,0.0,0.0,3,8,2410,0,1911,0,98109,47.6369,-122.355,1280,4000,10,14,2014,UNK,1130,2000
5450300195,3/27/2015,830000.0,4,2.75,2090,13500,1.0,0.0,0.0,4,8,2090,0,1949,0,98040,47.573,-122.225,2130,13500,3,27,2015,UNK,-40,0
1231001110,7/22/2014,380000.0,3,1.0,920,3532,1.0,0.0,0.0,3,6,920,0,1910,0,98118,47.5539,-122.26799999999999,1250,4000,7,22,2014,UNK,-330,-468
6303401050,2/20/2015,132500.0,3,0.75,850,8573,1.0,0.0,0.0,3,6,600,250,1945,0,98146,47.503,-122.35600000000001,850,8382,2,20,2015,UNK,0,191
1003400245,12/1/2014,179950.0,3,1.0,1130,9907,1.0,0.0,0.0,3,7,1130,0,1954,0,98188,47.4362,-122.286,1320,9907,12,1,2014,UNK,-190,0
7468900245,4/20/2015,188200.0,3,1.0,1260,7265,1.0,0.0,0.0,4,7,1260,0,1954,0,98002,47.2979,-122.22399999999999,940,7200,4,20,2015,UNK,320,65
5021900265,7/2/2014,659000.0,4,2.0,2090,10800,1.0,0.0,0.0,4,7,2090,0,1951,0,98040,47.5759,-122.223,2090,10800,7,2,2014,UNK,0,0
8100900015,10/22/2014,317000.0,3,2.0,2020,7260,1.5,0.0,0.0,3,7,1180,840,1926,0,98108,47.5496,-122.311,1400,5950,10,22,2014,UNK,620,1310
573000490,11/24/2014,625000.0,3,2.25,1970,4564,1.0,0.0,0.0,3,8,1470,500,1959,0,98199,47.6703,-122.41,1980,5000,11,24,2014,UNK,-10,-436
4022900837,6/13/2014,350000.0,3,1.75,1820,9545,1.0,0.0,0.0,3,7,1230,590,1976,0,98155,47.7772,-122.296,1790,9530,6,13,2014,UNK,30,15
475001295,6/25/2014,750000.0,3,1.5,1840,5000,1.5,0.0,0.0,5,7,1340,500,1915,0,98107,47.6652,-122.36200000000001,1840,5000,6,25,2014,UNK,0,0
5256500025,8/27/2014,457000.0,4,1.75,2100,10358,1.0,0.0,0.0,5,8,1280,820,1959,0,98133,47.7478,-122.338,2080,9000,8,27,2014,UNK,20,1358
2767601390,3/4/2015,632500.0,4,2.0,1770,5000,2.0,0.0,0.0,4,7,1770,0,1906,0,98107,47.6748,-122.38600000000001,1550,5000,3,4,2015,UNK,220,0
6700400110,7/2/2014,223000.0,3,2.0,1110,7231,1.0,0.0,0.0,4,7,1110,0,1991,0,98031,47.4036,-122.191,1550,7245,7,2,2014,UNK,-440,-14
8860300300,9/2/2014,610000.0,4,2.75,2090,8400,1.0,0.0,0.0,4,8,1240,850,1976,0,98052,47.6872,-122.12299999999999,2340,9000,9,2,2014,UNK,-250,-600
3738900165,10/24/2014,385000.0,4,1.75,2080,8215,2.0,0.0,0.0,4,7,2080,0,1948,0,98155,47.736999999999995,-122.305,1550,8215,10,24,2014,UNK,530,0
1314300018,3/24/2015,367500.0,3,3.25,1400,1343,2.0,0.0,0.0,3,7,1160,240,2005,0,98118,47.5483,-122.277,1400,1326,3,24,2015,N,0,17
3992700265,8/4/2014,385100.0,3,1.0,1060,8040,1.0,0.0,0.0,4,6,1060,0,1949,0,98125,47.7121,-122.287,1300,7620,8,4,2014,UNK,-240,420
1105000296,12/29/2014,230000.0,2,1.0,720,5913,1.0,0.0,0.0,3,6,720,0,1920,0,98118,47.5447,-122.27,1560,6600,12,29,2014,UNK,-840,-687
1773100121,6/23/2014,286000.0,3,2.75,1100,750,2.0,0.0,0.0,3,7,780,320,2008,0,98106,47.5601,-122.363,1170,4800,6,23,2014,N,-70,-4050
7585000110,3/26/2015,201700.0,3,1.0,1010,9576,1.0,0.0,0.0,4,7,1010,0,1967,0,98001,47.2956,-122.272,1540,9576,3,26,2015,UNK,-530,0
822069112,4/23/2015,1350000.0,4,4.75,5230,89298,2.5,0.0,0.0,3,11,5230,0,2002,0,98038,47.4097,-122.06299999999999,4110,107153,4,23,2015,UNK,1120,-17855
5423030300,5/19/2014,525000.0,4,1.75,2420,7672,1.0,0.0,0.0,3,8,1480,940,1979,0,98027,47.5637,-122.085,2370,7699,5,19,2014,UNK,50,-27
1387301730,2/2/2015,361000.0,3,1.5,1200,7236,1.0,0.0,0.0,3,7,1200,0,1975,0,98011,47.739,-122.194,1680,7800,2,2,2015,UNK,-480,-564
4447300008,9/23/2014,530000.0,3,1.5,1950,1963,3.0,0.0,0.0,3,8,1950,0,2002,0,98117,47.6904,-122.397,1590,2028,9,23,2014,UNK,360,-65
6413600123,10/8/2014,455000.0,3,2.25,1870,7403,1.0,0.0,0.0,3,7,1870,0,1950,0,98125,47.7171,-122.32,1630,7440,10,8,2014,UNK,240,-37
3288100100,11/20/2014,421000.0,4,2.25,1310,8400,1.0,0.0,0.0,4,7,1310,0,1966,0,98034,47.7317,-122.181,1600,8400,11,20,2014,UNK,-290,0
6127600110,5/2/2014,640000.0,4,2.0,1520,6200,1.5,0.0,0.0,3,7,1520,0,1945,0,98115,47.678000000000004,-122.26899999999999,1910,6200,5,2,2014,UNK,-390,0
3423049165,3/31/2015,240000.0,3,1.0,1270,12733,1.0,0.0,0.0,3,7,1270,0,1955,0,98188,47.445,-122.27600000000001,1660,11536,3,31,2015,UNK,-390,1197
1233100601,10/24/2014,360000.0,2,1.0,840,7414,1.0,0.0,0.0,4,6,840,0,1928,0,98033,47.6771,-122.17200000000001,1740,9784,10,24,2014,UNK,-900,-2370
3422059085,3/24/2015,157340.0,2,1.0,900,23000,1.0,0.0,0.0,2,7,900,0,1953,0,98042,47.3576,-122.156,1460,8265,3,24,2015,UNK,-560,14735
9294300600,4/15/2015,1240000.0,4,3.0,3010,6139,2.0,0.0,4.0,5,8,2560,450,1950,0,98115,47.6799,-122.26799999999999,2100,6798,4,15,2015,UNK,910,-659
7282900025,5/6/2014,250000.0,3,1.0,1050,6874,1.0,0.0,0.0,3,6,1050,0,1954,0,98133,47.762,-122.355,1500,8954,5,6,2014,UNK,-450,-2080
2526059076,2/25/2015,735000.0,6,2.75,3360,84506,1.0,0.0,0.0,5,7,2040,1320,1962,0,98052,47.715,-122.12100000000001,2190,43124,2,25,2015,UNK,1170,41382
5451100490,1/15/2015,884900.0,7,4.75,5370,10800,1.5,0.0,0.0,3,8,5370,0,1967,0,98040,47.538000000000004,-122.223,2310,10910,1,15,2015,UNK,3060,-110
126059097,10/23/2014,775000.0,3,3.5,2690,104544,2.0,0.0,0.0,3,8,2690,0,1948,1990,98072,47.7717,-122.11200000000001,2300,81698,10,23,2014,Y,390,22846
7739100015,5/2/2014,463000.0,3,1.75,1710,7320,1.0,0.0,0.0,3,7,1710,0,1948,0,98155,47.7512,-122.281,2260,8839,5,2,2014,UNK,-550,-1519
9828702251,6/23/2014,579000.0,3,2.5,1640,1269,3.0,0.0,0.0,3,8,1640,0,2009,0,98112,47.6197,-122.3,1590,1231,6,23,2014,N,50,38
9558040820,7/9/2014,570000.0,6,3.75,4000,6015,2.0,0.0,2.0,3,10,3080,920,2004,0,98058,47.453,-122.118,3180,5700,7,9,2014,N,820,315
1437580600,3/31/2015,1060000.0,5,4.5,4140,7924,2.0,0.0,0.0,3,10,4140,0,2005,0,98074,47.6102,-121.993,3960,8410,3,31,2015,N,180,-486
5469502460,9/9/2014,375000.0,4,2.75,3140,24800,1.0,0.0,0.0,4,8,2080,1060,1971,0,98042,47.3782,-122.161,2850,12900,9,9,2014,UNK,290,11900
2919701105,12/9/2014,422000.0,2,1.75,1320,2609,1.0,0.0,0.0,4,7,920,400,1938,0,98117,47.6878,-122.366,1200,4220,12,9,2014,UNK,120,-1611
952003585,2/9/2015,866500.0,4,3.5,3080,4945,2.0,0.0,0.0,3,9,2010,1070,2014,0,98126,47.5662,-122.37899999999999,1220,4945,2,9,2015,N,1860,0
3066400750,4/13/2015,705000.0,3,2.5,2500,10359,2.0,0.0,0.0,3,10,2500,0,1986,0,98074,47.6286,-122.051,2580,10142,4,13,2015,UNK,-80,217
2607740100,10/29/2014,470000.0,4,2.5,2520,9684,2.0,0.0,0.0,3,8,2520,0,1994,0,98045,47.4848,-121.801,2090,10133,10,29,2014,UNK,430,-449
793200100,12/18/2014,360000.0,3,1.25,2350,6200,1.0,0.0,0.0,4,7,1320,1030,1966,0,98007,47.5979,-122.135,2140,9543,12,18,2014,UNK,210,-3343
6744700900,4/29/2015,795000.0,4,2.5,2570,13450,1.0,0.0,4.0,3,8,1510,1060,1948,0,98155,47.7429,-122.285,3470,12615,4,29,2015,UNK,-900,835
1828300100,3/30/2015,800000.0,4,2.5,3100,7807,2.0,0.0,0.0,3,9,3100,0,2003,0,98034,47.7151,-122.227,3100,7807,3,30,2015,UNK,0,0
1118000110,5/29/2014,2450000.0,4,3.5,4730,13586,1.5,0.0,0.0,5,10,4270,460,1935,0,98112,47.6319,-122.288,3710,8828,5,29,2014,UNK,1020,4758
9297301015,4/8/2015,277284.0,3,1.75,1030,4800,1.0,0.0,0.0,3,6,930,100,1927,0,98126,47.566,-122.37299999999999,1540,4800,4,8,2015,UNK,-510,0
585000008,4/13/2015,460000.0,2,1.0,1020,4002,1.0,0.0,0.0,5,7,1020,0,1953,0,98116,47.5828,-122.395,1780,5000,4,13,2015,UNK,-760,-998
4070700300,5/4/2015,898888.0,3,2.5,2080,3729,2.0,0.0,0.0,3,9,2080,0,1996,0,98033,47.6731,-122.199,2080,4000,5,4,2015,UNK,0,-271
3026079031,8/6/2014,211000.0,3,1.0,1410,47916,1.0,0.0,0.0,3,7,1410,0,1981,0,98019,47.7149,-121.96,1810,215622,8,6,2014,UNK,-400,-167706
2781250750,8/28/2014,222000.0,2,2.0,1360,3300,2.0,0.0,0.0,3,6,1360,0,2004,0,98038,47.3489,-122.022,1310,3300,8,28,2014,N,50,0
203100625,5/29/2014,672000.0,3,2.5,2620,21587,2.0,0.0,0.0,3,7,2620,0,1992,0,98053,47.6384,-121.959,2570,23650,5,29,2014,UNK,50,-2063
687600110,10/20/2014,778000.0,3,2.25,2260,33080,1.0,0.0,0.0,5,9,1690,570,1974,0,98005,47.6386,-122.18299999999999,3020,35291,10,20,2014,UNK,-760,-2211
2473372250,1/21/2015,312500.0,3,1.75,1490,9493,1.0,0.0,0.0,4,8,1490,0,1976,0,98058,47.4514,-122.134,2440,9600,1,21,2015,UNK,-950,-107
7974700112,7/14/2014,650000.0,4,2.5,2530,6500,1.5,0.0,0.0,3,8,1720,810,1975,0,98115,47.6737,-122.28399999999999,2150,5280,7,14,2014,UNK,380,1220
2330000015,8/26/2014,740000.0,6,2.25,3140,10250,1.0,0.0,0.0,4,8,1570,1570,1959,0,98005,47.6116,-122.169,2320,10250,8,26,2014,UNK,820,0
7230300100,8/26/2014,320000.0,3,2.0,1820,17600,1.0,0.0,0.0,5,7,1820,0,1972,0,98059,47.4703,-122.11200000000001,2190,17440,8,26,2014,UNK,-370,160
2133010110,5/8/2015,455000.0,4,2.5,1770,13168,2.0,0.0,0.0,3,7,1770,0,1990,0,98019,47.7306,-121.96600000000001,2050,14859,5,8,2015,UNK,-280,-1691
4389201250,5/13/2014,2450000.0,5,4.0,4430,9000,2.0,0.0,0.0,3,10,4430,0,2013,0,98004,47.6168,-122.21600000000001,2470,9490,5,13,2014,N,1960,-490
3383900057,12/3/2014,500000.0,3,3.25,1490,902,3.0,0.0,0.0,3,8,1220,270,2001,0,98102,47.6357,-122.324,1550,1092,12,3,2014,UNK,-60,-190
2424410110,6/11/2014,325000.0,3,1.75,1790,27427,1.0,0.0,0.0,3,7,1130,660,1978,0,98065,47.532,-121.76100000000001,1610,16684,6,11,2014,UNK,180,10743
3126049436,9/12/2014,416000.0,3,2.5,1710,1296,3.0,0.0,0.0,3,8,1510,200,2004,0,98103,47.6963,-122.34200000000001,1610,1282,9,12,2014,N,100,14
9238500100,3/18/2015,495000.0,4,2.25,2070,20280,2.0,0.0,0.0,4,7,2070,0,1968,0,98072,47.773999999999994,-122.134,2190,21560,3,18,2015,UNK,-120,-1280
9828700900,5/5/2014,549000.0,2,1.0,1140,5400,1.0,0.0,0.0,5,7,1140,0,1908,0,98112,47.6205,-122.294,1520,4800,5,5,2014,UNK,-380,600
686400930,8/25/2014,589000.0,5,2.0,3930,10150,1.5,0.0,0.0,4,8,3070,860,1968,0,98008,47.6317,-122.11399999999999,2200,8190,8,25,2014,UNK,1730,1960
5515600088,11/21/2014,194820.0,3,1.5,1100,32700,1.0,0.0,0.0,3,7,1100,0,1967,0,98001,47.3186,-122.289,1616,32700,11,21,2014,UNK,-516,0
1254200015,12/16/2014,405000.0,3,2.5,2260,5500,1.5,0.0,0.0,3,7,1280,980,1910,0,98117,47.681000000000004,-122.38799999999999,1790,5355,12,16,2014,UNK,470,145
1254200015,4/8/2015,625000.0,3,2.5,2260,5500,1.5,0.0,0.0,3,7,1280,980,1910,0,98117,47.681000000000004,-122.38799999999999,1790,5355,4,8,2015,UNK,470,145
1523049209,11/13/2014,205000.0,3,1.0,1130,7014,1.0,0.0,0.0,3,7,1130,0,1954,0,98168,47.4743,-122.274,1440,9350,11,13,2014,UNK,-310,-2336
561000300,6/23/2014,345100.0,3,3.75,1950,8625,1.0,0.0,0.0,3,8,1360,590,1959,0,98178,47.505,-122.258,1950,6670,6,23,2014,UNK,0,1955
399000195,10/20/2014,200000.0,3,1.0,960,7500,1.0,0.0,0.0,3,6,960,0,1953,0,98178,47.4966,-122.255,1250,6000,10,20,2014,UNK,-290,1500
2540700110,2/12/2015,1910000.0,4,3.5,4210,18564,2.0,0.0,0.0,3,11,4210,0,2001,0,98039,47.6206,-122.225,3520,18564,2,12,2015,UNK,690,0
2523089097,10/29/2014,524500.0,3,1.5,3430,264844,1.0,0.0,2.0,3,7,2230,1200,1988,0,98045,47.4476,-121.723,1660,145926,10,29,2014,UNK,1770,118918
3026079055,8/26/2014,598600.0,4,2.75,3470,212639,2.0,0.0,0.0,3,7,2070,1400,1993,0,98019,47.7066,-121.96799999999999,2370,233917,8,26,2014,UNK,1100,-21278
1105000011,12/9/2014,367777.0,5,3.0,2140,5937,1.0,0.0,0.0,3,7,1280,860,1978,0,98118,47.5459,-122.27,1820,6710,12,9,2014,UNK,320,-773
5113400535,5/7/2014,750000.0,3,2.75,2520,5401,1.0,0.0,0.0,4,7,1360,1160,1946,0,98119,47.6452,-122.37299999999999,1800,5036,5,7,2014,UNK,720,365
3876301140,11/5/2014,575000.0,5,2.25,3550,7992,2.0,0.0,0.0,3,8,3550,0,1968,0,98034,47.7285,-122.179,2110,7992,11,5,2014,UNK,1440,0
1523049188,4/30/2015,84000.0,2,1.0,700,20130,1.0,0.0,0.0,3,6,700,0,1949,0,98168,47.4752,-122.271,1490,18630,4,30,2015,UNK,-790,1500
5621100115,12/18/2014,255000.0,2,1.0,740,5000,1.0,0.0,0.0,4,6,740,0,1926,0,98118,47.5298,-122.273,1170,4968,12,18,2014,UNK,-430,32
4219401080,5/20/2014,1740000.0,4,3.75,3300,4545,1.5,0.0,4.0,3,10,2600,700,1926,1999,98105,47.6561,-122.274,3300,5000,5,20,2014,Y,0,-455
2112700600,5/13/2015,415000.0,3,2.25,1640,5880,1.0,0.0,0.0,3,7,1240,400,1977,0,98106,47.5323,-122.351,1200,4760,5,13,2015,UNK,440,1120
3222049112,5/7/2015,449900.0,3,2.5,2780,8225,2.0,0.0,1.0,3,9,2780,0,1990,0,98198,47.3509,-122.323,720,9736,5,7,2015,UNK,2060,-1511
622059019,9/19/2014,220000.0,5,1.5,1830,94960,1.5,0.0,0.0,3,7,1830,0,1929,0,98031,47.4218,-122.21799999999999,1440,16365,9,19,2014,UNK,390,78595
9348700490,4/10/2015,899000.0,4,2.5,3540,9349,2.0,0.0,0.0,3,10,3540,0,2003,0,98052,47.7046,-122.10700000000001,3280,7546,4,10,2015,UNK,260,1803
9259900025,7/14/2014,430000.0,3,2.5,1440,7320,1.0,0.0,0.0,5,7,1440,0,1954,0,98125,47.7179,-122.316,1160,6941,7,14,2014,UNK,280,379
3022059066,1/30/2015,472500.0,4,2.5,2960,223462,2.0,0.0,0.0,3,10,2960,0,2001,0,98030,47.3646,-122.211,2770,16482,1,30,2015,UNK,190,206980
1777500090,12/29/2014,680000.0,6,2.5,3180,9375,1.0,0.0,0.0,4,8,1590,1590,1967,0,98006,47.5707,-122.12899999999999,2670,9625,12,29,2014,UNK,510,-250
3885803245,3/5/2015,1650000.0,5,4.0,3310,8400,2.0,0.0,0.0,3,10,3310,0,2000,0,98033,47.6914,-122.214,3430,8400,3,5,2015,UNK,-120,0
8819901030,11/18/2014,810000.0,3,2.0,2390,8025,2.0,0.0,0.0,5,7,2390,0,1921,0,98105,47.6707,-122.288,1920,5350,11,18,2014,UNK,470,2675
2623069067,3/5/2015,605000.0,3,2.5,2460,138085,2.0,0.0,0.0,4,9,2460,0,1977,0,98027,47.4572,-122.007,2090,219542,3,5,2015,UNK,370,-81457
8635700025,7/25/2014,522000.0,3,1.75,1630,15600,1.0,0.0,0.0,3,7,1630,0,1958,0,98033,47.68,-122.165,1830,10850,7,25,2014,UNK,-200,4750
98020300,2/3/2015,759000.0,5,2.75,3490,8230,2.0,0.0,0.0,3,10,3490,0,2005,0,98075,47.5825,-121.97,3480,7331,2,3,2015,N,10,899
7243500025,5/19/2014,411000.0,4,2.75,2500,5257,2.0,0.0,0.0,3,8,2500,0,1966,0,98118,47.5293,-122.287,1660,5970,5,19,2014,UNK,840,-713
3329510850,3/6/2015,286950.0,4,2.5,2080,9846,1.0,0.0,0.0,3,7,1240,840,1984,0,98001,47.3338,-122.26799999999999,1890,7977,3,6,2015,UNK,190,1869
9521100855,6/10/2014,440000.0,3,1.5,1290,1286,3.0,0.0,0.0,3,7,1290,0,2000,0,98103,47.6617,-122.34899999999999,1720,1286,6,10,2014,UNK,-430,0
723049156,5/23/2014,149000.0,3,1.0,1700,8645,1.0,0.0,0.0,3,6,1700,0,1955,0,98146,47.4899,-122.337,1500,7980,5,23,2014,UNK,200,665
723049156,11/12/2014,284700.0,3,1.0,1700,8645,1.0,0.0,0.0,3,6,1700,0,1955,0,98146,47.4899,-122.337,1500,7980,11,12,2014,UNK,200,665
5130000090,9/9/2014,374950.0,3,2.5,2540,11562,1.0,0.0,1.0,3,8,1290,1250,1964,0,98028,47.7614,-122.229,2230,10310,9,9,2014,UNK,310,1252
8562400025,9/16/2014,816000.0,3,1.5,1180,8545,1.0,0.0,0.0,3,8,1180,0,1952,0,98004,47.623999999999995,-122.2,1660,9000,9,16,2014,UNK,-480,-455
5706201140,11/21/2014,533250.0,4,1.75,1520,15398,1.0,0.0,0.0,4,7,1370,150,1960,0,98027,47.5265,-122.05,1840,12500,11,21,2014,UNK,-320,2898
3034200198,6/3/2014,689800.0,3,2.75,2390,9313,1.0,0.0,0.0,5,8,1390,1000,1942,0,98133,47.7209,-122.331,2390,12712,6,3,2014,UNK,0,-3399
4077800017,8/13/2014,775000.0,4,2.75,2740,6200,1.5,0.0,3.0,4,8,1820,920,1947,0,98125,47.7084,-122.277,2430,6000,8,13,2014,UNK,310,200
1245500099,5/6/2015,702000.0,3,2.5,2190,8528,1.0,0.0,0.0,3,8,1760,430,1991,0,98033,47.6943,-122.209,2060,9811,5,6,2015,UNK,130,-1283
4435000705,7/8/2014,160000.0,3,1.0,1350,8700,1.5,0.0,0.0,3,6,1350,0,1942,0,98188,47.4497,-122.289,1300,8700,7,8,2014,UNK,50,0
4435000705,3/9/2015,255500.0,3,1.0,1350,8700,1.5,0.0,0.0,3,6,1350,0,1942,0,98188,47.4497,-122.289,1300,8700,3,9,2015,UNK,50,0
2225059118,12/2/2014,949000.0,4,2.75,2980,42253,1.0,0.0,0.0,4,9,1860,1120,1973,0,98005,47.6392,-122.163,2980,42253,12,2,2014,UNK,0,0
5126900405,7/31/2014,169500.0,2,1.0,790,7450,1.0,0.0,0.0,4,6,790,0,1944,0,98058,47.4743,-122.17,800,7450,7,31,2014,UNK,-10,0
5603800110,9/15/2014,586000.0,4,2.25,2130,9000,2.0,0.0,0.0,4,8,2130,0,1965,0,98006,47.5716,-122.15899999999999,2110,10431,9,15,2014,UNK,20,-1431
2426059076,2/3/2015,680000.0,4,2.5,2700,37431,1.0,0.0,0.0,4,8,1600,1100,1978,0,98072,47.7258,-122.117,2290,37431,2,3,2015,UNK,410,0
3260200110,12/8/2014,851500.0,3,2.0,3200,18184,1.0,0.0,0.0,5,8,2000,1200,1977,0,98005,47.6034,-122.17200000000001,1670,7416,12,8,2014,UNK,1530,10768
4235401055,5/14/2014,582500.0,2,1.5,1159,4800,1.0,0.0,0.0,3,7,1159,0,1948,0,98199,47.6592,-122.399,1640,4800,5,14,2014,UNK,-481,0
1550000463,8/26/2014,637000.0,4,3.5,3080,118918,2.0,0.0,0.0,3,9,3080,0,2008,0,98019,47.7721,-121.92399999999999,1830,434728,8,26,2014,N,1250,-315810
1823049144,1/28/2015,225000.0,3,1.0,1000,9295,1.0,0.0,0.0,3,7,1000,0,1955,0,98146,47.483999999999995,-122.346,1320,13500,1,28,2015,UNK,-320,-4205
7012200215,12/31/2014,795000.0,3,3.25,2260,3727,2.0,0.0,0.0,3,8,1880,380,2003,0,98119,47.6422,-122.361,1600,4800,12,31,2014,UNK,660,-1073
5149300100,8/18/2014,304999.0,4,2.25,2270,9600,1.0,0.0,0.0,3,7,1290,980,1976,0,98023,47.3261,-122.355,1930,15000,8,18,2014,UNK,340,-5400
7335400215,5/5/2015,95000.0,1,0.75,760,5746,1.0,0.0,0.0,4,5,760,0,1915,0,98002,47.3046,-122.215,970,6696,5,5,2015,UNK,-210,-950
7227501450,10/16/2014,240000.0,4,1.75,1420,5382,1.0,0.0,0.0,5,5,1040,380,1942,0,98056,47.4946,-122.18700000000001,1150,5382,10,16,2014,UNK,270,0
8146300025,8/13/2014,772000.0,4,2.5,2500,8680,1.0,0.0,0.0,4,7,1250,1250,1958,0,98004,47.6073,-122.19200000000001,2140,8680,8,13,2014,UNK,360,0
3530540090,11/13/2014,245000.0,2,1.5,1450,6258,1.0,0.0,0.0,4,8,1450,0,1983,0,98198,47.3785,-122.322,1460,5375,11,13,2014,UNK,-10,883
9284802215,12/5/2014,430000.0,5,3.0,2500,5750,1.0,0.0,0.0,3,8,1430,1070,1999,0,98126,47.551,-122.369,1980,7130,12,5,2014,UNK,520,-1380
1250202430,6/11/2014,799000.0,3,1.5,2210,6300,1.5,0.0,0.0,5,8,2210,0,1916,0,98144,47.5892,-122.29,2700,6300,6,11,2014,UNK,-490,0
1241900028,4/17/2015,880000.0,5,2.75,3020,9187,2.0,0.0,0.0,3,9,3020,0,2007,0,98033,47.6806,-122.167,2250,9675,4,17,2015,N,770,-488
8691400600,12/8/2014,750000.0,4,2.5,3290,7538,2.0,0.0,0.0,3,9,3290,0,2004,0,98075,47.598,-121.97200000000001,3450,7538,12,8,2014,N,-160,0
1118000301,12/19/2014,2890000.0,4,4.0,5780,7173,2.0,0.0,0.0,3,11,4130,1650,2008,0,98112,47.6374,-122.288,3930,7994,12,19,2014,N,1850,-821
3905081500,6/4/2014,532000.0,3,2.5,1820,4910,2.0,0.0,0.0,3,8,1820,0,1993,0,98029,47.5703,-121.99600000000001,2090,6668,6,4,2014,UNK,-270,-1758
5611000090,8/5/2014,525000.0,4,2.75,2500,10330,1.0,0.0,0.0,4,8,1380,1120,1978,0,98155,47.7743,-122.286,2270,10430,8,5,2014,UNK,230,-100
2013800705,11/17/2014,239000.0,2,1.0,1210,9375,1.0,0.0,1.0,4,7,1210,0,1952,0,98198,47.3865,-122.322,1680,8400,11,17,2014,UNK,-470,975
9276200850,6/16/2014,460000.0,2,1.5,1090,4000,1.0,0.0,0.0,3,8,970,120,1951,0,98116,47.5798,-122.39299999999999,1700,4000,6,16,2014,UNK,-610,0
2785000110,6/5/2014,540000.0,4,2.25,1330,8400,1.5,0.0,0.0,3,8,1330,0,1962,0,98005,47.6078,-122.169,2270,10146,6,5,2014,UNK,-940,-1746
2919702655,6/6/2014,475000.0,2,1.0,890,4590,1.0,0.0,0.0,3,7,890,0,1923,0,98117,47.6901,-122.36200000000001,1310,4590,6,6,2014,UNK,-420,0
3942900115,4/21/2015,445000.0,3,1.75,1360,4998,1.0,0.0,0.0,3,8,1360,0,1968,0,98108,47.547,-122.302,1350,4998,4,21,2015,UNK,10,0
5452301810,9/5/2014,1580000.0,5,3.75,4220,9240,2.0,0.0,2.0,5,11,3420,800,1991,0,98040,47.5895,-122.229,3380,9240,9,5,2014,UNK,840,0
5104511730,4/9/2015,549950.0,4,2.5,3780,6800,2.0,0.0,0.0,3,8,3780,0,2004,0,98038,47.3526,-122.012,3640,7326,4,9,2015,N,140,-526
3923400123,10/17/2014,294950.0,4,2.0,2610,14321,1.5,0.0,0.0,4,6,1690,920,1940,0,98188,47.4672,-122.296,1630,8599,10,17,2014,UNK,980,5722
2249500367,10/21/2014,736000.0,3,2.5,1980,2975,3.0,0.0,2.0,3,8,1980,0,1993,0,98109,47.6294,-122.344,1980,3144,10,21,2014,UNK,0,-169
2916600110,4/30/2015,214946.0,3,1.75,1290,8688,1.0,0.0,0.0,4,7,1290,0,1980,0,98042,47.3655,-122.08,1750,9090,4,30,2015,UNK,-460,-402
3629921140,10/30/2014,856000.0,5,3.25,3620,5500,2.0,0.0,2.0,3,9,3620,0,2003,0,98029,47.5442,-121.99600000000001,3260,5500,10,30,2014,UNK,360,0
8682250090,5/4/2014,775000.0,2,2.5,2680,7392,1.0,0.0,0.0,3,9,2680,0,2004,0,98053,47.717,-122.02600000000001,2315,7045,5,4,2014,N,365,347
6929602605,2/3/2015,205000.0,3,1.75,1200,8631,1.0,0.0,0.0,3,7,1200,0,1959,0,98198,47.3864,-122.30799999999999,1564,8115,2,3,2015,UNK,-364,516
8550001515,10/1/2014,429592.0,2,2.75,1992,10946,1.5,0.0,4.0,5,6,1288,704,1903,0,98070,47.3551,-122.475,1110,8328,10,1,2014,UNK,882,2618
1775800740,2/6/2015,414250.0,4,1.75,1640,13566,1.0,0.0,0.0,4,7,1120,520,1977,0,98072,47.7423,-122.09899999999999,1470,13530,2,6,2015,UNK,170,36
1773101340,2/2/2015,399950.0,4,2.75,1920,4400,1.0,0.0,0.0,4,6,960,960,1906,0,98106,47.5532,-122.365,1040,4400,2,2,2015,UNK,880,0
5561710110,10/14/2014,319990.0,3,2.25,1840,7326,1.0,0.0,0.0,5,7,1370,470,1979,0,98031,47.3958,-122.16799999999999,2050,7475,10,14,2014,UNK,-210,-149
1115800110,1/9/2015,524000.0,3,1.5,1310,9471,1.0,0.0,0.0,4,8,1310,0,1970,0,98052,47.6644,-122.148,2100,9449,1,9,2015,UNK,-790,22
2131701240,1/8/2015,349950.0,2,1.0,1050,6317,1.5,0.0,0.0,4,7,1050,0,1913,0,98019,47.7364,-121.98100000000001,1600,9616,1,8,2015,UNK,-550,-3299
8827901450,10/31/2014,889000.0,4,2.5,2570,4480,1.5,0.0,0.0,4,8,1580,990,1927,0,98105,47.6701,-122.291,2070,4480,10,31,2014,UNK,500,0
4302200336,7/7/2014,300000.0,3,1.0,930,5160,1.5,0.0,0.0,5,6,930,0,1919,0,98106,47.5256,-122.35700000000001,1060,5160,7,7,2014,UNK,-130,0
7550800916,6/2/2014,395000.0,1,1.0,730,3000,1.0,0.0,0.0,3,7,730,0,1911,0,98107,47.6741,-122.396,1520,5000,6,2,2014,UNK,-790,-2000
534000112,2/3/2015,348000.0,2,2.5,1270,1242,3.0,0.0,0.0,3,7,1270,0,2008,0,98117,47.701,-122.36200000000001,1280,1199,2,3,2015,N,-10,43
3885801450,2/26/2015,830000.0,2,1.0,1150,6000,1.0,0.0,1.0,4,7,710,440,1921,0,98033,47.6841,-122.213,2450,7200,2,26,2015,UNK,-1300,-1200
522059013,6/12/2014,173000.0,2,1.0,820,10450,1.0,0.0,0.0,4,7,820,0,1965,0,98055,47.4261,-122.199,1240,11200,6,12,2014,UNK,-420,-750
3342700405,5/22/2014,585000.0,4,1.75,3000,42200,1.0,0.0,3.0,3,7,1500,1500,1950,0,98056,47.5265,-122.20200000000001,2500,9821,5,22,2014,UNK,500,32379
9276201140,2/13/2015,576750.0,3,2.0,2220,5000,1.0,0.0,0.0,4,7,1110,1110,1966,0,98116,47.5807,-122.39399999999999,1450,5000,2,13,2015,UNK,770,0
7972601280,5/4/2015,495000.0,5,3.25,2500,7620,1.0,0.0,3.0,3,7,1250,1250,1962,0,98106,47.5298,-122.344,2020,7620,5,4,2015,UNK,480,0
2734100734,10/15/2014,216650.0,3,3.5,1540,1427,2.0,0.0,0.0,3,7,1360,180,2007,0,98109,47.542,-122.322,1220,4000,10,15,2014,N,320,-2573
4022900077,4/13/2015,615000.0,4,2.75,2750,15450,1.0,0.0,0.0,3,8,1800,950,1978,0,98155,47.7749,-122.28299999999999,2750,10620,4,13,2015,UNK,0,4830
1777600490,10/24/2014,675000.0,4,2.5,3130,12463,1.0,0.0,0.0,4,8,1620,1510,1978,0,98006,47.568999999999996,-122.12700000000001,2740,11779,10,24,2014,UNK,390,684
2193310300,4/1/2015,510000.0,3,2.0,1430,9250,1.0,0.0,0.0,4,8,990,440,1983,0,98052,47.6952,-122.096,1830,8003,4,1,2015,UNK,-400,1247
2322069168,5/7/2014,630000.0,3,2.5,2680,327135,2.0,0.0,0.0,3,8,2680,0,1995,0,98010,47.3783,-122.00299999999999,2020,60080,5,7,2014,UNK,660,267055
7885800900,8/1/2014,359950.0,4,2.5,3010,5701,2.0,0.0,0.0,3,8,3010,0,2003,0,98042,47.3492,-122.152,3010,5772,8,1,2014,UNK,0,-71
1545800090,10/3/2014,265000.0,3,1.5,1530,7500,1.5,0.0,0.0,3,7,1530,0,1986,0,98038,47.3639,-122.055,2080,11250,10,3,2014,UNK,-550,-3750
7131300025,5/21/2014,210000.0,3,1.0,1240,4842,1.0,0.0,0.0,4,6,1240,0,1916,0,98118,47.5166,-122.26899999999999,1540,5110,5,21,2014,UNK,-300,-268
3221079055,3/25/2015,367000.0,3,2.5,2260,93218,1.0,0.0,2.0,4,6,2260,0,1998,0,98022,47.2582,-121.935,2180,111078,3,25,2015,UNK,80,-17860
9184700535,4/13/2015,1080000.0,4,2.25,2820,5000,1.5,0.0,2.0,4,9,1800,1020,1926,0,98122,47.6097,-122.287,2880,6000,4,13,2015,UNK,-60,-1000
1877500090,2/11/2015,756000.0,3,2.5,3560,8297,1.0,0.0,2.0,4,8,1650,1910,1948,0,98199,47.6473,-122.40700000000001,2760,8297,2,11,2015,UNK,800,0
723049476,7/24/2014,203000.0,3,2.25,1630,9145,1.0,0.0,0.0,3,7,1630,0,1960,0,98146,47.5,-122.34700000000001,1630,9206,7,24,2014,UNK,0,-61
8556800100,1/21/2015,535000.0,4,2.5,2880,23994,2.0,0.0,3.0,3,9,2880,0,2002,0,98022,47.2124,-122.005,2470,17009,1,21,2015,UNK,410,6985
9830200475,3/23/2015,525000.0,3,3.25,2200,7440,2.0,0.0,0.0,4,7,1710,490,1947,0,98118,47.5409,-122.26799999999999,1260,6765,3,23,2015,UNK,940,675
2525000690,3/9/2015,347500.0,3,1.75,1620,7500,1.0,0.0,0.0,3,7,1220,400,1981,0,98059,47.4815,-122.162,1470,7938,3,9,2015,UNK,150,-438
1891100090,5/5/2014,620000.0,3,1.75,1480,2185,2.5,0.0,0.0,3,9,1480,0,2005,0,98034,47.6945,-122.17,1480,2441,5,5,2014,N,0,-256
3447000100,4/22/2015,645000.0,4,2.5,2250,10696,2.0,0.0,0.0,3,8,2250,0,1996,0,98006,47.5715,-122.12799999999999,2340,13286,4,22,2015,UNK,-90,-2590
1118001295,12/3/2014,2200000.0,4,3.0,3540,11098,2.0,0.0,0.0,3,10,3000,0,1940,0,98112,47.63399999999999,-122.288,3430,8214,12,3,2014,UNK,110,2884
7968460110,6/19/2014,280000.0,3,2.0,1790,42399,1.0,0.0,0.0,4,7,1790,0,1990,0,98092,47.3143,-122.134,1330,40015,6,19,2014,UNK,460,2384
5101406489,5/1/2015,432000.0,3,2.0,1400,6380,1.0,0.0,0.0,4,7,700,700,1924,0,98125,47.7015,-122.316,1690,5800,5,1,2015,UNK,-290,580
9275702350,12/22/2014,790000.0,3,1.5,2390,4452,2.0,0.0,1.0,3,9,1790,600,1929,0,98126,47.5826,-122.37799999999999,2610,5000,12,22,2014,UNK,-220,-548
7752000090,1/13/2015,635000.0,4,1.75,2400,10050,1.0,0.0,0.0,5,8,2400,0,1957,0,98008,47.6339,-122.124,1680,10050,1,13,2015,UNK,720,0
293000165,8/19/2014,442000.0,3,1.5,2050,6384,1.0,0.0,0.0,3,7,1350,700,1958,0,98126,47.5325,-122.37799999999999,1590,7214,8,19,2014,UNK,460,-830
7852100110,4/22/2015,490000.0,4,3.0,2640,5267,2.0,0.0,0.0,3,7,2640,0,2001,0,98065,47.5298,-121.88,2640,5670,4,22,2015,UNK,0,-403
1311000600,9/25/2014,250000.0,5,1.75,2320,7700,1.0,0.0,0.0,5,7,1290,1030,1962,0,98001,47.3426,-122.285,1740,7210,9,25,2014,UNK,580,490
1732800820,6/19/2014,1330000.0,4,2.5,2440,3600,2.5,0.0,0.0,4,8,2440,0,1902,0,98119,47.6298,-122.36200000000001,2440,5440,6,19,2014,UNK,0,-1840
7893203565,10/27/2014,120000.0,3,1.0,1260,7500,1.0,0.0,0.0,3,6,1260,0,1954,0,98198,47.4191,-122.33,1260,7500,10,27,2014,UNK,0,0
2524049166,9/18/2014,2950000.0,5,4.75,6240,47480,1.0,0.0,3.0,3,11,4610,1630,2003,0,98040,47.5317,-122.23299999999999,4170,17668,9,18,2014,UNK,2070,29812
9406550100,9/23/2014,325000.0,4,2.5,1930,8458,2.0,0.0,0.0,3,7,1930,0,1993,0,98038,47.3645,-122.039,1670,9485,9,23,2014,UNK,260,-1027
3327000090,6/12/2014,210000.0,4,1.75,1200,7680,1.0,0.0,0.0,3,7,1200,0,1968,0,98092,47.3138,-122.19200000000001,1490,7800,6,12,2014,UNK,-290,-120
1220000100,5/4/2015,215000.0,1,1.0,970,7639,1.0,0.0,0.0,4,5,570,400,1920,0,98166,47.4655,-122.346,1360,7380,5,4,2015,UNK,-390,259
1066600025,10/29/2014,387000.0,3,1.75,1810,10800,1.0,0.0,0.0,5,8,1210,600,1968,0,98056,47.5236,-122.184,1800,10800,10,29,2014,UNK,10,0
3626039228,9/18/2014,408000.0,3,1.0,1380,7015,1.5,0.0,0.0,4,7,1380,0,1925,0,98117,47.6987,-122.36,1160,6700,9,18,2014,UNK,220,315
7635801032,7/10/2014,410000.0,3,1.0,1470,6500,1.0,0.0,0.0,4,7,1470,0,1953,0,98166,47.473,-122.36200000000001,1470,9300,7,10,2014,UNK,0,-2800
4364700600,12/16/2014,216000.0,3,1.0,1010,7920,1.0,0.0,0.0,3,6,1010,0,1925,0,98126,47.5249,-122.37,1520,7560,12,16,2014,UNK,-510,360
4364700600,3/30/2015,390000.0,3,1.0,1010,7920,1.0,0.0,0.0,3,6,1010,0,1925,0,98126,47.5249,-122.37,1520,7560,3,30,2015,UNK,-510,360
7774200236,12/11/2014,357000.0,3,1.5,1340,11744,1.0,0.0,0.0,2,7,1340,0,1950,0,98146,47.4947,-122.36,2020,13673,12,11,2014,UNK,-680,-1929
8025700590,5/19/2014,215000.0,3,1.0,970,7275,1.0,0.0,0.0,4,7,970,0,1970,0,98031,47.4006,-122.18799999999999,1750,7200,5,19,2014,UNK,-780,75
7129302095,2/13/2015,265000.0,3,1.0,1122,6554,1.5,0.0,0.0,3,5,1122,0,1900,0,98118,47.5135,-122.257,1610,5650,2,13,2015,UNK,-488,904
2997800076,12/9/2014,589950.0,3,2.75,1670,1350,3.0,0.0,0.0,3,9,1350,320,2014,0,98116,47.5763,-122.40799999999999,1520,4800,12,9,2014,N,150,-3450
7740100015,2/6/2015,440000.0,3,1.75,2840,16851,1.0,0.0,3.0,3,8,1600,1240,1950,0,98155,47.7458,-122.287,2650,11063,2,6,2015,UNK,190,5788
5279100625,4/29/2015,248000.0,2,1.0,770,8600,1.0,0.0,0.0,4,4,770,0,1914,0,98027,47.5325,-122.031,1420,6960,4,29,2015,UNK,-650,1640
1126059144,9/11/2014,730000.0,3,2.25,2040,130680,2.0,0.0,0.0,3,9,2040,0,1977,0,98072,47.7584,-122.13600000000001,3080,39630,9,11,2014,UNK,-1040,91050
5409800110,1/19/2015,425000.0,4,2.5,3052,12145,2.0,0.0,0.0,3,8,3052,0,2004,0,98003,47.2598,-122.304,2767,8604,1,19,2015,N,285,3541
7963900100,9/12/2014,680000.0,3,2.5,2620,14248,2.0,0.0,0.0,4,8,1830,790,1977,0,98004,47.6281,-122.194,2620,12343,9,12,2014,UNK,0,1905
9264910100,2/18/2015,341500.0,5,2.25,3120,10400,2.0,0.0,0.0,3,8,3120,0,1980,0,98023,47.3097,-122.34,2160,8267,2,18,2015,UNK,960,2133
8819900449,5/8/2015,395000.0,2,1.0,1100,3975,1.0,0.0,0.0,3,7,900,200,1950,0,98105,47.6701,-122.286,1110,4280,5,8,2015,UNK,-10,-305
1525059160,7/31/2014,1230000.0,4,2.75,3410,95396,1.5,0.0,0.0,4,10,3410,0,1962,0,98005,47.6547,-122.15799999999999,3721,35352,7,31,2014,UNK,-311,60044
7526800100,7/8/2014,695500.0,5,2.75,2510,9180,1.0,0.0,1.0,4,8,1600,910,1975,0,98052,47.6389,-122.098,2650,9780,7,8,2014,UNK,-140,-600
6385100100,10/2/2014,308000.0,3,1.75,1680,8629,1.0,0.0,0.0,3,8,1200,480,1977,0,98198,47.3662,-122.319,1990,8400,10,2,2014,UNK,-310,229
2085200261,2/18/2015,422500.0,3,2.0,1960,6450,1.0,0.0,0.0,4,7,1000,960,1977,0,98038,47.3972,-122.029,1660,20720,2,18,2015,UNK,300,-14270
3522900061,4/21/2015,418000.0,2,1.0,1040,6900,1.0,0.0,0.0,4,7,1040,0,1915,0,98136,47.5411,-122.391,1620,6280,4,21,2015,UNK,-580,620
2570500090,10/7/2014,385000.0,5,1.5,1750,9780,1.5,0.0,0.0,4,7,1750,0,1961,0,98028,47.7755,-122.235,1750,10295,10,7,2014,UNK,0,-515
5482700100,5/12/2014,876650.0,3,3.25,2170,12508,1.5,0.0,0.0,5,9,1650,520,1928,1970,98040,47.5665,-122.229,2720,21070,5,12,2014,Y,-550,-8562
567000268,8/21/2014,450000.0,3,2.5,1639,2710,2.0,0.0,0.0,3,8,1479,160,2003,0,98144,47.5924,-122.294,1580,1733,8,21,2014,UNK,59,977
3649100315,6/25/2014,418800.0,4,2.25,2100,9984,1.0,0.0,0.0,4,7,1290,810,1973,0,98028,47.7365,-122.242,1930,10511,6,25,2014,UNK,170,-527
6821102352,10/8/2014,330000.0,2,1.0,880,1753,2.0,0.0,0.0,4,7,880,0,1945,0,98199,47.6475,-122.397,1010,1748,10,8,2014,UNK,-130,5
6072300110,4/16/2015,550000.0,3,1.75,1940,8376,1.0,0.0,0.0,4,8,1290,650,1963,0,98006,47.5586,-122.17299999999999,2400,8674,4,16,2015,UNK,-460,-298
3223049131,10/30/2014,270000.0,4,2.5,2490,11650,1.0,0.0,0.0,3,7,1390,1100,1990,0,98148,47.4416,-122.33200000000001,2010,10495,10,30,2014,UNK,480,1155
1068000110,4/29/2015,978500.0,3,2.25,2060,7080,2.0,0.0,0.0,3,9,1800,260,1940,0,98199,47.6455,-122.40899999999999,3070,7500,4,29,2015,UNK,-1010,-420
2600020100,9/30/2014,975000.0,4,2.5,2720,10455,2.0,0.0,2.0,3,10,2500,220,1981,0,98006,47.5564,-122.15799999999999,3240,12348,9,30,2014,UNK,-520,-1893
5422500110,7/25/2014,455000.0,3,2.25,2180,6850,1.0,0.0,0.0,3,7,1750,430,1973,0,98034,47.7246,-122.21700000000001,1740,7016,7,25,2014,UNK,440,-166
4055700378,10/9/2014,1420000.0,4,3.25,3600,38016,2.0,0.0,2.0,3,11,3310,290,1991,0,98034,47.7124,-122.25299999999999,2440,22693,10,9,2014,UNK,1160,15323
795000820,4/6/2015,220000.0,2,1.0,840,9000,1.0,0.0,0.0,5,6,840,0,1951,0,98168,47.5033,-122.329,1350,10400,4,6,2015,UNK,-510,-1400
925059113,8/13/2014,490000.0,3,2.0,2370,12196,2.0,0.0,0.0,4,7,2370,0,1970,0,98033,47.6734,-122.176,1380,12196,8,13,2014,UNK,990,0
3275000090,4/21/2015,420000.0,4,2.25,2270,9100,2.0,0.0,0.0,3,7,2270,0,1978,0,98034,47.7242,-122.17,1710,7910,4,21,2015,UNK,560,1190
8946700100,12/8/2014,408500.0,4,2.5,2720,7043,2.0,0.0,0.0,3,9,2720,0,2003,0,98092,47.3315,-122.169,2640,6958,12,8,2014,UNK,80,85
809002485,3/27/2015,716000.0,3,1.5,1140,4800,1.5,0.0,0.0,3,7,1140,0,1915,0,98109,47.6368,-122.354,1260,4800,3,27,2015,UNK,-120,0
5332200405,6/2/2014,965000.0,4,2.5,2460,5000,2.0,0.0,0.0,5,8,1620,840,1938,0,98112,47.6282,-122.29299999999999,2320,5000,6,2,2014,UNK,140,0
1775950100,1/13/2015,357823.0,3,1.5,1240,9196,1.0,0.0,0.0,3,8,1240,0,1968,0,98072,47.7562,-122.094,1690,10800,1,13,2015,UNK,-450,-1604
9808700762,6/11/2014,7060000.0,5,4.5,10040,37325,2.0,1.0,2.0,3,11,7680,2360,1940,2001,98004,47.65,-122.214,3930,25449,6,11,2014,Y,6110,11876
1133000542,8/5/2014,425000.0,3,2.25,1670,9500,1.0,0.0,0.0,3,7,1170,500,1977,0,98125,47.7253,-122.309,1470,9500,8,5,2014,UNK,200,0
7905200315,4/16/2015,711777.0,4,1.75,2220,6731,1.0,0.0,0.0,4,7,1110,1110,1953,0,98116,47.5691,-122.391,1600,6350,4,16,2015,UNK,620,381
3949600090,12/1/2014,335000.0,3,1.0,980,9903,1.0,0.0,0.0,4,7,980,0,1966,0,98028,47.7746,-122.23899999999999,1830,9903,12,1,2014,UNK,-850,0
9274201730,6/16/2014,825000.0,4,1.5,1890,6938,1.5,0.0,0.0,3,8,1890,0,1919,0,98116,47.5896,-122.389,1700,6250,6,16,2014,UNK,190,688
7883604065,5/1/2015,210000.0,2,1.0,1100,6000,1.5,0.0,0.0,4,6,1100,0,1900,0,98108,47.5275,-122.323,1280,6000,5,1,2015,UNK,-180,0
1158700100,8/11/2014,575000.0,2,1.75,2770,19700,2.0,0.0,0.0,3,8,1780,990,1983,0,98177,47.7581,-122.365,2360,9700,8,11,2014,UNK,410,10000
7237500110,4/4/2015,1210000.0,4,2.75,4250,10925,2.0,0.0,0.0,3,10,4250,0,2003,0,98059,47.5297,-122.14,4650,11544,4,4,2015,UNK,-400,-619
8682280490,8/1/2014,431500.0,2,2.0,1370,4866,1.0,0.0,0.0,3,8,1370,0,2005,0,98053,47.70399999999999,-122.012,1365,4784,8,1,2014,N,5,82
224059111,9/3/2014,475000.0,3,1.5,1480,13457,1.0,0.0,0.0,3,7,1480,0,1959,0,98007,47.5914,-122.13600000000001,2100,10517,9,3,2014,UNK,-620,2940
4141800215,11/26/2014,1500000.0,4,3.75,3770,4000,2.5,0.0,0.0,5,9,2890,880,1916,0,98122,47.6157,-122.287,2800,5000,11,26,2014,UNK,970,-1000
1822069097,12/23/2014,540000.0,6,3.0,2870,206474,2.0,0.0,0.0,3,7,2330,540,1960,1985,98042,47.401,-122.095,2380,59677,12,23,2014,Y,490,146797
1668500100,12/10/2014,775000.0,3,2.5,3820,35016,2.0,0.0,0.0,4,9,3820,0,1987,0,98053,47.6496,-122.041,3010,35190,12,10,2014,UNK,810,-174
1254200615,7/16/2014,635000.0,3,2.5,1530,2978,1.0,0.0,0.0,3,7,1210,320,1997,0,98117,47.6796,-122.39,1640,5100,7,16,2014,UNK,-110,-2122
7135520300,4/7/2015,1300000.0,3,2.75,4120,16365,1.0,0.0,2.0,3,12,4120,0,1999,0,98059,47.5265,-122.148,4020,14110,4,7,2015,UNK,100,2255
1755700090,8/1/2014,405000.0,3,2.25,1590,7267,1.0,0.0,0.0,4,7,1100,490,1976,0,98133,47.7457,-122.33200000000001,2060,8336,8,1,2014,UNK,-470,-1069
2414600195,7/21/2014,210000.0,3,1.0,1520,8600,1.0,0.0,0.0,3,6,1040,480,1951,0,98168,47.5134,-122.335,1320,8600,7,21,2014,UNK,200,0
3592500985,5/4/2015,880000.0,4,2.5,2350,4675,2.0,0.0,0.0,3,9,2150,200,1923,0,98112,47.6344,-122.305,2240,3848,5,4,2015,UNK,110,827
1003600056,10/24/2014,239000.0,4,2.0,1370,8837,1.5,0.0,0.0,3,7,1370,0,1955,0,98188,47.4386,-122.285,1360,9000,10,24,2014,UNK,10,-163
9285800755,7/14/2014,515000.0,3,2.5,1540,6100,1.0,0.0,0.0,3,6,770,770,1944,2014,98126,47.5696,-122.37799999999999,1710,5950,7,14,2014,Y,-170,150
1269200229,7/23/2014,1380000.0,3,3.25,3786,38038,1.0,1.0,4.0,3,9,1934,1852,1978,2006,98070,47.3907,-122.448,2850,33361,7,23,2014,Y,936,4677
304100090,7/22/2014,215000.0,4,2.25,1500,5393,2.0,0.0,0.0,3,7,1500,0,1999,0,98001,47.3378,-122.262,1500,5952,7,22,2014,UNK,0,-559
7227800110,4/9/2015,315000.0,6,2.0,1750,17685,1.0,0.0,0.0,4,5,1750,0,1943,0,98056,47.5096,-122.178,1750,9209,4,9,2015,UNK,0,8476
7507500015,7/30/2014,442500.0,3,1.5,1800,8303,1.0,0.0,0.0,3,7,1200,600,1957,0,98133,47.7693,-122.35700000000001,1800,8171,7,30,2014,UNK,0,132
621069146,8/18/2014,311000.0,2,1.75,1180,55321,1.0,0.0,0.0,3,8,1180,0,1941,2004,98042,47.3329,-122.09100000000001,1480,56192,8,18,2014,Y,-300,-871
263000164,12/17/2014,425000.0,2,1.0,830,6030,1.0,0.0,0.0,4,6,830,0,1925,0,98103,47.6994,-122.34700000000001,1280,6030,12,17,2014,UNK,-450,0
263000291,9/4/2014,433500.0,3,1.75,1540,9450,1.0,0.0,0.0,4,6,1040,500,1919,0,98103,47.6985,-122.348,1200,5400,9,4,2014,UNK,340,4050
1566100625,8/4/2014,450000.0,3,2.25,1610,8296,2.0,0.0,0.0,3,8,1610,0,1978,0,98115,47.7,-122.29700000000001,1610,8288,8,4,2014,UNK,0,8
8861500015,5/20/2014,675000.0,3,2.25,1990,10260,2.0,0.0,0.0,4,8,1990,0,1987,0,98052,47.6801,-122.115,1990,10260,5,20,2014,UNK,0,0
8961990090,6/24/2014,535000.0,3,2.5,2070,4132,2.0,0.0,0.0,3,8,2070,0,1999,0,98074,47.6036,-122.015,1530,5606,6,24,2014,UNK,540,-1474
3584900090,6/13/2014,577000.0,3,1.75,1760,12874,1.0,0.0,0.0,4,7,1230,530,1967,0,98005,47.5906,-122.167,1950,10240,6,13,2014,UNK,-190,2634
8902000407,12/17/2014,480000.0,3,1.75,1740,8528,1.0,0.0,0.0,4,7,1290,450,1939,0,98125,47.7097,-122.303,1610,8528,12,17,2014,UNK,130,0
3026059014,1/12/2015,400000.0,3,1.5,1950,4473,1.0,0.0,0.0,4,6,1530,420,1914,0,98034,47.7094,-122.228,2670,14256,1,12,2015,UNK,-720,-9783
7304300906,6/13/2014,304000.0,3,1.0,1280,8184,1.5,0.0,0.0,4,6,1280,0,1947,0,98155,47.7467,-122.319,1120,8184,6,13,2014,UNK,160,0
8155820110,3/25/2015,355000.0,3,1.75,1460,7203,1.0,0.0,0.0,3,7,1460,0,1990,0,98056,47.5049,-122.189,1570,7203,3,25,2015,UNK,-110,0
722069232,9/5/2014,998000.0,4,3.25,3770,982998,2.0,0.0,0.0,3,10,3770,0,1992,0,98058,47.413999999999994,-122.087,2290,37141,9,5,2014,UNK,1480,945857
1825069031,8/14/2014,550000.0,4,1.75,2410,8447,2.0,0.0,3.0,4,8,2060,350,1936,1980,98074,47.6499,-122.088,2520,14789,8,14,2014,Y,-110,-6342
1825069031,10/16/2014,550000.0,4,1.75,2410,8447,2.0,0.0,3.0,4,8,2060,350,1936,1980,98074,47.6499,-122.088,2520,14789,10,16,2014,Y,-110,-6342
3348401584,8/21/2014,210000.0,3,1.75,1400,7300,2.0,0.0,0.0,3,6,1400,0,1948,0,98178,47.4999,-122.26799999999999,1440,10825,8,21,2014,UNK,-40,-3525
8029500100,2/26/2015,317000.0,3,2.5,2100,7587,2.0,0.0,0.0,3,9,2100,0,1990,0,98023,47.3072,-122.391,2330,8119,2,26,2015,UNK,-230,-532
7964410100,5/4/2015,700000.0,4,3.5,5360,25800,1.0,0.0,0.0,3,9,3270,2090,1971,0,98074,47.6099,-122.054,2650,21781,5,4,2015,UNK,2710,4019
1457500026,6/16/2014,265000.0,3,1.0,1000,9150,1.0,0.0,0.0,3,7,1000,0,1969,0,98059,47.4829,-122.124,1490,10647,6,16,2014,UNK,-490,-1497
7215730590,9/2/2014,700000.0,4,3.5,3150,6175,2.0,0.0,0.0,3,9,3150,0,2001,0,98075,47.5966,-122.01700000000001,3150,6986,9,2,2014,UNK,0,-811
7525530100,9/8/2014,1020000.0,5,3.5,4180,17841,2.0,0.0,2.0,3,10,3160,1020,1990,0,98075,47.5618,-122.037,3260,12608,9,8,2014,UNK,920,5233
1925059194,12/9/2014,1150000.0,4,2.25,2840,20242,1.0,0.0,0.0,3,8,2240,600,1972,0,98004,47.638999999999996,-122.21600000000001,2840,20372,12,9,2014,UNK,0,-130
5561401110,6/27/2014,460000.0,4,2.5,2110,35091,1.0,0.0,0.0,4,8,1290,820,1985,0,98027,47.467,-122.014,2740,36427,6,27,2014,UNK,-630,-1336
7173700524,9/24/2014,410000.0,2,1.5,1660,4000,1.0,0.0,0.0,3,7,1000,660,1950,0,98115,47.6832,-122.304,1570,5500,9,24,2014,UNK,90,-1500
9828202215,9/5/2014,665000.0,4,3.0,2160,4400,1.0,0.0,0.0,5,7,1320,840,1921,0,98122,47.6163,-122.29299999999999,1430,4400,9,5,2014,UNK,730,0
4113800300,4/14/2015,600000.0,4,2.5,2420,7744,2.0,0.0,0.0,3,9,2420,0,1994,0,98056,47.534,-122.18,2820,11129,4,14,2015,UNK,-400,-3385
6145600855,5/4/2015,502000.0,4,1.75,1920,3844,1.0,0.0,0.0,3,7,1170,750,1967,0,98133,47.7041,-122.353,1480,3844,5,4,2015,UNK,440,0
2130702350,6/4/2014,364950.0,4,2.5,2310,8030,2.0,0.0,0.0,3,7,2310,0,1978,0,98019,47.7433,-121.98200000000001,1780,8041,6,4,2014,UNK,530,-11
8815400735,5/29/2014,680000.0,3,2.25,2330,4000,1.5,0.0,2.0,5,7,1520,810,1927,0,98115,47.6732,-122.29,1870,4000,5,29,2014,UNK,460,0
5152600090,7/8/2014,235500.0,5,2.5,2340,13713,1.0,0.0,0.0,2,8,1670,670,1967,0,98003,47.3307,-122.324,2080,11000,7,8,2014,UNK,260,2713
7852090750,7/21/2014,576000.0,4,2.5,2590,5756,2.0,0.0,0.0,3,8,2590,0,2001,0,98065,47.5356,-121.875,2620,6109,7,21,2014,UNK,-30,-353
2488200459,5/5/2014,405000.0,2,3.0,1410,1240,2.0,0.0,0.0,3,8,1140,270,2006,0,98136,47.5221,-122.39,1410,1273,5,5,2014,N,0,-33
8035600590,7/16/2014,335000.0,3,2.75,2850,8039,1.0,0.0,0.0,4,8,1540,1310,1989,0,98031,47.4141,-122.204,2240,7727,7,16,2014,UNK,610,312
4438000165,4/20/2015,122000.0,2,1.0,730,6728,1.0,0.0,0.0,3,6,730,0,1953,0,98148,47.4275,-122.324,1170,7034,4,20,2015,UNK,-440,-306
6744700423,6/6/2014,432000.0,3,1.75,1470,6250,1.0,0.0,3.0,4,7,1070,400,1939,0,98155,47.7394,-122.288,2630,7050,6,6,2014,UNK,-1160,-800
2473002100,8/27/2014,375000.0,4,2.25,2330,11400,1.0,0.0,0.0,4,8,2330,0,1974,0,98058,47.4495,-122.148,2640,10200,8,27,2014,UNK,-310,1200
4399200245,6/25/2014,276000.0,4,2.25,2460,11250,1.0,0.0,0.0,4,8,2460,0,1959,0,98002,47.3182,-122.212,1630,10216,6,25,2014,UNK,830,1034
1326059085,7/21/2014,450000.0,3,2.25,2080,111513,1.5,0.0,0.0,3,8,1680,400,1977,0,98072,47.7403,-122.11200000000001,2440,107157,7,21,2014,UNK,-360,4356
6324000090,5/11/2015,210000.0,2,1.0,990,8140,1.0,0.0,0.0,1,6,990,0,1910,0,98116,47.5828,-122.382,2150,5000,5,11,2015,UNK,-1160,3140
9542830600,11/21/2014,279000.0,3,2.5,1450,4106,2.0,0.0,0.0,3,7,1450,0,2011,0,98038,47.3655,-122.01899999999999,2000,4000,11,21,2014,N,-550,106
2767604580,2/23/2015,635000.0,3,1.75,1340,3900,2.0,0.0,0.0,5,7,1340,0,1900,0,98107,47.6711,-122.37899999999999,1470,1611,2,23,2015,UNK,-130,2289
662310900,2/20/2015,350000.0,3,2.5,2730,7372,2.0,0.0,0.0,3,9,2730,0,1998,0,98023,47.2831,-122.346,2710,8343,2,20,2015,UNK,20,-971
1432600100,9/24/2014,218000.0,3,1.0,1140,7560,1.0,0.0,0.0,4,6,1140,0,1958,0,98058,47.4624,-122.185,1300,7560,9,24,2014,UNK,-160,0
8928100025,3/24/2015,750000.0,4,1.5,1950,6300,1.5,0.0,1.0,3,7,1650,300,1944,0,98115,47.6819,-122.271,1760,6300,3,24,2015,UNK,190,0
1221039058,2/13/2015,310597.0,4,1.75,2000,25700,1.0,0.0,0.0,4,7,1150,850,1958,0,98023,47.32,-122.36200000000001,2420,27500,2,13,2015,UNK,-420,-1800
3840700600,4/1/2015,355000.0,3,1.0,900,37800,1.0,0.0,0.0,4,5,700,200,1923,0,98034,47.7146,-122.234,1750,11998,4,1,2015,UNK,-850,25802
8691410100,5/27/2014,735000.0,5,2.75,3390,5211,2.0,0.0,0.0,3,9,3390,0,2004,0,98075,47.5977,-121.98100000000001,3210,5211,5,27,2014,N,180,0
7883607645,6/2/2014,155000.0,1,1.0,720,6000,1.0,0.0,0.0,3,6,720,0,1940,0,98108,47.5266,-122.316,1040,6000,6,2,2014,UNK,-320,0
9435300051,6/11/2014,354000.0,3,1.0,940,10368,1.0,0.0,0.0,3,7,940,0,1965,0,98052,47.6608,-122.133,2090,9620,6,11,2014,UNK,-1150,748
6179900090,5/7/2015,415000.0,3,1.75,1770,10513,1.0,0.0,0.0,4,7,1400,370,1982,0,98028,47.7726,-122.266,2070,9968,5,7,2015,UNK,-300,545
6840700165,7/1/2014,202000.0,1,1.0,590,833,1.0,0.0,0.0,4,7,590,0,1926,0,98122,47.6082,-122.29899999999999,780,1617,7,1,2014,UNK,-190,-784
2768301217,5/6/2015,580000.0,3,2.5,1980,1873,2.0,0.0,0.0,3,7,1470,510,1996,0,98107,47.6659,-122.369,1500,1873,5,6,2015,UNK,480,0
629000615,10/22/2014,1500000.0,4,3.25,3070,10375,2.0,0.0,0.0,3,10,2180,890,1962,2005,98004,47.5862,-122.198,2500,11194,10,22,2014,Y,570,-819
7202360600,10/8/2014,790000.0,4,2.5,3500,7519,2.0,0.0,0.0,3,9,3500,0,2004,0,98053,47.6799,-122.024,3920,7982,10,8,2014,N,-420,-463
7852020590,3/5/2015,499900.0,3,2.5,2100,5112,2.0,0.0,0.0,3,8,2100,0,1999,0,98065,47.5338,-121.867,2100,4370,3,5,2015,UNK,0,742
2023039160,4/23/2015,525000.0,4,2.25,2620,98881,1.0,0.0,0.0,3,7,1820,800,1952,0,98070,47.4662,-122.45299999999999,1728,95832,4,23,2015,UNK,892,3049
2597520090,6/22/2014,810000.0,4,2.5,2810,10613,2.0,0.0,0.0,3,9,2810,0,1989,0,98006,47.5424,-122.141,2800,9933,6,22,2014,UNK,10,680
8631600025,2/20/2015,425000.0,4,1.5,2290,8773,1.0,0.0,0.0,4,7,1330,960,1947,0,98133,47.7173,-122.33,1740,7058,2,20,2015,UNK,550,1715
8100000110,12/26/2014,241250.0,3,1.75,1350,7588,1.0,0.0,0.0,3,7,1350,0,1993,0,98010,47.3123,-122.023,1470,7341,12,26,2014,UNK,-120,247
5151800015,11/12/2014,318700.0,4,2.5,2770,19116,1.0,0.0,0.0,4,8,1600,1170,1961,0,98003,47.3386,-122.319,2730,18429,11,12,2014,UNK,40,687
9521101055,8/27/2014,720000.0,4,1.75,2530,5000,1.5,0.0,2.0,5,8,2070,460,1917,0,98103,47.6624,-122.348,1950,3600,8,27,2014,UNK,580,1400
2475901105,7/15/2014,291000.0,3,1.0,1280,10500,1.5,0.0,0.0,4,5,1280,0,1941,0,98024,47.566,-121.89399999999999,1410,10500,7,15,2014,UNK,-130,0
1726069202,7/18/2014,420000.0,3,1.75,1060,38644,1.0,0.0,0.0,3,7,1060,0,1983,0,98077,47.7442,-122.072,1310,11416,7,18,2014,UNK,-250,27228
3530450100,7/26/2014,210000.0,2,1.75,1000,3554,1.0,0.0,0.0,4,8,1000,0,1975,0,98198,47.3811,-122.32,1150,4000,7,26,2014,UNK,-150,-446
8941800100,4/27/2015,645000.0,3,3.25,3870,11000,2.0,0.0,2.0,3,9,2970,900,1991,0,98106,47.5545,-122.354,2970,11000,4,27,2015,UNK,900,0
809002215,5/19/2014,762000.0,5,2.0,3370,5000,1.5,0.0,0.0,4,7,2140,1230,1907,0,98109,47.6373,-122.35,1920,3200,5,19,2014,UNK,1450,1800
6209000165,7/24/2014,247500.0,4,1.75,2290,7765,1.0,0.0,0.0,3,6,2290,0,1936,1953,98146,47.4997,-122.353,1240,8215,7,24,2014,Y,1050,-450
4178500100,7/23/2014,282500.0,3,2.25,1670,7150,2.0,0.0,0.0,4,7,1670,0,1990,0,98042,47.3603,-122.088,1570,7040,7,23,2014,UNK,100,110
1523069086,6/5/2014,395000.0,3,1.75,1460,22651,1.0,0.0,0.0,4,7,1460,0,1961,0,98027,47.4861,-122.03,2030,49222,6,5,2014,UNK,-570,-26571
6121000090,6/16/2014,295000.0,3,1.75,1770,8235,1.0,0.0,0.0,3,7,1030,740,1960,0,98148,47.4323,-122.32799999999999,1560,8918,6,16,2014,UNK,210,-683
3342100785,8/26/2014,235000.0,2,1.0,820,5100,1.0,0.0,0.0,4,6,820,0,1954,0,98056,47.5175,-122.205,2270,5100,8,26,2014,UNK,-1450,0
6012500100,10/1/2014,770000.0,3,1.75,1900,6334,1.0,0.0,2.0,3,8,1450,450,1948,0,98105,47.6675,-122.27600000000001,1530,6334,10,1,2014,UNK,370,0
8682291720,5/8/2014,559950.0,2,2.0,1870,4950,1.0,0.0,0.0,3,8,1870,0,2006,0,98053,47.7195,-122.022,1670,4800,5,8,2014,N,200,150
5041300100,7/10/2014,639000.0,4,2.0,1840,5419,1.0,0.0,0.0,4,7,920,920,1942,0,98199,47.6483,-122.404,1800,5419,7,10,2014,UNK,40,0
2473101140,4/28/2015,314950.0,3,1.0,1590,8470,1.0,0.0,0.0,4,7,1140,450,1967,0,98058,47.4473,-122.15899999999999,1570,9375,4,28,2015,UNK,20,-905
8121100600,3/24/2015,525000.0,3,1.0,1640,6180,1.0,0.0,0.0,4,7,1640,0,1946,0,98118,47.5682,-122.28399999999999,1540,6180,3,24,2015,UNK,100,0
724069059,5/9/2014,2400000.0,3,2.25,3000,11665,1.5,1.0,4.0,3,11,3000,0,2001,0,98075,47.5884,-122.086,3000,15959,5,9,2014,UNK,0,-4294
2755200110,6/2/2014,820000.0,3,1.75,2160,6272,1.0,0.0,0.0,4,8,1390,770,1960,0,98115,47.6777,-122.306,1290,5376,6,2,2014,UNK,870,896
6169901130,9/11/2014,1390000.0,3,3.0,2490,3600,2.0,0.0,3.0,4,8,1790,700,1911,0,98119,47.6313,-122.369,2490,3600,9,11,2014,UNK,0,0
6385000025,10/17/2014,521450.0,3,2.0,1290,5700,1.0,0.0,0.0,5,7,1290,0,1950,0,98116,47.5713,-122.397,1160,5700,10,17,2014,UNK,130,0
509000090,10/6/2014,760750.0,3,2.5,3190,49137,2.0,0.0,0.0,3,9,3190,0,1988,0,98074,47.6027,-122.04299999999999,3240,53143,10,6,2014,UNK,-50,-4006
622059031,6/4/2014,759600.0,4,1.0,1540,115434,1.5,0.0,0.0,4,7,1540,0,1923,0,98031,47.4163,-122.22,2027,23522,6,4,2014,UNK,-487,91912
5358300100,6/19/2014,346150.0,3,2.0,2140,7200,1.0,0.0,0.0,4,8,1480,660,1966,0,98056,47.5084,-122.185,2070,7220,6,19,2014,UNK,70,-20
4459800100,4/22/2015,390000.0,2,1.0,980,3800,1.0,0.0,0.0,3,7,980,0,1926,0,98103,47.6903,-122.34,1520,5010,4,22,2015,UNK,-540,-1210
2473371780,9/24/2014,359950.0,5,2.25,2450,9432,2.0,0.0,0.0,3,8,2450,0,1973,0,98058,47.4519,-122.13,2310,9100,9,24,2014,UNK,140,332
9393700110,6/3/2014,430000.0,3,2.0,1360,5120,1.5,0.0,0.0,4,6,910,450,1924,0,98116,47.5587,-122.39299999999999,1440,5120,6,3,2014,UNK,-80,0
8691360490,4/24/2015,960000.0,4,3.5,4610,11676,2.0,0.0,0.0,3,10,4610,0,2000,0,98075,47.6011,-121.98299999999999,3900,11164,4,24,2015,UNK,710,512
9175600025,10/7/2014,800000.0,7,6.75,7480,41664,2.0,0.0,2.0,3,11,5080,2400,1953,0,98166,47.4643,-122.368,2810,33190,10,7,2014,UNK,4670,8474
7605800090,1/8/2015,1010000.0,3,2.5,2860,5805,2.0,0.0,0.0,3,9,2860,0,1999,0,98005,47.6218,-122.16,2360,5832,1,8,2015,UNK,500,-27
7334500090,1/20/2015,290000.0,3,2.0,1810,11456,1.0,0.0,0.0,3,7,1810,0,1970,0,98045,47.4648,-121.756,1360,12931,1,20,2015,UNK,450,-1475
8964800930,3/17/2015,1350000.0,4,2.0,2240,10296,1.0,0.0,0.0,5,8,2240,0,1948,0,98004,47.6177,-122.21700000000001,2500,10918,3,17,2015,UNK,-260,-622
2260800110,5/13/2014,777000.0,3,3.25,3610,59677,2.0,0.0,0.0,3,10,2440,1170,2003,0,98027,47.5464,-122.088,3130,65775,5,13,2014,UNK,480,-6098
7550800945,10/7/2014,526000.0,2,1.0,1450,4500,1.5,0.0,0.0,4,7,1450,0,1921,0,98107,47.6739,-122.396,1470,5000,10,7,2014,UNK,-20,-500
1972205338,4/18/2015,550000.0,3,3.5,1450,1091,2.0,0.0,0.0,3,8,1200,250,2007,0,98119,47.6475,-122.359,1490,3017,4,18,2015,N,-40,-1926
2946000590,12/23/2014,276000.0,3,1.5,1820,8750,1.0,0.0,0.0,4,7,1200,620,1958,0,98198,47.4213,-122.322,1500,8000,12,23,2014,UNK,320,750
5700003585,12/29/2014,2500000.0,5,3.25,5620,12672,2.0,0.0,0.0,4,11,4140,1480,1916,0,98144,47.5786,-122.287,4470,8050,12,29,2014,UNK,1150,4622
7129302235,1/22/2015,325000.0,3,1.75,2080,6554,1.0,0.0,0.0,3,7,1040,1040,1950,0,98118,47.5135,-122.257,1230,5650,1,22,2015,UNK,850,904
3278602490,9/26/2014,365000.0,3,2.5,1780,1754,3.0,0.0,0.0,3,8,1780,0,2007,0,98126,47.548,-122.37299999999999,1780,1607,9,26,2014,N,0,147
685000115,10/7/2014,2150000.0,8,6.0,4340,9415,2.0,0.0,0.0,3,8,4340,0,1967,0,98004,47.6316,-122.20200000000001,2050,9100,10,7,2014,UNK,2290,315
3423600025,3/5/2015,825050.0,4,3.25,2860,3680,2.0,0.0,0.0,3,9,1980,880,1925,1993,98115,47.6752,-122.3,2010,3680,3,5,2015,Y,850,0
7173700518,7/21/2014,690000.0,3,1.5,2540,9520,1.0,0.0,0.0,3,8,1500,1040,1959,0,98115,47.6834,-122.306,1870,6800,7,21,2014,UNK,670,2720
3277801450,4/15/2015,390000.0,4,1.0,1140,6250,1.5,0.0,0.0,3,6,1140,0,1958,0,98126,47.5433,-122.375,1140,1370,4,15,2015,UNK,0,4880
1862400518,3/4/2015,385000.0,3,2.0,1320,1297,3.0,0.0,0.0,3,7,1320,0,1995,0,98117,47.6959,-122.376,1380,1503,3,4,2015,UNK,-60,-206
8078350090,3/31/2015,619000.0,3,2.5,2040,7503,2.0,0.0,0.0,3,8,2040,0,1987,0,98029,47.5718,-122.021,2170,7503,3,31,2015,UNK,-130,0
1423089118,3/25/2015,494000.0,4,2.25,1790,42000,1.0,0.0,0.0,3,7,1170,620,1983,0,98045,47.4819,-121.744,2060,50094,3,25,2015,UNK,-270,-8094
7980900011,4/27/2015,412450.0,3,2.0,1910,13505,1.0,0.0,0.0,3,8,1910,0,1955,0,98034,47.7114,-122.23,2010,8000,4,27,2015,UNK,-100,5505
5309100750,1/23/2015,580000.0,3,1.75,1460,2800,2.0,0.0,0.0,3,7,1460,0,1928,0,98117,47.6779,-122.37100000000001,1220,4062,1,23,2015,UNK,240,-1262
322059097,11/5/2014,269900.0,3,1.5,1420,22100,1.0,0.0,0.0,5,7,1420,0,1957,0,98042,47.4193,-122.149,1540,21780,11,5,2014,UNK,-120,320
9834200165,4/6/2015,704300.0,4,1.5,1790,4080,1.5,0.0,0.0,5,7,1790,0,1928,0,98144,47.5749,-122.291,1710,4080,4,6,2015,UNK,80,0
2420069201,11/7/2014,267000.0,3,2.0,1390,6005,2.0,0.0,0.0,3,8,1390,0,2005,0,98022,47.2117,-121.99,1264,5550,11,7,2014,N,126,455
4167300300,8/13/2014,310000.0,4,1.75,1880,12150,1.0,0.0,0.0,3,7,1280,600,1976,0,98023,47.3272,-122.363,1980,9680,8,13,2014,UNK,-100,2470
1105000745,1/23/2015,227064.0,3,1.5,1570,10824,2.0,0.0,0.0,3,7,1570,0,1908,0,98118,47.54,-122.275,1530,8125,1,23,2015,UNK,40,2699
8927600100,5/28/2014,925000.0,3,2.5,2690,7000,2.0,0.0,0.0,5,7,1840,850,1943,0,98115,47.6784,-122.277,1800,6435,5,28,2014,UNK,890,565
8078490090,5/8/2015,245000.0,3,1.75,1670,11452,1.0,0.0,2.0,3,8,1670,0,1992,0,98022,47.1913,-122.015,1820,11152,5,8,2015,UNK,-150,300
1736100090,12/14/2014,339888.0,3,1.0,1040,7490,1.0,0.0,0.0,3,7,1040,0,1969,0,98034,47.7137,-122.213,1520,7410,12,14,2014,UNK,-480,80
3876200100,7/10/2014,439000.0,4,2.0,1560,7500,1.0,0.0,0.0,4,7,1560,0,1968,0,98034,47.7281,-122.181,1730,7500,7,10,2014,UNK,-170,0
6844702290,5/27/2014,400000.0,2,1.0,1470,6120,1.0,0.0,0.0,2,7,1470,0,1940,0,98115,47.6914,-122.287,1840,6120,5,27,2014,UNK,-370,0
4022906430,6/30/2014,560000.0,3,2.25,2070,15002,1.5,0.0,0.0,3,8,2070,0,1955,2013,98155,47.7635,-122.274,2070,15002,6,30,2014,Y,0,0
5040800015,10/1/2014,703011.0,2,1.0,1370,5922,1.0,0.0,2.0,3,8,1130,240,1941,0,98199,47.6473,-122.406,2460,6759,10,1,2014,UNK,-1090,-837
9297301055,12/9/2014,363000.0,2,1.0,1120,4800,1.0,0.0,0.0,3,7,770,0,1926,0,98126,47.5669,-122.37200000000001,1510,4800,12,9,2014,UNK,-390,0
318500300,9/19/2014,650000.0,4,2.75,2640,6240,2.0,0.0,0.0,3,9,2640,0,2001,0,98075,47.5788,-122.059,2640,5898,9,19,2014,UNK,0,342
1839910300,1/6/2015,299950.0,3,1.0,1030,9916,1.0,0.0,0.0,4,7,1030,0,1972,0,98034,47.7218,-122.176,1470,9044,1,6,2015,UNK,-440,872
1446400785,4/22/2015,228950.0,3,1.0,1120,6625,1.0,0.0,0.0,3,6,1120,0,1942,0,98168,47.4879,-122.33200000000001,1120,6794,4,22,2015,UNK,0,-169
4036800015,10/1/2014,465000.0,4,1.75,1730,11700,1.0,0.0,0.0,3,7,880,850,1956,0,98008,47.6031,-122.13,1570,7820,10,1,2014,UNK,160,3880
8965500900,2/13/2015,725000.0,3,2.5,2090,9847,2.0,0.0,2.0,3,9,2090,0,1983,0,98006,47.5651,-122.11399999999999,2860,11483,2,13,2015,UNK,-770,-1636
3751603173,6/4/2014,212500.0,3,1.0,920,14400,1.0,0.0,0.0,4,7,920,0,1977,0,98001,47.2816,-122.26899999999999,1170,9600,6,4,2014,UNK,-250,4800
3423059140,9/10/2014,526000.0,4,2.25,2970,54450,2.0,0.0,0.0,3,8,2970,0,1983,1998,98058,47.4338,-122.146,2260,6465,9,10,2014,Y,710,47985
114101055,12/23/2014,383000.0,3,2.5,1720,10031,2.0,0.0,0.0,3,8,1720,0,1993,0,98028,47.7688,-122.238,2280,5845,12,23,2014,UNK,-560,4186
2475200590,4/21/2015,244000.0,3,1.75,1460,4692,1.0,0.0,0.0,3,7,1460,0,1988,0,98055,47.472,-122.19200000000001,1600,4557,4,21,2015,UNK,-140,135
3856905010,8/5/2014,565000.0,3,1.5,1540,3570,1.5,0.0,0.0,5,7,1490,50,1930,0,98105,47.6692,-122.325,1620,4080,8,5,2014,UNK,-80,-510
7226500100,2/19/2015,373000.0,8,3.0,2850,12714,1.0,0.0,0.0,3,7,2850,0,1959,0,98055,47.4859,-122.205,1480,4942,2,19,2015,UNK,1370,7772
3580900090,9/2/2014,300000.0,3,2.0,1310,9855,1.0,0.0,0.0,3,7,1310,0,1962,0,98034,47.7296,-122.241,1310,8370,9,2,2014,UNK,0,1485
9558000100,5/20/2014,405000.0,5,2.5,2430,4781,2.0,0.0,0.0,3,9,2430,0,2001,0,98058,47.4487,-122.117,2420,4770,5,20,2014,UNK,10,11
1872900076,6/20/2014,979000.0,3,1.5,1700,14133,1.0,0.0,1.0,4,8,1700,0,1954,0,98004,47.6166,-122.22,2630,17376,6,20,2014,UNK,-930,-3243
1221059112,11/16/2014,324888.0,4,1.75,2160,28750,2.0,0.0,0.0,4,8,2160,0,1978,0,98092,47.3212,-122.118,1790,53578,11,16,2014,UNK,370,-24828
2877102495,4/29/2015,445000.0,3,1.5,860,3200,1.0,0.0,0.0,3,6,860,0,1929,0,98117,47.6791,-122.36200000000001,1220,4300,4,29,2015,UNK,-360,-1100
4400200057,2/21/2015,761000.0,3,3.5,2050,2020,2.0,0.0,0.0,3,8,1520,530,2006,0,98112,47.6235,-122.306,1230,3640,2,21,2015,N,820,-1620
1049010300,4/27/2015,435000.0,4,2.0,1650,4745,1.0,0.0,0.0,3,7,1130,520,1972,0,98034,47.7359,-122.18,1650,5184,4,27,2015,UNK,0,-439
6802210090,8/22/2014,252000.0,3,2.25,1570,8410,1.0,0.0,0.0,3,7,1180,390,1991,0,98022,47.1942,-121.99,1540,8410,8,22,2014,UNK,30,0
726049232,6/23/2014,350000.0,3,1.75,1660,10150,1.5,0.0,0.0,3,7,1660,0,1957,0,98133,47.7512,-122.34200000000001,1640,8906,6,23,2014,UNK,20,1244
3262300940,11/7/2014,875000.0,3,1.0,1220,8119,1.0,0.0,0.0,4,7,1220,0,1955,0,98039,47.6328,-122.236,1910,8119,11,7,2014,UNK,-690,0
3262300940,2/10/2015,940000.0,3,1.0,1220,8119,1.0,0.0,0.0,4,7,1220,0,1955,0,98039,47.6328,-122.236,1910,8119,2,10,2015,UNK,-690,0
1214700090,8/19/2014,280000.0,3,2.0,1780,11342,1.0,0.0,0.0,3,7,1780,0,1964,0,98148,47.4617,-122.32700000000001,2140,8449,8,19,2014,UNK,-360,2893
8564950300,9/19/2014,450000.0,3,2.5,2180,4226,2.0,0.0,0.0,3,8,2180,0,2004,0,98011,47.7733,-122.226,2540,4607,9,19,2014,N,-360,-381
3321069006,12/31/2014,905000.0,3,2.5,3520,237402,2.5,0.0,0.0,3,9,3520,0,2004,0,98092,47.2687,-122.056,2310,165963,12,31,2014,N,1210,71439
3751601501,7/16/2014,382450.0,3,2.5,2220,20531,2.0,0.0,0.0,3,8,2220,0,1998,0,98001,47.2864,-122.264,2420,19249,7,16,2014,UNK,-200,1282
1156000100,12/24/2014,246700.0,3,2.0,1610,13309,1.0,0.0,0.0,4,7,1610,0,1967,0,98042,47.3398,-122.133,1610,15725,12,24,2014,UNK,0,-2416
3972900735,8/14/2014,220000.0,3,1.5,1070,9331,1.0,0.0,0.0,3,6,1070,0,1956,0,98155,47.7633,-122.31299999999999,1480,8400,8,14,2014,UNK,-410,931
6888900115,2/16/2015,555750.0,3,1.0,1060,4880,1.0,0.0,0.0,2,6,910,150,1913,0,98118,47.5545,-122.288,1200,4880,2,16,2015,UNK,-140,0
3031200165,6/11/2014,262500.0,3,1.5,1160,8906,1.0,0.0,0.0,3,7,1160,0,1962,0,98118,47.5362,-122.29,1160,8906,6,11,2014,UNK,0,0
5683000033,12/1/2014,515000.0,2,1.0,910,4725,1.0,0.0,0.0,3,7,910,0,1949,0,98115,47.676,-122.281,1600,5200,12,1,2014,UNK,-690,-475
7230000265,6/17/2014,499500.0,3,2.5,2970,21907,2.0,0.0,0.0,3,9,2970,0,1998,0,98059,47.4741,-122.09899999999999,2040,27917,6,17,2014,UNK,930,-6010
985001015,6/4/2014,135000.0,1,1.0,790,13062,1.0,0.0,0.0,3,6,790,0,1942,0,98168,47.4919,-122.311,1240,7137,6,4,2014,UNK,-450,5925
2815600215,11/18/2014,462500.0,2,2.0,1540,7290,2.0,0.0,0.0,3,7,1540,0,1948,1983,98136,47.551,-122.395,1540,7072,11,18,2014,Y,0,218
3585900090,4/15/2015,937500.0,4,2.5,3130,21100,1.0,0.0,4.0,3,9,2530,600,1956,0,98177,47.7598,-122.37200000000001,3680,23000,4,15,2015,UNK,-550,-1900
5101407370,4/22/2015,458000.0,3,1.5,1470,9570,1.0,0.0,0.0,3,7,1280,190,1941,0,98125,47.7032,-122.306,1390,9570,4,22,2015,UNK,80,0
871001105,10/22/2014,845000.0,4,2.75,3160,7143,1.5,0.0,0.0,3,8,2100,1060,1933,0,98199,47.6513,-122.406,2200,6122,10,22,2014,UNK,960,1021
424069233,5/31/2014,660000.0,3,2.25,2675,40910,2.0,0.0,0.0,3,8,2675,0,1984,0,98075,47.5916,-122.055,2300,39438,5,31,2014,UNK,375,1472
3830630090,4/17/2015,265000.0,3,2.0,1340,6783,1.0,0.0,0.0,4,7,1340,0,1987,0,98030,47.3504,-122.177,1630,6458,4,17,2015,UNK,-290,325
1997200215,5/7/2014,599999.0,9,4.5,3830,6988,2.5,0.0,0.0,3,7,2450,1380,1938,0,98103,47.6927,-122.338,1460,6291,5,7,2014,UNK,2370,697
1898310110,12/2/2014,280000.0,3,2.5,1800,8697,2.0,0.0,0.0,3,8,1800,0,1987,0,98023,47.3115,-122.4,1770,8390,12,2,2014,UNK,30,307
3407700047,10/29/2014,1060000.0,3,3.25,2990,189852,2.0,0.0,0.0,4,10,2990,0,1974,0,98072,47.746,-122.13799999999999,3500,48760,10,29,2014,UNK,-510,141092
9542100165,11/7/2014,875000.0,4,3.0,3720,14125,1.0,0.0,0.0,4,9,1930,1790,1960,0,98005,47.5911,-122.177,3160,15300,11,7,2014,UNK,560,-1175
7140800100,10/14/2014,125000.0,3,1.0,920,7276,1.0,0.0,0.0,4,6,920,0,1961,0,98002,47.285,-122.211,1120,7276,10,14,2014,UNK,-200,0
7202340930,12/9/2014,634800.0,4,3.0,3280,4904,2.0,0.0,0.0,3,7,3280,0,2005,0,98053,47.6802,-122.03299999999999,2600,5004,12,9,2014,N,680,-100
9262800057,2/3/2015,269950.0,4,1.0,1440,9600,1.0,0.0,0.0,2,7,1440,0,1964,0,98001,47.3168,-122.264,1740,43560,2,3,2015,UNK,-300,-33960
1159100100,6/20/2014,359950.0,3,2.25,1940,11612,1.0,0.0,0.0,4,8,1100,840,1981,0,98178,47.5018,-122.23,2180,8954,6,20,2014,UNK,-240,2658
7230900100,12/15/2014,417000.0,3,1.75,1590,11454,1.0,0.0,0.0,4,8,1590,0,1979,0,98056,47.5049,-122.186,1970,9960,12,15,2014,UNK,-380,1494
8682301910,7/22/2014,389000.0,2,2.0,1340,4122,1.0,0.0,0.0,3,8,1340,0,2007,0,98053,47.7182,-122.022,1350,4273,7,22,2014,N,-10,-151
7701450110,8/15/2014,1040000.0,4,2.5,3770,10893,2.0,0.0,2.0,3,11,3770,0,1997,0,98006,47.5646,-122.12899999999999,3710,9685,8,15,2014,UNK,60,1208
1725059209,9/29/2014,698000.0,6,2.5,2680,11250,1.0,0.0,0.0,5,7,1340,1340,1967,0,98033,47.6553,-122.19,2200,9875,9,29,2014,UNK,480,1375
4025300195,3/18/2015,685000.0,4,2.5,2820,10125,2.0,0.0,0.0,3,8,2820,0,2008,0,98155,47.7494,-122.304,1560,10125,3,18,2015,N,1260,0
985000900,11/5/2014,198500.0,3,1.75,1520,7137,1.0,0.0,0.0,3,5,1520,0,1932,0,98168,47.4924,-122.311,1240,8602,11,5,2014,UNK,280,-1465
7140700850,3/26/2015,350000.0,4,2.5,2560,5428,2.0,0.0,0.0,3,8,2560,0,2012,0,98042,47.3835,-122.095,2620,5428,3,26,2015,N,-60,0
522079067,4/8/2015,649950.0,3,2.5,3310,387684,1.0,0.0,0.0,3,8,2160,1150,1919,1996,98038,47.4167,-121.936,2340,189050,4,8,2015,Y,970,198634
1387300940,4/29/2015,441000.0,3,1.5,1540,7200,1.0,0.0,0.0,3,7,1540,0,1968,0,98011,47.7357,-122.195,1560,7500,4,29,2015,UNK,-20,-300
8562700090,11/11/2014,462600.0,3,1.75,1430,11761,1.0,0.0,0.0,4,8,1430,0,1964,0,98052,47.6686,-122.15700000000001,2040,10035,11,11,2014,UNK,-610,1726
2122059236,3/6/2015,365070.0,4,2.5,2506,6232,2.0,0.0,0.0,3,7,2506,0,2006,0,98030,47.3734,-122.182,2070,8260,3,6,2015,N,436,-2028
514500090,5/13/2014,550000.0,4,2.0,2250,7500,1.0,0.0,0.0,5,7,1200,1050,1956,0,98005,47.5877,-122.15700000000001,1440,7500,5,13,2014,UNK,810,0
5680001095,4/28/2015,470000.0,5,1.75,2740,9600,1.0,0.0,0.0,4,7,1370,1370,1945,0,98144,47.5738,-122.315,1990,4800,4,28,2015,UNK,750,4800
2475900855,8/27/2014,340000.0,3,1.75,1540,10400,1.0,0.0,0.0,3,6,1540,0,1977,0,98024,47.5651,-121.89,1090,7500,8,27,2014,UNK,450,2900
8669400100,8/5/2014,910000.0,4,2.75,4190,38912,1.0,0.0,0.0,4,9,2040,2150,1965,0,98005,47.6472,-122.15700000000001,3050,36884,8,5,2014,UNK,1140,2028
3824100051,4/7/2015,405000.0,4,1.75,1690,8392,1.0,0.0,0.0,3,7,1190,500,1979,0,98028,47.773,-122.256,1880,9861,4,7,2015,UNK,-190,-1469
952004875,6/2/2014,661000.0,4,2.25,1990,4600,1.5,0.0,2.0,4,8,1420,570,1932,0,98126,47.5638,-122.38,1810,5750,6,2,2014,UNK,180,-1150
9522350090,11/6/2014,635000.0,4,2.5,2410,7069,2.0,0.0,0.0,3,9,2410,0,1993,0,98034,47.7094,-122.234,2240,7184,11,6,2014,UNK,170,-115
1787600252,5/5/2015,282000.0,2,1.0,1150,6098,1.0,0.0,0.0,3,7,950,200,1948,0,98125,47.7259,-122.32799999999999,1790,8455,5,5,2015,UNK,-640,-2357
7148000315,2/11/2015,235000.0,4,1.75,1720,10137,2.0,0.0,0.0,3,7,1720,0,1956,0,98188,47.4424,-122.27600000000001,1350,10205,2,11,2015,UNK,370,-68
2180001080,8/19/2014,277500.0,3,2.0,1260,22100,2.0,0.0,0.0,4,7,1260,0,1981,0,98023,47.2772,-122.354,1430,13000,8,19,2014,UNK,-170,9100
1328330590,4/20/2015,346500.0,5,2.5,2020,8250,1.0,0.0,0.0,4,8,1430,590,1978,0,98058,47.4432,-122.135,1680,8959,4,20,2015,UNK,340,-709
34001304,4/10/2015,480000.0,5,2.25,2240,5500,1.0,0.0,0.0,3,7,1490,750,1959,0,98136,47.5305,-122.391,2010,6050,4,10,2015,UNK,230,-550
1558500100,9/16/2014,360000.0,4,2.25,1930,6508,2.0,0.0,0.0,3,8,1930,0,1996,0,98019,47.7458,-121.977,2170,6548,9,16,2014,UNK,-240,-40
2887950110,11/6/2014,245000.0,3,2.5,1820,6785,1.0,0.0,0.0,3,7,1420,400,1994,0,98092,47.3201,-122.177,1710,6055,11,6,2014,UNK,110,730
6852700412,9/19/2014,625000.0,3,3.5,1560,1490,2.0,0.0,0.0,3,8,1240,320,1995,0,98102,47.6248,-122.319,1560,1662,9,19,2014,UNK,0,-172
1798000100,5/29/2014,750500.0,5,3.0,2170,2440,1.5,0.0,0.0,4,8,1450,720,1911,0,98115,47.6724,-122.31700000000001,2070,4000,5,29,2014,UNK,100,-1560
9516500100,4/18/2015,525000.0,3,1.75,1600,9579,1.0,0.0,0.0,3,8,1180,420,1977,0,98072,47.7662,-122.15899999999999,1750,9829,4,18,2015,UNK,-150,-250
203400090,7/29/2014,740000.0,4,3.5,3760,57063,2.0,0.0,0.0,3,9,2950,810,1998,0,98053,47.6328,-121.964,2870,28945,7,29,2014,UNK,890,28118
4036800805,5/13/2014,523000.0,3,1.5,1240,7735,1.0,0.0,0.0,4,7,1240,0,1957,0,98008,47.601000000000006,-122.12200000000001,1260,7500,5,13,2014,UNK,-20,235
7129302615,3/4/2015,292000.0,3,1.75,1090,4500,1.5,0.0,0.0,5,8,1090,0,1929,0,98118,47.5157,-122.256,1640,5225,3,4,2015,UNK,-550,-725
7278700100,1/21/2015,625000.0,4,2.5,2740,9599,1.0,0.0,2.0,3,8,1820,920,1961,0,98177,47.7728,-122.385,2660,8280,1,21,2015,UNK,80,1319
7852070090,1/16/2015,700000.0,3,2.5,3110,11727,2.0,0.0,2.0,3,9,3110,0,2002,0,98065,47.5445,-121.87100000000001,4240,13353,1,16,2015,UNK,-1130,-1626
1250200552,3/12/2015,399950.0,3,2.5,1610,1320,2.0,0.0,0.0,3,7,1280,330,2007,0,98144,47.6,-122.29799999999999,1480,1602,3,12,2015,N,130,-282
9126100608,2/25/2015,545000.0,4,3.5,1880,1341,3.0,0.0,0.0,3,8,1650,230,2007,0,98122,47.6053,-122.306,1740,1883,2,25,2015,N,140,-542
396100025,8/7/2014,339999.0,4,2.0,1740,6369,1.0,0.0,0.0,5,6,870,870,1954,0,98133,47.7461,-122.33200000000001,1560,7200,8,7,2014,UNK,180,-831
9184700600,12/1/2014,1210000.0,4,2.25,3270,6000,2.0,0.0,0.0,5,8,2180,1090,1909,0,98122,47.6101,-122.286,2880,6000,12,1,2014,UNK,390,0
4221250090,11/13/2014,545000.0,3,2.5,1990,5149,2.0,0.0,0.0,3,8,1990,0,2003,0,98075,47.5895,-122.01899999999999,2280,4506,11,13,2014,UNK,-290,643
8731901810,3/9/2015,260000.0,4,1.75,1960,8400,1.0,0.0,0.0,4,8,1960,0,1967,0,98023,47.3111,-122.37899999999999,2080,8400,3,9,2015,UNK,-120,0
7977201707,5/23/2014,526000.0,3,1.75,1680,3420,1.0,0.0,0.0,3,7,960,720,1992,0,98115,47.6854,-122.291,1680,4080,5,23,2014,UNK,0,-660
3260350090,11/12/2014,701000.0,4,3.0,2910,8540,2.0,0.0,0.0,3,9,2910,0,2003,0,98059,47.5223,-122.156,3040,6091,11,12,2014,UNK,-130,2449
7399300850,10/3/2014,290000.0,3,2.25,1500,7482,1.0,0.0,0.0,4,7,1210,290,1968,0,98055,47.4619,-122.18700000000001,1480,7308,10,3,2014,UNK,20,174
461002551,10/4/2014,330600.0,1,1.0,580,1799,1.0,0.0,0.0,3,7,580,0,1908,2005,98117,47.6829,-122.375,1260,4000,10,4,2014,Y,-680,-2201
9158100090,4/27/2015,550500.0,3,1.75,2540,8280,1.0,0.0,0.0,3,7,1270,1270,1949,0,98177,47.7219,-122.35799999999999,1950,8280,4,27,2015,UNK,590,0
9358002305,3/13/2015,430000.0,2,1.0,950,6426,1.0,0.0,0.0,3,7,950,0,1949,0,98126,47.5653,-122.37,1360,2550,3,13,2015,UNK,-410,3876
6447300265,10/14/2014,4000000.0,4,5.5,7080,16573,2.0,0.0,0.0,3,12,5760,1320,2008,0,98039,47.6151,-122.22399999999999,3140,15996,10,14,2014,N,3940,577
2235000015,8/4/2014,260600.0,2,1.0,810,4560,1.0,0.0,0.0,3,7,810,0,1928,0,98126,47.5425,-122.376,1490,4560,8,4,2014,UNK,-680,0
9523104345,12/18/2014,825000.0,5,3.0,4080,7500,2.0,0.0,2.0,4,8,2720,1360,1961,0,98103,47.6722,-122.34899999999999,2000,4545,12,18,2014,UNK,2080,2955
6139100056,10/23/2014,378950.0,4,2.0,1820,8400,1.0,0.0,0.0,5,7,1300,520,1956,0,98155,47.7615,-122.329,1700,9450,10,23,2014,UNK,120,-1050
808300090,1/16/2015,435000.0,4,2.5,2650,9065,2.0,0.0,0.0,3,7,2650,0,2000,0,98019,47.7258,-121.959,2590,13218,1,16,2015,UNK,60,-4153
8077100031,4/22/2015,631000.0,3,2.25,1670,1396,2.0,0.0,0.0,3,9,1250,420,2015,0,98115,47.6814,-122.288,1610,5191,4,22,2015,N,60,-3795
1402650110,5/18/2014,415000.0,3,2.5,2480,8342,2.0,0.0,0.0,3,8,2480,0,1986,0,98058,47.4381,-122.134,2300,8303,5,18,2014,UNK,180,39
7985000100,10/21/2014,222000.0,3,1.75,1240,7560,1.0,0.0,0.0,3,8,1070,170,1967,0,98003,47.333,-122.3,1650,7560,10,21,2014,UNK,-410,0
1796350690,8/20/2014,245000.0,3,2.0,1390,8250,1.0,0.0,0.0,3,7,1390,0,1987,0,98042,47.3707,-122.094,1390,7875,8,20,2014,UNK,0,375
7504110110,3/25/2015,720000.0,3,2.5,2880,10126,2.0,0.0,0.0,4,10,2880,0,1985,0,98074,47.6319,-122.037,2960,10514,3,25,2015,UNK,-80,-388
4324500490,12/23/2014,215000.0,3,1.0,1060,9954,1.0,0.0,0.0,4,7,1060,0,1960,0,98032,47.3801,-122.289,1620,8760,12,23,2014,UNK,-560,1194
1257202120,10/30/2014,579100.0,2,1.0,1070,2754,1.0,0.0,0.0,3,7,830,240,1924,0,98103,47.6755,-122.331,1760,4080,10,30,2014,UNK,-690,-1326
3987700115,7/28/2014,522500.0,4,1.75,1640,9299,1.5,0.0,0.0,4,7,870,770,1943,0,98056,47.5334,-122.16799999999999,2460,14326,7,28,2014,UNK,-820,-5027
9137101353,9/19/2014,489000.0,3,2.0,1510,3000,1.0,0.0,0.0,4,7,910,600,1972,0,98115,47.6804,-122.319,1620,4000,9,19,2014,UNK,-110,-1000
3298701066,5/6/2015,240000.0,3,1.0,1230,2353,1.5,0.0,0.0,4,6,1230,0,1925,0,98106,47.5177,-122.354,1280,1572,5,6,2015,UNK,-50,781
8682290100,4/21/2015,420250.0,3,2.0,1510,3657,1.0,0.0,0.0,3,8,1510,0,2007,0,98053,47.7225,-122.029,1510,3657,4,21,2015,N,0,0
4055700778,11/14/2014,523000.0,4,2.5,3180,20870,2.0,0.0,0.0,3,8,2120,1060,1967,0,98034,47.7176,-122.241,2700,14190,11,14,2014,UNK,480,6680
438000025,5/13/2014,628000.0,4,2.0,2260,6000,1.0,0.0,0.0,3,8,1430,830,1958,0,98115,47.6876,-122.29799999999999,2030,5874,5,13,2014,UNK,230,126
2474400300,5/6/2015,320000.0,4,2.5,1920,7277,2.0,0.0,0.0,4,8,1920,0,1990,0,98031,47.4058,-122.19200000000001,2300,7645,5,6,2015,UNK,-380,-368
87000283,11/18/2014,359950.0,3,2.5,1980,7800,2.0,0.0,0.0,3,8,1980,0,1999,0,98055,47.4492,-122.199,1700,20580,11,18,2014,UNK,280,-12780
2946001645,5/5/2014,232000.0,2,1.0,1200,8063,1.0,0.0,0.0,4,6,1200,0,1958,0,98198,47.4204,-122.324,1200,7500,5,5,2014,UNK,0,563
9294300495,11/14/2014,810000.0,4,2.25,2020,5600,1.0,0.0,2.0,4,8,1210,810,1961,0,98115,47.6821,-122.26700000000001,2660,6050,11,14,2014,UNK,-640,-450
492000475,12/11/2014,245000.0,4,1.5,2010,7561,1.5,0.0,0.0,4,7,1890,120,1921,0,98002,47.31100000000001,-122.227,1420,6564,12,11,2014,UNK,590,997
3876540600,5/7/2015,273000.0,3,2.25,1930,8192,1.0,0.0,0.0,3,7,1470,460,1984,0,98003,47.2624,-122.29899999999999,1510,8192,5,7,2015,UNK,420,0
4122500100,2/11/2015,1190000.0,5,2.5,2710,14989,1.0,0.0,0.0,3,8,1720,990,1959,0,98004,47.6411,-122.20700000000001,3180,16624,2,11,2015,UNK,-470,-1635
2461900945,4/21/2015,438000.0,5,1.0,1950,6250,1.5,0.0,0.0,4,7,1450,0,1917,0,98136,47.5511,-122.38600000000001,1950,6250,4,21,2015,UNK,0,0
7221400495,7/17/2014,400000.0,3,1.75,2110,19600,1.0,0.0,0.0,4,8,2110,0,1959,0,98055,47.4742,-122.198,880,10077,7,17,2014,UNK,1230,9523
2349300090,5/16/2014,340000.0,3,1.0,1250,4800,1.0,0.0,0.0,4,7,1250,0,1951,0,98126,47.5517,-122.381,1404,4800,5,16,2014,UNK,-154,0
9523100459,6/9/2014,552000.0,2,2.5,1380,951,3.0,0.0,0.0,3,9,1380,0,2006,0,98103,47.6654,-122.355,1430,3400,6,9,2014,N,-50,-2449
3856904580,11/25/2014,790000.0,3,1.75,2050,4080,2.0,0.0,0.0,3,8,2050,0,1991,0,98105,47.6698,-122.325,1890,4080,11,25,2014,UNK,160,0
7345600755,7/7/2014,360000.0,3,1.5,1800,22000,2.0,0.0,0.0,3,8,1800,0,1931,0,98168,47.4889,-122.286,1440,16640,7,7,2014,UNK,360,5360
798000457,3/2/2015,235000.0,3,1.0,1310,15022,1.0,0.0,0.0,3,7,1310,0,1934,1984,98168,47.5008,-122.33200000000001,1530,13154,3,2,2015,Y,-220,1868
7986400945,10/10/2014,775000.0,2,1.0,1010,3600,1.0,0.0,0.0,3,7,1010,0,1913,0,98107,47.6641,-122.35700000000001,1540,3600,10,10,2014,UNK,-530,0
395300100,5/14/2014,489200.0,3,2.75,1850,9600,1.5,0.0,0.0,5,7,1850,0,1965,0,98034,47.7259,-122.226,1250,10500,5,14,2014,UNK,600,-900
2473510090,7/29/2014,341000.0,3,2.25,1750,8900,2.0,0.0,0.0,4,8,1750,0,1977,0,98058,47.4451,-122.13600000000001,1680,7910,7,29,2014,UNK,70,990
1329300300,10/1/2014,335000.0,4,2.5,2154,6050,2.0,0.0,0.0,3,8,2154,0,2012,0,98030,47.3513,-122.17399999999999,2305,5769,10,1,2014,N,-151,281
952007069,1/21/2015,393500.0,3,1.75,1230,1441,2.0,0.0,0.0,3,8,1010,220,2004,0,98116,47.5626,-122.382,1170,1942,1,21,2015,N,60,-501
8073000265,9/18/2014,360000.0,3,2.0,1960,8846,1.0,0.0,3.0,4,6,980,980,1940,0,98178,47.5101,-122.24600000000001,2190,6363,9,18,2014,UNK,-230,2483
952004745,3/4/2015,400800.0,4,1.0,1070,5750,1.0,0.0,0.0,3,6,870,200,1923,0,98126,47.56399999999999,-122.37899999999999,1270,5750,3,4,2015,UNK,-200,0
1376800115,11/3/2014,585000.0,3,1.0,1450,5378,1.0,0.0,0.0,3,7,1190,260,1939,0,98199,47.6436,-122.405,1810,5559,11,3,2014,UNK,-360,-181
6613000750,10/1/2014,1600000.0,4,2.75,3680,5000,2.0,0.0,3.0,3,9,2480,1200,1936,0,98105,47.6599,-122.26899999999999,3200,5000,10,1,2014,UNK,480,0
2303900090,7/29/2014,2880000.0,4,2.5,5760,32033,2.0,0.0,4.0,4,12,4390,1370,1994,0,98177,47.7288,-122.37,3420,28475,7,29,2014,UNK,2340,3558
6713700025,5/15/2014,300000.0,3,1.0,1220,13000,1.0,0.0,0.0,4,7,1220,0,1955,0,98133,47.7608,-122.353,1510,12600,5,15,2014,UNK,-290,400
4083304535,11/14/2014,1050000.0,4,2.75,2950,4560,2.0,0.0,0.0,5,7,1810,1140,1912,0,98103,47.6525,-122.333,2000,4560,11,14,2014,UNK,950,0
3626039403,9/22/2014,360000.0,3,1.5,1340,1110,2.0,0.0,0.0,3,7,1040,300,1999,0,98117,47.698,-122.366,1220,1110,9,22,2014,UNK,120,0
254000100,6/20/2014,665900.0,4,2.25,2870,5453,2.0,0.0,1.0,4,8,2220,650,1926,0,98146,47.5129,-122.38799999999999,1660,4800,6,20,2014,UNK,1210,653
2724049076,8/22/2014,470000.0,4,1.0,2590,18224,1.5,0.0,0.0,4,7,2000,590,1911,0,98118,47.5318,-122.286,1800,7080,8,22,2014,UNK,790,11144
8562500690,5/13/2014,581000.0,4,1.75,2090,8164,1.0,0.0,0.0,4,8,1070,1020,1963,0,98052,47.6715,-122.155,1310,7975,5,13,2014,UNK,780,189
3834500195,7/7/2014,527000.0,6,3.5,3000,8401,1.0,0.0,0.0,3,8,1500,1500,1979,0,98125,47.7226,-122.29899999999999,1400,8403,7,7,2014,UNK,1600,-2
2207100405,5/6/2015,423000.0,4,1.75,1730,7245,1.0,0.0,0.0,4,7,880,0,1955,0,98007,47.5995,-122.14399999999999,1550,7245,5,6,2015,UNK,180,0
9482700475,9/27/2014,875000.0,4,3.5,2850,4416,1.5,0.0,0.0,3,7,2040,810,1926,0,98103,47.6835,-122.34200000000001,1860,4416,9,27,2014,UNK,990,0
7905200386,7/29/2014,410000.0,3,1.0,1020,6903,1.0,0.0,0.0,3,7,1020,0,1951,0,98116,47.57100000000001,-122.39200000000001,1440,6678,7,29,2014,UNK,-420,225
8680500090,3/16/2015,606000.0,3,2.5,2200,6005,2.0,0.0,0.0,3,9,2200,0,1997,0,98072,47.7408,-122.169,2320,6098,3,16,2015,UNK,-120,-93
3424089119,5/1/2015,654000.0,3,2.5,3240,60840,2.0,0.0,0.0,3,7,3240,0,1997,0,98045,47.5192,-121.764,2570,204732,5,1,2015,UNK,670,-143892
1437500015,7/9/2014,150000.0,3,0.75,490,38500,1.5,0.0,0.0,4,5,490,0,1959,0,98014,47.7112,-121.315,800,18297,7,9,2014,UNK,-310,20203
3298700110,11/9/2014,373000.0,3,2.5,2990,6771,1.0,0.0,0.0,3,7,1550,1440,2003,0,98106,47.5237,-122.353,1800,6771,11,9,2014,UNK,1190,0
6300000337,5/29/2014,550000.0,5,2.0,2450,9488,1.0,0.0,0.0,4,7,1240,1210,1900,1955,98133,47.7056,-122.34,1310,5693,5,29,2014,Y,1140,3795
8561200110,5/21/2014,512500.0,3,2.5,1900,7604,2.0,0.0,0.0,3,8,1900,0,1990,0,98033,47.7002,-122.18799999999999,1980,9583,5,21,2014,UNK,-80,-1979
2781250110,4/28/2015,360000.0,4,2.5,2640,7388,2.0,0.0,0.0,3,7,2640,0,2003,0,98038,47.3505,-122.027,2640,6383,4,28,2015,UNK,0,1005
4442800008,9/26/2014,369000.0,3,2.0,1340,1480,3.0,0.0,0.0,3,8,1340,0,1997,0,98117,47.6904,-122.39299999999999,1340,1321,9,26,2014,UNK,0,159
2619920110,12/30/2014,825000.0,4,2.5,3220,5262,2.0,0.0,0.0,3,9,3220,0,2003,0,98033,47.6878,-122.162,3220,4921,12,30,2014,UNK,0,341
7334501130,12/1/2014,255000.0,3,2.0,930,11475,1.0,0.0,0.0,3,7,930,0,1978,0,98045,47.4644,-121.745,1280,11250,12,1,2014,UNK,-350,225
9471200115,5/28/2014,1290000.0,4,2.5,3240,10800,1.0,0.0,0.0,3,10,2260,980,1946,0,98105,47.6709,-122.262,3490,10800,5,28,2014,UNK,-250,0
2597500090,8/8/2014,270000.0,5,2.5,2630,8470,1.5,0.0,0.0,4,8,2630,0,1968,0,98002,47.2863,-122.196,1780,8575,8,8,2014,UNK,850,-105
8665050490,9/24/2014,480680.0,3,2.5,1730,4924,2.0,0.0,0.0,3,8,1730,0,1996,0,98029,47.5672,-122.005,1610,4313,9,24,2014,UNK,120,611
1736800740,3/3/2015,525000.0,4,1.75,2120,7725,1.0,0.0,0.0,3,8,1220,900,1965,0,98007,47.6003,-122.14399999999999,2160,7725,3,3,2015,UNK,-40,0
6163901751,6/23/2014,291500.0,3,1.0,880,9238,1.5,0.0,0.0,5,6,880,0,1946,0,98155,47.7494,-122.319,1170,9238,6,23,2014,UNK,-290,0
2323059184,12/30/2014,305000.0,4,2.0,1800,13551,1.0,0.0,0.0,4,7,1800,0,1974,0,98059,47.4721,-122.12799999999999,1730,13551,12,30,2014,UNK,70,0
7349650490,5/7/2015,285000.0,3,1.75,1600,7500,1.0,0.0,0.0,3,7,1600,0,1998,0,98002,47.2831,-122.199,1620,7461,5,7,2015,UNK,-20,39
1025039086,9/16/2014,1880000.0,3,2.5,3280,29111,2.0,1.0,3.0,3,11,3280,0,1925,0,98199,47.6699,-122.416,3530,21074,9,16,2014,UNK,-250,8037
274100090,1/8/2015,329500.0,5,1.75,3290,8000,1.0,0.0,0.0,3,7,1790,1500,1968,0,98030,47.3733,-122.214,2380,7000,1,8,2015,UNK,910,1000
3342104046,7/8/2014,1570000.0,4,2.25,2890,18226,3.0,1.0,4.0,3,10,2890,0,1984,0,98056,47.5169,-122.209,2870,11151,7,8,2014,UNK,20,7075
7893801862,8/11/2014,379260.0,3,2.5,1730,7202,1.0,0.0,0.0,3,7,1330,400,1991,0,98198,47.4099,-122.329,2100,8125,8,11,2014,UNK,-370,-923
7852060490,7/9/2014,356000.0,3,2.5,1590,3411,2.0,0.0,0.0,3,7,1590,0,2000,0,98065,47.5303,-121.87799999999999,1590,3411,7,9,2014,UNK,0,0
7923300115,12/1/2014,571900.0,4,1.75,1710,8947,1.0,0.0,0.0,4,7,1710,0,1956,0,98007,47.5947,-122.135,1360,10133,12,1,2014,UNK,350,-1186
2868300115,8/21/2014,271500.0,3,1.75,1995,18360,2.0,0.0,0.0,3,7,1995,0,1957,0,98198,47.4129,-122.322,1980,13640,8,21,2014,UNK,15,4720
9477001270,3/16/2015,390000.0,3,1.75,1300,10030,1.0,0.0,0.0,4,7,1300,0,1967,0,98034,47.7359,-122.19200000000001,1520,7713,3,16,2015,UNK,-220,2317
522069119,5/12/2015,550000.0,3,2.5,2720,62310,1.0,0.0,0.0,3,8,2040,680,1985,0,98038,47.4168,-122.074,2770,204296,5,12,2015,UNK,-50,-141986
2025049175,1/5/2015,755000.0,2,2.5,1360,2070,2.0,0.0,0.0,3,8,1360,0,1999,0,98102,47.6423,-122.329,1920,2092,1,5,2015,UNK,-560,-22
2771604226,11/18/2014,509500.0,2,2.5,1590,1485,2.0,0.0,0.0,3,8,1300,290,1994,0,98199,47.6375,-122.387,1880,3675,11,18,2014,UNK,-290,-2190
2917200615,3/25/2015,486700.0,2,1.0,1200,6278,1.0,0.0,0.0,3,7,1080,120,1942,0,98103,47.7001,-122.351,1200,6211,3,25,2015,UNK,0,67
9551201295,7/28/2014,527500.0,2,1.0,1170,3000,1.5,0.0,0.0,3,7,1170,0,1910,0,98103,47.6697,-122.338,1530,4000,7,28,2014,UNK,-360,-1000
7443000985,8/15/2014,475000.0,5,2.5,2010,3600,1.5,0.0,0.0,3,6,1510,500,1912,0,98119,47.6522,-122.366,1780,3600,8,15,2014,UNK,230,0
3395041194,8/27/2014,268000.0,3,2.75,1880,1793,2.0,0.0,0.0,3,7,1810,70,2001,0,98108,47.5405,-122.29299999999999,1800,2537,8,27,2014,UNK,80,-744
1024069162,4/16/2015,562000.0,3,2.0,3250,50529,2.0,0.0,0.0,4,8,3250,0,1978,0,98075,47.5849,-122.016,2370,47480,4,16,2015,UNK,880,3049
5452800735,7/22/2014,780000.0,4,2.5,2270,13449,1.0,0.0,0.0,4,9,1310,960,1975,0,98040,47.5416,-122.23200000000001,2810,13475,7,22,2014,UNK,-540,-26
2902200015,1/6/2015,700000.0,9,3.0,3680,4400,2.0,0.0,0.0,3,7,2830,850,1908,0,98102,47.6374,-122.324,1960,2450,1,6,2015,UNK,1720,1950
1698900195,9/2/2014,710000.0,3,2.0,1880,3000,1.0,0.0,0.0,4,8,1040,840,1931,0,98109,47.6418,-122.351,1790,3000,9,2,2014,UNK,90,0
442000015,6/12/2014,445000.0,3,1.0,1050,5664,1.0,0.0,0.0,4,7,910,140,1947,0,98115,47.6897,-122.285,1500,5664,6,12,2014,UNK,-450,0
222069058,9/15/2014,729000.0,3,3.25,2250,60548,1.0,0.0,0.0,3,9,2250,0,2005,0,98038,47.4246,-122.014,2760,84070,9,15,2014,N,-510,-23522
2926049449,6/18/2014,384400.0,3,3.25,1689,1388,3.0,0.0,0.0,3,8,1689,0,2008,0,98125,47.7174,-122.31700000000001,1459,1384,6,18,2014,N,230,4
6071800100,3/27/2015,815000.0,6,3.0,2860,17853,1.0,0.0,0.0,3,8,1430,1430,1962,2015,98006,47.54600000000001,-122.175,1920,13452,3,27,2015,Y,940,4401
4003000110,10/29/2014,865000.0,4,2.5,2710,4069,3.0,0.0,0.0,4,10,2710,0,1990,0,98122,47.604,-122.288,1810,3586,10,29,2014,UNK,900,483
925059198,8/28/2014,514000.0,3,2.0,1770,7200,1.0,0.0,0.0,4,7,1770,0,1967,0,98033,47.6642,-122.17299999999999,2250,11250,8,28,2014,UNK,-480,-4050
6072700110,5/20/2014,615000.0,4,2.75,2820,13193,1.0,0.0,0.0,3,8,1860,960,1965,0,98006,47.5579,-122.17399999999999,2580,13193,5,20,2014,UNK,240,0
1926069143,10/16/2014,865000.0,4,3.25,3400,99170,1.0,0.0,0.0,4,8,2000,1400,1980,0,98072,47.7293,-122.09899999999999,3460,47920,10,16,2014,UNK,-60,51250
2871000300,10/13/2014,755000.0,4,2.5,3110,6930,2.0,0.0,0.0,3,9,3110,0,2004,0,98052,47.7011,-122.11200000000001,3090,7000,10,13,2014,N,20,-70
6163900301,4/27/2015,425000.0,4,1.0,1480,8321,1.0,0.0,0.0,3,7,1080,400,1953,0,98155,47.7629,-122.318,1580,8502,4,27,2015,UNK,-100,-181
4318200090,6/18/2014,375000.0,2,1.0,940,9839,1.0,0.0,0.0,3,6,940,0,1910,0,98136,47.5379,-122.38600000000001,1330,8740,6,18,2014,UNK,-390,1099
9526600090,4/24/2015,750000.0,4,2.5,2680,4548,2.0,0.0,0.0,3,8,2680,0,2009,0,98052,47.7073,-122.11399999999999,2750,4548,4,24,2015,N,-70,0
629420100,9/26/2014,722000.0,4,2.75,3190,5408,2.0,0.0,0.0,3,9,3190,0,2005,0,98075,47.5903,-121.988,3160,5773,9,26,2014,N,30,-365
6905200215,3/31/2015,1010000.0,3,2.5,1920,4480,2.0,0.0,1.0,3,9,1920,0,1949,1997,98119,47.6472,-122.37299999999999,1790,4500,3,31,2015,Y,130,-20
7202430110,6/25/2014,725000.0,3,2.5,2610,7510,2.0,0.0,0.0,3,9,2610,0,1996,0,98052,47.6648,-122.137,2610,8458,6,25,2014,UNK,0,-948
87000245,9/30/2014,170000.0,3,0.75,1040,42180,1.0,0.0,0.0,2,6,1040,0,1947,0,98055,47.4518,-122.199,1270,24090,9,30,2014,UNK,-230,18090
6667400090,5/1/2015,845000.0,4,3.25,2880,35315,1.0,0.0,0.0,3,11,2270,610,1982,0,98005,47.6587,-122.163,1910,167378,5,1,2015,UNK,970,-132063
6802200100,1/15/2015,271900.0,3,2.0,1450,8771,2.0,0.0,0.0,4,7,1450,0,1991,0,98022,47.1947,-121.98899999999999,1450,8653,1,15,2015,UNK,0,118
913000315,6/5/2014,1300000.0,6,4.5,3902,3880,3.0,0.0,4.0,4,9,2782,1120,1977,0,98116,47.5837,-122.399,1100,3870,6,5,2014,UNK,2802,10
8732030490,12/22/2014,261500.0,4,2.5,2460,7800,1.0,0.0,0.0,3,8,1500,960,1977,0,98023,47.3081,-122.384,2210,7800,12,22,2014,UNK,250,0
3629920600,5/16/2014,619500.0,3,2.5,2170,5000,2.0,0.0,0.0,3,9,2170,0,2003,0,98029,47.5458,-121.99600000000001,2170,5000,5,16,2014,UNK,0,0
1524079156,6/10/2014,435000.0,5,2.25,1970,15247,1.0,0.0,0.0,3,7,1450,520,1986,0,98024,47.5669,-121.905,1300,10800,6,10,2014,UNK,670,4447
6450301690,10/3/2014,210000.0,3,1.0,1000,5454,1.0,0.0,0.0,3,7,1000,0,1954,0,98133,47.7339,-122.337,1320,5250,10,3,2014,UNK,-320,204
5309101050,11/26/2014,489950.0,3,2.0,1580,4010,1.0,0.0,0.0,4,7,790,790,1909,0,98117,47.6769,-122.37100000000001,1350,5350,11,26,2014,UNK,230,-1340
8857600820,5/8/2014,260000.0,4,1.5,2130,8800,1.0,0.0,0.0,3,7,1100,1030,1962,0,98032,47.383,-122.288,1480,8120,5,8,2014,UNK,650,680
3500100025,6/28/2014,300000.0,4,1.0,1370,8499,1.0,0.0,0.0,3,7,1370,0,1949,0,98155,47.736000000000004,-122.301,1370,8187,6,28,2014,UNK,0,312
5152100110,4/22/2015,530000.0,4,2.0,2150,14161,1.0,0.0,2.0,3,8,1330,820,1966,0,98003,47.3376,-122.323,2310,14034,4,22,2015,UNK,-160,127
3298600850,12/16/2014,235000.0,3,1.75,1370,14030,1.0,0.0,0.0,4,8,1370,0,1977,0,98092,47.2969,-122.163,2100,15260,12,16,2014,UNK,-730,-1230
3856902250,1/5/2015,593500.0,3,1.0,1370,4000,2.0,0.0,0.0,4,8,1370,0,1918,0,98105,47.6711,-122.324,1370,4000,1,5,2015,UNK,0,0
8887001140,7/23/2014,562000.0,3,3.0,3290,80471,2.0,0.0,2.0,4,8,2330,960,1975,0,98070,47.504,-122.464,1830,30494,7,23,2014,UNK,1460,49977
2621069066,4/27/2015,585000.0,3,2.0,3190,207346,2.0,0.0,0.0,3,9,3190,0,1994,0,98022,47.2737,-122.015,2930,206474,4,27,2015,UNK,260,872
251620090,5/30/2014,2400000.0,4,3.25,4140,20734,1.0,0.0,1.0,3,10,3300,840,1977,2005,98004,47.6344,-122.215,4020,20008,5,30,2014,Y,120,726
3546000090,2/24/2015,199500.0,3,1.75,1690,8901,1.0,0.0,0.0,3,7,1690,0,1986,0,98030,47.3546,-122.176,1690,7532,2,24,2015,UNK,0,1369
3359500755,9/2/2014,544500.0,5,1.0,1690,3240,1.5,0.0,0.0,3,7,1690,0,1914,0,98115,47.6746,-122.325,1230,4500,9,2,2014,UNK,460,-1260
3579800485,2/18/2015,394900.0,3,1.0,1430,13370,1.0,0.0,0.0,3,7,1430,0,1962,0,98034,47.7317,-122.241,1670,10075,2,18,2015,UNK,-240,3295
2919201335,7/31/2014,912000.0,4,3.75,1980,4095,2.0,0.0,0.0,3,9,1980,0,2009,0,98103,47.6901,-122.35600000000001,1480,3840,7,31,2014,N,500,255
1796370930,7/10/2014,260000.0,3,2.5,1490,8102,2.0,0.0,0.0,4,7,1490,0,1990,0,98042,47.3712,-122.09200000000001,1640,7943,7,10,2014,UNK,-150,159
3864000090,2/19/2015,858000.0,5,3.0,3620,12778,1.0,0.0,2.0,5,8,1900,1720,1964,0,98006,47.5512,-122.191,2930,10669,2,19,2015,UNK,690,2109
8651100110,12/9/2014,1280000.0,4,2.5,2720,16454,1.0,0.0,1.0,5,9,1870,850,1963,0,98040,47.5489,-122.21600000000001,3560,15993,12,9,2014,UNK,-840,461
8731730590,5/13/2015,242150.0,4,1.75,1490,8544,1.0,0.0,0.0,4,7,1490,0,1970,0,98031,47.3894,-122.166,1180,8372,5,13,2015,UNK,310,172
1761100300,10/30/2014,220000.0,3,1.75,1230,7200,1.0,0.0,0.0,3,7,1230,0,1986,0,98023,47.2881,-122.363,1540,7210,10,30,2014,UNK,-310,-10
9542800820,4/30/2015,235000.0,3,2.0,1900,7980,1.0,0.0,0.0,4,7,1340,560,1977,0,98023,47.305,-122.37299999999999,1690,7840,4,30,2015,UNK,210,140
2644900110,10/21/2014,370000.0,3,1.75,1530,10300,1.0,0.0,0.0,4,7,1530,0,1978,0,98133,47.7767,-122.35600000000001,1940,9883,10,21,2014,UNK,-410,417
1626069198,10/3/2014,450000.0,3,1.75,2290,44866,1.0,0.0,0.0,3,8,1390,900,1981,0,98077,47.7398,-122.041,2410,44866,10,3,2014,UNK,-120,0
5101408593,7/11/2014,534950.0,5,1.5,2240,6337,1.0,0.0,0.0,3,8,1280,960,1956,0,98125,47.7046,-122.316,1870,6380,7,11,2014,UNK,370,-43
7853270100,3/15/2015,730000.0,4,2.5,3470,14271,2.0,0.0,0.0,3,9,3470,0,2005,0,98065,47.5423,-121.87700000000001,3450,9380,3,15,2015,N,20,4891
3308030100,9/25/2014,465000.0,4,2.5,3050,32450,1.0,0.0,0.0,4,8,1550,1500,1983,0,98030,47.3626,-122.209,2350,15390,9,25,2014,UNK,700,17060
1330280100,8/1/2014,178000.0,3,1.0,1100,5734,1.0,0.0,0.0,4,7,1100,0,1955,0,98030,47.3632,-122.17399999999999,1770,6050,8,1,2014,UNK,-670,-316
2212200090,2/9/2015,215000.0,3,1.0,1610,7140,1.0,0.0,0.0,3,7,1080,530,1976,0,98031,47.3943,-122.189,1800,7600,2,9,2015,UNK,-190,-460
9264921140,3/12/2015,300000.0,3,2.75,1910,15508,1.0,0.0,0.0,3,8,1210,700,1984,0,98023,47.3128,-122.345,2450,7989,3,12,2015,UNK,-540,7519
8902000068,5/15/2014,430000.0,3,2.0,1510,7066,1.0,0.0,2.0,3,7,1230,280,1973,0,98125,47.7053,-122.303,1950,8089,5,15,2014,UNK,-440,-1023
7338000850,7/31/2014,183000.0,3,1.5,1280,4366,2.0,0.0,0.0,4,6,1280,0,1985,0,98002,47.335,-122.215,1280,4366,7,31,2014,UNK,0,0
2770600853,6/12/2014,585000.0,3,2.5,1910,1501,2.5,0.0,0.0,3,8,1530,380,2007,0,98199,47.6441,-122.385,1760,1750,6,12,2014,N,150,-249
4239400740,7/16/2014,192950.0,3,1.0,1170,3330,2.0,0.0,0.0,4,6,1170,0,1969,0,98092,47.3155,-122.182,1090,3330,7,16,2014,UNK,80,0
6184700100,9/26/2014,599000.0,2,1.0,1550,7713,1.0,0.0,0.0,3,7,1550,0,1930,1979,98117,47.7005,-122.35799999999999,1340,6350,9,26,2014,Y,210,1363
3157600615,7/8/2014,326500.0,3,1.0,1060,7920,1.0,0.0,0.0,4,7,1060,0,1968,0,98106,47.5649,-122.35799999999999,1060,7457,7,8,2014,UNK,0,463
6145601810,7/18/2014,358803.0,2,1.0,1040,5765,1.0,0.0,0.0,3,7,1040,0,1944,0,98133,47.7024,-122.346,1040,3844,7,18,2014,UNK,0,1921
1235700042,5/28/2014,537000.0,3,2.5,1550,12920,2.0,0.0,0.0,5,7,1550,0,1999,0,98033,47.6973,-122.194,2610,10800,5,28,2014,UNK,-1060,2120
7781600025,10/23/2014,1160000.0,3,2.5,2490,24691,1.0,1.0,4.0,4,9,1580,910,1961,0,98146,47.488,-122.36399999999999,2800,24121,10,23,2014,UNK,-310,570
7116500705,1/29/2015,156000.0,2,1.0,920,5889,1.0,0.0,0.0,4,6,920,0,1950,0,98002,47.3012,-122.21799999999999,1210,6180,1,29,2015,UNK,-290,-291
2320069206,3/25/2015,219000.0,3,1.0,1250,8276,1.5,0.0,0.0,5,6,1250,0,1939,0,98022,47.2092,-121.99700000000001,1250,8792,3,25,2015,UNK,0,-516
1794501390,5/1/2015,1190000.0,3,1.5,2540,2700,2.0,0.0,0.0,4,8,1630,910,1922,0,98119,47.637,-122.361,2520,5400,5,1,2015,UNK,20,-2700
2122059160,4/27/2015,248000.0,5,1.75,2190,16788,1.0,0.0,2.0,3,8,1380,810,1978,0,98030,47.3764,-122.176,1920,8366,4,27,2015,UNK,270,8422
2421069039,2/9/2015,340000.0,3,1.75,1340,196020,1.0,0.0,0.0,4,7,1340,0,1987,0,98010,47.2931,-121.992,2250,232230,2,9,2015,UNK,-910,-36210
5452800495,4/22/2015,899100.0,5,2.5,2410,15300,1.0,0.0,0.0,4,8,1400,1010,1975,0,98040,47.5416,-122.23100000000001,2440,15300,4,22,2015,UNK,-30,0
4024100961,7/28/2014,346950.0,3,1.75,1830,10954,1.0,0.0,0.0,3,7,1830,0,1963,0,98155,47.7554,-122.306,1850,8624,7,28,2014,UNK,-20,2330
7857001560,9/17/2014,330000.0,3,1.0,1850,5775,2.0,0.0,0.0,3,6,1740,110,1928,0,98108,47.5446,-122.296,1520,3578,9,17,2014,UNK,330,2197
9540100025,7/31/2014,325000.0,3,1.0,1410,8250,1.0,0.0,0.0,3,7,1410,0,1954,0,98177,47.7621,-122.36,1580,8250,7,31,2014,UNK,-170,0
2473410740,10/27/2014,315000.0,3,1.75,1460,7884,1.0,0.0,0.0,3,8,1460,0,1975,0,98058,47.4457,-122.12799999999999,2050,7210,10,27,2014,UNK,-590,674
2770604365,6/23/2014,649950.0,3,2.5,1500,1375,2.0,0.0,0.0,3,9,1200,300,2014,0,98119,47.6451,-122.375,1680,1627,6,23,2014,N,-180,-252
173000025,8/25/2014,316000.0,3,1.0,1130,7200,1.5,0.0,0.0,4,6,1130,0,1942,0,98133,47.7298,-122.355,1350,1358,8,25,2014,UNK,-220,5842
7853340490,6/17/2014,386000.0,2,2.5,1620,3196,2.0,0.0,0.0,3,8,1620,0,2008,0,98065,47.5167,-121.87799999999999,1750,2828,6,17,2014,N,-130,368
239000115,4/8/2015,535000.0,2,1.75,2330,7280,1.0,0.0,0.0,3,7,1450,880,1982,0,98188,47.4282,-122.28,1830,12178,4,8,2015,UNK,500,-4898
9528101032,3/25/2015,600000.0,3,3.0,1520,1800,3.0,0.0,0.0,3,7,1520,0,2003,0,98115,47.6822,-122.32600000000001,1520,1500,3,25,2015,UNK,0,300
5416100110,11/18/2014,339000.0,4,2.5,2840,8746,2.0,0.0,0.0,3,8,2840,0,2001,0,98022,47.19,-122.01299999999999,2630,9900,11,18,2014,UNK,210,-1154
4331000265,9/26/2014,167000.0,3,2.0,1520,7456,1.0,0.0,0.0,3,7,1520,0,1949,0,98166,47.4745,-122.34299999999999,1740,8464,9,26,2014,UNK,-220,-1008
5249803885,12/15/2014,430000.0,3,1.0,1740,4800,1.0,0.0,0.0,3,8,1740,0,1952,0,98118,47.5596,-122.27,1600,4800,12,15,2014,UNK,140,0
7853301390,8/21/2014,688000.0,4,4.0,4000,9309,2.0,0.0,0.0,3,9,4000,0,2007,0,98065,47.5421,-121.88799999999999,3920,8048,8,21,2014,N,80,1261
1376800025,9/8/2014,834500.0,3,2.25,2780,6000,1.0,0.0,3.0,4,9,1670,1110,1948,0,98199,47.6442,-122.406,2780,6000,9,8,2014,UNK,0,0
7639900025,6/28/2014,1080000.0,4,4.25,3500,8750,1.0,0.0,4.0,5,9,2140,1360,1951,0,98177,47.7222,-122.367,3110,8750,6,28,2014,UNK,390,0
2822059262,12/1/2014,250000.0,3,1.0,1060,52272,1.0,0.0,0.0,3,7,1060,0,1960,0,98030,47.36,-122.178,1900,5971,12,1,2014,UNK,-840,46301
8113100850,4/10/2015,402500.0,3,1.0,1290,4000,1.5,0.0,0.0,3,7,1290,0,1926,0,98118,47.5462,-122.277,1160,5040,4,10,2015,UNK,130,-1040
565300110,12/16/2014,432500.0,3,2.5,2390,6435,1.0,0.0,0.0,3,8,1600,790,1978,0,98034,47.726000000000006,-122.194,2020,7300,12,16,2014,UNK,370,-865
1887000100,8/14/2014,485000.0,5,1.75,2460,14100,1.0,0.0,0.0,3,7,1380,1080,1972,0,98028,47.7452,-122.22399999999999,2028,11078,8,14,2014,UNK,432,3022
8731990090,8/20/2014,560000.0,4,2.75,2930,22000,1.0,0.0,3.0,4,9,1580,0,1978,0,98023,47.3227,-122.384,2930,9758,8,20,2014,UNK,0,12242
3432500705,10/21/2014,410000.0,4,2.25,2200,8292,2.0,0.0,0.0,3,7,2200,0,1990,0,98155,47.7456,-122.315,1090,8290,10,21,2014,UNK,1110,2
1015500300,5/15/2014,455000.0,3,2.5,1870,7344,1.0,0.0,0.0,3,8,1470,400,1980,0,98034,47.7265,-122.206,1930,7344,5,15,2014,UNK,-60,0
3972300100,12/29/2014,459500.0,4,2.5,2060,8968,1.0,0.0,0.0,4,7,1190,870,1975,0,98155,47.7686,-122.31700000000001,1350,8972,12,29,2014,UNK,710,-4
3876300600,12/12/2014,371000.0,4,1.75,1610,11305,1.0,0.0,0.0,3,7,1610,0,1968,0,98034,47.727,-122.176,1870,11850,12,12,2014,UNK,-260,-545
2111010940,2/20/2015,289500.0,3,2.25,2120,3400,2.0,0.0,0.0,3,7,2120,0,2002,0,98092,47.3364,-122.17,2420,3400,2,20,2015,UNK,-300,0
2771102158,10/21/2014,395000.0,3,3.5,1450,1263,2.0,0.0,0.0,3,8,1160,290,2007,0,98199,47.6508,-122.383,1390,1282,10,21,2014,N,60,-19
1498304065,6/14/2014,496752.0,2,1.0,1980,5000,1.0,0.0,0.0,4,7,1090,890,1923,0,98144,47.58600000000001,-122.295,1720,5000,6,14,2014,UNK,260,0
6150200375,10/1/2014,227000.0,2,1.0,860,6800,1.0,0.0,0.0,3,6,860,0,1943,0,98133,47.7274,-122.337,1220,6800,10,1,2014,UNK,-360,0
3343901340,8/4/2014,330000.0,3,1.75,1460,9261,1.0,0.0,0.0,3,7,1460,0,1985,0,98056,47.5155,-122.189,1550,8800,8,4,2014,UNK,-90,461
4037800015,1/23/2015,480000.0,5,2.0,2590,8610,1.0,0.0,0.0,4,7,1340,1250,1958,0,98008,47.6112,-122.126,1750,8610,1,23,2015,UNK,840,0
1626079066,8/6/2014,290000.0,2,1.0,1120,217800,1.0,0.0,0.0,3,6,1120,0,1976,0,98019,47.7378,-121.912,1480,217800,8,6,2014,UNK,-360,0
6200017,11/12/2014,281000.0,3,1.0,1340,21336,1.5,0.0,0.0,4,5,1340,0,1945,0,98032,47.4023,-122.273,1340,37703,11,12,2014,UNK,0,-16367
5249805090,4/7/2015,705000.0,4,1.5,1780,3120,1.5,0.0,3.0,3,8,1780,0,1926,0,98118,47.5589,-122.264,1710,3600,4,7,2015,UNK,70,-480
4217401055,5/2/2014,1400000.0,4,2.5,2920,4000,1.5,0.0,0.0,5,8,1910,1010,1909,0,98105,47.6578,-122.28,2470,4000,5,2,2014,UNK,450,0
7738500475,12/12/2014,485000.0,4,3.25,2820,6611,1.0,0.0,0.0,3,7,1410,1410,1958,0,98155,47.7473,-122.285,2320,6611,12,12,2014,UNK,500,0
2767603250,3/9/2015,622000.0,3,2.25,1550,1919,3.0,0.0,0.0,3,8,1550,0,2003,0,98107,47.6729,-122.37899999999999,1550,2918,3,9,2015,UNK,0,-999
2620069113,9/2/2014,380000.0,3,2.25,1600,39848,1.0,0.0,3.0,4,8,1600,0,1958,0,98022,47.1991,-122.01299999999999,1600,39848,9,2,2014,UNK,0,0
3760500336,11/26/2014,2130000.0,4,2.75,3190,19513,2.0,0.0,4.0,4,10,3190,0,1982,0,98034,47.6991,-122.235,2750,13496,11,26,2014,UNK,440,6017
5101404563,6/27/2014,561500.0,3,1.75,1960,6380,1.0,0.0,0.0,4,7,980,980,1939,0,98115,47.6975,-122.316,1480,6380,6,27,2014,UNK,480,0
9407000600,9/16/2014,242000.0,3,1.0,970,9600,1.0,0.0,0.0,3,7,970,0,1972,0,98045,47.4451,-121.76799999999999,1110,9600,9,16,2014,UNK,-140,0
9353300600,6/24/2014,348500.0,3,1.5,1360,10726,1.0,0.0,0.0,4,7,1360,0,1966,0,98059,47.4948,-122.134,1650,10726,6,24,2014,UNK,-290,0
9353300600,3/26/2015,370000.0,3,1.5,1360,10726,1.0,0.0,0.0,4,7,1360,0,1966,0,98059,47.4948,-122.134,1650,10726,3,26,2015,UNK,-290,0
993000090,4/14/2015,752000.0,6,3.75,3810,6663,2.0,0.0,0.0,4,8,3810,0,1977,0,98103,47.6938,-122.34,1610,4561,4,14,2015,UNK,2200,2102
1796361140,10/31/2014,230000.0,3,1.75,1340,8250,1.0,0.0,0.0,3,7,1100,240,1985,0,98042,47.3668,-122.09,1540,7860,10,31,2014,UNK,-200,390
1112000031,3/18/2015,715000.0,3,2.25,1990,4977,3.0,0.0,0.0,3,9,1990,0,2012,0,98118,47.5404,-122.26799999999999,1280,5000,3,18,2015,N,710,-23
2822049160,4/17/2015,240415.0,3,1.75,1120,10187,1.0,0.0,0.0,3,7,1120,0,1968,0,98198,47.3694,-122.311,1900,8736,4,17,2015,UNK,-780,1451
3856904560,11/25/2014,562000.0,4,1.75,2060,4080,1.5,0.0,0.0,3,7,1460,600,1922,1996,98105,47.6698,-122.325,1620,4080,11,25,2014,Y,440,0
2492200956,8/5/2014,360000.0,3,1.5,1170,4080,1.0,0.0,0.0,5,6,1170,0,1917,0,98126,47.5338,-122.381,920,4242,8,5,2014,UNK,250,-162
2770604079,10/29/2014,659950.0,3,2.5,1610,1246,2.0,0.0,1.0,3,9,1080,530,2014,0,98119,47.6423,-122.375,1610,1249,10,29,2014,N,0,-3
2719100042,6/23/2014,458500.0,3,2.0,1890,1599,2.0,0.0,0.0,3,9,1430,460,2012,0,98136,47.5438,-122.385,1780,1562,6,23,2014,N,110,37
7899800864,3/5/2015,259950.0,2,2.0,1070,649,2.0,0.0,0.0,3,9,720,350,2008,0,98106,47.5213,-122.35700000000001,1070,928,3,5,2015,N,0,-279
9485750110,9/18/2014,366000.0,3,1.75,1680,6108,1.0,0.0,0.0,3,8,1680,0,1989,0,98055,47.4501,-122.208,2220,5664,9,18,2014,UNK,-540,444
2024059058,4/28/2015,978000.0,4,2.75,2890,7821,2.0,0.0,0.0,3,9,2890,0,2014,0,98006,47.553999999999995,-122.189,2890,10108,4,28,2015,N,0,-2287
7977201865,4/21/2015,525000.0,2,1.0,1360,6120,1.0,0.0,0.0,3,7,1060,300,1947,0,98115,47.6841,-122.291,1800,5100,4,21,2015,UNK,-440,1020
4232900940,5/22/2014,926300.0,3,1.5,1660,4800,2.0,0.0,0.0,3,8,1660,0,1907,0,98119,47.6352,-122.35799999999999,1690,4000,5,22,2014,UNK,-30,800
3364900375,4/23/2015,750000.0,2,1.0,1620,6120,1.0,0.0,0.0,3,7,1620,0,1951,0,98115,47.6731,-122.32600000000001,1650,4590,4,23,2015,UNK,-30,1530
4151800375,12/4/2014,660000.0,2,1.0,960,6263,1.0,0.0,1.0,4,6,960,0,1942,0,98033,47.6646,-122.20200000000001,1460,6054,12,4,2014,UNK,-500,209
2610100015,8/13/2014,305000.0,4,1.75,1000,7200,1.5,0.0,0.0,4,6,1000,0,1947,0,98155,47.742,-122.324,1280,7200,8,13,2014,UNK,-280,0
8682230590,4/26/2015,800000.0,2,2.5,2395,6143,1.0,0.0,0.0,3,8,2395,0,2003,0,98053,47.7114,-122.029,2170,6162,4,26,2015,UNK,225,-19
3876100940,4/27/2015,600000.0,4,1.75,3050,9440,1.0,0.0,0.0,3,8,1800,1250,1966,0,98034,47.7228,-122.18299999999999,2020,8660,4,27,2015,UNK,1030,780
1221079058,8/27/2014,435000.0,2,1.0,1120,88327,1.5,0.0,0.0,4,6,1120,0,1972,0,98010,47.3205,-121.867,1640,136662,8,27,2014,UNK,-520,-48335
2770605550,3/10/2015,1140000.0,4,3.25,2960,4296,2.0,0.0,0.0,3,9,2190,770,2007,0,98119,47.6526,-122.37200000000001,2150,6000,3,10,2015,N,810,-1704
4468400214,10/10/2014,318000.0,3,2.25,1250,1017,3.0,0.0,0.0,3,8,1250,0,2008,0,98133,47.7099,-122.333,1250,1017,10,10,2014,N,0,0
2767705010,10/6/2014,639000.0,4,2.0,1940,5000,1.0,0.0,0.0,4,7,980,960,1910,0,98107,47.6719,-122.369,1940,5000,10,6,2014,UNK,0,0
5422560930,3/16/2015,453000.0,3,2.5,1750,3900,2.0,0.0,0.0,3,8,1750,0,1977,0,98052,47.6638,-122.12899999999999,1750,5700,3,16,2015,UNK,0,-1800
824059211,11/17/2014,800000.0,4,1.75,2150,9148,1.0,0.0,0.0,4,7,2150,0,1955,0,98004,47.5828,-122.197,2370,9148,11,17,2014,UNK,-220,0
6825100015,6/4/2014,437000.0,2,1.75,1500,6800,1.0,0.0,0.0,4,7,910,590,1942,0,98117,47.7004,-122.37100000000001,1450,6800,6,4,2014,UNK,50,0
4166600115,11/21/2014,1150000.0,3,2.75,3230,75889,2.0,1.0,4.0,3,7,3230,0,1925,1993,98023,47.3344,-122.37,2560,72229,11,21,2014,Y,670,3660
3574801500,9/26/2014,490000.0,4,2.5,3000,8645,2.0,0.0,0.0,3,8,3000,0,1985,0,98034,47.7315,-122.22399999999999,1930,8866,9,26,2014,UNK,1070,-221
9477001140,7/10/2014,499950.0,4,1.75,1520,7700,1.0,0.0,0.0,4,7,1520,0,1967,0,98034,47.7356,-122.191,1520,7500,7,10,2014,UNK,0,200
3384300100,12/26/2014,160134.0,3,1.5,1190,10116,1.0,0.0,0.0,3,7,1190,0,1968,0,98042,47.385,-122.085,1190,9905,12,26,2014,UNK,0,211
6123600100,12/15/2014,191000.0,3,1.0,990,8255,1.0,0.0,0.0,3,7,990,0,1953,0,98148,47.425,-122.331,1180,9750,12,15,2014,UNK,-190,-1495
1311300100,1/15/2015,221000.0,3,1.0,1250,7280,1.0,0.0,0.0,3,7,1250,0,1965,0,98001,47.3414,-122.286,1450,7350,1,15,2015,UNK,-200,-70
3812400854,10/28/2014,352800.0,4,2.0,2080,6360,1.0,0.0,0.0,3,7,1330,750,1960,0,98118,47.5392,-122.27799999999999,2080,6741,10,28,2014,UNK,0,-381
1326069188,5/11/2015,350000.0,3,2.5,1640,10424,2.0,0.0,0.0,3,7,1640,0,1988,0,98019,47.7345,-121.977,1560,10101,5,11,2015,UNK,80,323
3131201865,6/17/2014,458000.0,4,1.5,1550,3000,1.5,0.0,0.0,3,7,1350,200,1918,0,98105,47.6604,-122.324,1710,5535,6,17,2014,UNK,-160,-2535
321059059,5/19/2014,359950.0,3,1.0,1290,189486,1.0,0.0,0.0,4,7,1290,0,1960,0,98092,47.3356,-122.15700000000001,2370,98881,5,19,2014,UNK,-1080,90605
223039330,4/7/2015,1050000.0,3,3.0,3250,5093,2.0,0.0,3.0,3,10,3250,0,2004,0,98146,47.5123,-122.39,2820,7752,4,7,2015,N,430,-2659
7857000900,7/24/2014,353000.0,3,1.75,1260,11775,1.0,0.0,0.0,5,6,1260,0,1942,0,98108,47.5501,-122.296,1270,5480,7,24,2014,UNK,-10,6295
8109800110,8/1/2014,717550.0,3,3.5,2840,4468,3.0,0.0,0.0,3,10,2840,0,2006,0,98052,47.7069,-122.117,3040,5400,8,1,2014,N,-200,-932
5422560900,8/7/2014,450000.0,3,2.25,1960,6500,2.0,0.0,0.0,4,8,1960,0,1977,0,98052,47.6642,-122.12899999999999,1860,6160,8,7,2014,UNK,100,340
3332000195,9/24/2014,167500.0,3,1.0,760,3090,1.0,0.0,0.0,2,5,760,0,1903,0,98118,47.5513,-122.275,1020,5356,9,24,2014,UNK,-260,-2266
2423029245,6/17/2014,550000.0,3,1.75,2240,78225,2.0,0.0,0.0,5,8,2240,0,1976,0,98070,47.4638,-122.484,2030,202554,6,17,2014,UNK,210,-124329
8651600110,4/21/2015,939000.0,4,2.25,2240,9684,2.0,0.0,0.0,4,9,2240,0,1970,0,98040,47.5489,-122.225,2440,9618,4,21,2015,UNK,-200,66
7902200015,4/29/2015,700000.0,3,1.75,1820,15570,1.0,0.0,2.0,3,8,1820,0,1948,0,98146,47.5068,-122.38600000000001,2490,9480,4,29,2015,UNK,-670,6090
3523089019,5/19/2014,480000.0,4,3.5,3370,435600,2.0,0.0,3.0,3,9,3370,0,2005,0,98045,47.4398,-121.738,2790,114868,5,19,2014,N,580,320732
8827900015,8/29/2014,501000.0,3,1.0,1160,4360,1.0,0.0,0.0,4,8,1160,0,1929,0,98105,47.6718,-122.291,1810,4360,8,29,2014,UNK,-650,0
9237800100,2/4/2015,580000.0,3,2.25,1640,8625,1.0,0.0,0.0,3,8,1320,320,1987,0,98052,47.6772,-122.15299999999999,1770,9476,2,4,2015,UNK,-130,-851
2724089019,5/23/2014,527550.0,1,0.75,820,59677,1.0,0.0,0.0,3,5,820,0,1999,0,98065,47.5316,-121.764,1590,14163,5,23,2014,UNK,-770,45514
5416501030,11/24/2014,399000.0,4,2.5,2800,4687,2.0,0.0,0.0,3,9,2800,0,2005,0,98038,47.3594,-122.04,2750,4750,11,24,2014,N,50,-63
7211402305,4/15/2015,240000.0,3,1.75,1780,5000,1.5,0.0,0.0,3,6,1080,700,1957,0,98146,47.5105,-122.36,1500,5000,4,15,2015,UNK,280,0
1221059176,3/11/2015,353000.0,4,2.75,2200,268329,1.0,0.0,0.0,3,7,1410,790,1989,0,98092,47.3224,-122.12200000000001,2240,58806,3,11,2015,UNK,-40,209523
7549802600,5/28/2014,335000.0,4,2.0,1480,3132,1.0,0.0,0.0,5,6,740,740,1910,0,98108,47.55,-122.31200000000001,1480,6420,5,28,2014,UNK,0,-3288
4112100165,3/17/2015,475000.0,3,3.0,2010,2554,2.0,0.0,0.0,3,7,1860,150,2001,0,98118,47.5525,-122.26899999999999,1370,5100,3,17,2015,UNK,640,-2546
7518506595,8/26/2014,660000.0,3,2.0,2880,5100,1.5,0.0,0.0,4,7,2080,800,1926,0,98117,47.6805,-122.385,1820,5100,8,26,2014,UNK,1060,0
2767602490,7/24/2014,551000.0,3,1.0,940,1948,1.0,0.0,0.0,5,6,940,0,1900,0,98107,47.6733,-122.383,1700,5000,7,24,2014,UNK,-760,-3052
3821000100,3/20/2015,249950.0,4,1.75,1620,10530,1.0,0.0,0.0,3,7,1620,0,1968,0,98030,47.3808,-122.211,1890,9975,3,20,2015,UNK,-270,555
524069019,11/20/2014,1150000.0,4,3.25,4400,262666,2.0,0.0,0.0,3,11,4400,0,1988,0,98075,47.5927,-122.064,3240,9791,11,20,2014,UNK,1160,252875
1492800296,7/3/2014,575000.0,3,1.75,1530,6743,1.0,0.0,0.0,3,7,1410,120,1955,0,98116,47.5745,-122.396,2040,6000,7,3,2014,UNK,-510,743
7855900110,7/18/2014,1090000.0,4,2.75,3460,11350,1.0,0.0,4.0,4,9,1780,1680,1974,0,98006,47.56800000000001,-122.15299999999999,3200,13874,7,18,2014,UNK,260,-2524
7853290090,11/18/2014,515000.0,4,2.5,2890,7306,2.0,0.0,0.0,3,7,2890,0,2006,0,98065,47.5447,-121.883,2850,6687,11,18,2014,N,40,619
2123049175,12/10/2014,235000.0,3,1.5,1980,11214,1.0,0.0,0.0,3,7,1980,0,1959,0,98168,47.4696,-122.29799999999999,1510,9072,12,10,2014,UNK,470,2142
2025049064,9/15/2014,796000.0,3,1.0,1980,3243,1.5,0.0,0.0,3,8,1980,0,1912,0,98102,47.6429,-122.32700000000001,1380,1249,9,15,2014,UNK,600,1994
6046401105,4/23/2015,450000.0,2,1.5,1450,2550,1.0,0.0,0.0,3,7,820,630,1984,0,98103,47.6911,-122.348,1450,5100,4,23,2015,UNK,0,-2550
3505100756,11/6/2014,2050000.0,4,3.0,4280,18834,1.0,0.0,4.0,5,11,2180,2100,1971,0,98116,47.5811,-122.4,2490,8858,11,6,2014,UNK,1790,9976
5468730110,5/8/2014,270000.0,4,2.5,1810,6509,2.0,0.0,0.0,3,7,1810,0,1994,0,98042,47.3531,-122.14299999999999,1760,7417,5,8,2014,UNK,50,-908
5154200015,4/14/2015,1710000.0,3,3.0,2490,27702,2.0,1.0,4.0,3,10,2490,0,2000,0,98116,47.5596,-122.40299999999999,2580,12119,4,14,2015,UNK,-90,15583
9285800590,3/9/2015,565000.0,3,1.0,1610,4108,1.5,0.0,0.0,5,7,1610,0,1928,0,98126,47.5704,-122.376,1680,4467,3,9,2015,UNK,-70,-359
4083304190,8/4/2014,680000.0,1,2.5,1820,3008,2.0,0.0,0.0,3,7,1090,730,1910,2004,98103,47.6529,-122.339,1860,3420,8,4,2014,Y,-40,-412
2470100110,8/4/2014,5570000.0,5,5.75,9200,35069,2.0,0.0,0.0,3,13,6200,3000,2001,0,98039,47.6289,-122.23299999999999,3560,24345,8,4,2014,UNK,5640,10724
7574910490,11/14/2014,864500.0,4,2.5,3520,35991,2.0,0.0,0.0,4,10,3520,0,1992,0,98077,47.7437,-122.035,3210,35991,11,14,2014,UNK,310,0
868001030,9/15/2014,1150000.0,4,2.25,3740,18000,1.0,0.0,0.0,4,9,1870,1870,1951,0,98177,47.7027,-122.37799999999999,2610,10902,9,15,2014,UNK,1130,7098
8108600464,5/15/2014,335000.0,3,2.25,2150,30476,2.0,0.0,0.0,3,7,2150,0,1991,0,98188,47.4605,-122.277,2010,10800,5,15,2014,UNK,140,19676
3295610490,5/4/2015,911000.0,4,3.25,3526,15958,2.0,0.0,0.0,3,10,3526,0,1997,0,98075,47.567,-122.03299999999999,3639,15090,5,4,2015,UNK,-113,868
5013500110,11/12/2014,425000.0,2,1.0,1070,6625,1.0,0.0,0.0,3,7,830,240,1950,0,98116,47.5736,-122.39299999999999,1310,6625,11,12,2014,UNK,-240,0
3223069019,10/29/2014,299950.0,3,1.0,1410,81021,1.0,0.0,0.0,3,7,1410,0,1949,1981,98058,47.4303,-122.06700000000001,2000,81021,10,29,2014,Y,-590,0
2725069085,12/8/2014,864000.0,4,2.5,3190,49658,2.0,0.0,0.0,3,10,3190,0,1999,0,98074,47.6216,-122.015,3040,49658,12,8,2014,UNK,150,0
6821600265,3/5/2015,425000.0,2,1.0,1270,6000,1.0,0.0,0.0,3,7,1270,0,1939,0,98199,47.6482,-122.39299999999999,1770,6000,3,5,2015,UNK,-500,0
1471701780,8/14/2014,374950.0,4,1.5,1970,14490,1.5,0.0,0.0,4,7,1970,0,1963,0,98059,47.4612,-122.069,1880,14880,8,14,2014,UNK,90,-390
9835800750,12/3/2014,247000.0,3,2.25,1640,7630,1.0,0.0,0.0,4,8,1180,460,1968,0,98032,47.3739,-122.29,1930,7630,12,3,2014,UNK,-290,0
8835900015,12/12/2014,475000.0,3,1.0,1600,7161,1.0,0.0,0.0,3,8,1600,0,1953,0,98118,47.5507,-122.26100000000001,1760,8280,12,12,2014,UNK,-160,-1119
806800110,8/1/2014,275000.0,3,2.5,3020,5868,2.0,0.0,0.0,3,7,3020,0,2003,0,98092,47.3361,-122.175,2710,5470,8,1,2014,UNK,310,398
826069002,10/29/2014,355000.0,2,1.0,1350,368517,1.0,0.0,0.0,3,6,1350,0,1947,0,98077,47.7617,-122.061,2330,104108,10,29,2014,UNK,-980,264409
2222059064,3/18/2015,285000.0,4,1.75,1870,22072,1.0,0.0,0.0,3,7,1070,800,1959,0,98042,47.3775,-122.165,2100,10185,3,18,2015,UNK,-230,11887
7781600100,9/5/2014,1340000.0,3,2.75,2730,38869,1.5,0.0,4.0,3,9,1940,790,1963,2001,98146,47.4857,-122.361,2630,28188,9,5,2014,Y,100,10681
4047200265,8/11/2014,325000.0,2,1.0,1100,17817,1.0,0.0,0.0,3,7,620,480,1980,0,98019,47.7728,-121.9,1790,20009,8,11,2014,UNK,-690,-2192
2125059013,4/20/2015,1670000.0,5,3.5,4320,40816,2.0,0.0,0.0,4,11,4320,0,1997,0,98004,47.644,-122.185,4320,44584,4,20,2015,UNK,0,-3768
2011400583,6/6/2014,402000.0,3,2.5,2700,9994,1.0,0.0,3.0,4,7,1350,1350,1959,0,98198,47.397,-122.321,2470,10664,6,6,2014,UNK,230,-670
3526039160,8/14/2014,1100000.0,3,3.0,3700,16857,1.0,0.0,0.0,3,10,2170,1530,2000,0,98117,47.6956,-122.39200000000001,2320,12000,8,14,2014,UNK,1380,4857
8718500495,7/30/2014,375000.0,4,1.75,2190,9225,1.0,0.0,0.0,4,7,1250,940,1959,0,98028,47.7396,-122.256,2190,9225,7,30,2014,UNK,0,0
3815500165,9/11/2014,396000.0,5,2.75,2840,12253,1.0,0.0,0.0,3,7,1420,1420,1960,0,98028,47.7618,-122.25299999999999,2210,11620,9,11,2014,UNK,630,633
5104450690,7/16/2014,320000.0,4,2.75,2610,9077,1.0,0.0,0.0,4,8,1310,1300,1987,0,98058,47.4612,-122.147,1900,10500,7,16,2014,UNK,710,-1423
7202260300,7/9/2014,610000.0,3,2.5,2630,5827,2.0,0.0,0.0,3,8,2630,0,2001,0,98053,47.688,-122.038,2330,4715,7,9,2014,UNK,300,1112
1423600300,11/17/2014,249950.0,3,1.5,1090,7698,1.0,0.0,0.0,5,7,1090,0,1966,0,98058,47.4553,-122.17399999999999,1540,7624,11,17,2014,UNK,-450,74
1796100015,4/23/2015,675000.0,4,3.5,3090,100835,2.0,0.0,0.0,3,9,3090,0,1999,0,98092,47.3087,-122.088,2400,50543,4,23,2015,UNK,690,50292
3874900090,3/26/2015,448000.0,2,2.0,1670,7772,1.0,0.0,0.0,4,6,860,810,1919,0,98126,47.5461,-122.37700000000001,1300,7770,3,26,2015,UNK,370,2
4232902615,4/28/2015,819000.0,3,1.0,1300,3600,2.0,0.0,0.0,3,7,1300,0,1900,0,98119,47.6345,-122.366,2510,4800,4,28,2015,UNK,-1210,-1200
3585900495,11/10/2014,1250000.0,3,2.5,3670,18505,1.0,0.0,4.0,3,10,2530,1140,1983,0,98177,47.7588,-122.376,2920,20000,11,10,2014,UNK,750,-1495
3790700110,12/1/2014,225000.0,4,2.5,1700,6031,2.0,0.0,0.0,3,8,1700,0,1994,0,98030,47.3582,-122.191,1930,6035,12,1,2014,UNK,-230,-4
3626079040,7/30/2014,790000.0,2,3.0,2560,982278,1.0,0.0,0.0,3,8,2560,0,2004,0,98014,47.6955,-121.861,1620,40946,7,30,2014,N,940,941332
2461900375,4/14/2015,685000.0,4,2.5,2770,6000,2.0,0.0,0.0,3,8,2400,370,1993,0,98136,47.5536,-122.383,2120,6000,4,14,2015,UNK,650,0
8651611690,6/20/2014,812000.0,3,3.25,3240,8338,2.0,0.0,0.0,3,9,3240,0,2001,0,98074,47.6321,-122.064,3420,8405,6,20,2014,UNK,-180,-67
8682301050,12/2/2014,705000.0,2,2.5,2300,6400,1.0,0.0,0.0,3,8,2300,0,2007,0,98053,47.7196,-122.02,2300,6400,12,2,2014,N,0,0
1858600042,4/29/2015,360000.0,4,3.0,2483,6870,2.0,0.0,0.0,3,8,2483,0,2005,0,98030,47.3627,-122.199,1943,6434,4,29,2015,N,540,436
2767604252,1/12/2015,344000.0,1,1.5,760,779,3.0,0.0,0.0,3,8,760,0,2006,0,98107,47.6715,-122.382,1290,1189,1,12,2015,N,-530,-410
1954700615,10/22/2014,825000.0,4,1.5,2040,6900,2.0,0.0,0.0,3,9,2040,0,1903,0,98112,47.6188,-122.285,3150,8220,10,22,2014,UNK,-1110,-1320
6844702690,4/27/2015,476500.0,3,1.0,1200,6120,1.0,0.0,0.0,4,7,950,250,1945,0,98115,47.6929,-122.287,1550,6120,4,27,2015,UNK,-350,0
2695600195,11/24/2014,379500.0,2,1.0,960,5096,1.0,0.0,0.0,5,7,960,0,1949,0,98126,47.5314,-122.37799999999999,1760,4488,11,24,2014,UNK,-800,608
426059055,10/3/2014,620000.0,3,1.75,2410,35236,1.0,0.0,0.0,3,8,2410,0,1980,0,98072,47.7651,-122.166,2110,16980,10,3,2014,UNK,300,18256
1769600147,7/31/2014,477590.0,3,3.25,2260,7701,2.0,0.0,0.0,3,8,1760,500,2000,0,98146,47.5053,-122.37700000000001,1880,7529,7,31,2014,UNK,380,172
9268200300,5/20/2014,490000.0,3,1.0,1910,8190,1.0,0.0,0.0,4,7,1010,900,1946,0,98117,47.696999999999996,-122.365,1600,5042,5,20,2014,UNK,310,3148
3052700855,6/28/2014,470000.0,3,1.5,1500,5000,1.5,0.0,0.0,4,7,1140,360,1927,0,98117,47.678999999999995,-122.37299999999999,1500,5000,6,28,2014,UNK,0,0
9828702262,7/24/2014,500000.0,3,2.25,1360,1236,2.0,0.0,0.0,3,8,1140,220,2006,0,98112,47.6198,-122.29899999999999,1620,1231,7,24,2014,N,-260,5
1568100386,6/30/2014,370000.0,3,1.0,1320,7341,1.0,0.0,0.0,3,7,1320,0,1982,0,98155,47.7367,-122.295,1160,7573,6,30,2014,UNK,160,-232
4385700735,3/11/2015,790000.0,2,1.5,1940,4400,1.0,0.0,0.0,3,7,970,970,1923,0,98112,47.6371,-122.279,1480,3080,3,11,2015,UNK,460,1320
3425059206,6/24/2014,725000.0,4,2.5,2650,18295,2.0,0.0,0.0,3,8,2650,0,1986,0,98005,47.6075,-122.154,2230,19856,6,24,2014,UNK,420,-1561
6848200018,5/28/2014,840000.0,4,2.75,3040,2800,2.0,0.0,0.0,3,9,2100,940,1906,0,98102,47.6245,-122.32700000000001,1260,2178,5,28,2014,UNK,1780,622
3023049256,6/4/2014,390000.0,3,1.0,1240,11108,1.0,0.0,0.0,4,7,1240,0,1952,0,98166,47.4465,-122.354,2220,16533,6,4,2014,UNK,-980,-5425
4019301500,8/28/2014,507000.0,3,2.25,2210,11585,1.0,0.0,0.0,4,7,1510,700,1958,0,98155,47.7574,-122.279,1870,14092,8,28,2014,UNK,340,-2507
402000115,11/22/2014,263500.0,3,1.75,1540,6273,1.0,0.0,0.0,4,6,770,770,1951,0,98118,47.5305,-122.277,1140,5512,11,22,2014,UNK,400,761
9206950110,7/12/2014,369000.0,3,2.5,1320,1683,2.0,0.0,0.0,3,8,1270,50,2004,0,98106,47.5357,-122.365,1320,2206,7,12,2014,N,0,-523
8106300820,8/14/2014,500000.0,3,2.5,3040,5326,2.0,0.0,0.0,3,9,3040,0,2008,0,98055,47.4472,-122.20700000000001,3040,5442,8,14,2014,N,0,-116
8082400011,4/6/2015,570000.0,2,1.0,910,4301,1.0,0.0,0.0,4,7,910,0,1923,0,98117,47.6814,-122.399,1810,4301,4,6,2015,UNK,-900,0
7137960110,3/6/2015,284000.0,4,3.0,2040,7145,1.0,0.0,0.0,3,8,1490,550,1994,0,98092,47.3275,-122.171,1940,7145,3,6,2015,UNK,100,0
546000820,11/10/2014,415000.0,2,1.0,980,4108,1.0,0.0,0.0,3,7,980,0,1947,0,98117,47.687,-122.381,1500,4046,11,10,2014,UNK,-520,62
3330500705,5/15/2014,197500.0,3,1.0,980,3090,1.5,0.0,0.0,3,6,980,0,1903,0,98118,47.5525,-122.277,980,3090,5,15,2014,UNK,0,0
1454600266,10/27/2014,925000.0,4,3.75,4420,9492,2.0,0.0,1.0,3,9,3420,1000,1962,0,98125,47.7211,-122.28299999999999,2880,9900,10,27,2014,UNK,1540,-408
3335000025,11/12/2014,468000.0,3,2.0,1570,6300,1.0,0.0,0.0,3,7,820,750,1953,2005,98118,47.5565,-122.275,1510,4281,11,12,2014,Y,60,2019
1454100056,7/15/2014,355000.0,3,1.0,1600,5001,1.5,0.0,0.0,5,6,1080,520,1930,0,98125,47.7232,-122.289,1340,5001,7,15,2014,UNK,260,0
5035300090,8/12/2014,639000.0,4,1.75,1830,6000,1.0,0.0,0.0,4,7,930,900,1939,0,98199,47.6536,-122.41,1540,6000,8,12,2014,UNK,290,0
7504050090,4/12/2015,720000.0,3,2.5,2820,14250,2.0,0.0,0.0,3,11,2820,0,1991,0,98074,47.6396,-122.054,2820,12600,4,12,2015,UNK,0,1650
408100110,6/12/2014,381000.0,3,1.75,1800,6000,1.0,0.0,0.0,5,6,900,900,1950,0,98155,47.7505,-122.31700000000001,1060,6628,6,12,2014,UNK,740,-628
5701700011,5/23/2014,1050000.0,3,4.0,4380,42769,2.0,0.0,0.0,5,11,4380,0,1983,0,98052,47.7167,-122.109,3630,35425,5,23,2014,UNK,750,7344
3629970930,11/11/2014,670000.0,3,3.0,2980,3730,2.0,0.0,0.0,3,9,2980,0,2005,0,98029,47.5533,-121.995,2710,3640,11,11,2014,N,270,90
7017200110,10/28/2014,400000.0,3,1.0,1690,6658,1.0,0.0,0.0,3,7,1690,0,1942,1982,98133,47.7099,-122.35,1080,5925,10,28,2014,Y,610,733
4054500590,6/26/2014,910000.0,4,3.5,4040,50479,2.0,0.0,0.0,3,11,4040,0,1987,0,98077,47.7196,-122.04799999999999,3770,40899,6,26,2014,UNK,270,9580
2126059048,4/2/2015,294000.0,3,1.0,1250,9427,1.0,0.0,0.0,3,6,1250,0,1931,0,98034,47.7254,-122.175,1590,8250,4,2,2015,UNK,-340,1177
984200590,3/10/2015,315001.0,3,1.75,1500,10230,1.0,0.0,0.0,2,7,1500,0,1968,0,98058,47.4349,-122.16799999999999,1770,8374,3,10,2015,UNK,-270,1856
9353300090,7/31/2014,360000.0,3,2.0,1630,10723,1.0,0.0,0.0,5,7,1630,0,1959,0,98059,47.4898,-122.133,1450,10723,7,31,2014,UNK,180,0
7600057,8/5/2014,520000.0,3,2.0,1410,2700,2.0,0.0,0.0,4,7,1410,0,1902,0,98122,47.6029,-122.302,1750,4000,8,5,2014,UNK,-340,-1300
2919701944,10/10/2014,474000.0,3,1.0,1140,4560,1.0,0.0,0.0,4,6,770,370,1944,0,98117,47.6889,-122.36200000000001,1340,3980,10,10,2014,UNK,-200,580
7202341110,3/13/2015,702000.0,4,2.5,3280,5876,2.0,0.0,0.0,3,7,3280,0,2004,0,98053,47.6802,-122.03399999999999,2600,5000,3,13,2015,N,680,876
1122069019,8/26/2014,728000.0,4,3.5,3490,87497,2.0,0.0,0.0,3,9,3490,0,2001,0,98038,47.4028,-122.00200000000001,2400,55657,8,26,2014,UNK,1090,31840
1565950090,3/5/2015,308000.0,4,2.5,2020,7277,2.0,0.0,0.0,3,8,2020,0,1993,0,98055,47.4318,-122.19,2820,7284,3,5,2015,UNK,-800,-7
1724069059,5/24/2014,2000000.0,5,4.0,4580,4443,3.0,1.0,4.0,3,10,4580,0,2004,0,98075,47.5682,-122.059,2710,4443,5,24,2014,N,1870,0
4137000110,7/25/2014,340000.0,3,2.5,2270,7917,2.0,0.0,0.0,3,8,2270,0,1986,0,98092,47.2643,-122.22,2160,7917,7,25,2014,UNK,110,0
7849200945,4/1/2015,306500.0,2,1.75,1310,10200,1.0,0.0,0.0,4,6,1310,0,1947,0,98065,47.5231,-121.82,1500,7200,4,1,2015,UNK,-190,3000
2397101270,1/26/2015,716000.0,3,2.0,1420,3600,1.5,0.0,0.0,4,7,1420,0,1904,0,98119,47.6367,-122.36399999999999,1250,3600,1,26,2015,UNK,170,0
2726059100,9/9/2014,950000.0,4,3.0,2980,44431,2.0,0.0,0.0,2,10,2640,340,1981,0,98034,47.7154,-122.161,2010,7332,9,9,2014,UNK,970,37099
7202331500,8/29/2014,673200.0,5,3.0,4180,8561,2.0,0.0,0.0,3,7,4180,0,2003,0,98053,47.6833,-122.04,3425,6591,8,29,2014,UNK,755,1970
439000090,3/23/2015,564500.0,4,2.25,1950,6000,1.0,0.0,0.0,3,7,1350,600,1961,0,98115,47.6909,-122.301,1980,6000,3,23,2015,UNK,-30,0
7788000100,2/6/2015,393000.0,4,1.75,1790,11801,1.0,0.0,0.0,4,8,1790,0,1974,0,98056,47.5172,-122.17,2000,12988,2,6,2015,UNK,-210,-1187
8658300315,3/12/2015,425000.0,5,1.75,1400,5071,1.0,0.0,0.0,3,5,1400,0,1916,0,98014,47.6499,-121.90799999999999,1200,7500,3,12,2015,UNK,200,-2429
1723049567,7/30/2014,150000.0,3,1.0,1320,24684,1.0,0.0,0.0,3,7,1320,0,1979,0,98168,47.4771,-122.322,1120,21214,7,30,2014,UNK,200,3470
621069039,2/20/2015,327000.0,4,2.25,1620,106722,1.0,0.0,0.0,3,8,1200,420,1980,0,98042,47.3394,-122.09100000000001,1620,38400,2,20,2015,UNK,0,68322
6806300750,3/18/2015,444900.0,4,2.5,3120,7448,2.0,0.0,0.0,3,9,3120,0,1998,0,98042,47.3645,-122.126,2980,8102,3,18,2015,UNK,140,-654
1898900100,7/22/2014,305000.0,4,2.5,2100,14773,2.0,0.0,0.0,3,8,2100,0,1998,0,98023,47.3045,-122.391,2370,15440,7,22,2014,UNK,-270,-667
2767603931,8/18/2014,469000.0,3,3.25,1370,1194,3.0,0.0,0.0,3,8,1370,0,2004,0,98107,47.6718,-122.38799999999999,1800,2678,8,18,2014,N,-430,-1484
6072400820,9/26/2014,525000.0,3,1.75,1520,7875,1.0,0.0,0.0,5,8,1520,0,1969,0,98006,47.5569,-122.176,2150,9428,9,26,2014,UNK,-630,-1553
1922059396,4/4/2015,330000.0,3,2.5,2410,17424,1.0,0.0,0.0,3,7,1630,780,1978,0,98030,47.3741,-122.21799999999999,1530,11761,4,4,2015,UNK,880,5663
8818900300,10/2/2014,618000.0,4,1.0,1260,4080,1.0,0.0,0.0,4,7,1260,0,1911,0,98105,47.6644,-122.324,1340,4080,10,2,2014,UNK,-80,0
9264910900,11/17/2014,295500.0,4,2.5,2830,7350,1.0,0.0,0.0,3,8,1690,1140,1982,0,98023,47.3088,-122.34100000000001,2350,7768,11,17,2014,UNK,480,-418
3223039013,7/18/2014,567035.0,3,2.0,2064,46173,2.0,0.0,0.0,5,7,2064,0,1903,0,98070,47.4469,-122.455,1640,21780,7,18,2014,UNK,424,24393
5561300750,7/25/2014,518000.0,4,2.25,2640,34870,1.0,0.0,0.0,3,8,1770,870,1977,0,98027,47.4688,-122.009,2500,35580,7,25,2014,UNK,140,-710
9407111220,5/4/2015,303000.0,2,1.0,1020,9200,1.0,0.0,0.0,3,7,1020,0,1978,0,98045,47.4461,-121.76899999999999,1520,9600,5,4,2015,UNK,-500,-400
1332200110,7/8/2014,300000.0,4,2.5,2200,8065,2.0,0.0,0.0,3,7,2200,0,1998,0,98031,47.4042,-122.213,2641,8535,7,8,2014,UNK,-441,-470
2207200820,10/15/2014,413107.0,3,1.5,1420,7520,1.0,0.0,0.0,4,7,1420,0,1956,0,98007,47.601000000000006,-122.134,2000,7520,10,15,2014,UNK,-580,0
3362400615,8/20/2014,400000.0,3,1.0,1350,3090,1.5,0.0,0.0,5,6,1350,0,1914,0,98103,47.681999999999995,-122.348,1350,3090,8,20,2014,UNK,0,0
3013300017,4/8/2015,535000.0,3,1.0,1290,6859,1.0,0.0,0.0,4,7,1290,0,1941,0,98136,47.5317,-122.387,1560,6369,4,8,2015,UNK,-270,490
1982200015,9/19/2014,555000.0,4,2.0,1680,2600,1.0,0.0,0.0,5,7,840,840,1915,0,98107,47.6648,-122.363,1680,3340,9,19,2014,UNK,0,-740
7140700300,11/19/2014,312000.0,3,2.5,2280,6386,2.0,0.0,0.0,3,8,2280,0,2008,0,98042,47.3861,-122.096,2550,4835,11,19,2014,N,-270,1551
9363600457,6/3/2014,785200.0,3,2.25,1840,3500,1.5,0.0,0.0,5,8,1540,300,1910,0,98122,47.6063,-122.292,1800,3300,6,3,2014,UNK,40,200
1245001220,10/16/2014,749000.0,4,2.0,2040,11850,1.0,0.0,2.0,3,7,1020,1020,1959,0,98033,47.6891,-122.208,2040,8504,10,16,2014,UNK,0,3346
723049333,4/5/2015,285000.0,3,1.5,1490,10367,1.0,0.0,0.0,3,7,1010,480,1957,0,98146,47.4973,-122.34700000000001,1000,8254,4,5,2015,UNK,490,2113
7853301220,9/10/2014,425000.0,4,2.5,2440,5088,2.0,0.0,0.0,3,7,2440,0,2007,0,98065,47.5406,-121.889,2440,5762,9,10,2014,N,0,-674
8665900336,7/17/2014,360000.0,3,2.0,1930,15540,1.0,0.0,0.0,3,8,1260,670,1958,0,98155,47.7675,-122.307,1900,12123,7,17,2014,UNK,30,3417
1591000015,5/5/2015,260000.0,3,1.0,1200,6615,1.0,0.0,0.0,4,7,1200,0,1954,0,98106,47.5168,-122.351,1230,6615,5,5,2015,UNK,-30,0
7972601270,5/30/2014,369000.0,3,2.0,1550,8509,1.0,0.0,0.0,3,7,1150,400,1959,0,98106,47.5299,-122.344,1840,7620,5,30,2014,UNK,-290,889
1221039156,8/15/2014,275000.0,4,2.5,2180,11132,1.0,0.0,0.0,4,8,1620,560,1978,0,98023,47.3187,-122.367,1950,13801,8,15,2014,UNK,230,-2669
993001332,9/3/2014,407000.0,3,2.25,1430,1448,3.0,0.0,0.0,3,8,1430,0,2005,0,98103,47.6916,-122.34100000000001,1430,1383,9,3,2014,N,0,65
7748000025,4/12/2015,575000.0,2,1.75,1230,5418,1.0,0.0,0.0,3,8,990,240,1949,0,98117,47.6839,-122.376,1330,5074,4,12,2015,UNK,-100,344
7871500485,4/27/2015,1240000.0,3,1.5,1670,3852,2.0,0.0,3.0,4,8,1670,0,1928,0,98119,47.6411,-122.37100000000001,2320,4572,4,27,2015,UNK,-650,-720
1370802540,1/8/2015,875000.0,2,2.5,2720,4913,1.0,0.0,1.0,4,8,1700,1020,1936,0,98199,47.6384,-122.404,2520,5303,1,8,2015,UNK,200,-390
1839500115,7/12/2014,320000.0,4,1.5,2220,6811,1.0,0.0,0.0,4,7,1270,950,1961,0,98056,47.5059,-122.193,1800,7350,7,12,2014,UNK,420,-539
4389201064,7/3/2014,810000.0,3,1.5,1520,9041,1.0,0.0,0.0,4,7,1520,0,1954,0,98004,47.6158,-122.213,3260,10020,7,3,2014,UNK,-1740,-979
1545805820,4/14/2015,274000.0,3,1.75,1590,7620,1.0,0.0,0.0,4,7,1090,500,1984,0,98038,47.3655,-122.04799999999999,1590,7620,4,14,2015,UNK,0,0
273800100,12/19/2014,239900.0,4,1.75,1480,9523,1.0,0.0,0.0,3,7,1120,360,1959,0,98030,47.3732,-122.21700000000001,1590,8300,12,19,2014,UNK,-110,1223
7663700654,12/14/2014,450000.0,4,1.5,1860,7808,1.0,0.0,0.0,3,7,1080,780,1953,0,98125,47.7314,-122.3,1530,7884,12,14,2014,UNK,330,-76
3751606513,6/30/2014,263400.0,4,2.0,1360,60548,1.0,0.0,0.0,3,6,960,400,1960,0,98001,47.2718,-122.265,1930,28800,6,30,2014,UNK,-570,31748
399000025,4/15/2015,265000.0,3,1.0,1360,5967,1.0,0.0,0.0,3,6,1360,0,1954,0,98178,47.4973,-122.256,1360,6052,4,15,2015,UNK,0,-85
7130300785,6/16/2014,418000.0,4,3.0,2360,6250,1.0,0.0,2.0,3,7,1460,900,1960,0,98118,47.512,-122.249,2500,6250,6,16,2014,UNK,-140,0
3818700123,8/13/2014,390000.0,3,2.0,2360,5737,2.0,0.0,0.0,3,8,2360,0,2003,0,98028,47.7633,-122.262,1600,9163,8,13,2014,UNK,760,-3426
7891600245,4/22/2015,430000.0,3,2.0,1860,7500,1.0,0.0,0.0,3,7,930,930,1909,0,98106,47.5662,-122.36399999999999,1000,5000,4,22,2015,UNK,860,2500
5556300076,4/23/2015,1440000.0,3,2.25,2630,9705,2.5,0.0,2.0,4,8,2630,0,1987,0,98052,47.6485,-122.12100000000001,2640,14284,4,23,2015,UNK,-10,-4579
3421069118,11/20/2014,297000.0,2,1.75,1280,37373,1.0,0.0,0.0,4,7,1280,0,1996,0,98022,47.2631,-122.01899999999999,2180,48351,11,20,2014,UNK,-900,-10978
7280300042,4/1/2015,650000.0,4,2.25,2330,7220,2.0,0.0,0.0,3,8,1600,730,1988,0,98177,47.7764,-122.38600000000001,2220,9100,4,1,2015,UNK,110,-1880
9368700031,5/9/2014,195000.0,2,1.0,720,18000,1.0,0.0,0.0,3,6,720,0,1950,0,98178,47.5054,-122.26100000000001,1250,7925,5,9,2014,UNK,-530,10075
3223069118,6/16/2014,554000.0,3,3.5,3380,108900,2.0,0.0,0.0,3,9,2700,680,1999,0,98058,47.4316,-122.075,2250,130680,6,16,2014,UNK,1130,-21780
2522029039,9/29/2014,550000.0,3,2.0,3650,843309,2.0,0.0,0.0,4,7,3650,0,1991,0,98070,47.3627,-122.49600000000001,1870,273992,9,29,2014,UNK,1780,569317
7977200590,2/19/2015,700000.0,3,1.75,1640,4590,1.5,0.0,0.0,5,7,1640,0,1951,0,98115,47.6846,-122.294,1760,5100,2,19,2015,UNK,-120,-510
3124089086,10/2/2014,300000.0,4,1.0,1730,177657,1.5,0.0,0.0,3,5,1730,0,1948,0,98065,47.5163,-121.829,1400,45175,10,2,2014,UNK,330,132482
1568100215,10/7/2014,315000.0,2,1.0,1030,8576,1.5,0.0,0.0,5,6,1030,0,1952,0,98155,47.7352,-122.295,1310,8504,10,7,2014,UNK,-280,72
5364200649,10/8/2014,603000.0,3,1.0,1790,5250,1.0,0.0,0.0,3,7,1400,390,1943,0,98105,47.6627,-122.27600000000001,1790,5250,10,8,2014,UNK,0,0
2771601730,6/29/2014,530000.0,2,1.0,840,3400,1.0,0.0,2.0,4,7,840,0,1924,0,98119,47.6403,-122.37200000000001,2000,4000,6,29,2014,UNK,-1160,-600
7201800300,9/9/2014,397500.0,3,1.75,1300,8480,1.0,0.0,0.0,3,7,1300,0,1969,0,98052,47.6991,-122.13,1740,7280,9,9,2014,UNK,-440,1200
7224500300,3/25/2015,221000.0,3,1.0,1240,5250,1.5,0.0,0.0,4,6,1240,0,1904,0,98055,47.4917,-122.206,1240,5250,3,25,2015,UNK,0,0
3876312350,12/2/2014,466000.0,4,2.25,2170,8050,1.0,0.0,0.0,3,7,1220,950,1976,0,98072,47.7354,-122.17399999999999,1820,7700,12,2,2014,UNK,350,350
853000261,6/19/2014,197500.0,3,1.0,1330,5412,2.0,0.0,0.0,5,7,1330,0,1905,0,98022,47.2053,-121.993,1710,10825,6,19,2014,UNK,-380,-5413
7165700110,5/7/2015,280000.0,3,3.0,1390,1080,2.0,0.0,0.0,3,7,1140,250,2006,0,98118,47.5325,-122.28200000000001,1450,1461,5,7,2015,N,-60,-381
5708500208,10/3/2014,412000.0,2,1.5,1240,3873,1.0,0.0,0.0,4,6,860,380,1909,0,98116,47.5752,-122.38799999999999,1240,4336,10,3,2014,UNK,0,-463
5014000215,8/18/2014,454000.0,2,1.0,880,6731,1.0,0.0,0.0,4,7,880,0,1950,0,98116,47.5694,-122.395,1240,6731,8,18,2014,UNK,-360,0
2126079014,5/12/2014,540000.0,4,2.25,2540,228254,1.0,0.0,0.0,3,8,1450,1090,1990,0,98019,47.718999999999994,-121.912,1780,59241,5,12,2014,UNK,760,169013
5595900090,6/9/2014,250000.0,5,1.5,2520,5753,1.5,0.0,0.0,4,7,1510,1010,1928,0,98022,47.2058,-121.99700000000001,1620,6875,6,9,2014,UNK,900,-1122
1445500100,5/11/2015,900000.0,5,2.25,2510,35691,1.0,0.0,0.0,3,9,2510,0,1967,0,98005,47.6435,-122.154,3160,35037,5,11,2015,UNK,-650,654
4270600025,5/13/2014,245000.0,5,1.75,2020,7902,1.0,0.0,0.0,3,7,1220,800,1962,0,98168,47.51,-122.32700000000001,2220,8819,5,13,2014,UNK,-200,-917
3546000490,10/7/2014,290000.0,3,1.75,2060,7251,1.0,0.0,0.0,3,7,1350,710,1987,0,98030,47.3569,-122.175,1520,7582,10,7,2014,UNK,540,-331
423049067,2/5/2015,160000.0,2,1.0,930,7742,1.0,0.0,0.0,3,6,930,0,1933,0,98168,47.507,-122.302,2240,8723,2,5,2015,UNK,-1310,-981
9272201250,3/30/2015,1260000.0,2,1.5,2700,7225,1.5,0.0,4.0,3,8,1660,1040,1910,2008,98116,47.5892,-122.383,2970,5150,3,30,2015,Y,-270,2075
3226049184,3/27/2015,325000.0,2,1.0,1060,6050,1.0,0.0,0.0,3,7,940,120,1939,0,98125,47.7028,-122.321,1540,5279,3,27,2015,UNK,-480,771
5381000082,1/8/2015,185000.0,2,1.0,670,6750,1.0,0.0,0.0,4,5,670,0,1947,0,98188,47.4521,-122.28299999999999,1700,11520,1,8,2015,UNK,-1030,-4770
475000750,9/25/2014,477000.0,3,2.0,1750,4990,1.0,0.0,0.0,3,7,950,800,1916,0,98107,47.6667,-122.361,1700,5000,9,25,2014,UNK,50,-10
1900000195,6/30/2014,100000.0,2,1.0,930,7623,1.0,0.0,0.0,2,6,930,0,1942,0,98166,47.467,-122.34899999999999,1300,7641,6,30,2014,UNK,-370,-18
5162100820,5/4/2015,345000.0,4,2.5,2420,11481,1.0,0.0,0.0,3,8,1370,1050,1985,0,98003,47.341,-122.318,2290,8985,5,4,2015,UNK,130,2496
6113400047,3/31/2015,530000.0,4,2.25,2410,14985,1.0,0.0,1.0,4,7,1950,460,1965,0,98166,47.4278,-122.34299999999999,2510,15256,3,31,2015,UNK,-100,-271
7460000015,6/20/2014,203000.0,3,1.0,1150,7156,1.0,0.0,0.0,4,6,1150,0,1953,0,98168,47.4864,-122.31700000000001,1210,7156,6,20,2014,UNK,-60,0
7202340820,10/28/2014,599000.0,4,2.5,2480,5000,2.0,0.0,0.0,3,7,2480,0,2004,0,98053,47.6811,-122.035,2410,5000,10,28,2014,N,70,0
5393601690,7/20/2014,370000.0,4,1.0,1310,6000,1.5,0.0,0.0,3,7,1310,0,1940,0,98144,47.5822,-122.295,1630,6000,7,20,2014,UNK,-320,0
7686203275,2/27/2015,140000.0,3,1.0,1240,8000,1.0,0.0,0.0,4,6,1040,200,1954,0,98198,47.4204,-122.316,1240,8000,2,27,2015,UNK,0,0
2490200165,6/23/2014,500000.0,3,1.0,1150,5100,2.0,0.0,0.0,3,8,1150,0,1911,2005,98136,47.5349,-122.384,1440,5100,6,23,2014,Y,-290,0
597000195,2/3/2015,527200.0,3,1.75,1460,4000,1.0,0.0,2.0,4,7,730,730,1929,0,98144,47.5768,-122.307,1360,4000,2,3,2015,UNK,100,0
5119010090,5/10/2014,549900.0,5,2.75,3060,7015,1.0,0.0,0.0,5,8,1600,1460,1979,0,98146,47.5052,-122.37200000000001,2190,7600,5,10,2014,UNK,870,-585
1873100490,5/2/2015,760000.0,4,2.5,3520,8095,2.0,0.0,0.0,3,9,3520,0,2006,0,98052,47.7065,-122.109,2460,4676,5,2,2015,N,1060,3419
3336001911,7/28/2014,319000.0,2,1.0,960,4400,1.0,0.0,0.0,4,7,960,0,1951,0,98118,47.5269,-122.264,1520,5000,7,28,2014,UNK,-560,-600
1922059445,6/23/2014,362300.0,3,2.5,2430,15264,2.0,0.0,0.0,3,8,2430,0,1997,0,98030,47.3805,-122.208,2260,10416,6,23,2014,UNK,170,4848
7203600750,4/27/2015,421000.0,3,2.5,1930,4505,1.0,0.0,3.0,4,7,1440,490,1973,0,98198,47.3459,-122.32600000000001,1550,4505,4,27,2015,UNK,380,0
6021503740,3/4/2015,690000.0,3,1.0,1090,4000,1.5,0.0,0.0,4,7,1090,0,1945,0,98117,47.6846,-122.38600000000001,1520,4000,3,4,2015,UNK,-430,0
3324069058,8/28/2014,640000.0,3,2.5,2790,31798,1.0,0.0,0.0,5,8,1650,1140,1953,0,98027,47.5241,-122.039,1400,14849,8,28,2014,UNK,1390,16949
7345310100,12/8/2014,238000.0,4,1.75,1650,6900,1.0,0.0,0.0,3,7,910,740,1978,1993,98002,47.2802,-122.211,1540,7645,12,8,2014,Y,110,-745
6398000011,6/2/2014,789000.0,3,3.0,3740,39640,2.0,0.0,2.0,3,10,3740,0,1991,0,98070,47.4036,-122.462,2930,26136,6,2,2014,UNK,810,13504
5460600110,4/23/2015,1050000.0,6,4.0,5310,12741,2.0,0.0,2.0,3,10,3600,1710,1967,0,98040,47.5696,-122.213,4190,12632,4,23,2015,UNK,1120,109
9478500590,4/8/2015,302500.0,3,2.5,1690,4476,2.0,0.0,0.0,3,7,1690,0,2008,0,98042,47.3663,-122.11399999999999,2250,4488,4,8,2015,N,-560,-12
8645501091,3/11/2015,259950.0,4,1.75,1400,7920,1.0,0.0,0.0,3,7,1400,0,1963,0,98058,47.4658,-122.184,1910,7700,3,11,2015,UNK,-510,220
8099800590,6/20/2014,456000.0,3,1.5,1440,28516,1.0,0.0,0.0,4,7,1440,0,1975,0,98075,47.5829,-122.005,2080,27049,6,20,2014,UNK,-640,1467
339600090,9/25/2014,369950.0,3,2.5,1360,3718,2.0,0.0,0.0,3,7,1360,0,1987,0,98052,47.6827,-122.09700000000001,1090,3718,9,25,2014,UNK,270,0
3522029031,5/16/2014,363750.0,3,1.75,1726,197326,2.0,0.0,0.0,4,7,1726,0,1982,0,98070,47.3484,-122.505,2114,99316,5,16,2014,UNK,-388,98010
725079058,8/11/2014,585000.0,3,1.75,2220,216493,1.0,0.0,2.0,3,8,2220,0,1989,0,98014,47.6624,-121.95100000000001,2900,169884,8,11,2014,UNK,-680,46609
104530110,10/8/2014,268000.0,3,2.5,1850,6676,2.0,0.0,0.0,3,7,1850,0,1986,0,98023,47.3103,-122.36,1700,6663,10,8,2014,UNK,150,13
6852700246,9/23/2014,1200000.0,5,2.5,2860,4000,2.0,0.0,0.0,4,8,2160,700,1910,0,98102,47.6225,-122.318,1340,1224,9,23,2014,UNK,1520,2776
2124700015,7/16/2014,345000.0,3,1.0,1120,10176,1.0,0.0,0.0,3,6,920,200,1905,0,98118,47.5235,-122.277,1350,7500,7,16,2014,UNK,-230,2676
8665900291,2/25/2015,539000.0,4,2.5,2340,19850,2.0,0.0,0.0,3,9,2340,0,1993,0,98155,47.7672,-122.306,1930,15439,2,25,2015,UNK,410,4411
8965500820,7/2/2014,851000.0,5,3.25,3760,9792,2.0,0.0,0.0,3,9,2550,1210,1984,0,98006,47.5654,-122.115,2960,16500,7,2,2014,UNK,800,-6708
1024000100,4/8/2015,900000.0,3,2.5,1920,7200,2.0,0.0,2.0,3,10,1780,140,1997,0,98116,47.5709,-122.40799999999999,2080,5000,4,8,2015,UNK,-160,2200
6132600165,7/3/2014,850000.0,3,2.5,3230,5000,2.0,0.0,2.0,5,8,2430,800,1945,0,98117,47.7011,-122.389,1820,5000,7,3,2014,UNK,1410,0
4040800090,5/6/2014,390000.0,3,1.75,1260,6500,1.0,0.0,0.0,4,7,1260,0,1966,0,98008,47.6224,-122.116,1500,7700,5,6,2014,UNK,-240,-1200
3432500215,6/10/2014,345000.0,3,1.75,1540,6909,1.0,0.0,0.0,4,7,920,620,1955,0,98155,47.7451,-122.31299999999999,1130,6908,6,10,2014,UNK,410,1
3630030110,6/16/2014,534500.0,3,2.5,1700,3150,2.0,0.0,0.0,3,8,1700,0,2005,0,98029,47.5505,-121.99799999999999,1700,3600,6,16,2014,N,0,-450
9297300740,11/18/2014,643500.0,6,5.25,3600,3960,2.0,0.0,0.0,3,7,2400,1200,1971,0,98126,47.5656,-122.37200000000001,1450,4600,11,18,2014,UNK,2150,-640
3592500866,4/2/2015,1210000.0,3,2.75,3150,5520,1.5,0.0,0.0,4,8,2130,1020,1925,0,98112,47.6345,-122.302,3160,6200,4,2,2015,UNK,-10,-680
5019500215,1/15/2015,495000.0,2,1.75,1280,4000,1.0,0.0,0.0,4,7,730,550,1929,0,98116,47.5798,-122.383,2250,5382,1,15,2015,UNK,-970,-1382
3290800215,7/30/2014,535000.0,2,1.0,980,4120,1.0,0.0,0.0,3,7,830,150,1950,2014,98115,47.6815,-122.291,1760,4120,7,30,2014,Y,-780,0
7853230590,10/29/2014,435000.0,4,2.5,2190,6578,2.0,0.0,0.0,3,7,2190,0,2004,0,98065,47.5305,-121.84700000000001,2190,5416,10,29,2014,N,0,1162
1221000490,11/13/2014,305000.0,4,2.0,2470,1831,2.0,0.0,0.0,3,7,1970,500,2009,0,98166,47.4645,-122.337,1310,7500,11,13,2014,N,1160,-5669
5210200077,6/19/2014,799000.0,4,2.5,2590,7910,2.0,0.0,0.0,3,9,2590,0,2001,0,98115,47.6978,-122.28399999999999,1700,7488,6,19,2014,UNK,890,422
3275880100,11/13/2014,700000.0,4,2.5,2580,15031,2.0,0.0,0.0,3,9,2580,0,1999,0,98052,47.6895,-122.094,3030,10361,11,13,2014,UNK,-450,4670
2767704345,5/20/2014,467000.0,3,2.25,1270,1213,2.0,0.0,0.0,3,8,1040,230,2005,0,98107,47.6736,-122.375,1410,1265,5,20,2014,N,-140,-52
1432701380,4/7/2015,263000.0,3,1.0,1250,7560,1.0,0.0,0.0,3,6,1250,0,1959,0,98058,47.4493,-122.17299999999999,1270,7615,4,7,2015,UNK,-20,-55
1564000740,8/20/2014,760000.0,4,2.5,4660,7157,2.0,0.0,0.0,3,9,3020,1640,2003,0,98059,47.5352,-122.156,3300,7047,8,20,2014,UNK,1360,110
8141300300,2/7/2015,293000.0,4,2.5,2019,4435,2.0,0.0,3.0,3,8,2019,0,2008,0,98022,47.1958,-121.97399999999999,1950,4800,2,7,2015,N,69,-365
1388600110,8/21/2014,245000.0,3,2.0,1490,7929,1.0,0.0,0.0,3,7,1490,0,1989,0,98002,47.2875,-122.21799999999999,1650,7929,8,21,2014,UNK,-160,0
3523029059,7/31/2014,181000.0,2,1.5,1560,10807,1.0,0.0,0.0,2,7,1560,0,1949,0,98070,47.4444,-122.509,1660,196591,7,31,2014,UNK,-100,-185784
1061500110,4/23/2015,240000.0,3,1.0,1030,15264,1.0,0.0,0.0,4,7,1030,0,1962,0,98056,47.5016,-122.16799999999999,1430,14840,4,23,2015,UNK,-400,424
7555210100,11/17/2014,880000.0,4,2.75,2560,7961,1.0,0.0,2.0,4,8,1450,1110,1975,0,98033,47.6499,-122.199,2500,9009,11,17,2014,UNK,60,-1048
9407150100,6/25/2014,285000.0,3,2.0,1460,6377,1.0,0.0,0.0,3,7,1460,0,1995,0,98038,47.3679,-122.02,1600,6250,6,25,2014,UNK,-140,127
6414100721,4/16/2015,407500.0,2,1.0,770,6017,1.0,0.0,0.0,3,7,770,0,1950,0,98125,47.7223,-122.321,1670,7500,4,16,2015,UNK,-900,-1483
4307340490,8/12/2014,325000.0,4,2.5,1960,3543,2.0,0.0,0.0,3,7,1960,0,2004,0,98056,47.4849,-122.184,2420,3646,8,12,2014,N,-460,-103
4022900569,10/17/2014,405000.0,3,1.75,1900,10454,1.0,0.0,0.0,3,7,1390,510,1978,0,98155,47.7748,-122.291,2000,12000,10,17,2014,UNK,-100,-1546
2114700115,4/7/2015,291700.0,3,2.5,1970,4120,1.5,0.0,0.0,3,6,1230,740,1927,0,98106,47.5328,-122.346,1470,4080,4,7,2015,UNK,500,40
2320069364,10/16/2014,370000.0,3,2.5,2490,18525,2.0,0.0,3.0,3,8,2490,0,1995,0,98022,47.2119,-122.001,1850,9516,10,16,2014,UNK,640,9009
4331400090,5/28/2014,270000.0,3,1.5,1430,8960,1.0,0.0,0.0,4,6,1430,0,1953,0,98166,47.4759,-122.34899999999999,1560,10125,5,28,2014,UNK,-130,-1165
3886902870,5/27/2014,800000.0,4,2.5,2680,7200,1.0,0.0,0.0,3,8,1380,1300,1952,2013,98033,47.6835,-122.18700000000001,1950,8520,5,27,2014,Y,730,-1320
9136102680,9/23/2014,626500.0,3,1.75,1610,3210,1.0,0.0,0.0,5,7,910,0,1928,0,98103,47.6656,-122.335,1420,3210,9,23,2014,UNK,190,0
2581900165,10/21/2014,1130000.0,4,3.5,4300,8406,2.0,0.0,1.0,3,11,3580,720,1987,0,98040,47.5396,-122.214,2770,10006,10,21,2014,UNK,1530,-1600
3793501050,8/22/2014,399950.0,4,2.5,3200,7545,2.0,0.0,0.0,3,7,3200,0,2003,0,98038,47.3666,-122.03,2840,7137,8,22,2014,UNK,360,408
619000100,7/24/2014,419000.0,3,1.75,2140,15030,1.0,0.0,0.0,4,7,1570,570,1958,0,98166,47.4181,-122.338,2170,15030,7,24,2014,UNK,-30,0
4178700100,7/15/2014,1160000.0,4,2.5,4240,43995,2.0,0.0,0.0,3,10,4240,0,1989,0,98075,47.6008,-122.044,3720,59522,7,15,2014,UNK,520,-15527
3225059223,5/19/2014,1410000.0,4,3.5,3410,10769,2.0,0.0,0.0,3,10,3410,0,2008,0,98004,47.6081,-122.198,2650,10058,5,19,2014,N,760,711
3885805325,7/31/2014,710000.0,4,2.75,2090,8064,2.0,0.0,0.0,5,7,2090,0,1967,0,98033,47.6829,-122.195,1460,8400,7,31,2014,UNK,630,-336
4151800195,3/30/2015,650000.0,3,1.0,1410,4840,1.0,0.0,2.0,4,6,1230,180,1942,0,98033,47.6646,-122.204,1410,5400,3,30,2015,UNK,0,-560
1137300690,2/20/2015,369900.0,4,2.5,2820,33750,2.0,0.0,0.0,4,9,2820,0,1984,0,98072,47.7387,-122.096,2510,36180,2,20,2015,UNK,310,-2430
203600590,6/27/2014,641000.0,4,2.5,2770,63118,2.0,0.0,0.0,3,9,2770,0,1997,0,98014,47.6622,-121.961,2770,44224,6,27,2014,UNK,0,18894
7745500015,3/18/2015,403000.0,3,1.0,1400,6879,1.0,0.0,0.0,3,7,1400,0,1951,0,98155,47.7508,-122.286,1950,7400,3,18,2015,UNK,-550,-521
1370802600,7/3/2014,1020000.0,3,3.25,3620,4000,2.0,0.0,0.0,3,10,2730,890,2005,0,98199,47.6393,-122.40299999999999,1910,5000,7,3,2014,N,1710,-1000
5452800645,9/22/2014,865000.0,4,2.5,2260,13600,1.0,0.0,0.0,4,8,1770,490,1974,0,98040,47.5436,-122.23299999999999,2630,13995,9,22,2014,UNK,-370,-395
1324049015,11/11/2014,2490000.0,4,2.5,3440,23954,1.5,1.0,3.0,5,10,2260,1180,1931,0,98040,47.5636,-122.23100000000001,4230,18723,11,11,2014,UNK,-790,5231
7645900165,10/16/2014,810000.0,4,1.0,2150,3588,2.0,0.0,3.0,4,8,1850,300,1926,0,98126,47.5767,-122.37799999999999,1950,3588,10,16,2014,UNK,200,0
6798100652,7/15/2014,316750.0,3,2.5,1256,1154,3.0,0.0,0.0,3,7,1256,0,2005,0,98125,47.7146,-122.311,1309,1232,7,15,2014,N,-53,-78
1023079147,8/20/2014,652500.0,4,2.25,2220,130244,2.0,0.0,0.0,3,8,2220,0,1989,0,98027,47.4989,-121.9,2680,130680,8,20,2014,UNK,-460,-436
7972601250,2/4/2015,360000.0,6,2.75,2850,15240,1.0,0.0,0.0,3,7,1850,1000,1962,0,98106,47.5288,-122.345,2090,7620,2,4,2015,UNK,760,7620
421000215,4/16/2015,208000.0,2,1.0,700,5100,1.0,0.0,0.0,4,5,700,0,1953,0,98056,47.4957,-122.16799999999999,970,5811,4,16,2015,UNK,-270,-711
4054520100,2/10/2015,898000.0,4,2.5,3700,63991,2.0,0.0,0.0,3,10,3700,0,1992,0,98077,47.7319,-122.051,3210,47215,2,10,2015,UNK,490,16776
3579700015,2/27/2015,295000.0,4,1.75,1400,11934,1.0,0.0,0.0,3,7,1050,350,1961,0,98028,47.7346,-122.244,2080,10400,2,27,2015,UNK,-680,1534
9310300215,5/6/2015,652500.0,4,1.75,3130,18253,2.0,0.0,0.0,3,7,3130,0,1978,0,98133,47.7402,-122.348,1850,12220,5,6,2015,UNK,1280,6033
3905081800,7/25/2014,560000.0,4,3.0,2170,5764,2.0,0.0,0.0,3,8,2170,0,1992,0,98029,47.5673,-121.999,2010,5681,7,25,2014,UNK,160,83
7236100025,5/4/2015,280000.0,3,1.0,1020,8400,1.0,0.0,0.0,4,7,1020,0,1957,0,98056,47.4905,-122.18,1690,8030,5,4,2015,UNK,-670,370
2023049206,6/30/2014,289950.0,3,2.5,1760,8584,1.5,0.0,0.0,5,7,1760,0,1937,0,98148,47.4612,-122.325,2160,8584,6,30,2014,UNK,-400,0
3223059015,4/10/2015,397500.0,3,2.5,1860,44093,1.0,0.0,0.0,3,7,1860,0,1978,0,98055,47.4381,-122.18799999999999,1900,6130,4,10,2015,UNK,-40,37963
1726069064,3/24/2015,380000.0,2,1.0,1140,75132,1.0,0.0,0.0,3,7,1140,0,1956,0,98077,47.7349,-122.074,2570,35200,3,24,2015,UNK,-1430,39932
1423089162,10/31/2014,415900.0,3,2.5,1670,22703,1.0,0.0,0.0,3,7,1310,360,1988,0,98045,47.4708,-121.756,1510,16817,10,31,2014,UNK,160,5886
8024201503,7/16/2014,475000.0,2,1.75,1710,8645,1.0,0.0,0.0,4,7,1510,200,1923,0,98115,47.7005,-122.31299999999999,1280,5366,7,16,2014,UNK,430,3279
859000110,10/2/2014,125000.0,1,1.0,500,7440,1.0,0.0,0.0,1,5,500,0,1928,0,98106,47.5252,-122.36200000000001,1350,7440,10,2,2014,UNK,-850,0
2322059039,8/21/2014,238000.0,3,1.0,1470,32670,1.0,0.0,0.0,3,7,1020,450,1958,0,98042,47.3811,-122.14399999999999,2640,24100,8,21,2014,UNK,-1170,8570
2023049245,8/20/2014,296000.0,4,1.5,1370,9750,1.0,0.0,0.0,3,7,1070,300,1953,0,98168,47.4718,-122.323,1540,9789,8,20,2014,UNK,-170,-39
114100745,5/6/2014,475000.0,6,3.0,3470,117612,1.5,0.0,0.0,3,7,3470,0,1924,0,98028,47.7663,-122.234,2120,17100,5,6,2014,UNK,1350,100512
2391601380,2/23/2015,390000.0,3,2.25,1650,6250,1.5,0.0,0.0,3,7,1650,0,1910,0,98116,47.5639,-122.4,2060,6250,2,23,2015,UNK,-410,0
2313900740,11/19/2014,425000.0,3,1.0,1180,3750,1.0,0.0,0.0,3,6,1030,150,1940,0,98116,47.5726,-122.382,1280,3750,11,19,2014,UNK,-100,0
9521101015,6/26/2014,725000.0,6,3.0,3110,5000,1.5,0.0,0.0,5,7,1810,1300,1921,0,98103,47.6631,-122.348,1600,4000,6,26,2014,UNK,1510,1000
1036400110,7/2/2014,605000.0,3,2.25,2080,12134,1.0,0.0,0.0,4,8,1530,550,1973,0,98052,47.6315,-122.102,2320,12400,7,2,2014,UNK,-240,-266
2572400100,11/5/2014,302000.0,3,1.0,1600,1950,2.0,0.0,0.0,2,7,1600,0,1906,0,98122,47.6028,-122.31200000000001,1310,1138,11,5,2014,UNK,290,812
6821600300,3/18/2015,886000.0,3,2.25,2380,6000,2.0,0.0,0.0,5,9,1650,730,1931,0,98199,47.6472,-122.39299999999999,2000,6000,3,18,2015,UNK,380,0
9547205225,8/14/2014,540000.0,4,1.75,1630,6120,1.0,0.0,0.0,5,7,980,650,1918,0,98115,47.6821,-122.31,1630,4080,8,14,2014,UNK,0,2040
3876312490,4/14/2015,435000.0,4,2.25,1910,8400,2.0,0.0,0.0,3,7,1910,0,1975,0,98072,47.7352,-122.175,1910,8400,4,14,2015,UNK,0,0
1591600044,10/10/2014,409000.0,4,3.25,3140,10752,2.0,0.0,0.0,3,7,2300,840,1992,0,98146,47.5022,-122.363,1300,9920,10,10,2014,UNK,1840,832
7201800090,1/6/2015,405000.0,3,1.0,1250,7280,1.0,0.0,0.0,3,7,1250,0,1975,0,98052,47.6986,-122.12899999999999,1690,7280,1,6,2015,UNK,-440,0
4221270100,6/11/2014,560200.0,3,2.5,1990,3984,2.0,0.0,0.0,3,8,1990,0,2004,0,98075,47.5914,-122.01700000000001,2320,3984,6,11,2014,N,-330,0
2473410690,6/23/2014,324000.0,4,1.75,2110,7208,1.0,0.0,0.0,3,8,1170,940,1975,0,98058,47.4464,-122.12899999999999,1820,7208,6,23,2014,UNK,290,0
7300410110,5/19/2014,390000.0,4,2.5,2490,8290,2.0,0.0,0.0,3,9,2490,0,1999,0,98092,47.3305,-122.171,2690,7008,5,19,2014,UNK,-200,1282
7224500090,4/7/2015,414000.0,2,1.0,800,5000,1.0,0.0,0.0,3,6,800,0,1938,0,98055,47.4914,-122.204,1220,5000,4,7,2015,UNK,-420,0
7852000110,9/3/2014,441500.0,3,2.5,2360,4670,2.0,0.0,0.0,3,7,2360,0,1998,0,98065,47.537,-121.87100000000001,2420,5620,9,3,2014,UNK,-60,-950
4302200590,3/9/2015,375000.0,3,2.5,1770,5146,2.0,0.0,0.0,3,7,1770,0,1992,0,98106,47.5263,-122.35600000000001,1230,5160,3,9,2015,UNK,540,-14
8635750090,6/2/2014,668500.0,4,2.5,2710,5500,2.0,0.0,0.0,3,9,2710,0,1999,0,98074,47.6027,-122.023,2710,6242,6,2,2014,UNK,0,-742
1133000100,10/7/2014,540000.0,5,1.5,1940,10202,1.5,0.0,0.0,4,7,1940,0,1940,0,98125,47.7213,-122.31,1900,8000,10,7,2014,UNK,40,2202
7631800025,6/6/2014,1040000.0,4,3.25,3450,11240,2.0,0.0,3.0,4,10,2430,1020,1960,2001,98166,47.4556,-122.37200000000001,2412,19499,6,6,2014,Y,1038,-8259
2998800110,3/25/2015,1350000.0,4,3.25,3440,4920,2.0,0.0,4.0,3,10,2520,920,2014,0,98116,47.5727,-122.40899999999999,2350,5166,3,25,2015,N,1090,-246
2432000110,5/7/2014,758000.0,4,2.75,2410,9549,1.0,0.0,0.0,4,7,1780,630,1956,0,98033,47.6503,-122.197,2090,9549,5,7,2014,UNK,320,0
824059140,5/27/2014,949880.0,4,2.25,2290,10687,2.0,0.0,0.0,3,9,2290,0,1978,0,98004,47.5878,-122.20200000000001,2290,10300,5,27,2014,UNK,0,387
4229400015,5/7/2015,570000.0,3,1.0,1030,4089,1.5,0.0,0.0,3,7,1030,0,1927,0,98116,47.574,-122.385,1440,4917,5,7,2015,UNK,-410,-828
7805450110,5/6/2014,736000.0,4,2.5,2290,12047,2.0,0.0,0.0,4,9,2290,0,1988,0,98006,47.5599,-122.105,3130,15666,5,6,2014,UNK,-840,-3619
9839301055,6/26/2014,670000.0,3,1.5,1490,4400,1.5,0.0,0.0,4,7,1490,0,1906,0,98122,47.6113,-122.292,1560,4400,6,26,2014,UNK,-70,0
9471201110,4/6/2015,1130000.0,4,1.75,2370,8400,1.0,0.0,0.0,5,9,1270,1100,1949,0,98105,47.6716,-122.264,2370,8400,4,6,2015,UNK,0,0
1189000645,10/22/2014,650000.0,4,2.0,1930,3976,1.5,0.0,0.0,4,8,1930,0,1914,0,98122,47.6117,-122.29700000000001,1470,4080,10,22,2014,UNK,460,-104
6788201015,6/16/2014,690000.0,2,1.75,1600,4000,1.0,0.0,0.0,5,7,850,750,1918,0,98112,47.6408,-122.3,1860,4000,6,16,2014,UNK,-260,0
425069147,3/13/2015,610000.0,4,2.25,2240,45738,2.0,0.0,0.0,3,7,2240,0,1988,0,98053,47.687,-122.04700000000001,3180,45738,3,13,2015,UNK,-940,0
9268200600,5/19/2014,413500.0,2,1.0,770,4000,1.0,0.0,0.0,5,5,770,0,1924,0,98117,47.6959,-122.36399999999999,1420,5040,5,19,2014,UNK,-650,-1040
9201000100,4/14/2015,765000.0,3,2.5,2300,9752,2.0,0.0,2.0,3,8,2300,0,1968,2003,98075,47.5825,-122.07600000000001,2640,10764,4,14,2015,Y,-340,-1012
4140930110,12/10/2014,828200.0,4,2.75,3400,7081,2.0,0.0,0.0,3,9,3400,0,2001,0,98006,47.5661,-122.12299999999999,3060,7081,12,10,2014,UNK,340,0
7226000110,7/26/2014,205000.0,2,1.0,900,4397,1.0,0.0,0.0,3,6,900,0,1918,0,98055,47.4851,-122.205,1430,4500,7,26,2014,UNK,-530,-103
4358700100,12/2/2014,465000.0,3,2.5,1450,5175,1.0,0.0,0.0,3,8,1030,420,1995,0,98133,47.7082,-122.338,1740,9250,12,2,2014,UNK,-290,-4075
2228900195,3/11/2015,556000.0,4,2.5,2240,5402,2.0,0.0,0.0,3,8,2240,0,2005,0,98133,47.772,-122.35,2240,7560,3,11,2015,N,0,-2158
3905100740,6/8/2014,540000.0,4,2.5,1780,4169,2.0,0.0,0.0,3,8,1780,0,1994,0,98029,47.5695,-122.006,1830,4164,6,8,2014,UNK,-50,5
3295900490,7/29/2014,423000.0,4,2.5,2320,4254,2.0,0.0,0.0,3,8,2320,0,2004,0,98059,47.48,-122.137,2330,4602,7,29,2014,N,-10,-348
7379700051,4/10/2015,375000.0,3,1.75,1590,14766,1.0,0.0,0.0,3,8,1590,0,1963,0,98007,47.5902,-122.147,2040,10190,4,10,2015,UNK,-450,4576
7348200195,12/9/2014,173250.0,3,1.0,990,12696,1.5,0.0,0.0,3,7,990,0,1936,0,98168,47.4776,-122.279,1260,8937,12,9,2014,UNK,-270,3759
4047200300,2/5/2015,599900.0,3,1.5,2605,12030,1.0,0.0,0.0,3,8,1355,1250,2003,0,98019,47.7725,-121.899,1590,15242,2,5,2015,UNK,1015,-3212
4242900215,6/18/2014,646000.0,5,2.75,2870,4461,1.0,0.0,0.0,3,7,1650,1220,1976,0,98107,47.675,-122.39,1890,4196,6,18,2014,UNK,980,265
7851980100,6/5/2014,1080000.0,5,4.75,5180,17811,2.0,0.0,2.0,3,11,4070,1110,2001,0,98065,47.5405,-121.868,3960,15103,6,5,2014,UNK,1220,2708
9126101645,6/10/2014,558000.0,4,2.0,2180,3870,1.0,0.0,0.0,3,7,1020,1160,1900,0,98122,47.6089,-122.303,1520,2580,6,10,2014,UNK,660,1290
2695600375,11/10/2014,354000.0,2,1.0,850,5225,1.0,0.0,0.0,3,7,850,0,1949,0,98126,47.5311,-122.38,1230,5225,11,10,2014,UNK,-380,0
6648150090,1/8/2015,1200000.0,4,4.0,4050,9517,2.0,0.0,0.0,3,11,3360,690,1990,0,98040,47.5769,-122.215,3330,9436,1,8,2015,UNK,720,81
1189000245,3/31/2015,670000.0,4,2.0,2250,4200,1.5,0.0,0.0,3,7,1650,600,1909,0,98122,47.6136,-122.29700000000001,1200,3360,3,31,2015,UNK,1050,840
1169000057,10/6/2014,1130000.0,6,4.25,3100,9378,3.0,0.0,2.0,3,11,3100,0,1978,0,98112,47.6381,-122.314,3270,6334,10,6,2014,UNK,-170,3044
4013800131,8/7/2014,267500.0,2,1.0,1747,12250,2.5,0.0,0.0,4,6,1747,0,1948,0,98001,47.3282,-122.285,1620,10300,8,7,2014,UNK,127,1950
1787270090,2/25/2015,299800.0,4,2.5,2410,4708,2.0,0.0,0.0,3,8,2410,0,2002,0,98092,47.3229,-122.182,2517,5290,2,25,2015,UNK,-107,-582
4037200735,4/14/2015,430000.0,4,1.75,2070,9120,1.0,0.0,0.0,4,7,1250,820,1958,0,98008,47.6045,-122.12299999999999,1650,8400,4,14,2015,UNK,420,720
4083302370,3/13/2015,775000.0,5,1.0,1860,3040,1.5,0.0,0.0,3,7,1530,330,1921,0,98103,47.6559,-122.339,1910,3600,3,13,2015,UNK,-50,-560
4319200820,1/22/2015,333000.0,3,1.0,950,5214,1.0,0.0,0.0,3,7,830,120,1944,0,98126,47.5362,-122.37899999999999,1490,7636,1,22,2015,UNK,-540,-2422
7663700551,4/7/2015,336000.0,3,2.0,1060,11765,1.0,0.0,0.0,4,6,1060,0,1951,0,98125,47.7333,-122.302,1500,9151,4,7,2015,UNK,-440,2614
6821102350,1/9/2015,323000.0,2,1.0,880,1712,2.0,0.0,0.0,4,7,880,0,1945,0,98199,47.6475,-122.397,1360,1748,1,9,2015,UNK,-480,-36
723069089,7/15/2014,575000.0,4,2.5,2550,56628,2.0,0.0,0.0,3,9,2550,0,2001,0,98027,47.4913,-122.081,1870,56628,7,15,2014,UNK,680,0
8165500110,12/5/2014,328000.0,2,2.25,1550,2079,2.0,0.0,0.0,3,8,1550,0,2008,0,98106,47.54,-122.368,1420,1977,12,5,2014,N,130,102
8081900195,12/10/2014,572500.0,3,1.0,1590,4600,1.5,0.0,0.0,4,7,1290,300,1926,0,98117,47.6807,-122.399,1770,4350,12,10,2014,UNK,-180,250
2878601425,5/22/2014,600000.0,3,1.75,1650,5100,1.0,0.0,0.0,5,7,1040,610,1908,0,98115,47.6873,-122.321,1540,5100,5,22,2014,UNK,110,0
5104512070,4/20/2015,412000.0,4,3.0,2430,7242,2.0,0.0,0.0,3,8,2430,0,2003,0,98038,47.3533,-122.015,2430,7242,4,20,2015,UNK,0,0
3885802970,12/3/2014,827500.0,3,2.5,1810,7200,1.0,0.0,0.0,5,7,1310,500,1960,0,98033,47.6885,-122.211,2050,7200,12,3,2014,UNK,-240,0
3021049140,3/25/2015,300000.0,4,2.5,2890,17349,2.0,0.0,0.0,3,8,2890,0,1994,0,98023,47.2822,-122.34,2330,22356,3,25,2015,UNK,560,-5007
5249801720,11/13/2014,415000.0,3,2.5,1280,5040,2.0,0.0,0.0,4,7,1280,0,1985,0,98118,47.5611,-122.27600000000001,1500,5040,11,13,2014,UNK,-220,0
2025049006,11/12/2014,750000.0,7,2.75,3410,4056,1.5,0.0,0.0,4,8,2130,0,1906,0,98102,47.6454,-122.316,2510,4056,11,12,2014,UNK,900,0
7575700015,7/10/2014,800000.0,3,2.75,2220,4000,2.0,0.0,0.0,3,8,1700,520,1914,2000,98122,47.617,-122.291,1800,4000,7,10,2014,Y,420,0
2724049146,3/17/2015,420000.0,3,1.0,1060,6000,1.0,0.0,0.0,3,8,1060,0,1954,0,98118,47.5427,-122.275,1240,7874,3,17,2015,UNK,-180,-1874
8074200100,10/15/2014,266000.0,3,1.5,1120,8250,1.0,0.0,0.0,4,7,1120,0,1957,0,98056,47.4905,-122.179,1320,8400,10,15,2014,UNK,-200,-150
1517900100,10/21/2014,499000.0,4,2.5,2680,10590,2.0,0.0,0.0,3,8,2680,0,2004,0,98019,47.7377,-121.97,2330,5566,10,21,2014,N,350,5024
2391602250,6/26/2014,440000.0,4,1.5,1770,5750,2.0,0.0,0.0,3,7,1770,0,1947,0,98116,47.5621,-122.39399999999999,970,5750,6,26,2014,UNK,800,0
7635801311,6/23/2014,495000.0,3,2.0,2950,12196,2.0,0.0,0.0,4,7,2310,640,1918,0,98166,47.4702,-122.365,2320,19844,6,23,2014,UNK,630,-7648
3362401295,3/30/2015,630000.0,2,1.75,1260,5300,1.0,0.0,0.0,4,7,840,420,1951,0,98103,47.6809,-122.348,1280,3000,3,30,2015,UNK,-20,2300
3303230110,8/4/2014,424000.0,3,1.75,1430,6818,1.0,0.0,0.0,5,7,1430,0,1972,0,98034,47.7271,-122.196,1480,7210,8,4,2014,UNK,-50,-392
1522600100,6/4/2014,760000.0,4,2.5,2730,36183,2.0,0.0,0.0,3,9,2730,0,1986,0,98052,47.7036,-122.12700000000001,2710,5964,6,4,2014,UNK,20,30219
6646200090,8/19/2014,650000.0,4,3.5,3270,15704,2.0,0.0,0.0,3,9,2110,1160,1990,0,98074,47.6256,-122.042,3020,8582,8,19,2014,UNK,250,7122
2522059112,5/7/2014,248500.0,4,1.75,1720,10018,1.0,0.0,0.0,5,7,1720,0,1960,0,98042,47.3614,-122.119,1220,10018,5,7,2014,UNK,500,0
3205100110,4/21/2015,379600.0,3,1.75,1270,12420,1.0,0.0,0.0,4,7,1270,0,1962,0,98056,47.5387,-122.179,1560,9910,4,21,2015,UNK,-290,2510
6414100025,7/21/2014,538000.0,4,2.5,3260,10032,1.0,0.0,0.0,3,8,1960,1300,1978,0,98125,47.7203,-122.323,1802,7249,7,21,2014,UNK,1458,2783
3529000930,6/16/2014,530000.0,4,2.5,2050,6360,2.0,0.0,0.0,3,8,2050,0,1988,0,98029,47.5641,-122.01100000000001,2070,7541,6,16,2014,UNK,-20,-1181
4141400100,1/20/2015,545000.0,4,2.25,2050,9720,2.0,0.0,0.0,3,8,2050,0,1967,0,98008,47.5911,-122.119,2310,9680,1,20,2015,UNK,-260,40
9562200090,6/24/2014,925000.0,4,3.0,3580,35261,1.5,0.0,0.0,3,10,3580,0,1985,0,98072,47.7577,-122.134,3540,36750,6,24,2014,UNK,40,-1489
7399800110,12/9/2014,565000.0,4,2.75,1960,48787,1.5,0.0,0.0,4,9,1960,0,1983,0,98072,47.7484,-122.111,1970,36425,12,9,2014,UNK,-10,12362
6917700356,5/14/2014,405100.0,2,1.0,840,3522,1.0,0.0,0.0,3,6,840,0,1947,0,98199,47.6575,-122.395,1390,4800,5,14,2014,UNK,-550,-1278
4040800600,6/9/2014,502000.0,3,1.75,1300,8800,1.0,0.0,0.0,4,8,1300,0,1963,0,98008,47.6199,-122.116,1350,8800,6,9,2014,UNK,-50,0
3629920300,11/3/2014,425000.0,3,2.25,1260,3000,2.0,0.0,0.0,3,7,1260,0,2003,0,98029,47.5454,-121.99700000000001,1630,3042,11,3,2014,UNK,-370,-42
8944290090,6/23/2014,233500.0,3,2.25,1650,2958,2.0,0.0,0.0,3,7,1650,0,1985,0,98031,47.3916,-122.167,1510,3788,6,23,2014,UNK,140,-830
8091410930,3/23/2015,287000.0,3,2.5,1710,10341,2.0,0.0,2.0,3,7,1710,0,1986,0,98030,47.3494,-122.171,1830,9358,3,23,2015,UNK,-120,983
3313600266,2/13/2015,190000.0,3,1.0,1180,8775,1.0,0.0,0.0,3,7,1180,0,1966,0,98002,47.2848,-122.223,1300,8100,2,13,2015,UNK,-120,675
9508850100,11/3/2014,666000.0,3,2.25,2780,31510,2.0,0.0,0.0,3,8,2780,0,1979,0,98053,47.67,-122.024,2890,36400,11,3,2014,UNK,-110,-4890
3330501545,12/1/2014,330000.0,2,1.0,950,3090,1.0,0.0,0.0,4,6,950,0,1909,0,98118,47.551,-122.27600000000001,1230,4120,12,1,2014,UNK,-280,-1030
31000165,9/11/2014,1490000.0,5,3.5,3620,7821,2.0,0.0,2.0,3,10,2790,830,1958,2010,98040,47.5738,-122.215,2690,9757,9,11,2014,Y,930,-1936
4123810090,9/9/2014,393000.0,3,2.25,2140,10256,2.0,0.0,0.0,3,8,2140,0,1987,0,98038,47.3751,-122.044,2040,11717,9,9,2014,UNK,100,-1461
1180500100,9/24/2014,353000.0,4,2.75,1920,4627,1.0,0.0,0.0,3,8,1010,910,1998,0,98178,47.5003,-122.23,1910,7210,9,24,2014,UNK,10,-2583
7549801140,10/20/2014,260000.0,2,1.0,750,6720,1.0,0.0,0.0,3,6,750,0,1916,0,98108,47.552,-122.31,920,6720,10,20,2014,UNK,-170,0
7254000100,12/15/2014,680000.0,3,2.5,2060,2551,2.0,0.0,0.0,3,8,1900,160,2001,0,98005,47.5881,-122.165,2060,2936,12,15,2014,UNK,0,-385
644200090,7/15/2014,921000.0,3,2.25,2380,11200,1.0,0.0,0.0,4,8,2380,0,1963,0,98004,47.5873,-122.193,2010,11200,7,15,2014,UNK,370,0
5101407305,12/18/2014,319000.0,2,1.0,750,6380,1.0,0.0,0.0,3,7,750,0,1949,0,98125,47.7033,-122.30799999999999,1690,6495,12,18,2014,UNK,-940,-115
6817801030,4/22/2015,280000.0,3,1.0,1160,10881,1.0,0.0,0.0,2,7,920,240,1983,0,98074,47.6339,-122.03299999999999,1280,10843,4,22,2015,UNK,-120,38
7454001280,6/11/2014,220000.0,3,1.0,1050,6300,1.0,0.0,0.0,3,6,1050,0,1942,0,98146,47.5128,-122.374,740,6300,6,11,2014,UNK,310,0
8651440740,1/21/2015,219000.0,3,1.5,1740,5200,1.0,0.0,0.0,4,7,1060,680,1977,0,98042,47.3657,-122.094,1540,5200,1,21,2015,UNK,200,0
1954430190,8/8/2014,528000.0,4,2.75,2050,7171,1.0,0.0,0.0,3,8,1540,510,1988,0,98074,47.6194,-122.042,1960,7110,8,8,2014,UNK,90,61
4292300010,5/27/2014,405000.0,3,1.75,1980,8100,1.0,0.0,0.0,4,7,1310,670,1949,0,98133,47.7353,-122.331,1450,8212,5,27,2014,UNK,530,-112
8929000290,5/14/2014,372977.0,3,2.5,1690,1618,2.0,0.0,0.0,3,8,1150,540,2014,0,98029,47.5518,-121.99799999999999,1690,1618,5,14,2014,N,0,0
1250201680,5/7/2015,934550.0,4,3.25,2320,5900,1.5,0.0,2.0,4,9,2320,0,1910,0,98144,47.597,-122.292,2320,6240,5,7,2015,UNK,0,-340
868001705,2/6/2015,1470000.0,3,1.5,2480,9900,2.0,0.0,3.0,3,10,2130,350,1940,0,98177,47.7018,-122.381,2860,9288,2,6,2015,UNK,-380,612
1370801585,6/3/2014,975000.0,4,2.25,2290,5350,2.0,0.0,0.0,4,9,2120,170,1958,0,98199,47.6428,-122.411,2910,5350,6,3,2014,UNK,-620,0
7501000130,5/5/2014,800866.0,5,2.5,3180,13806,2.0,0.0,0.0,4,10,3180,0,1990,0,98033,47.652,-122.182,3180,13798,5,5,2014,UNK,0,8
4178300130,4/13/2015,950000.0,7,3.5,3470,16264,2.0,0.0,0.0,4,9,3470,0,1980,0,98007,47.6203,-122.149,3040,13500,4,13,2015,UNK,430,2764
7550801206,9/4/2014,624000.0,4,3.0,1540,4140,1.5,0.0,0.0,5,7,1540,0,1902,0,98107,47.6728,-122.396,1460,5000,9,4,2014,UNK,80,-860
9201300050,8/14/2014,1850000.0,5,2.25,2800,8442,2.0,1.0,4.0,3,9,2800,0,1963,2001,98075,47.5784,-122.07600000000001,3220,9156,8,14,2014,Y,-420,-714
3816300095,5/14/2014,310000.0,3,1.0,1050,9876,1.0,0.0,0.0,3,7,1050,0,1953,0,98028,47.7635,-122.262,1760,9403,5,14,2014,UNK,-710,473
7399301100,12/4/2014,315000.0,3,1.75,1480,6800,1.0,0.0,0.0,4,7,1480,0,1968,0,98055,47.4633,-122.18799999999999,1500,7900,12,4,2014,UNK,-20,-1100
4151800470,8/20/2014,675000.0,3,2.0,1010,5973,1.0,0.0,0.0,5,6,1010,0,1942,0,98033,47.6652,-122.20200000000001,1920,6015,8,20,2014,UNK,-910,-42
7811000020,11/13/2014,490000.0,3,1.75,1660,8208,1.0,0.0,0.0,4,8,1660,0,1965,0,98005,47.5919,-122.154,2210,11000,11,13,2014,UNK,-550,-2792
5166700050,2/11/2015,600000.0,5,2.25,2760,6350,1.0,0.0,0.0,3,7,1380,0,1958,0,98126,47.5561,-122.37899999999999,2060,6342,2,11,2015,UNK,700,8
4045500130,9/9/2014,154000.0,2,1.0,1040,20524,1.0,0.0,3.0,3,6,1040,0,1949,1989,98014,47.6981,-121.875,1880,38996,9,9,2014,Y,-840,-18472
2927600675,6/9/2014,480000.0,4,1.75,2220,6500,2.0,0.0,3.0,4,8,2220,0,1964,0,98166,47.4519,-122.375,2430,11600,6,9,2014,UNK,-210,-5100
7686202580,2/13/2015,196900.0,3,1.0,1270,7500,1.0,0.0,0.0,3,6,1270,0,1954,0,98198,47.4214,-122.316,1250,8000,2,13,2015,UNK,20,-500
5690500095,8/26/2014,735000.0,3,3.25,2960,39370,2.0,0.0,0.0,3,10,2960,0,1989,0,98011,47.7452,-122.20200000000001,2960,56628,8,26,2014,UNK,0,-17258
3876540630,2/27/2015,205500.0,3,2.0,1330,8748,1.0,0.0,0.0,3,7,1330,0,1986,0,98003,47.2619,-122.29799999999999,1510,8584,2,27,2015,UNK,-180,164
8929000170,6/16/2014,357186.0,2,1.75,1210,1040,2.0,0.0,0.0,3,8,1210,0,2014,0,98029,47.5519,-121.999,1210,1090,6,16,2014,N,0,-50
2621400080,1/28/2015,275000.0,4,2.5,2120,6754,2.0,0.0,0.0,3,7,2120,0,1998,0,98030,47.3629,-122.184,2120,6937,1,28,2015,UNK,0,-183
8154100020,9/6/2014,248500.0,3,1.75,2090,12026,1.0,0.0,0.0,4,7,2090,0,1948,0,98002,47.3095,-122.21700000000001,1700,9496,9,6,2014,UNK,390,2530
8097000190,6/2/2014,350000.0,3,2.5,2680,7836,2.0,0.0,0.0,3,8,2680,0,1990,2009,98092,47.3203,-122.185,2340,8040,6,2,2014,Y,340,-204
2624089181,8/12/2014,390000.0,4,2.75,1790,47250,1.0,0.0,0.0,3,7,1220,570,1987,0,98045,47.5302,-121.74600000000001,1250,43791,8,12,2014,UNK,540,3459
8718500275,7/15/2014,390000.0,3,2.75,1950,12240,1.0,0.0,0.0,3,7,1250,700,1956,0,98028,47.7401,-122.258,1880,12000,7,15,2014,UNK,70,240
3575305495,4/13/2015,660000.0,5,2.25,3740,14913,1.5,0.0,0.0,4,9,3740,0,1979,0,98074,47.6234,-122.059,2180,7600,4,13,2015,UNK,1560,7313
411100020,11/17/2014,310000.0,3,1.75,1140,8263,1.0,0.0,0.0,5,7,1140,0,1950,0,98155,47.7407,-122.32700000000001,1140,6770,11,17,2014,UNK,0,1493
9113200020,6/12/2014,717000.0,3,2.5,2480,5137,2.0,0.0,0.0,3,9,2480,0,2000,0,98052,47.684,-122.164,2480,6023,6,12,2014,UNK,0,-886
2011400019,12/30/2014,260000.0,5,2.5,2580,11250,1.0,0.0,0.0,3,7,1410,1170,1964,0,98198,47.397,-122.31299999999999,2240,11780,12,30,2014,UNK,340,-530
3912000020,4/30/2015,745000.0,3,2.0,2290,5001,1.0,0.0,0.0,4,7,1490,800,1960,0,98103,47.6909,-122.339,1230,5001,4,30,2015,UNK,1060,0
8078370010,2/18/2015,470000.0,4,2.5,2320,12042,1.0,0.0,0.0,4,7,1320,1000,1975,0,98072,47.76300000000001,-122.16,2160,7054,2,18,2015,UNK,160,4988
5104650020,5/5/2015,429000.0,3,2.5,2530,8820,2.0,0.0,0.0,3,8,2530,0,1997,0,98031,47.42,-122.205,2340,9472,5,5,2015,UNK,190,-652
7417700664,4/8/2015,220000.0,4,2.0,1400,7140,1.0,0.0,0.0,3,7,1400,0,1969,0,98155,47.7719,-122.309,1610,10500,4,8,2015,UNK,-210,-3360
2770604920,9/3/2014,497000.0,3,3.0,2060,1850,2.0,0.0,0.0,3,8,1400,0,2007,0,98119,47.6543,-122.37299999999999,1910,2951,9,3,2014,N,150,-1101
1930300190,7/14/2014,716100.0,3,1.0,1640,4000,1.5,0.0,0.0,5,7,1640,0,1909,0,98103,47.6563,-122.351,2140,4000,7,14,2014,UNK,-500,0
3024079069,9/11/2014,371000.0,4,1.0,1960,94525,1.5,0.0,0.0,3,6,1960,0,1979,0,98027,47.5418,-121.962,2430,188564,9,11,2014,UNK,-470,-94039
723069049,7/24/2014,379000.0,5,2.75,3000,25175,1.0,0.0,0.0,4,7,1500,1500,1961,0,98027,47.497,-122.088,2170,40523,7,24,2014,UNK,830,-15348
2210500019,3/24/2015,937500.0,3,1.0,1320,8500,1.0,0.0,0.0,4,7,1320,0,1954,0,98039,47.6187,-122.226,2790,10800,3,24,2015,UNK,-1470,-2300
3856901435,10/27/2014,720000.0,4,2.0,1760,4500,1.5,0.0,0.0,5,7,1760,0,1906,0,98103,47.6711,-122.331,1740,4220,10,27,2014,UNK,20,280
3948900050,4/27/2015,616000.0,3,3.25,2130,2306,2.0,0.0,1.0,5,7,1420,710,1924,0,98136,47.5424,-122.391,1560,4500,4,27,2015,UNK,570,-2194
5412400170,4/14/2015,259000.0,3,2.0,1390,7120,1.0,0.0,0.0,3,7,1390,0,1988,0,98030,47.3786,-122.179,1530,7688,4,14,2015,UNK,-140,-568
2856102280,5/14/2014,538000.0,3,1.75,1400,3825,1.5,0.0,0.0,4,6,1100,300,1904,0,98117,47.6793,-122.39299999999999,1720,5100,5,14,2014,UNK,-320,-1275
3288100290,5/7/2015,605000.0,3,2.75,3230,9576,1.5,0.0,0.0,4,8,3230,0,1966,0,98034,47.7307,-122.18299999999999,2820,9576,5,7,2015,UNK,410,0
5145000190,11/3/2014,369950.0,3,1.0,1110,7603,1.0,0.0,0.0,3,7,1110,0,1967,0,98034,47.7262,-122.22399999999999,1260,8094,11,3,2014,UNK,-150,-491
6679000170,4/14/2015,310000.0,3,2.5,1670,4220,2.0,0.0,0.0,3,7,1670,0,2002,0,98038,47.3834,-122.02799999999999,1670,4238,4,14,2015,UNK,0,-18
9536601045,4/28/2015,227500.0,3,1.0,1540,9450,1.0,0.0,0.0,4,7,1540,0,1960,0,98198,47.3612,-122.315,1210,9450,4,28,2015,UNK,330,0
8731981410,11/21/2014,274000.0,4,2.25,2090,7400,1.0,0.0,0.0,3,9,1670,420,1973,0,98023,47.3178,-122.38,2260,8000,11,21,2014,UNK,-170,-600
3574801350,11/20/2014,410000.0,3,2.0,1410,8088,1.0,0.0,0.0,3,7,1410,0,1987,0,98034,47.7303,-122.227,1770,7401,11,20,2014,UNK,-360,687
1922069099,5/23/2014,354800.0,3,2.0,1370,78408,1.0,0.0,0.0,5,7,1370,0,1964,0,98042,47.3867,-122.081,1620,9690,5,23,2014,UNK,-250,68718
871001735,9/11/2014,650000.0,4,2.25,1910,5120,1.0,0.0,0.0,3,8,1300,610,1954,0,98199,47.6534,-122.40899999999999,1810,5153,9,11,2014,UNK,100,-33
2022059308,5/5/2015,353000.0,3,2.0,1678,13862,1.0,0.0,0.0,3,7,1678,0,1994,0,98030,47.3744,-122.19,1550,11753,5,5,2015,UNK,128,2109
2525300480,3/4/2015,224975.0,3,1.0,960,12745,1.0,0.0,0.0,4,6,960,0,1977,0,98038,47.3617,-122.03,1160,10488,3,4,2015,UNK,-200,2257
7979900440,5/12/2015,600000.0,2,1.75,2080,13054,1.0,0.0,1.0,3,7,2080,0,1951,0,98155,47.7435,-122.292,2440,13054,5,12,2015,UNK,-360,0
2558660290,2/18/2015,437500.0,3,2.25,1790,7700,1.0,0.0,0.0,4,7,1340,450,1976,0,98034,47.7205,-122.16799999999999,1610,7350,2,18,2015,UNK,180,350
8650300190,5/21/2014,567000.0,3,2.5,2540,6093,2.0,0.0,0.0,3,9,2540,0,1999,0,98034,47.7042,-122.236,2540,5924,5,21,2014,UNK,0,169
8643000225,5/6/2015,225000.0,5,1.5,1790,11656,2.0,0.0,0.0,3,7,1790,0,1963,0,98198,47.3961,-122.30799999999999,2040,9790,5,6,2015,UNK,-250,1866
1105000233,9/6/2014,255000.0,2,1.0,940,9330,1.0,0.0,0.0,3,6,940,0,1941,0,98118,47.5445,-122.273,1900,6145,9,6,2014,UNK,-960,3185
9831200500,3/4/2015,2480000.0,5,3.75,6810,7500,2.5,0.0,0.0,3,13,6110,700,1922,0,98102,47.6285,-122.322,2660,7500,3,4,2015,UNK,4150,0
945000250,6/13/2014,370000.0,2,1.0,900,4600,1.0,0.0,0.0,3,6,900,0,1951,0,98117,47.6918,-122.361,1060,4600,6,13,2014,UNK,-160,0
4101410050,4/21/2015,675000.0,4,1.75,1900,8800,1.0,0.0,0.0,3,8,1140,760,1975,0,98033,47.6579,-122.197,2280,8800,4,21,2015,UNK,-380,0
1571100130,9/4/2014,285000.0,3,1.0,1440,4268,1.0,0.0,0.0,3,7,1040,400,1953,0,98108,47.5468,-122.29299999999999,1370,4268,9,4,2014,UNK,70,0
7932000078,5/7/2014,310000.0,3,1.75,2070,37904,1.0,0.0,0.0,4,7,1420,650,1973,0,98058,47.425,-122.186,2011,19110,5,7,2014,UNK,59,18794
2592400170,12/2/2014,475000.0,4,2.5,2240,7245,1.0,0.0,0.0,4,7,1140,1100,1972,0,98034,47.7161,-122.17,1740,7350,12,2,2014,UNK,500,-105
2517010630,5/8/2015,410000.0,4,2.5,3320,5034,2.0,0.0,0.0,4,7,3320,0,2006,0,98042,47.4011,-122.164,2580,4950,5,8,2015,N,740,84
6926700225,7/2/2014,895000.0,4,2.25,1950,5950,1.0,0.0,0.0,3,8,1330,620,1947,0,98109,47.638999999999996,-122.34700000000001,2600,5593,7,2,2014,UNK,-650,357
8820902905,8/22/2014,375000.0,3,1.5,1240,7733,1.0,0.0,0.0,3,6,790,450,1941,0,98125,47.714,-122.28299999999999,1130,7733,8,22,2014,UNK,110,0
5104510190,4/27/2015,349000.0,4,2.5,1830,4694,2.0,0.0,0.0,3,7,1830,0,2003,0,98038,47.3573,-122.016,1830,5175,4,27,2015,UNK,0,-481
9839301060,4/6/2015,650500.0,3,1.75,1740,4400,1.5,0.0,0.0,3,8,1740,0,1903,0,98122,47.6115,-122.292,1740,4400,4,6,2015,UNK,0,0
2425700005,4/28/2015,760000.0,3,1.75,1410,15120,1.0,0.0,0.0,4,7,1410,0,1950,0,98004,47.5974,-122.195,1880,15120,4,28,2015,UNK,-470,0
9276201190,5/20/2014,480000.0,4,2.75,2050,3960,1.0,0.0,0.0,4,7,1180,870,1986,0,98116,47.5808,-122.39399999999999,1440,5040,5,20,2014,UNK,610,-1080
8644210050,9/26/2014,689000.0,4,2.75,3220,16145,2.0,0.0,0.0,3,10,3220,0,1993,0,98075,47.5786,-121.995,3200,12921,9,26,2014,UNK,20,3224
2741100280,5/13/2014,415000.0,3,1.75,1960,5000,1.0,0.0,0.0,5,6,980,980,1911,0,98108,47.5576,-122.31700000000001,1790,5000,5,13,2014,UNK,170,0
2891000680,4/27/2015,195000.0,3,1.75,1070,6110,1.0,0.0,0.0,4,7,1070,0,1968,0,98002,47.3249,-122.20700000000001,1350,6148,4,27,2015,UNK,-280,-38
7366100080,7/31/2014,318000.0,5,2.5,2820,9956,1.0,0.0,0.0,4,7,1410,1410,1967,0,98168,47.4715,-122.33,2700,9956,7,31,2014,UNK,120,0
3211270170,5/23/2014,404000.0,4,3.0,4060,35621,1.0,0.0,0.0,3,9,2030,2030,1989,0,98092,47.3059,-122.10799999999999,2950,35259,5,23,2014,UNK,1110,362
3330500920,10/30/2014,339950.0,2,1.0,800,3090,1.0,0.0,0.0,4,6,800,0,1925,0,98118,47.5518,-122.277,1400,3090,10,30,2014,UNK,-600,0
5437820080,11/24/2014,215000.0,3,1.0,1260,7897,1.0,0.0,0.0,3,7,1260,0,1979,0,98022,47.1946,-122.00299999999999,1560,8285,11,24,2014,UNK,-300,-388
8097000380,8/18/2014,339900.0,3,2.5,2420,7423,2.0,0.0,0.0,3,8,2420,0,1990,0,98092,47.3199,-122.186,2260,7629,8,18,2014,UNK,160,-206
2591010290,5/19/2014,285000.0,1,1.5,810,3211,2.0,0.0,0.0,4,7,810,0,1982,0,98033,47.6939,-122.184,1320,3298,5,19,2014,UNK,-510,-87
1324300380,7/16/2014,550000.0,3,1.0,1600,5000,1.5,0.0,0.0,3,7,1110,490,1947,0,98107,47.655,-122.35799999999999,1380,5000,7,16,2014,UNK,220,0
3226049478,7/25/2014,430000.0,4,1.0,1350,9000,1.5,0.0,0.0,4,7,1350,0,1964,0,98103,47.6953,-122.33200000000001,1940,8000,7,25,2014,UNK,-590,1000
7941500170,12/2/2014,219000.0,3,1.0,970,7790,1.0,0.0,0.0,3,6,970,0,1967,0,98003,47.3165,-122.325,1150,8160,12,2,2014,UNK,-180,-370
7522500005,8/15/2014,555000.0,2,1.5,1780,4750,1.0,0.0,0.0,4,7,1080,700,1947,0,98117,47.6859,-122.395,1690,5962,8,15,2014,UNK,90,-1212
1545801630,7/21/2014,233000.0,3,2.0,1350,7686,1.0,0.0,0.0,3,7,1350,0,1989,0,98038,47.3609,-122.053,1470,7686,7,21,2014,UNK,-120,0
5151600480,4/2/2015,248000.0,3,1.75,1840,19501,1.0,0.0,0.0,4,8,1270,570,1972,0,98003,47.3364,-122.318,1910,12000,4,2,2015,UNK,-70,7501
2731600080,4/22/2015,454000.0,5,2.25,2550,9200,1.0,0.0,0.0,4,8,1580,970,1975,0,98166,47.4673,-122.363,2090,9200,4,22,2015,UNK,460,0
2804600010,3/31/2015,950000.0,4,2.5,1700,4418,2.0,0.0,0.0,3,8,1700,0,1931,2000,98112,47.6434,-122.3,2090,4174,3,31,2015,Y,-390,244
8899210680,9/15/2014,359000.0,3,2.5,2430,7857,2.0,0.0,0.0,5,8,1730,700,1980,0,98055,47.4546,-122.211,2160,8740,9,15,2014,UNK,270,-883
6649300190,9/3/2014,407500.0,5,2.0,2740,8230,1.5,0.0,0.0,3,7,2210,530,1962,0,98155,47.7352,-122.29700000000001,2130,8232,9,3,2014,UNK,610,-2
1312200080,5/28/2014,224000.0,3,1.5,1560,7300,1.0,0.0,0.0,4,7,1040,520,1964,0,98001,47.3427,-122.281,1460,7910,5,28,2014,UNK,100,-610
1721801025,7/18/2014,210000.0,2,1.0,1040,4590,1.0,0.0,0.0,3,7,1040,0,1954,0,98146,47.5078,-122.337,1040,6120,7,18,2014,UNK,0,-1530
7942200050,1/23/2015,261000.0,4,1.75,1820,9824,1.0,0.0,0.0,5,7,1820,0,1968,0,98042,47.3833,-122.09299999999999,1410,11013,1,23,2015,UNK,410,-1189
9528100963,8/6/2014,719000.0,3,3.0,1833,1706,3.0,0.0,0.0,3,9,1833,0,1998,0,98115,47.6827,-122.325,1466,1455,8,6,2014,UNK,367,251
9297301495,2/3/2015,440000.0,3,2.5,2160,3738,2.0,0.0,0.0,3,8,2160,0,1994,0,98126,47.5661,-122.375,1500,4000,2,3,2015,UNK,660,-262
192300020,5/21/2014,525000.0,3,2.75,2100,10362,2.0,0.0,0.0,3,9,1510,590,1998,0,98045,47.4347,-121.417,2240,11842,5,21,2014,UNK,-140,-1480
9477100170,7/21/2014,375000.0,3,1.5,1370,9720,2.0,0.0,0.0,3,7,1370,0,1968,0,98034,47.7302,-122.197,1510,8775,7,21,2014,UNK,-140,945
6705120280,3/31/2015,428000.0,2,2.5,1414,1960,2.0,0.0,0.0,3,8,1414,0,1986,0,98006,47.5423,-122.189,1414,2511,3,31,2015,UNK,0,-551
7203220050,11/18/2014,988830.0,5,3.25,4115,7910,2.0,0.0,0.0,3,9,4115,0,2014,0,98053,47.6847,-122.016,3950,6765,11,18,2014,N,165,1145
6858700225,10/4/2014,199950.0,3,1.75,1550,6225,1.0,0.0,0.0,4,7,1550,0,1949,0,98002,47.3098,-122.21799999999999,1760,9496,10,4,2014,UNK,-210,-3271
8712100605,10/28/2014,840000.0,4,2.25,2100,3671,1.5,0.0,0.0,3,8,1750,350,1929,0,98112,47.6359,-122.3,1800,4560,10,28,2014,UNK,300,-889
5702380500,9/8/2014,285000.0,3,1.75,1160,7006,1.0,0.0,0.0,4,7,1160,0,1992,0,98022,47.1937,-121.98,1670,7750,9,8,2014,UNK,-510,-744
6181430280,9/15/2014,330000.0,5,2.5,3597,4972,2.0,0.0,0.0,3,7,3597,0,2006,0,98001,47.3002,-122.28200000000001,3193,6000,9,15,2014,N,404,-1028
7138000170,1/2/2015,147500.0,3,1.5,1230,10125,1.0,0.0,0.0,3,7,1230,0,1960,0,98198,47.397,-122.29899999999999,1970,10125,1,2,2015,UNK,-740,0
6669010290,11/7/2014,320000.0,4,2.5,2190,7125,2.0,0.0,0.0,5,8,2190,0,1978,0,98032,47.3709,-122.285,2190,8075,11,7,2014,UNK,0,-950
5706200280,7/1/2014,382500.0,3,1.75,1040,9000,1.0,0.0,0.0,4,7,1040,0,1967,0,98027,47.5253,-122.04299999999999,1750,10878,7,1,2014,UNK,-710,-1878
1338300170,3/24/2015,2050000.0,5,4.0,4690,8208,2.0,0.0,0.0,3,9,3040,1650,1926,0,98112,47.6321,-122.304,3300,8001,3,24,2015,UNK,1390,207
8562800250,8/14/2014,596000.0,4,2.25,2270,10000,1.0,0.0,0.0,5,8,1720,550,1974,0,98006,47.5599,-122.14200000000001,2270,10148,8,14,2014,UNK,0,-148
109210280,11/11/2014,220000.0,4,2.25,1950,7280,2.0,0.0,0.0,4,8,1950,0,1979,0,98023,47.2957,-122.37,1910,7280,11,11,2014,UNK,40,0
3216900080,9/25/2014,325000.0,3,2.5,1880,6818,2.0,0.0,0.0,3,8,1880,0,1993,0,98031,47.4206,-122.18299999999999,1970,7000,9,25,2014,UNK,-90,-182
629500170,3/26/2015,679950.0,4,2.5,2850,5664,2.0,0.0,0.0,3,9,2850,0,2001,0,98075,47.5835,-121.99600000000001,2850,5475,3,26,2015,UNK,0,189
5272200005,2/18/2015,175000.0,2,1.0,1160,6911,1.0,0.0,0.0,3,7,1160,0,1947,0,98125,47.7149,-122.318,1120,6948,2,18,2015,UNK,40,-37
7205000080,12/1/2014,268000.0,3,1.75,1370,10050,1.0,0.0,1.0,4,7,1370,0,1966,0,98023,47.3338,-122.34100000000001,1720,10050,12,1,2014,UNK,-350,0
1117200170,9/19/2014,715000.0,4,3.5,3260,110579,2.0,0.0,0.0,3,10,3260,0,1997,0,98053,47.6436,-121.99700000000001,3470,97895,9,19,2014,UNK,-210,12684
5561300480,4/8/2015,600000.0,7,2.25,3170,36384,2.0,0.0,0.0,3,8,3170,0,1969,0,98027,47.4654,-122.00299999999999,2460,38370,4,8,2015,UNK,710,-1986
3293400010,3/4/2015,950000.0,5,2.5,3450,35880,2.0,0.0,0.0,3,11,3450,0,1992,0,98052,47.7173,-122.09899999999999,3450,26820,3,4,2015,UNK,0,9060
3421059049,6/10/2014,475000.0,2,1.75,1490,224334,1.0,0.0,2.0,3,8,1490,0,1983,0,98092,47.2645,-122.163,2350,213879,6,10,2014,UNK,-860,10455
524069049,4/2/2015,700000.0,3,1.5,1460,78408,1.0,0.0,0.0,4,7,1460,0,1963,0,98075,47.59,-122.05799999999999,3320,7787,4,2,2015,UNK,-1860,70621
1524079093,8/27/2014,275000.0,3,1.75,1300,20700,1.0,0.0,0.0,3,7,1300,0,1962,0,98024,47.5587,-121.904,1930,37638,8,27,2014,UNK,-630,-16938
1524079093,3/18/2015,369500.0,3,1.75,1300,20700,1.0,0.0,0.0,3,7,1300,0,1962,0,98024,47.5587,-121.904,1930,37638,3,18,2015,UNK,-630,-16938
3832710680,7/21/2014,215000.0,4,2.0,1540,7575,1.0,0.0,0.0,4,7,1040,500,1978,0,98032,47.3664,-122.279,1720,7575,7,21,2014,UNK,-180,0
686200840,4/22/2015,593450.0,4,2.25,2130,7172,2.0,0.0,0.0,4,8,2130,0,1964,0,98008,47.6271,-122.11200000000001,1910,7653,4,22,2015,UNK,220,-481
8682310460,7/9/2014,498800.0,2,1.75,1350,4614,1.0,0.0,0.0,3,8,1350,0,2008,0,98053,47.7091,-122.015,1680,4775,7,9,2014,N,-330,-161
446000190,12/8/2014,849000.0,5,3.25,2450,6534,2.0,0.0,0.0,3,8,1770,680,1951,2014,98115,47.688,-122.281,1620,6534,12,8,2014,Y,830,0
8805900430,12/29/2014,1150000.0,4,2.5,1940,4875,2.0,0.0,0.0,4,9,1940,0,1925,0,98112,47.6427,-122.304,1790,4875,12,29,2014,UNK,150,0
3629921060,7/15/2014,825000.0,5,2.5,2890,5110,2.0,0.0,2.0,3,9,2890,0,2003,0,98029,47.5453,-121.995,3010,5110,7,15,2014,UNK,-120,0
8856890020,2/24/2015,265000.0,3,1.75,1680,9769,1.0,0.0,0.0,3,8,1340,340,1989,0,98058,47.4631,-122.126,1730,9686,2,24,2015,UNK,-50,83
2115510470,12/23/2014,285000.0,4,2.25,1960,10400,1.0,0.0,0.0,4,8,1220,740,1985,0,98023,47.3199,-122.39200000000001,1650,8660,12,23,2014,UNK,310,1740
1545803890,12/31/2014,240000.0,3,1.75,1590,7931,1.0,0.0,0.0,3,7,1190,400,1979,0,98038,47.3628,-122.05,1680,7931,12,31,2014,UNK,-90,0
3322049126,7/21/2014,261000.0,4,1.0,1390,17739,1.0,0.0,0.0,3,7,1390,0,1958,0,98003,47.3457,-122.302,1230,7840,7,21,2014,UNK,160,9899
6669020500,6/27/2014,330000.0,4,1.75,2440,7350,1.0,0.0,0.0,3,8,1610,830,1978,0,98032,47.3743,-122.285,2180,7680,6,27,2014,UNK,260,-330
3832710840,6/2/2014,250000.0,4,2.0,1850,7560,1.0,0.0,0.0,4,7,1540,310,1978,0,98032,47.3666,-122.277,1620,7658,6,2,2014,UNK,230,-98
7212651950,7/10/2014,350000.0,4,2.5,2800,9538,2.0,0.0,0.0,3,8,2800,0,1993,0,98003,47.2675,-122.307,1970,7750,7,10,2014,UNK,830,1788
1331900020,9/25/2014,930000.0,3,2.5,3780,35273,1.5,0.0,0.0,3,10,3780,0,1986,0,98072,47.7499,-122.119,3450,35273,9,25,2014,UNK,330,0
7140200380,10/30/2014,275000.0,3,2.0,1910,8050,1.0,0.0,0.0,4,7,1000,910,1980,0,98030,47.37,-122.17,1780,7344,10,30,2014,UNK,130,706
7972601235,2/23/2015,325000.0,4,2.25,2460,7620,1.0,0.0,0.0,3,7,1230,1230,1969,0,98106,47.5285,-122.345,2090,7620,2,23,2015,UNK,370,0
2848700585,4/24/2015,255000.0,1,1.0,810,5000,1.0,0.0,1.0,3,7,590,220,1936,0,98106,47.5696,-122.36,1920,5000,4,24,2015,UNK,-1110,0
6132600380,3/20/2015,562200.0,3,1.5,1900,5250,1.0,0.0,0.0,4,7,1500,400,1943,0,98117,47.6991,-122.39200000000001,1810,5250,3,20,2015,UNK,90,0
2424059127,8/20/2014,952000.0,2,1.75,3490,88909,1.0,0.0,3.0,3,10,2320,1170,1980,0,98006,47.5462,-122.11200000000001,3490,40185,8,20,2014,UNK,0,48724
2591830130,5/4/2014,365000.0,3,2.5,2200,7350,1.0,0.0,0.0,5,8,1570,630,1988,0,98058,47.4395,-122.161,2350,7557,5,4,2014,UNK,-150,-207
1771100130,3/16/2015,332900.0,3,1.5,1190,11996,1.0,0.0,0.0,4,7,1190,0,1969,0,98077,47.7561,-122.071,1190,9756,3,16,2015,UNK,0,2240
8856700190,4/23/2015,721000.0,3,2.25,2040,18360,2.0,0.0,0.0,4,8,2040,0,1983,0,98052,47.6976,-122.137,2590,21315,4,23,2015,UNK,-550,-2955
7852040080,4/21/2015,487275.0,4,2.5,2400,3986,2.0,0.0,0.0,3,8,2400,0,1999,0,98065,47.5344,-121.87700000000001,2070,3986,4,21,2015,UNK,330,0
5648600190,4/29/2015,310000.0,3,2.5,1670,5791,2.0,0.0,0.0,3,7,1670,0,1995,0,98055,47.4424,-122.18799999999999,1610,6034,4,29,2015,UNK,60,-243
4154300275,1/15/2015,245000.0,2,1.0,990,4800,1.0,0.0,0.0,3,6,990,0,1908,0,98118,47.5615,-122.28,1700,5400,1,15,2015,UNK,-710,-600
5438000280,4/15/2015,325000.0,3,1.75,2920,10573,1.0,0.0,0.0,4,7,2920,0,1964,0,98055,47.4429,-122.195,1560,10572,4,15,2015,UNK,1360,1
9201000480,11/12/2014,550000.0,3,1.75,1840,9401,1.0,0.0,0.0,3,8,1840,0,1971,0,98075,47.5847,-122.075,2850,14323,11,12,2014,UNK,-1010,-4922
1604600660,5/12/2014,350000.0,2,1.0,910,4500,1.5,0.0,0.0,4,7,910,0,1906,0,98118,47.5633,-122.289,1270,3500,5,12,2014,UNK,-360,1000
522069022,7/14/2014,599000.0,5,2.5,2950,72309,2.0,0.0,0.0,3,8,2950,0,2006,0,98058,47.4186,-122.079,1480,56192,7,14,2014,N,1470,16117
4331400190,11/12/2014,259950.0,3,1.5,1240,9500,1.0,0.0,0.0,4,7,1240,0,1955,0,98166,47.4756,-122.35,1845,10125,11,12,2014,UNK,-605,-625
9407150130,12/1/2014,240000.0,4,2.5,1980,7264,2.0,0.0,0.0,3,7,1980,0,1996,0,98038,47.3678,-122.01899999999999,1600,6380,12,1,2014,UNK,380,884
2212900470,2/11/2015,186000.0,3,1.0,1200,10080,1.0,0.0,0.0,4,7,1200,0,1969,0,98042,47.3261,-122.135,1230,9800,2,11,2015,UNK,-30,280
6600220080,2/4/2015,395000.0,3,1.5,1280,15028,1.0,0.0,0.0,3,7,1280,0,1982,0,98074,47.6304,-122.035,1470,13698,2,4,2015,UNK,-190,1330
9558050020,9/15/2014,475000.0,4,2.5,3150,5757,2.0,0.0,0.0,3,9,3150,0,2004,0,98058,47.4568,-122.117,3100,5757,9,15,2014,N,50,0
8691300420,8/4/2014,815000.0,5,3.5,3500,10794,2.0,0.0,0.0,3,10,3500,0,1996,0,98075,47.5887,-121.97399999999999,3110,10837,8,4,2014,UNK,390,-43
5450300010,9/2/2014,572000.0,3,1.5,1680,13751,1.0,0.0,0.0,4,7,1680,0,1951,0,98040,47.5716,-122.227,1760,13500,9,2,2014,UNK,-80,251
339600460,10/17/2014,419500.0,3,2.5,1360,3188,2.0,0.0,0.0,3,7,1360,0,1986,0,98052,47.6831,-122.096,1090,3188,10,17,2014,UNK,270,0
9264910920,9/3/2014,298700.0,3,2.25,2110,7350,1.0,0.0,0.0,3,8,1530,580,1980,0,98023,47.3088,-122.34100000000001,2640,7777,9,3,2014,UNK,-530,-427
121029034,6/24/2014,549000.0,2,1.0,2034,13392,1.0,1.0,4.0,5,7,1159,875,1947,0,98070,47.3312,-122.50299999999999,1156,15961,6,24,2014,UNK,878,-2569
2123049420,4/22/2015,278000.0,3,1.5,1900,9994,1.0,0.0,0.0,3,7,1120,780,1960,0,98168,47.4729,-122.301,1900,9994,4,22,2015,UNK,0,0
7950302890,12/30/2014,455000.0,4,2.0,2380,4500,1.5,0.0,0.0,3,6,1470,910,1926,2014,98118,47.5652,-122.281,1300,4500,12,30,2014,Y,1080,0
6117500430,8/19/2014,925000.0,5,3.5,4050,13495,1.0,0.0,2.0,4,9,2230,0,1988,0,98166,47.4384,-122.352,3210,13495,8,19,2014,UNK,840,0
1972200660,4/15/2015,465000.0,2,1.5,1120,1201,3.0,0.0,0.0,3,8,1120,0,1999,0,98103,47.6524,-122.353,1370,1298,4,15,2015,UNK,-250,-97
3629830050,10/1/2014,620000.0,4,4.0,2850,2970,2.0,0.0,0.0,3,8,2120,730,1999,0,98029,47.547,-122.01,2380,3559,10,1,2014,UNK,470,-589
9257900010,4/22/2015,499900.0,4,2.25,2360,7650,1.0,0.0,0.0,3,8,1640,0,1963,0,98155,47.75,-122.292,2320,11060,4,22,2015,UNK,40,-3410
6072000440,2/6/2015,620000.0,5,3.0,2540,11422,1.0,0.0,0.0,3,8,1270,1270,1962,2014,98006,47.5459,-122.176,2090,10741,2,6,2015,Y,450,681
6844702630,11/8/2014,450000.0,3,1.75,1160,6120,1.0,0.0,0.0,3,7,1040,120,1941,0,98115,47.6926,-122.287,1530,6120,11,8,2014,UNK,-370,0
3630090050,2/20/2015,690000.0,4,3.5,2710,2147,2.0,0.0,0.0,3,10,2220,490,2007,0,98029,47.5468,-121.994,2650,2252,2,20,2015,N,60,-105
9809000020,5/13/2014,1900000.0,5,2.25,3120,16672,2.0,0.0,0.0,4,9,3120,0,1969,0,98004,47.6458,-122.219,3740,17853,5,13,2014,UNK,-620,-1181
9809000020,3/13/2015,1940000.0,5,2.25,3120,16672,2.0,0.0,0.0,4,9,3120,0,1969,0,98004,47.6458,-122.219,3740,17853,3,13,2015,UNK,-620,-1181
5021900050,8/18/2014,832500.0,3,2.0,1870,9527,1.0,0.0,0.0,4,7,1870,0,1951,1997,98040,47.5777,-122.22399999999999,1970,11904,8,18,2014,Y,-100,-2377
1003600080,11/7/2014,245000.0,3,1.0,1010,9678,1.0,0.0,0.0,5,7,1010,0,1955,0,98188,47.4396,-122.285,1010,9375,11,7,2014,UNK,0,303
7701960130,10/17/2014,820000.0,3,2.5,2980,18935,1.5,0.0,0.0,3,11,2980,0,1990,0,98077,47.7133,-122.079,3670,18225,10,17,2014,UNK,-690,710
2395710020,8/7/2014,369000.0,4,2.75,2420,6495,2.0,0.0,0.0,3,8,2420,0,2005,0,98038,47.3771,-122.029,2420,6200,8,7,2014,N,0,295
7203230010,10/15/2014,1050000.0,4,3.25,3830,8331,2.0,0.0,0.0,3,9,3830,0,2014,0,98053,47.6906,-122.01899999999999,4080,8425,10,15,2014,N,-250,-94
9830200380,9/17/2014,653000.0,3,3.0,3040,5067,3.0,0.0,2.0,3,10,3040,0,1993,0,98118,47.5409,-122.26700000000001,1820,5998,9,17,2014,UNK,1220,-931
9407111100,4/22/2015,220650.0,2,1.75,1460,10500,1.0,0.0,0.0,3,7,1460,0,1980,0,98045,47.4461,-121.76799999999999,1340,9600,4,22,2015,UNK,120,900
9572000080,6/16/2014,300000.0,5,3.0,1940,6355,1.0,0.0,0.0,3,8,1200,740,2007,0,98168,47.49800000000001,-122.322,1940,5033,6,16,2014,N,0,1322
3629870420,9/12/2014,970000.0,4,3.5,3780,20023,2.0,0.0,2.0,3,10,3780,0,2001,0,98029,47.5491,-122.006,2150,3675,9,12,2014,UNK,1630,16348
2459970020,11/24/2014,360000.0,4,2.5,1950,5451,2.0,0.0,0.0,3,7,1950,0,2004,0,98058,47.4341,-122.14399999999999,2240,6221,11,24,2014,N,-290,-770
5547700190,3/30/2015,672500.0,3,2.5,2450,5760,2.0,0.0,0.0,3,9,2450,0,2000,0,98074,47.6145,-122.02600000000001,2450,5762,3,30,2015,UNK,0,-2
421000285,4/23/2015,268000.0,4,1.5,1730,7020,1.5,0.0,0.0,4,5,1730,0,1953,0,98056,47.4939,-122.167,1110,7020,4,23,2015,UNK,620,0
3277801640,12/2/2014,440000.0,4,1.5,1690,3245,1.5,0.0,0.0,3,8,1690,0,1929,0,98126,47.5445,-122.375,1380,1590,12,2,2014,UNK,310,1655
1250203070,5/14/2014,1400000.0,3,2.5,2550,7200,2.0,0.0,2.0,3,10,2550,0,1981,2013,98144,47.5996,-122.288,2030,3500,5,14,2014,Y,520,3700
8077200470,7/18/2014,590000.0,4,2.5,2290,11072,2.0,0.0,0.0,3,9,2290,0,1986,0,98074,47.6283,-122.03,2340,9774,7,18,2014,UNK,-50,1298
302000545,1/27/2015,359000.0,4,2.25,2710,22860,1.0,0.0,0.0,4,7,1850,860,1962,0,98001,47.3207,-122.266,1700,22860,1,27,2015,UNK,1010,0
9542801990,5/29/2014,266500.0,4,1.75,1880,7632,1.0,0.0,0.0,4,7,1180,700,1978,0,98023,47.3068,-122.37200000000001,1840,8528,5,29,2014,UNK,40,-896
3343901403,12/16/2014,635000.0,4,2.5,2930,8679,2.0,0.0,0.0,3,8,2930,0,2014,0,98056,47.5164,-122.19,2030,7264,12,16,2014,N,900,1415
1121059030,10/13/2014,559000.0,3,2.5,3110,217800,2.0,0.0,0.0,3,9,3110,0,2001,0,98092,47.3281,-122.124,2220,217800,10,13,2014,UNK,890,0
9290850950,12/18/2014,895000.0,4,2.5,3480,38985,2.0,0.0,0.0,3,10,3480,0,1989,0,98053,47.6895,-122.052,3630,36290,12,18,2014,UNK,-150,2695
1136100006,1/27/2015,625000.0,2,1.5,1110,118047,1.0,0.0,0.0,3,7,1110,0,1961,0,98072,47.7467,-122.12799999999999,2970,43500,1,27,2015,UNK,-1860,74547
7923300285,3/12/2015,650000.0,4,2.25,2440,9320,1.0,0.0,0.0,4,7,1880,560,1957,0,98007,47.5933,-122.135,1530,9335,3,12,2015,UNK,910,-15
1823059028,2/24/2015,312500.0,4,1.75,2280,7840,1.0,0.0,0.0,3,7,1280,1000,1957,0,98055,47.4809,-122.22399999999999,2120,7260,2,24,2015,UNK,160,580
8864000440,9/25/2014,225000.0,3,1.0,900,6099,1.0,0.0,0.0,3,6,790,110,1944,0,98168,47.4807,-122.289,1240,6099,9,25,2014,UNK,-340,0
9512500680,11/19/2014,425000.0,4,1.75,1980,8400,1.0,0.0,0.0,3,7,1330,650,1968,0,98052,47.6721,-122.152,1920,8400,11,19,2014,UNK,60,0
3421069120,2/19/2015,329999.0,3,2.75,3360,41250,1.0,0.0,0.0,4,7,1820,1540,1988,0,98022,47.2604,-122.023,2580,98881,2,19,2015,UNK,780,-57631
4376700430,7/16/2014,572000.0,5,2.25,2340,9225,2.0,0.0,0.0,3,8,2340,0,1973,0,98052,47.6369,-122.098,2140,9348,7,16,2014,UNK,200,-123
8562890430,4/7/2015,386500.0,4,2.5,3110,5048,2.0,0.0,0.0,3,8,3110,0,2002,0,98042,47.3782,-122.125,3110,5190,4,7,2015,UNK,0,-142
452002005,1/21/2015,452000.0,2,1.0,980,5000,1.0,0.0,0.0,3,6,980,0,1904,0,98107,47.6744,-122.369,1270,4500,1,21,2015,UNK,-290,500
7228500094,12/12/2014,278000.0,4,2.0,1480,6324,1.0,0.0,0.0,3,7,1480,0,1943,0,98122,47.6147,-122.302,1480,3600,12,12,2014,UNK,0,2724
8078700020,6/3/2014,474900.0,3,2.25,1800,43647,1.0,0.0,0.0,4,8,1800,0,1976,0,98072,47.7757,-122.132,2480,25608,6,3,2014,UNK,-680,18039
5035300255,4/14/2015,450000.0,2,1.75,2130,6574,1.0,0.0,0.0,3,8,1500,630,1946,0,98199,47.6529,-122.411,2130,6275,4,14,2015,UNK,0,299
9528104985,11/4/2014,611000.0,2,1.0,1270,5100,1.0,0.0,0.0,3,7,1100,170,1900,0,98115,47.6771,-122.32799999999999,1670,3900,11,4,2014,UNK,-400,1200
7237590010,6/5/2014,214100.0,2,2.5,1150,2064,2.0,0.0,0.0,3,7,1150,0,2004,0,98001,47.3516,-122.292,1880,2855,6,5,2014,N,-730,-791
3158500250,5/14/2014,317000.0,3,2.5,1840,5011,2.0,0.0,0.0,3,8,1840,0,2012,0,98038,47.3555,-122.054,2000,4793,5,14,2014,N,-160,218
868001402,3/5/2015,1000000.0,4,3.5,3180,12528,2.0,0.0,1.0,4,9,2060,1120,1979,0,98177,47.7058,-122.37899999999999,2850,11410,3,5,2015,UNK,330,1118
5606000233,4/24/2015,1000000.0,5,2.75,1510,5700,2.0,0.0,1.0,4,7,1510,0,1946,0,98105,47.6653,-122.27,2190,5700,4,24,2015,UNK,-680,0
5214500660,5/5/2015,525000.0,4,2.5,3070,7200,2.0,0.0,0.0,3,8,3070,0,2005,0,98059,47.4899,-122.13799999999999,2590,7200,5,5,2015,N,480,0
3578110020,10/1/2014,436000.0,3,2.25,1800,6680,2.0,0.0,0.0,3,8,1800,0,1983,0,98034,47.7293,-122.223,1630,8621,10,1,2014,UNK,170,-1941
3578401330,7/18/2014,450000.0,3,1.75,1540,9154,1.0,0.0,0.0,3,8,1540,0,1983,0,98074,47.6207,-122.042,1990,10273,7,18,2014,UNK,-450,-1119
7525000080,5/2/2014,588500.0,3,1.75,2330,14892,1.0,0.0,0.0,3,8,1970,360,1980,0,98074,47.6267,-122.046,2570,14217,5,2,2014,UNK,-240,675
4273000095,5/11/2015,340000.0,4,1.75,1400,8374,1.0,0.0,0.0,3,7,1400,0,1953,0,98166,47.4735,-122.344,1420,8360,5,11,2015,UNK,-20,14
4014400190,7/14/2014,482000.0,4,2.5,2846,85377,1.5,0.0,0.0,3,8,1976,870,2000,0,98001,47.317,-122.281,1696,57934,7,14,2014,UNK,1150,27443
8678500020,12/13/2014,1580000.0,4,3.5,5830,131116,2.0,0.0,0.0,3,11,5830,0,2005,0,98024,47.5986,-121.949,5340,207206,12,13,2014,N,490,-76090
6918700130,8/11/2014,749000.0,3,2.5,3380,7126,2.0,0.0,0.0,3,8,3380,0,1965,2003,98008,47.6276,-122.12200000000001,1810,7308,8,11,2014,Y,1570,-182
2473350470,5/11/2015,330000.0,3,1.5,1440,7875,1.0,0.0,0.0,4,8,1440,0,1968,0,98058,47.4561,-122.148,1800,8964,5,11,2015,UNK,-360,-1089
9274200314,8/21/2014,568000.0,3,2.5,1740,1279,3.0,0.0,0.0,3,8,1740,0,2008,0,98116,47.5891,-122.387,1740,1280,8,21,2014,N,0,-1
2938100010,9/24/2014,239000.0,3,1.75,1470,8925,1.0,0.0,0.0,4,7,1470,0,1957,0,98022,47.2026,-122.0,1430,9282,9,24,2014,UNK,40,-357
8564950250,1/7/2015,528000.0,3,2.5,2810,4932,2.0,0.0,0.0,3,8,2810,0,2003,0,98011,47.7739,-122.227,2470,4919,1,7,2015,UNK,340,13
3438502715,7/30/2014,385000.0,4,3.0,2090,5102,1.0,0.0,0.0,3,7,1350,740,1994,0,98106,47.5427,-122.35600000000001,2090,5102,7,30,2014,UNK,0,0
280610020,9/2/2014,825000.0,4,3.25,4110,14219,2.0,0.0,2.0,4,10,2570,1540,1979,0,98028,47.7382,-122.264,2760,12283,9,2,2014,UNK,1350,1936
2487200938,11/26/2014,815000.0,5,3.25,3230,5000,2.0,0.0,1.0,3,9,2350,880,2002,0,98136,47.5202,-122.39299999999999,1520,5000,11,26,2014,UNK,1710,0
1775500362,10/13/2014,625000.0,4,2.5,2601,34335,2.0,0.0,0.0,3,9,2601,0,1995,0,98072,47.742,-122.087,2080,32336,10,13,2014,UNK,521,1999
2483200010,10/7/2014,690000.0,3,1.75,2070,6000,1.0,0.0,3.0,3,8,1340,730,1955,0,98136,47.5226,-122.382,2200,6000,10,7,2014,UNK,-130,0
4365700130,3/25/2015,210000.0,3,1.0,1660,7440,1.0,0.0,0.0,3,7,1270,390,1957,0,98106,47.5242,-122.36200000000001,1540,7440,3,25,2015,UNK,120,0
9136101271,4/16/2015,599000.0,4,1.0,1590,4280,1.5,0.0,0.0,3,7,1590,0,1924,0,98103,47.667,-122.335,2230,4280,4,16,2015,UNK,-640,0
1370804295,2/12/2015,860000.0,3,1.75,1860,5584,1.0,0.0,0.0,3,8,1310,550,1951,0,98199,47.637,-122.4,1630,6022,2,12,2015,UNK,230,-438
422049178,2/12/2015,147200.0,3,1.0,1420,9600,1.0,0.0,0.0,4,6,1420,0,1954,0,98188,47.4232,-122.292,1400,8415,2,12,2015,UNK,20,1185
9161100795,5/6/2015,476900.0,3,1.0,1240,5758,1.5,0.0,0.0,4,6,960,280,1910,0,98116,47.5675,-122.396,1460,5750,5,6,2015,UNK,-220,8
5561300380,8/7/2014,450000.0,4,2.5,2500,36254,1.0,0.0,0.0,4,8,1590,910,1978,0,98027,47.4685,-122.00399999999999,2360,36254,8,7,2014,UNK,140,0
1443550020,5/6/2015,570000.0,4,2.5,2640,11816,2.0,0.0,0.0,3,8,2640,0,1999,0,98019,47.733000000000004,-121.96799999999999,2400,11816,5,6,2015,UNK,240,0
9547201155,10/16/2014,567500.0,3,1.0,1440,3060,1.5,0.0,0.0,4,7,1440,0,1910,0,98115,47.6769,-122.307,1440,3570,10,16,2014,UNK,0,-510
3625059120,10/23/2014,790000.0,5,3.25,3030,20446,2.0,0.0,2.0,3,9,2130,900,1976,0,98008,47.6133,-122.10600000000001,2890,20908,10,23,2014,UNK,140,-462
644000185,7/7/2014,875000.0,3,1.5,1820,12686,1.0,0.0,0.0,4,7,1820,0,1952,0,98004,47.5886,-122.195,3020,11550,7,7,2014,UNK,-1200,1136
5710500010,6/10/2014,490000.0,3,2.0,2220,10275,2.0,0.0,0.0,3,9,1640,580,1980,0,98027,47.5304,-122.055,2300,9975,6,10,2014,UNK,-80,300
2482410130,6/10/2014,335000.0,3,1.75,2430,9133,1.0,0.0,0.0,4,7,1410,1020,1978,0,98059,47.5116,-122.15700000000001,1980,9592,6,10,2014,UNK,450,-459
6071900130,4/15/2015,550000.0,3,1.75,1670,10798,1.0,0.0,0.0,4,8,1670,0,1962,0,98006,47.549,-122.17,2290,10798,4,15,2015,UNK,-620,0
6817800630,5/16/2014,385000.0,3,1.75,1180,10541,1.0,0.0,0.0,4,7,940,240,1981,0,98074,47.6348,-122.03200000000001,1230,10879,5,16,2014,UNK,-50,-338
6204400130,7/18/2014,395000.0,3,1.75,1620,8085,1.0,0.0,0.0,3,7,1210,410,1976,0,98011,47.7349,-122.197,1700,8085,7,18,2014,UNK,-80,0
9274203190,6/11/2014,650000.0,2,1.0,1030,5750,1.0,0.0,0.0,5,8,1030,0,1928,0,98116,47.5861,-122.391,1570,5750,6,11,2014,UNK,-540,0
293610020,3/4/2015,637000.0,4,2.75,2900,5803,2.0,0.0,0.0,3,9,2900,0,2007,0,98028,47.7368,-122.23200000000001,2900,6212,3,4,2015,N,0,-409
3583400130,10/14/2014,692500.0,3,2.25,3420,9900,1.0,0.0,0.0,3,9,1710,1710,1963,2004,98028,47.7412,-122.256,2290,10700,10,14,2014,Y,1130,-800
7230400430,9/30/2014,322400.0,3,1.75,1710,15844,1.0,0.0,0.0,4,8,1710,0,1964,0,98059,47.4706,-122.1,1990,20359,9,30,2014,UNK,-280,-4515
7140600190,9/5/2014,233500.0,3,1.5,1580,10517,1.0,0.0,0.0,4,6,1580,0,1957,0,98002,47.2903,-122.214,1400,10658,9,5,2014,UNK,180,-141
6817801410,6/24/2014,400000.0,3,2.0,1230,11413,1.0,0.0,0.0,3,7,990,240,1984,0,98074,47.6321,-122.03399999999999,1570,11517,6,24,2014,UNK,-340,-104
6430500010,6/20/2014,547000.0,5,2.5,2200,4080,1.5,0.0,0.0,5,7,1420,780,1916,0,98103,47.6872,-122.35,1300,4080,6,20,2014,UNK,900,0
3023049215,7/2/2014,519000.0,5,2.25,2570,13054,1.0,0.0,1.0,3,8,1470,1100,1950,1992,98166,47.4487,-122.352,2570,19807,7,2,2014,Y,0,-6753
3625710080,6/26/2014,1030000.0,4,3.5,3320,19850,1.0,0.0,2.0,4,10,2040,0,1977,0,98040,47.527,-122.228,3240,15470,6,26,2014,UNK,80,4380
3390600010,5/2/2014,365000.0,3,1.0,1090,6435,1.0,0.0,0.0,4,7,1090,0,1955,0,98106,47.5334,-122.365,1340,6435,5,2,2014,UNK,-250,0
9238480020,3/19/2015,699000.0,5,2.75,2970,36817,2.0,0.0,0.0,4,8,2970,0,1978,0,98072,47.7731,-122.139,2730,29150,3,19,2015,UNK,240,7667
1036000080,10/9/2014,525000.0,3,1.75,1970,8000,1.0,0.0,0.0,4,8,1970,0,1968,0,98052,47.6324,-122.1,1910,8000,10,9,2014,UNK,60,0
1561930020,5/22/2014,430000.0,4,3.0,3220,8936,2.0,0.0,0.0,3,9,2450,770,1990,0,98031,47.4208,-122.213,2810,10500,5,22,2014,UNK,410,-1564
3876100080,12/15/2014,325000.0,3,1.0,1600,7500,1.0,0.0,0.0,3,7,1600,0,1966,0,98034,47.7198,-122.182,2050,7200,12,15,2014,UNK,-450,300
7454000605,7/10/2014,279000.0,2,1.0,670,6300,1.0,0.0,0.0,5,6,670,0,1942,0,98126,47.5161,-122.374,760,6300,7,10,2014,UNK,-90,0
1870400635,3/11/2015,805000.0,4,1.75,2360,4750,2.0,0.0,0.0,5,7,1660,700,1911,0,98115,47.6729,-122.29299999999999,1810,4750,3,11,2015,UNK,550,0
8820900299,2/4/2015,419950.0,3,3.0,2150,3962,1.5,0.0,0.0,3,7,1540,610,1949,0,98125,47.7183,-122.285,1730,4609,2,4,2015,UNK,420,-647
8132700185,4/16/2015,425000.0,2,1.0,620,4455,1.0,0.0,0.0,3,6,620,0,1927,0,98117,47.6877,-122.395,1180,5000,4,16,2015,UNK,-560,-545
6413600275,7/24/2014,446000.0,4,1.75,1730,5922,2.0,0.0,0.0,5,7,1730,0,1949,0,98125,47.7188,-122.321,1700,6127,7,24,2014,UNK,30,-205
2888000020,3/2/2015,455000.0,5,2.0,2500,7860,1.0,0.0,0.0,3,7,1040,1460,1963,0,98034,47.7212,-122.226,2060,9684,3,2,2015,UNK,440,-1824
3298700426,7/9/2014,226550.0,3,1.0,990,4440,1.0,0.0,0.0,3,6,990,0,1943,0,98106,47.522,-122.354,990,6771,7,9,2014,UNK,0,-2331
3362401815,9/30/2014,764000.0,3,2.0,1420,4080,1.5,0.0,0.0,5,8,1420,0,1904,0,98103,47.6801,-122.348,1220,3060,9,30,2014,UNK,200,1020
5469500020,5/5/2015,439950.0,3,2.25,2170,15000,2.0,0.0,0.0,4,8,2170,0,1978,0,98042,47.3863,-122.15799999999999,2430,14256,5,5,2015,UNK,-260,744
6430000280,12/16/2014,453000.0,4,2.0,1880,5100,1.0,0.0,0.0,3,8,1880,0,1952,0,98103,47.6872,-122.34899999999999,1610,4590,12,16,2014,UNK,270,510
1140000190,2/6/2015,219950.0,3,1.0,1300,9620,1.0,0.0,0.0,3,7,1300,0,1971,0,98003,47.282,-122.331,1420,9620,2,6,2015,UNK,-120,0
8021700715,5/14/2014,702500.0,3,1.5,2360,6750,2.0,0.0,0.0,5,7,1930,430,1926,0,98103,47.6923,-122.33200000000001,1320,4500,5,14,2014,UNK,1040,2250
5151600170,10/16/2014,285000.0,3,1.5,1780,12231,1.0,0.0,0.0,4,8,1780,0,1956,0,98003,47.335,-122.321,2460,12663,10,16,2014,UNK,-680,-432
8129700255,2/13/2015,798750.0,2,2.25,2160,2578,3.0,0.0,0.0,3,8,2160,0,2005,0,98103,47.6607,-122.354,1800,2142,2,13,2015,N,360,436
9285800345,6/26/2014,320000.0,2,1.0,950,5316,1.0,0.0,2.0,3,7,950,0,1948,0,98126,47.57,-122.38,1620,6085,6,26,2014,UNK,-670,-769
5706200170,12/16/2014,425000.0,3,1.75,1680,14630,1.5,0.0,0.0,3,8,1680,0,1985,0,98027,47.5272,-122.044,1920,14630,12,16,2014,UNK,-240,0
5536500020,7/16/2014,540000.0,4,2.5,2290,4450,2.0,0.0,0.0,3,9,2290,0,2004,0,98072,47.7385,-122.169,2570,5096,7,16,2014,N,-280,-646
98000950,12/10/2014,1060000.0,4,5.25,4140,14757,2.0,0.0,2.0,3,11,4140,0,2005,0,98075,47.5871,-121.969,4440,15523,12,10,2014,N,-300,-766
3362401611,3/25/2015,1170000.0,4,3.75,3920,4500,3.0,0.0,0.0,3,8,3920,0,2013,0,98103,47.6805,-122.346,2040,3000,3,25,2015,N,1880,1500
6205500280,4/21/2015,576000.0,3,1.75,1500,13891,1.0,0.0,0.0,4,7,1500,0,1951,0,98005,47.5866,-122.175,2020,13891,4,21,2015,UNK,-520,0
7199330010,4/17/2015,525000.0,3,1.75,1720,7200,1.0,0.0,0.0,3,7,1140,580,1977,0,98052,47.6977,-122.132,1700,8400,4,17,2015,UNK,20,-1200
1332200130,8/22/2014,324950.0,4,2.5,2641,8615,2.0,0.0,0.0,3,7,2641,0,1998,0,98031,47.4038,-122.213,2641,8091,8,22,2014,UNK,0,524
3244500078,8/22/2014,600000.0,3,2.5,4930,77536,2.0,0.0,0.0,3,9,3930,1000,1981,0,98072,47.7634,-122.139,2760,7351,8,22,2014,UNK,2170,70185
3342102880,8/11/2014,464000.0,3,2.5,2460,5400,1.0,0.0,0.0,4,8,1520,940,2001,0,98056,47.5231,-122.20200000000001,1745,5400,8,11,2014,UNK,715,0
2557000630,7/7/2014,266000.0,4,2.25,1995,7102,2.0,0.0,0.0,4,8,1995,0,1981,0,98023,47.2986,-122.37,1880,7950,7,7,2014,UNK,115,-848
1117200190,8/4/2014,775000.0,3,2.5,3010,74390,2.0,0.0,0.0,3,10,3010,0,1998,0,98053,47.6442,-121.999,3240,109771,8,4,2014,UNK,-230,-35381
8122100130,6/18/2014,415000.0,3,1.75,1270,4800,1.0,0.0,0.0,3,7,1270,0,1952,2014,98126,47.5362,-122.376,1220,4800,6,18,2014,Y,50,0
9558040050,9/19/2014,550000.0,4,2.75,3080,6731,2.0,0.0,3.0,3,9,3080,0,2003,0,98058,47.4522,-122.118,3080,6731,9,19,2014,UNK,0,0
5702380630,1/14/2015,235000.0,3,2.25,1670,7606,2.0,0.0,0.0,3,7,1670,0,1990,0,98022,47.1949,-121.98200000000001,1670,7433,1,14,2015,UNK,0,173
3300790670,6/20/2014,280000.0,3,2.0,1470,8089,1.0,0.0,0.0,3,7,1470,0,1987,0,98198,47.3878,-122.316,1530,7721,6,20,2014,UNK,-60,368
2558660190,10/30/2014,459000.0,3,1.75,1730,7807,1.0,0.0,0.0,3,7,1260,470,1976,0,98034,47.7211,-122.169,1800,7650,10,30,2014,UNK,-70,157
4388000460,10/14/2014,195000.0,3,1.0,1070,7615,1.0,0.0,0.0,4,7,1070,0,1969,0,98023,47.3189,-122.37299999999999,1240,6906,10,14,2014,UNK,-170,709
3224800010,11/12/2014,235000.0,3,1.5,1660,8738,1.0,0.0,0.0,4,7,1080,580,1959,0,98002,47.3117,-122.208,1500,8466,11,12,2014,UNK,160,272
1672000020,11/26/2014,711800.0,4,2.25,2410,16650,1.0,0.0,0.0,4,8,2410,0,1965,0,98006,47.5706,-122.163,2720,11141,11,26,2014,UNK,-310,5509
2767701416,1/16/2015,440000.0,3,2.5,1040,1032,3.0,0.0,0.0,3,7,1040,0,2007,0,98107,47.6673,-122.37700000000001,1290,1275,1,16,2015,N,-250,-243
7821200307,2/17/2015,515000.0,2,1.0,970,3300,1.0,0.0,0.0,4,7,970,0,1916,0,98103,47.6609,-122.34299999999999,1060,3600,2,17,2015,UNK,-90,-300
4219400290,5/2/2014,1200000.0,5,2.75,2910,9480,1.5,0.0,0.0,3,8,2910,0,1939,0,98105,47.6552,-122.27799999999999,2940,6600,5,2,2014,UNK,-30,2880
6072650290,4/6/2015,560000.0,3,1.75,2340,12443,1.5,0.0,0.0,4,8,2340,0,1965,0,98006,47.5432,-122.177,1970,9600,4,6,2015,UNK,370,2843
5647900670,6/20/2014,340000.0,3,1.75,1880,11249,1.0,0.0,0.0,3,7,1330,550,1985,0,98001,47.3295,-122.257,1870,14547,6,20,2014,UNK,10,-3298
1965200010,11/10/2014,600000.0,2,1.0,1110,3500,1.5,0.0,0.0,3,6,970,140,1912,0,98102,47.6453,-122.32700000000001,1884,1778,11,10,2014,UNK,-774,1722
319500080,6/18/2014,764000.0,4,2.5,2790,7938,2.0,0.0,0.0,3,9,2790,0,1997,0,98074,47.6223,-122.02600000000001,2780,7779,6,18,2014,UNK,10,159
9526500080,7/29/2014,337000.0,4,2.0,1590,8779,1.0,0.0,0.0,3,8,1590,0,2001,0,98019,47.7408,-121.97399999999999,2090,9600,7,29,2014,UNK,-500,-821
7856410430,5/30/2014,1390000.0,6,2.75,5700,20000,1.0,0.0,4.0,4,10,2850,2850,1977,0,98006,47.5601,-122.16,3690,15700,5,30,2014,UNK,2010,4300
8128700005,11/19/2014,249000.0,4,1.0,1200,7552,1.0,0.0,0.0,3,6,1060,140,1919,0,98126,47.5317,-122.37,1580,7680,11,19,2014,UNK,-380,-128
3444910020,7/15/2014,350000.0,3,3.0,3200,35782,1.0,0.0,0.0,3,8,2360,840,1978,0,98042,47.4121,-122.154,3090,37887,7,15,2014,UNK,110,-2105
2025700130,1/29/2015,269950.0,3,2.25,1510,6000,1.0,0.0,0.0,4,7,1150,360,1993,0,98038,47.3484,-122.036,1510,6000,1,29,2015,UNK,0,0
224069134,2/25/2015,735000.0,3,1.75,1880,108900,1.0,0.0,0.0,3,7,1880,0,1978,0,98075,47.5913,-122.01,2730,37731,2,25,2015,UNK,-850,71169
4217400305,3/31/2015,1300000.0,4,2.5,3070,4000,2.0,0.0,0.0,4,8,2070,1000,1940,0,98105,47.659,-122.281,2560,4000,3,31,2015,UNK,510,0
3288301410,9/11/2014,475000.0,4,2.25,2110,7560,2.0,0.0,0.0,4,8,2110,0,1974,0,98034,47.7331,-122.18299999999999,2110,7560,9,11,2014,UNK,0,0
9264950660,3/10/2015,339000.0,3,2.0,2350,8459,1.5,0.0,0.0,3,9,2350,0,1989,0,98023,47.3043,-122.34899999999999,2430,8459,3,10,2015,UNK,-80,0
6744700285,3/11/2015,600000.0,4,3.5,3270,15160,1.0,0.0,2.0,3,8,1660,1610,1997,0,98155,47.7437,-122.287,2790,15160,3,11,2015,UNK,480,0
7750500275,8/7/2014,397500.0,4,1.75,2220,4760,1.0,0.0,0.0,3,7,1320,900,1918,0,98106,47.5215,-122.348,940,4760,8,7,2014,UNK,1280,0
1125069153,8/22/2014,1530000.0,4,3.5,5990,111078,2.0,0.0,0.0,3,11,5990,0,2004,0,98053,47.667,-121.994,4690,118918,8,22,2014,N,1300,-7840
1425059178,5/7/2014,460000.0,3,2.0,1760,9055,2.0,0.0,0.0,4,7,1760,0,1985,0,98052,47.6534,-122.12799999999999,2010,9383,5,7,2014,UNK,-250,-328
6671900130,12/16/2014,370000.0,4,2.75,2200,5207,1.0,0.0,0.0,5,7,1120,1080,1951,0,98133,47.74,-122.34299999999999,1210,6008,12,16,2014,UNK,990,-801
3172600151,3/25/2015,250000.0,4,1.0,1550,7296,1.5,0.0,0.0,3,6,1550,0,1957,0,98106,47.5184,-122.366,1370,7680,3,25,2015,UNK,180,-384
7237550020,7/3/2014,1100000.0,4,3.75,5070,60123,2.0,0.0,0.0,3,11,5070,0,2000,0,98053,47.6567,-122.00399999999999,4920,101930,7,3,2014,UNK,150,-41807
1934800078,9/30/2014,430000.0,2,2.25,1040,1516,2.0,0.0,0.0,3,8,1040,0,2008,0,98122,47.6037,-122.307,1560,1920,9,30,2014,N,-520,-404
4385700660,8/7/2014,1090000.0,3,1.5,2560,4000,1.5,0.0,0.0,5,8,1660,900,1927,0,98112,47.6384,-122.279,2560,4000,8,7,2014,UNK,0,0
923000414,4/19/2015,670000.0,3,1.75,1850,8160,1.0,0.0,0.0,3,8,1850,0,1952,0,98177,47.7241,-122.363,1600,8160,4,19,2015,UNK,250,0
2624049167,4/23/2015,461550.0,3,1.5,2090,11895,1.0,0.0,0.0,3,7,1790,300,1954,0,98118,47.5362,-122.26700000000001,2180,11072,4,23,2015,UNK,-90,823
8929000380,8/5/2014,479990.0,3,2.5,2010,2386,2.0,0.0,0.0,3,8,1390,620,2014,0,98029,47.5525,-121.99799999999999,1690,1870,8,5,2014,N,320,516
4221250010,4/14/2015,643000.0,4,2.5,2518,4663,2.0,0.0,0.0,3,8,2518,0,2005,0,98075,47.5894,-122.01700000000001,2280,4525,4,14,2015,N,238,138
8861500080,9/30/2014,607000.0,3,2.75,2810,12813,2.0,0.0,0.0,3,8,2040,770,1988,0,98052,47.6796,-122.11399999999999,1890,10336,9,30,2014,UNK,920,2477
1592000780,5/23/2014,625000.0,3,2.5,2600,10092,1.0,0.0,0.0,3,9,2600,0,1984,0,98074,47.6223,-122.03200000000001,2440,9298,5,23,2014,UNK,160,794
2484200080,7/29/2014,731100.0,3,2.5,2060,8778,1.0,0.0,0.0,3,8,1160,900,1953,2010,98136,47.5245,-122.384,1990,7560,7,29,2014,Y,70,1218
2322059136,3/9/2015,859000.0,3,2.5,2920,434728,2.0,0.0,3.0,4,8,2920,0,1999,0,98042,47.3809,-122.13,3150,55216,3,9,2015,UNK,-230,379512
2591820080,11/3/2014,435000.0,4,2.5,2130,10375,2.0,0.0,0.0,4,8,2130,0,1986,0,98058,47.4381,-122.16,2220,8508,11,3,2014,UNK,-90,1867
5729000080,10/29/2014,465000.0,3,3.0,2290,15600,1.0,0.0,0.0,3,8,1420,870,1948,1990,98001,47.3558,-122.29,1890,14143,10,29,2014,Y,400,1457
5100402764,4/15/2015,740000.0,3,1.0,1230,6380,1.5,0.0,0.0,3,7,1230,0,1927,0,98115,47.6947,-122.315,1250,6380,4,15,2015,UNK,-20,0
5454000010,12/10/2014,740000.0,3,1.75,2020,9478,1.0,0.0,0.0,4,9,2020,0,1961,0,98040,47.5383,-122.238,3050,15594,12,10,2014,UNK,-1030,-6116
5412300130,11/19/2014,250000.0,3,2.0,1430,7280,1.0,0.0,0.0,3,7,990,440,1980,0,98030,47.3742,-122.18,1430,7280,11,19,2014,UNK,0,0
6873000190,3/11/2015,656000.0,2,2.5,2270,1763,3.0,0.0,0.0,3,7,1820,450,2009,0,98052,47.6757,-122.12100000000001,2180,1763,3,11,2015,N,90,0
9485300190,10/9/2014,300000.0,4,2.5,1910,8058,2.0,0.0,0.0,3,8,1910,0,1992,0,98031,47.3891,-122.17200000000001,1910,6500,10,9,2014,UNK,0,1558
326069132,2/20/2015,643000.0,3,1.5,1780,214315,1.0,0.0,0.0,3,7,1780,0,1954,0,98077,47.7631,-122.02799999999999,2740,133419,2,20,2015,UNK,-960,80896
3832061060,8/7/2014,311000.0,4,2.5,2690,6124,2.0,0.0,0.0,3,7,2690,0,2007,0,98042,47.3343,-122.05799999999999,2300,6002,8,7,2014,N,390,122
6918730130,7/21/2014,360000.0,3,1.75,1330,7482,1.0,0.0,0.0,4,7,1330,0,1975,0,98034,47.7322,-122.20700000000001,1480,8096,7,21,2014,UNK,-150,-614
7952800010,5/19/2014,475000.0,4,2.5,3060,10043,1.0,0.0,0.0,4,8,1700,1360,1968,0,98133,47.7387,-122.337,1630,8296,5,19,2014,UNK,1430,1747
3834500417,8/9/2014,469950.0,3,3.25,1760,1778,3.0,0.0,0.0,3,8,1760,0,2008,0,98125,47.7201,-122.301,1520,1615,8,9,2014,N,240,163
5071700020,7/3/2014,240000.0,3,1.75,1570,8750,1.0,0.0,0.0,3,7,1570,0,1960,0,98148,47.4425,-122.333,1890,8825,7,3,2014,UNK,-320,-75
3826000470,9/29/2014,232000.0,2,1.0,960,8100,1.0,0.0,0.0,3,6,810,150,1936,0,98168,47.494,-122.304,960,12150,9,29,2014,UNK,0,-4050
921059132,8/13/2014,350000.0,3,2.0,1680,81893,1.0,0.0,0.0,3,7,1680,0,1991,0,98092,47.3248,-122.179,2480,38637,8,13,2014,UNK,-800,43256
1926059027,1/9/2015,803000.0,2,1.0,1440,33747,1.5,0.0,0.0,3,7,1440,0,1928,0,98034,47.7223,-122.209,1980,8400,1,9,2015,UNK,-540,25347
1328320440,12/10/2014,355000.0,3,2.25,1960,7000,1.0,0.0,0.0,3,8,1600,360,1980,0,98058,47.4427,-122.126,1980,7140,12,10,2014,UNK,-20,-140
1972202005,5/21/2014,475000.0,4,2.0,1790,2250,1.0,0.0,2.0,4,7,840,950,1909,0,98103,47.6526,-122.345,1440,1545,5,21,2014,UNK,350,705
2592201350,3/24/2015,823000.0,3,2.5,2560,9825,2.0,0.0,0.0,4,9,2560,0,1988,0,98006,47.5497,-122.145,2710,12034,3,24,2015,UNK,-150,-2209
6430500293,11/12/2014,395000.0,2,1.5,1010,3060,1.0,0.0,0.0,4,7,1010,0,1918,0,98103,47.6897,-122.354,1160,4080,11,12,2014,UNK,-150,-1020
6450300840,4/27/2015,499000.0,4,3.75,2560,5250,2.0,0.0,0.0,3,7,1900,660,1963,2006,98133,47.7326,-122.34200000000001,1400,5250,4,27,2015,Y,1160,0
1189000225,4/2/2015,420000.0,2,1.75,1200,3136,1.0,0.0,0.0,3,7,800,400,1904,2005,98122,47.6132,-122.29700000000001,1330,3164,4,2,2015,Y,-130,-28
7804700020,8/12/2014,961500.0,3,2.5,3910,14000,2.0,0.0,0.0,3,10,3910,0,1999,0,98008,47.6374,-122.12,2280,14000,8,12,2014,UNK,1630,0
9542300430,3/31/2015,833000.0,4,1.75,2260,12238,1.0,0.0,0.0,3,9,2260,0,1967,0,98005,47.5976,-122.178,2430,10204,3,31,2015,UNK,-170,2034
1775930440,6/23/2014,479000.0,3,2.25,2110,11319,2.0,0.0,0.0,4,8,2110,0,1978,0,98072,47.742,-122.105,1860,11319,6,23,2014,UNK,250,0
1725059182,7/1/2014,1150000.0,4,2.5,3340,10422,2.0,0.0,0.0,3,10,3340,0,1996,0,98033,47.6515,-122.197,1770,9490,7,1,2014,UNK,1570,932
3992700130,7/8/2014,267000.0,3,1.0,1400,8100,1.5,0.0,0.0,3,6,1400,0,1944,0,98125,47.7124,-122.289,1420,8100,7,8,2014,UNK,-20,0
824069193,9/11/2014,555000.0,4,1.75,1760,94525,1.5,0.0,0.0,3,7,1760,0,1988,0,98075,47.5882,-122.07,3030,34848,9,11,2014,UNK,-1270,59677
3904910480,7/31/2014,490000.0,3,2.5,2010,9725,2.0,0.0,0.0,4,8,2010,0,1987,0,98029,47.56800000000001,-122.01799999999999,1850,6858,7,31,2014,UNK,160,2867
2877102651,5/29/2014,619000.0,4,2.0,2300,3400,1.5,0.0,0.0,5,8,1550,750,1915,0,98117,47.678000000000004,-122.361,1670,4200,5,29,2014,UNK,630,-800
9289100170,10/31/2014,569950.0,5,2.75,2510,28185,1.0,0.0,0.0,4,7,1600,910,1963,0,98155,47.7719,-122.28200000000001,2910,14880,10,31,2014,UNK,-400,13305
3797000680,11/25/2014,549000.0,3,2.0,1340,3000,2.0,0.0,0.0,5,7,1340,0,1905,0,98103,47.6857,-122.34899999999999,1120,3000,11,25,2014,UNK,220,0
3378900020,10/23/2014,422500.0,3,1.75,1560,7245,1.5,0.0,0.0,3,7,1560,0,1962,1985,98052,47.6868,-122.119,2220,8502,10,23,2014,Y,-660,-1257
4180300050,8/1/2014,400000.0,4,3.5,3350,9681,1.0,0.0,1.0,3,7,2140,1210,1980,0,98198,47.3978,-122.322,2580,9681,8,1,2014,UNK,770,0
7852010670,7/9/2014,692500.0,4,2.75,3710,7984,2.0,0.0,0.0,3,9,3710,0,1999,0,98065,47.5352,-121.868,2950,7984,7,9,2014,UNK,760,0
8562890280,6/26/2014,310000.0,4,2.5,2430,5499,2.0,0.0,0.0,3,8,2430,0,2002,0,98042,47.3779,-122.125,2890,5190,6,26,2014,UNK,-460,309
3991400080,12/16/2014,499900.0,3,1.75,2430,8820,1.0,0.0,2.0,3,8,1630,800,1977,0,98178,47.4972,-122.23299999999999,2390,10050,12,16,2014,UNK,40,-1230
8651510020,8/27/2014,492000.0,3,2.25,2100,7335,2.0,0.0,0.0,3,8,2100,0,1983,0,98074,47.647,-122.061,2050,8930,8,27,2014,UNK,50,-1595
3924500130,5/6/2015,460000.0,2,2.5,1880,40575,1.0,0.0,0.0,3,9,1880,0,1987,0,98024,47.5614,-121.899,1930,32935,5,6,2015,UNK,-50,7640
2533300130,7/16/2014,800000.0,3,2.5,1630,2640,2.0,0.0,0.0,5,8,1630,0,1919,0,98119,47.6452,-122.37100000000001,1630,3000,7,16,2014,UNK,0,-360
510002995,4/7/2015,832600.0,4,1.0,1640,4200,1.5,0.0,0.0,3,7,1640,0,1925,0,98103,47.6601,-122.33200000000001,1730,3990,4,7,2015,UNK,-90,210
3825500080,3/18/2015,470000.0,4,2.75,2310,7350,1.0,0.0,0.0,3,8,1670,640,1989,0,98011,47.7505,-122.182,2600,6077,3,18,2015,UNK,-290,1273
8682231190,10/21/2014,542000.0,2,2.0,1930,4500,1.0,0.0,0.0,3,8,1930,0,2003,0,98053,47.7104,-122.031,1670,5200,10,21,2014,UNK,260,-700
9412400185,6/19/2014,1310000.0,4,4.5,4750,13912,2.0,0.0,2.0,3,10,3600,1150,2005,0,98118,47.5332,-122.265,3600,22124,6,19,2014,N,1150,-8212
7893804790,10/10/2014,308130.0,4,2.5,2300,7500,1.0,0.0,3.0,2,7,1650,650,1959,0,98198,47.4125,-122.33,2300,7500,10,10,2014,UNK,0,0
3630070010,3/11/2015,310000.0,2,1.0,1050,2699,1.0,0.0,0.0,3,7,1050,0,2005,0,98029,47.5471,-121.99600000000001,1240,2671,3,11,2015,N,-190,28
723049132,10/22/2014,235000.0,2,1.0,1500,8015,1.0,0.0,0.0,3,6,1500,0,1947,0,98146,47.5027,-122.348,1130,8015,10,22,2014,UNK,370,0
1432600415,9/19/2014,215000.0,3,1.0,1150,7560,1.0,0.0,0.0,4,6,1150,0,1958,0,98058,47.4613,-122.184,1230,7560,9,19,2014,UNK,-80,0
3306200010,6/5/2014,210000.0,4,1.5,1920,10403,1.0,0.0,0.0,3,7,1370,550,1959,0,98023,47.2987,-122.366,1550,9619,6,5,2014,UNK,370,784
425069102,11/26/2014,730000.0,4,2.75,3660,150282,2.0,0.0,0.0,3,10,3660,0,1990,0,98053,47.6813,-122.04799999999999,3090,53578,11,26,2014,UNK,570,96704
1683600130,12/10/2014,245000.0,3,1.75,1720,9342,1.0,0.0,0.0,4,7,1140,580,1981,0,98092,47.3177,-122.182,1330,7540,12,10,2014,UNK,390,1802
3741600020,9/15/2014,540000.0,3,2.25,2100,20018,1.0,0.0,4.0,3,8,1470,630,1948,0,98166,47.4544,-122.366,2410,17196,9,15,2014,UNK,-310,2822
5412101150,2/3/2015,299000.0,4,2.5,2400,6078,2.0,0.0,0.0,3,8,2400,0,2001,0,98001,47.2606,-122.285,2406,7642,2,3,2015,UNK,-6,-1564
509000020,11/18/2014,510000.0,3,2.5,2540,40106,2.0,0.0,0.0,3,10,2540,0,1991,0,98074,47.6037,-122.04299999999999,3190,71797,11,18,2014,UNK,-650,-31691
1311500020,7/3/2014,198000.0,4,1.75,2080,7200,1.0,0.0,0.0,4,7,1050,1030,1966,0,98001,47.3385,-122.28200000000001,1500,7350,7,3,2014,UNK,580,-150
662350050,5/23/2014,950000.0,5,3.25,3400,7452,2.0,0.0,0.0,3,10,3400,0,1999,0,98007,47.6141,-122.13600000000001,2650,8749,5,23,2014,UNK,750,-1297
3327020290,2/20/2015,300000.0,4,1.75,2200,7600,2.0,0.0,0.0,3,8,2200,0,1978,0,98092,47.3131,-122.191,1910,7600,2,20,2015,UNK,290,0
1086100130,9/4/2014,528000.0,5,1.75,2140,8580,1.0,0.0,0.0,3,7,1200,940,1962,0,98033,47.6625,-122.178,1600,9206,9,4,2014,UNK,540,-626
2111011060,6/18/2014,507000.0,5,3.25,3850,16249,2.0,0.0,2.0,3,9,3030,820,2002,0,98092,47.3324,-122.16799999999999,2640,7393,6,18,2014,UNK,1210,8856
7852090280,2/19/2015,770000.0,4,3.25,4270,6384,2.0,0.0,0.0,3,9,3060,1210,2001,0,98065,47.5362,-121.874,2850,6285,2,19,2015,UNK,1420,99
2873000780,2/20/2015,255000.0,3,1.75,1340,7210,1.0,0.0,0.0,4,7,1340,0,1975,0,98031,47.4182,-122.167,1370,7210,2,20,2015,UNK,-30,0
3530470190,5/5/2015,220000.0,1,1.5,1100,3451,1.5,0.0,0.0,4,8,1100,0,1978,0,98198,47.3829,-122.322,1400,4560,5,5,2015,UNK,-300,-1109
5014600440,2/23/2015,690700.0,5,2.75,2870,5349,2.0,0.0,0.0,3,9,2870,0,2005,0,98059,47.5405,-122.18700000000001,2800,5000,2,23,2015,N,70,349
5049800005,6/27/2014,447000.0,2,1.0,1320,8380,1.0,0.0,0.0,3,7,1320,0,1953,0,98177,47.705,-122.367,1290,8025,6,27,2014,UNK,30,355
7443001470,5/20/2014,755000.0,6,2.0,2150,4505,1.0,0.0,0.0,3,7,1270,880,1952,0,98119,47.6514,-122.369,1740,4505,5,20,2014,UNK,410,0
2771604640,3/13/2015,700000.0,4,1.5,2470,6000,1.5,0.0,0.0,3,7,1480,990,1940,0,98199,47.6365,-122.391,2140,4000,3,13,2015,UNK,330,2000
7140200280,7/15/2014,250000.0,4,2.75,1910,7700,1.0,0.0,0.0,4,7,1000,910,1980,0,98030,47.369,-122.17,1880,7875,7,15,2014,UNK,30,-175
3793500780,5/10/2014,320000.0,3,2.5,2130,6969,2.0,0.0,0.0,3,7,2130,0,2003,0,98038,47.3655,-122.027,1670,9545,5,10,2014,UNK,460,-2576
5525400420,5/14/2014,565000.0,4,2.5,2240,14667,2.0,0.0,0.0,4,9,2240,0,1989,0,98059,47.5276,-122.161,2410,11243,5,14,2014,UNK,-170,3424
7986400305,4/24/2015,754300.0,5,2.75,1800,4500,2.0,0.0,0.0,4,7,1680,120,1939,0,98107,47.6648,-122.35799999999999,1730,4500,4,24,2015,UNK,70,0
3619600143,5/5/2014,650000.0,3,1.5,2160,9000,1.0,0.0,2.0,4,8,1400,0,1949,0,98177,47.7241,-122.369,3010,9000,5,5,2014,UNK,-850,0
7787890050,2/18/2015,529888.0,4,2.5,3140,8455,2.0,0.0,0.0,3,8,3140,0,2003,0,98059,47.4866,-122.147,3140,7391,2,18,2015,UNK,0,1064
2780700050,11/6/2014,432000.0,3,2.5,1920,9812,2.0,0.0,0.0,3,8,1920,0,2000,0,98028,47.7633,-122.243,1830,10534,11,6,2014,UNK,90,-722
5595900280,3/18/2015,235000.0,3,1.0,1050,7670,1.5,0.0,0.0,5,7,1050,0,1955,0,98022,47.2046,-121.99600000000001,1220,7670,3,18,2015,UNK,-170,0
7203220130,1/27/2015,994900.0,4,3.5,3695,6556,2.0,0.0,0.0,3,9,3695,0,2014,0,98053,47.683,-122.015,4160,6786,1,27,2015,N,-465,-230
9406540130,4/3/2015,489000.0,4,2.5,3910,8442,2.0,0.0,0.0,3,9,2710,1200,2000,0,98038,47.3766,-122.027,2650,7576,4,3,2015,UNK,1260,866
9526600250,4/20/2015,800000.0,4,2.75,3010,7427,2.0,0.0,0.0,3,8,3010,0,2010,0,98052,47.7068,-122.11200000000001,3000,4929,4,20,2015,N,10,2498
9542900190,5/16/2014,370000.0,4,1.5,1370,9957,1.0,0.0,0.0,3,7,900,470,1972,0,98034,47.7237,-122.181,1510,8088,5,16,2014,UNK,-140,1869
3840700653,12/12/2014,436000.0,4,2.75,2080,9600,1.0,0.0,0.0,3,8,1240,840,1979,0,98034,47.7149,-122.235,1880,9525,12,12,2014,UNK,200,75
6084200080,5/28/2014,395000.0,3,2.5,2250,3757,2.0,0.0,0.0,3,7,2250,0,2006,0,98059,47.4787,-122.12899999999999,2250,4556,5,28,2014,N,0,-799
3705900130,5/23/2014,377691.0,5,1.75,2120,8399,1.0,0.0,0.0,4,7,1320,800,1942,0,98133,47.7621,-122.335,2120,8398,5,23,2014,UNK,0,1
3333002385,4/17/2015,370000.0,5,3.0,2220,5185,2.0,0.0,3.0,3,7,2220,0,2003,0,98118,47.543,-122.29,2340,6316,4,17,2015,UNK,-120,-1131
3904910050,10/23/2014,515000.0,3,2.5,1440,4394,1.0,0.0,0.0,5,8,1440,0,1987,0,98029,47.5688,-122.01899999999999,1900,5893,10,23,2014,UNK,-460,-1499
5556900080,9/26/2014,169000.0,3,1.0,910,7686,1.0,0.0,0.0,3,7,910,0,1969,0,98001,47.3405,-122.288,1020,7686,9,26,2014,UNK,-110,0
4443800415,3/21/2015,475000.0,3,1.0,1270,4268,1.0,0.0,0.0,3,7,1270,0,1921,0,98117,47.6848,-122.39200000000001,1310,4080,3,21,2015,UNK,-40,188
3791400250,4/25/2015,420000.0,3,2.5,2480,6180,2.0,0.0,0.0,3,9,2480,0,1999,0,98031,47.4044,-122.208,2870,6180,4,25,2015,UNK,-390,0
9551201585,7/1/2014,1300000.0,6,2.75,2630,9420,2.0,0.0,0.0,5,9,2510,120,1900,0,98103,47.6695,-122.337,1540,4969,7,1,2014,UNK,1090,4451
7856620050,2/25/2015,822000.0,3,2.0,2410,13300,2.0,0.0,0.0,3,9,1840,570,1985,0,98006,47.5632,-122.148,2930,10900,2,25,2015,UNK,-520,2400
9320200050,12/16/2014,1500000.0,4,2.75,2930,25697,1.0,0.0,0.0,4,9,2310,620,1964,0,98004,47.6264,-122.226,3810,20681,12,16,2014,UNK,-880,5016
1954420380,3/30/2015,485000.0,3,2.25,1570,6810,1.0,0.0,0.0,3,8,1180,390,1988,0,98074,47.6176,-122.044,1620,6584,3,30,2015,UNK,-50,226
740500010,8/7/2014,270000.0,4,1.0,1900,8505,1.0,0.0,0.0,3,7,1200,700,1956,0,98055,47.4406,-122.196,1440,8505,8,7,2014,UNK,460,0
6673050020,4/1/2015,300000.0,6,2.5,2590,11250,1.0,0.0,0.0,4,8,1390,1200,1978,0,98055,47.4608,-122.196,2270,8360,4,1,2015,UNK,320,2890
1853081060,4/16/2015,878000.0,4,2.5,3810,7728,2.0,0.0,0.0,3,9,3810,0,2007,0,98074,47.5925,-122.05799999999999,3290,7728,4,16,2015,N,520,0
6308000020,4/3/2015,590000.0,3,2.5,2290,4203,2.0,0.0,0.0,3,9,2290,0,2001,0,98006,47.5441,-122.17200000000001,2290,5089,4,3,2015,UNK,0,-886
1720800305,11/19/2014,611900.0,1,2.25,1220,2100,2.0,0.0,2.0,4,8,1220,0,1946,1979,98033,47.6703,-122.204,3150,6000,11,19,2014,Y,-1930,-3900
1682000280,3/19/2015,240000.0,3,1.75,1100,7373,1.0,0.0,0.0,4,7,1100,0,1968,0,98092,47.3124,-122.18299999999999,1430,8415,3,19,2015,UNK,-330,-1042
3814800280,4/17/2015,395000.0,4,2.5,2810,10951,2.0,0.0,0.0,3,8,2810,0,2003,0,98092,47.3249,-122.18700000000001,1680,6625,4,17,2015,UNK,1130,4326
3352402195,7/16/2014,169000.0,3,1.0,890,7110,1.0,0.0,0.0,3,6,890,0,1957,0,98178,47.4971,-122.26100000000001,1100,8375,7,16,2014,UNK,-210,-1265
9320600170,3/24/2015,200500.0,3,2.0,1280,14972,1.0,0.0,0.0,3,7,1280,0,1963,0,98031,47.4129,-122.209,1800,9698,3,24,2015,UNK,-520,5274
5205000250,4/10/2015,308000.0,3,2.5,2320,7140,2.0,0.0,0.0,3,8,2320,0,1990,0,98003,47.275,-122.295,2360,7955,4,10,2015,UNK,-40,-815
9264920250,7/10/2014,290256.0,3,2.25,1720,7885,2.0,0.0,0.0,3,8,1720,0,1983,0,98023,47.3136,-122.344,2340,7885,7,10,2014,UNK,-620,0
2473101190,4/27/2015,279950.0,3,1.75,1530,8800,1.0,0.0,0.0,4,7,1040,490,1967,0,98058,47.4483,-122.15799999999999,1530,8690,4,27,2015,UNK,0,110
5437820020,8/7/2014,195000.0,3,1.75,1580,7875,1.0,0.0,0.0,3,7,1580,0,1979,0,98022,47.1958,-122.00299999999999,1560,8314,8,7,2014,UNK,20,-439
4067600275,8/26/2014,630000.0,3,1.0,1360,13000,1.0,0.0,0.0,5,6,1360,0,1945,0,98010,47.3359,-122.03299999999999,1890,19650,8,26,2014,UNK,-530,-6650
6447300345,4/6/2015,1160000.0,4,3.0,2680,15438,2.0,0.0,2.0,3,8,2680,0,1902,1956,98039,47.6109,-122.226,4480,14406,4,6,2015,Y,-1800,1032
3905100280,7/1/2014,478000.0,3,2.25,1640,3896,2.0,0.0,0.0,3,8,1640,0,1994,0,98029,47.5689,-122.006,1780,3999,7,1,2014,UNK,-140,-103
9285800275,8/14/2014,835000.0,3,2.25,2520,6690,2.0,0.0,2.0,5,8,1700,820,1944,1990,98126,47.5705,-122.381,1990,5792,8,14,2014,Y,530,898
1891100130,4/17/2015,639000.0,3,2.25,1400,2421,2.0,0.0,0.0,3,9,1400,0,2005,0,98034,47.695,-122.169,1500,2743,4,17,2015,N,-100,-322
1592000250,10/13/2014,623000.0,4,2.75,2300,12633,2.0,0.0,0.0,3,9,2300,0,1984,0,98074,47.6218,-122.03200000000001,2240,9246,10,13,2014,UNK,60,3387
2328800130,12/17/2014,220000.0,3,1.75,1900,7680,1.0,0.0,0.0,3,7,1260,640,1959,0,98178,47.5081,-122.266,2000,7740,12,17,2014,UNK,-100,-60
6067910130,3/25/2015,526000.0,3,2.25,2000,18099,1.0,0.0,0.0,4,8,1250,750,1978,0,98006,47.5443,-122.18,2060,12000,3,25,2015,UNK,-60,6099
3333002790,1/23/2015,243500.0,2,1.0,900,5016,1.0,0.0,0.0,3,6,900,0,1948,0,98118,47.542,-122.28200000000001,1420,5184,1,23,2015,UNK,-520,-168
9478400080,5/12/2014,750000.0,4,2.5,2980,4930,2.0,0.0,0.0,3,9,2890,90,2000,0,98006,47.5445,-122.12,2980,6099,5,12,2014,UNK,0,-1169
3450300020,3/18/2015,329000.0,4,2.0,1850,9126,1.0,0.0,0.0,5,7,1850,0,1963,0,98059,47.5009,-122.164,1730,9110,3,18,2015,UNK,120,16
2663000050,9/26/2014,525000.0,4,1.0,1570,4000,1.5,0.0,0.0,3,7,1570,0,1920,0,98102,47.6275,-122.321,1610,4000,9,26,2014,UNK,-40,0
3145600250,3/17/2015,190000.0,2,1.0,670,3101,1.0,0.0,0.0,4,6,670,0,1948,0,98118,47.5546,-122.274,1660,4100,3,17,2015,UNK,-990,-999
6206100130,6/26/2014,772650.0,4,2.5,2660,10800,1.0,0.0,0.0,3,7,2660,0,1955,2014,98005,47.5894,-122.17200000000001,2640,10800,6,26,2014,Y,20,0
8944320420,7/10/2014,355000.0,3,2.5,2110,4038,2.0,0.0,0.0,4,8,2110,0,1989,0,98042,47.3875,-122.15299999999999,2110,3727,7,10,2014,UNK,0,311
224069145,4/1/2015,650000.0,3,1.75,1970,54450,1.0,0.0,0.0,3,8,1570,400,1980,0,98075,47.5936,-122.012,2460,36677,4,1,2015,UNK,-490,17773
3363900280,3/11/2015,678500.0,3,2.75,1210,3600,1.5,0.0,2.0,5,7,1210,0,1910,0,98103,47.6798,-122.354,1630,3910,3,11,2015,UNK,-420,-310
7504110050,6/26/2014,669950.0,4,2.5,2670,11877,2.0,0.0,0.0,3,9,2670,0,1996,0,98074,47.6327,-122.036,2430,11333,6,26,2014,UNK,240,544
624100950,3/11/2015,850000.0,3,2.25,3000,18450,1.0,0.0,0.0,3,10,3000,0,1983,0,98077,47.7274,-122.06200000000001,2980,12304,3,11,2015,UNK,20,6146
9416400020,8/27/2014,572000.0,3,2.75,2200,3885,2.0,0.0,0.0,3,8,2200,0,2002,0,98074,47.6171,-122.02799999999999,2710,6000,8,27,2014,UNK,-510,-2115
3578400950,8/1/2014,492450.0,3,1.75,1540,13002,1.0,0.0,0.0,2,8,1200,0,1984,0,98074,47.6231,-122.044,1620,10098,8,1,2014,UNK,-80,2904
4100000050,10/30/2014,813000.0,3,1.75,2080,11866,1.0,0.0,0.0,3,8,2080,0,1960,0,98005,47.5872,-122.17299999999999,2240,10696,10,30,2014,UNK,-160,1170
3475000080,8/28/2014,710000.0,3,2.0,1780,9732,1.0,0.0,0.0,3,8,1780,0,1967,0,98040,47.5796,-122.229,1900,10200,8,28,2014,UNK,-120,-468
7871500345,12/2/2014,792500.0,3,1.5,1960,2400,2.0,0.0,0.0,3,8,1330,630,1911,0,98119,47.6423,-122.37,2090,4000,12,2,2014,UNK,-130,-1600
8857600680,3/13/2015,285900.0,5,1.5,1690,7725,1.5,0.0,0.0,4,7,1690,0,1961,0,98032,47.3859,-122.288,1690,7739,3,13,2015,UNK,0,-14
2817100430,5/11/2015,389000.0,3,2.0,2080,12972,1.0,0.0,0.0,4,7,1250,830,1981,0,98070,47.3733,-122.432,1530,10089,5,11,2015,UNK,550,2883
7649400170,12/5/2014,675000.0,3,2.25,2070,2833,2.0,0.0,2.0,3,8,1490,580,1966,0,98136,47.5543,-122.398,1940,3794,12,5,2014,UNK,130,-961
4048400185,10/22/2014,352000.0,2,0.75,760,33801,1.0,0.0,0.0,4,4,760,0,1931,0,98059,47.4703,-122.07600000000001,1100,39504,10,22,2014,UNK,-340,-5703
3303960250,5/7/2015,1050000.0,4,3.25,4020,11588,2.0,0.0,0.0,3,11,4020,0,2000,0,98059,47.5217,-122.155,3190,8066,5,7,2015,UNK,830,3522
2785000480,1/8/2015,768500.0,4,1.75,3620,10400,1.0,0.0,0.0,4,8,1820,1800,1965,0,98005,47.6069,-122.167,2410,10400,1,8,2015,UNK,1210,0
2926049400,12/26/2014,500000.0,4,2.0,2330,7778,1.0,0.0,0.0,3,7,1230,1100,1961,0,98125,47.7109,-122.323,1250,8160,12,26,2014,UNK,1080,-382
5452302195,12/30/2014,685000.0,3,2.5,1460,8800,1.0,0.0,0.0,4,7,1460,0,1956,0,98040,47.5895,-122.23200000000001,2200,8800,12,30,2014,UNK,-740,0
3528900980,5/23/2014,648475.0,4,2.75,2250,5700,1.0,0.0,0.0,3,8,1200,1050,1951,0,98109,47.6406,-122.344,1720,3850,5,23,2014,UNK,530,1850
3886901795,4/22/2015,655000.0,6,5.0,2850,6600,2.0,0.0,0.0,3,7,2850,0,1994,0,98033,47.6813,-122.18700000000001,1870,9900,4,22,2015,UNK,980,-3300
1868900675,9/12/2014,895000.0,4,2.75,2640,4000,2.0,0.0,0.0,5,8,1730,910,1925,0,98115,47.6727,-122.29700000000001,1530,3740,9,12,2014,UNK,1110,260
4031000290,4/8/2015,195000.0,3,1.0,1310,9554,1.0,0.0,0.0,3,7,960,350,1962,0,98001,47.2949,-122.285,1310,9845,4,8,2015,UNK,0,-291
9264960480,12/8/2014,368000.0,4,2.5,2720,7350,2.0,0.0,0.0,3,9,2720,0,1989,0,98023,47.3028,-122.35,2570,8336,12,8,2014,UNK,150,-986
3303980680,2/28/2015,997000.0,4,3.5,3430,13609,2.0,0.0,0.0,3,11,3430,0,2001,0,98059,47.5196,-122.15100000000001,3880,11614,2,28,2015,UNK,-450,1995
1775930010,12/22/2014,335000.0,3,2.75,1990,19991,1.0,0.0,0.0,3,7,1340,650,1977,0,98072,47.7434,-122.10600000000001,1750,9775,12,22,2014,UNK,240,10216
3329520170,5/21/2014,250000.0,3,2.0,1170,7258,1.0,0.0,0.0,3,7,1170,0,1984,0,98001,47.3333,-122.266,1410,7750,5,21,2014,UNK,-240,-492
9321010130,3/12/2015,278500.0,3,1.75,1390,8980,1.0,0.0,0.0,4,8,1390,0,1985,0,98022,47.2015,-122.005,1770,9085,3,12,2015,UNK,-380,-105
7696600020,1/28/2015,260000.0,4,1.5,1540,7300,2.0,0.0,0.0,3,7,1540,0,1973,0,98001,47.3317,-122.27600000000001,1580,7650,1,28,2015,UNK,-40,-350
2690600005,10/1/2014,162500.0,2,1.0,760,6141,1.0,0.0,0.0,2,6,760,0,1920,0,98118,47.5469,-122.277,900,4120,10,1,2014,UNK,-140,2021
923049323,7/14/2014,239000.0,4,1.0,1280,8316,1.0,0.0,0.0,3,6,1280,0,1950,0,98168,47.4989,-122.302,1310,7830,7,14,2014,UNK,-30,486
6705870080,11/21/2014,600000.0,4,2.5,2990,5122,2.0,0.0,0.0,3,8,2990,0,2004,0,98075,47.5773,-122.055,3140,7875,11,21,2014,N,-150,-2753
3797710010,4/28/2015,350000.0,4,2.25,1770,7778,2.0,0.0,0.0,3,7,1770,0,1998,0,98031,47.4192,-122.20100000000001,1770,7591,4,28,2015,UNK,0,187
98030630,12/15/2014,852500.0,5,3.75,3830,8131,2.0,0.0,0.0,3,10,3830,0,2005,0,98075,47.5837,-121.971,3570,7290,12,15,2014,N,260,841
8106300840,7/21/2014,485000.0,3,2.5,2870,5490,2.0,0.0,0.0,3,9,2870,0,2008,0,98055,47.4471,-122.20700000000001,3040,5442,7,21,2014,N,-170,48
1074100020,10/7/2014,299000.0,3,1.0,1520,8320,1.0,0.0,0.0,3,6,1520,0,1953,0,98133,47.7699,-122.335,1500,8320,10,7,2014,UNK,20,0
418000010,4/22/2015,227450.0,2,1.0,660,6509,1.0,0.0,0.0,4,5,660,0,1952,0,98056,47.4938,-122.171,970,5713,4,22,2015,UNK,-310,796
1782000130,5/23/2014,383000.0,3,1.0,1800,5612,1.0,0.0,0.0,4,7,1200,600,1942,0,98126,47.525,-122.37799999999999,1450,5250,5,23,2014,UNK,350,362
2124079093,1/12/2015,835000.0,2,3.25,3570,392475,1.0,0.0,0.0,3,9,2370,1200,1998,0,98024,47.5448,-121.93,3190,217800,1,12,2015,UNK,380,174675
9828702890,2/11/2015,760000.0,5,1.5,3050,2992,1.5,0.0,0.0,4,8,1920,1130,1931,0,98112,47.621,-122.302,1200,1209,2,11,2015,UNK,1850,1783
3797001815,2/17/2015,532500.0,2,1.0,820,3000,1.0,0.0,0.0,4,7,820,0,1924,0,98103,47.6842,-122.348,1490,3000,2,17,2015,UNK,-670,0
6979900080,11/25/2014,635000.0,3,2.5,3610,26359,1.0,0.0,0.0,3,8,1950,1660,1998,0,98053,47.6306,-121.96799999999999,2620,26427,11,25,2014,UNK,990,-68
7319900345,8/25/2014,438500.0,3,2.0,1490,3072,1.0,0.0,0.0,5,7,770,720,1912,0,98144,47.5772,-122.307,1320,3072,8,25,2014,UNK,170,0
4346300010,6/18/2014,545500.0,3,2.5,1560,9361,1.5,0.0,0.0,4,7,1360,200,1936,0,98108,47.5591,-122.295,1670,6244,6,18,2014,UNK,-110,3117
2432000130,4/14/2015,675000.0,3,1.75,1660,9549,1.0,0.0,0.0,3,7,1660,0,1956,0,98033,47.6503,-122.198,2090,9549,4,14,2015,UNK,-430,0
9165100130,6/18/2014,450000.0,3,1.75,1180,4080,1.0,0.0,0.0,4,6,760,420,1928,0,98117,47.6825,-122.391,1490,4080,6,18,2014,UNK,-310,0
844000425,12/23/2014,199999.0,3,1.0,960,10815,1.0,0.0,0.0,5,5,960,0,1900,0,98010,47.3091,-122.006,1330,10815,12,23,2014,UNK,-370,0
6076500364,9/10/2014,375000.0,3,1.5,1630,16170,1.0,0.0,0.0,3,7,1630,0,1988,0,98034,47.7104,-122.235,1630,9931,9,10,2014,UNK,0,6239
9238430430,4/30/2015,600000.0,4,2.25,2260,43847,2.0,0.0,0.0,3,8,2260,0,1982,0,98072,47.7713,-122.12899999999999,2470,37304,4,30,2015,UNK,-210,6543
2854800095,7/8/2014,292600.0,3,1.5,1520,7123,1.0,0.0,0.0,4,7,1520,0,1959,0,98056,47.4991,-122.176,1450,8023,7,8,2014,UNK,70,-900
31200020,3/19/2015,1040000.0,5,2.75,3050,8904,1.0,0.0,0.0,4,8,1650,1400,1956,0,98040,47.5709,-122.214,2920,8904,3,19,2015,UNK,130,0
5364200381,10/10/2014,610000.0,3,1.0,1000,4959,1.0,0.0,0.0,3,8,1000,0,1945,0,98105,47.6629,-122.277,2240,4959,10,10,2014,UNK,-1240,0
1515910290,8/25/2014,397450.0,4,2.5,2650,9451,2.0,0.0,0.0,4,8,2650,0,1993,0,98042,47.3693,-122.12899999999999,2510,8850,8,25,2014,UNK,140,601
3459000020,4/14/2015,382000.0,3,2.25,1750,15528,1.0,0.0,0.0,3,8,1270,480,1963,0,98155,47.7739,-122.274,2170,12000,4,14,2015,UNK,-420,3528
3303000130,1/16/2015,370000.0,3,2.25,1770,7667,1.0,0.0,0.0,3,8,1270,500,1966,0,98177,47.7724,-122.36200000000001,2180,8103,1,16,2015,UNK,-410,-436
3303000130,4/28/2015,520000.0,3,2.25,1770,7667,1.0,0.0,0.0,3,8,1270,500,1966,0,98177,47.7724,-122.36200000000001,2180,8103,4,28,2015,UNK,-410,-436
3235100080,7/1/2014,260000.0,2,1.0,770,7906,1.0,0.0,0.0,4,6,770,0,1948,0,98155,47.76600000000001,-122.32,990,7906,7,1,2014,UNK,-220,0
7284900460,11/20/2014,890000.0,4,2.5,3370,7200,2.0,0.0,0.0,3,8,3370,0,2014,0,98177,47.7698,-122.384,1880,7200,11,20,2014,N,1490,0
6332940020,8/26/2014,344000.0,5,2.0,2130,8412,1.0,0.0,0.0,3,7,1440,690,1946,2000,98155,47.7403,-122.318,2310,7474,8,26,2014,Y,-180,938
8802400415,6/25/2014,205000.0,3,1.0,1050,8498,1.0,0.0,0.0,3,7,1050,0,1958,0,98031,47.4038,-122.20299999999999,1340,8498,6,25,2014,UNK,-290,0
4131500190,5/7/2015,379000.0,5,2.5,2803,8550,1.0,0.0,0.0,3,8,2803,0,1963,2011,98003,47.3032,-122.306,1810,8550,5,7,2015,Y,993,0
7524400250,8/22/2014,424240.0,3,2.0,2080,12094,2.0,0.0,0.0,4,8,2080,0,1982,0,98052,47.7035,-122.164,2230,12204,8,22,2014,UNK,-150,-110
7524400250,11/24/2014,589950.0,3,2.0,2080,12094,2.0,0.0,0.0,4,8,2080,0,1982,0,98052,47.7035,-122.164,2230,12204,11,24,2014,UNK,-150,-110
4441300440,5/12/2014,582000.0,4,1.75,2120,4650,1.0,0.0,1.0,3,7,1190,930,1951,0,98117,47.6964,-122.4,2070,6487,5,12,2014,UNK,50,-1837
1898200080,3/12/2015,349000.0,3,2.5,2550,7709,2.0,0.0,0.0,3,9,2550,0,1989,0,98023,47.3081,-122.391,2410,9250,3,12,2015,UNK,140,-1541
1245003375,4/8/2015,658000.0,3,1.0,1290,12005,1.0,0.0,0.0,4,7,1290,0,1966,0,98033,47.6835,-122.199,1930,8000,4,8,2015,UNK,-640,4005
3574300250,10/29/2014,294000.0,5,2.75,1790,5000,1.5,0.0,0.0,4,7,1060,730,1915,0,98106,47.5655,-122.363,1400,5000,10,29,2014,UNK,390,0
5071400104,6/26/2014,690000.0,5,3.5,2720,7598,2.0,0.0,0.0,3,8,1860,860,1993,0,98115,47.6931,-122.28299999999999,2430,7728,6,26,2014,UNK,290,-130
9287801150,4/23/2015,600000.0,3,1.0,1040,5000,1.5,0.0,2.0,3,7,1040,0,1912,0,98107,47.6754,-122.359,1440,4400,4,23,2015,UNK,-400,600
8651431100,1/16/2015,199990.0,3,1.0,840,5200,1.0,0.0,0.0,3,6,840,0,1969,2014,98042,47.3685,-122.07700000000001,870,5200,1,16,2015,Y,-30,0
236500010,12/9/2014,220000.0,3,1.75,1650,8850,1.0,0.0,0.0,3,7,1650,0,1959,0,98188,47.4331,-122.291,1400,8800,12,9,2014,UNK,250,50
1441800250,1/26/2015,440000.0,4,2.25,2080,15750,1.0,0.0,0.0,3,8,1460,620,1976,0,98034,47.7225,-122.2,1960,10500,1,26,2015,UNK,120,5250
8929000050,9/4/2014,439990.0,4,2.5,1540,1994,2.0,0.0,0.0,3,8,1540,0,2014,0,98029,47.5526,-121.999,1540,1689,9,4,2014,N,0,305
98030660,3/11/2015,815000.0,4,2.5,3880,7208,2.0,0.0,0.0,3,10,3880,0,2006,0,98075,47.5841,-121.971,3280,7221,3,11,2015,N,600,-13
3905100380,4/21/2015,535000.0,4,2.25,1860,3766,2.0,0.0,0.0,3,8,1860,0,1995,0,98029,47.5699,-122.006,1860,4169,4,21,2015,UNK,0,-403
1140000050,11/26/2014,215000.0,3,1.75,1280,10016,1.0,0.0,0.0,4,7,1280,0,1975,0,98003,47.2823,-122.333,1670,9764,11,26,2014,UNK,-390,252
5561000010,2/23/2015,605000.0,3,2.5,3200,35012,1.5,0.0,0.0,3,8,2100,1100,1965,0,98027,47.4651,-121.993,2690,35100,2,23,2015,UNK,510,-88
8856920250,5/30/2014,349900.0,3,2.5,2200,7278,2.0,0.0,0.0,3,8,2200,0,1990,0,98058,47.4624,-122.132,2190,8580,5,30,2014,UNK,10,-1302
5100402668,2/18/2015,495000.0,3,1.0,1570,5510,1.0,0.0,0.0,4,7,1070,500,1940,0,98115,47.6942,-122.319,1770,6380,2,18,2015,UNK,-200,-870
2426049180,10/14/2014,515100.0,3,2.5,2074,4900,2.0,0.0,0.0,3,8,2074,0,1997,0,98034,47.7327,-122.23299999999999,1840,7382,10,14,2014,UNK,234,-2482
205000010,6/24/2014,620000.0,4,2.5,2450,55387,2.0,0.0,0.0,3,9,2450,0,1994,0,98053,47.6323,-121.985,2730,38827,6,24,2014,UNK,-280,16560
7504060020,1/22/2015,657500.0,4,2.25,2520,10370,2.0,0.0,0.0,3,9,2520,0,1980,0,98074,47.6377,-122.04899999999999,2848,12682,1,22,2015,UNK,-328,-2312
4204400098,1/19/2015,250000.0,5,1.75,2190,8250,1.0,0.0,2.0,3,7,1190,1000,1963,0,98055,47.4887,-122.223,2570,8250,1,19,2015,UNK,-380,0
4204400098,4/21/2015,385000.0,5,1.75,2190,8250,1.0,0.0,2.0,3,7,1190,1000,1963,0,98055,47.4887,-122.223,2570,8250,4,21,2015,UNK,-380,0
2131200766,5/22/2014,307000.0,3,1.5,2320,7500,1.0,0.0,0.0,3,7,2320,0,1976,0,98019,47.7413,-121.979,1480,10000,5,22,2014,UNK,840,-2500
7760400480,5/13/2015,288000.0,3,2.5,1370,9253,1.0,0.0,0.0,3,7,1090,280,1994,0,98042,47.3717,-122.073,1470,9253,5,13,2015,UNK,-100,0
1863900225,10/28/2014,226450.0,3,1.75,1730,7200,1.5,0.0,0.0,4,6,1730,0,1944,0,98032,47.3774,-122.236,860,7200,10,28,2014,UNK,870,0
1787600224,3/10/2015,390000.0,3,2.5,1640,6991,1.0,0.0,0.0,3,7,1110,530,1967,0,98125,47.7255,-122.32700000000001,1860,7342,3,10,2015,UNK,-220,-351
323089134,9/30/2014,350000.0,3,1.0,1300,10236,1.0,0.0,0.0,4,6,1300,0,1971,0,98045,47.5028,-121.77,1380,11325,9,30,2014,UNK,-80,-1089
7663700759,12/1/2014,368000.0,3,1.5,1560,7884,1.0,0.0,0.0,3,7,1060,500,1969,0,98125,47.7312,-122.29799999999999,1820,9000,12,1,2014,UNK,-260,-1116
3856904970,8/18/2014,469000.0,2,1.0,1120,4284,1.0,0.0,0.0,3,6,730,390,1921,0,98105,47.6688,-122.324,2050,4160,8,18,2014,UNK,-930,124
1126059007,3/23/2015,865000.0,3,2.25,2670,150270,2.0,0.0,0.0,3,9,2670,0,1985,0,98072,47.7601,-122.134,3080,81054,3,23,2015,UNK,-410,69216
2473002850,1/13/2015,515000.0,5,2.5,3810,15916,1.5,0.0,0.0,5,8,3810,0,1967,0,98058,47.4521,-122.14,2470,11662,1,13,2015,UNK,1340,4254
1112700130,1/23/2015,410000.0,3,1.75,1440,8560,1.0,0.0,0.0,4,7,1440,0,1979,0,98034,47.7296,-122.23200000000001,1460,7560,1,23,2015,UNK,-20,1000
121059007,8/8/2014,210000.0,4,1.0,1200,43560,1.0,0.0,0.0,3,5,1200,0,1968,0,98042,47.3375,-122.12299999999999,1400,54450,8,8,2014,UNK,-200,-10890
2896600020,3/25/2015,460000.0,3,1.75,1520,7700,1.0,0.0,0.0,3,7,820,700,1969,0,98034,47.7226,-122.219,1420,7674,3,25,2015,UNK,100,26
9264900660,9/19/2014,241500.0,4,2.5,2500,9654,1.0,0.0,0.0,3,8,1830,670,1979,0,98023,47.3137,-122.34299999999999,2500,8839,9,19,2014,UNK,0,815
7754900280,6/23/2014,322200.0,4,2.25,2010,19000,2.0,0.0,0.0,4,8,2010,0,1975,0,98042,47.3734,-122.119,1950,19626,6,23,2014,UNK,60,-626
9282801950,8/18/2014,279000.0,4,1.0,1210,6000,1.5,0.0,2.0,3,7,1210,0,1943,0,98178,47.5026,-122.234,1470,6000,8,18,2014,UNK,-260,0
3123039063,9/8/2014,303000.0,2,1.0,1100,27007,1.0,0.0,0.0,4,6,1100,0,1943,0,98070,47.4471,-122.473,1746,91476,9,8,2014,UNK,-646,-64469
2770606915,10/20/2014,420000.0,3,1.5,1050,6615,1.0,0.0,0.0,4,6,800,250,1950,0,98199,47.6578,-122.39,1530,5250,10,20,2014,UNK,-480,1365
5379804690,8/13/2014,249000.0,3,1.75,2120,18335,1.0,0.0,0.0,3,7,1380,740,1961,0,98188,47.451,-122.273,2050,18333,8,13,2014,UNK,70,2
6855700080,7/14/2014,294950.0,3,1.0,1240,8840,1.0,0.0,0.0,3,6,1240,0,1952,0,98125,47.7277,-122.30799999999999,1250,8840,7,14,2014,UNK,-10,0
3856900507,5/12/2014,1320000.0,4,3.5,3460,3997,2.0,0.0,0.0,3,10,2560,900,2004,0,98103,47.6718,-122.329,1860,4000,5,12,2014,N,1600,-3
3501600185,9/15/2014,335000.0,3,1.75,1270,4800,1.0,0.0,0.0,3,7,1270,0,1953,0,98117,47.69300000000001,-122.361,1490,4800,9,15,2014,UNK,-220,0
1068000235,6/5/2014,1160000.0,4,2.25,2980,8051,1.5,0.0,2.0,4,10,2020,960,1935,0,98199,47.6426,-122.40899999999999,2760,5499,6,5,2014,UNK,220,2552
7519000585,3/11/2015,520000.0,2,1.0,1250,3708,1.5,0.0,0.0,3,7,1250,0,1926,0,98117,47.685,-122.363,1430,3708,3,11,2015,UNK,-180,0
1562200380,9/16/2014,560000.0,4,1.75,1740,8800,1.0,0.0,0.0,4,8,1740,0,1965,0,98007,47.6232,-122.14200000000001,2180,8436,9,16,2014,UNK,-440,364
7523700305,10/12/2014,243400.0,4,1.5,1730,7464,2.0,0.0,0.0,4,7,1730,0,1959,0,98032,47.3782,-122.304,1370,7860,10,12,2014,UNK,360,-396
8807810050,5/29/2014,405000.0,3,2.0,1240,14404,1.0,0.0,0.0,3,7,1240,0,1988,0,98053,47.6614,-122.06,1350,9990,5,29,2014,UNK,-110,4414
3699100130,10/2/2014,495000.0,2,1.0,1670,14695,1.5,0.0,0.0,5,7,1670,0,1930,0,98033,47.7001,-122.2,1800,11355,10,2,2014,UNK,-130,3340
2215901650,4/2/2015,350000.0,4,2.5,2140,7095,2.0,0.0,0.0,3,8,2140,0,1992,0,98038,47.3528,-122.057,1600,7182,4,2,2015,UNK,540,-87
1099900020,12/11/2014,368500.0,5,2.75,2530,7601,1.0,0.0,0.0,3,7,1520,1010,1992,0,98188,47.4683,-122.26299999999999,2400,7776,12,11,2014,UNK,130,-175
5128000010,1/5/2015,99000.0,2,1.0,960,8236,1.0,0.0,0.0,2,6,960,0,1948,0,98058,47.4698,-122.166,1260,8236,1,5,2015,UNK,-300,0
3303980660,6/3/2014,1070000.0,4,3.75,4130,12320,2.0,0.0,0.0,3,11,4130,0,2001,0,98059,47.5194,-122.15100000000001,3690,11227,6,3,2014,UNK,440,1093
1155640050,8/26/2014,430000.0,4,1.75,1710,7724,1.0,0.0,0.0,3,8,1710,0,1983,0,98155,47.7721,-122.29299999999999,1940,7724,8,26,2014,UNK,-230,0
8087800020,5/15/2014,412500.0,3,1.5,1490,8475,1.0,0.0,0.0,4,7,1490,0,1963,0,98052,47.6571,-122.133,1490,8540,5,15,2014,UNK,0,-65
3293200190,12/13/2014,1120000.0,4,3.25,4750,62365,2.0,0.0,0.0,3,11,4750,0,1988,0,98052,47.7149,-122.09899999999999,3300,31866,12,13,2014,UNK,1450,30499
1862000010,8/28/2014,915000.0,4,2.5,3400,35062,2.0,0.0,0.0,4,11,3400,0,1988,0,98052,47.7168,-122.113,2880,9705,8,28,2014,UNK,520,25357
5711200170,5/23/2014,535000.0,3,2.5,2210,7620,2.0,0.0,0.0,3,8,2210,0,1994,0,98052,47.6938,-122.13,1920,7440,5,23,2014,UNK,290,180
8690800130,11/4/2014,390000.0,3,1.5,1650,8676,1.0,0.0,0.0,4,8,1130,520,1979,0,98133,47.7471,-122.352,1400,8499,11,4,2014,UNK,250,177
2768100545,9/8/2014,499000.0,3,1.5,1260,3135,1.0,0.0,0.0,4,7,780,480,1944,0,98107,47.6693,-122.37100000000001,1540,3025,9,8,2014,UNK,-280,110
2596400050,7/30/2014,375000.0,3,1.0,1960,7955,1.0,0.0,0.0,4,7,1260,700,1963,0,98177,47.7641,-122.36399999999999,1850,8219,7,30,2014,UNK,110,-264
2641400290,10/28/2014,349000.0,4,2.5,1800,7620,2.0,0.0,0.0,3,8,1800,0,1995,0,98055,47.4346,-122.20100000000001,1800,6879,10,28,2014,UNK,0,741
3210600010,10/31/2014,635000.0,3,2.25,1940,7482,1.0,0.0,0.0,4,7,1240,700,1964,0,98004,47.6004,-122.195,2340,9310,10,31,2014,UNK,-400,-1828
8691370290,12/15/2014,682000.0,4,2.75,2820,8009,2.0,0.0,0.0,3,9,2820,0,2001,0,98075,47.6,-121.977,2820,7398,12,15,2014,UNK,0,611
1790000080,2/3/2015,321027.0,4,2.25,2820,16770,1.0,0.0,0.0,4,8,1920,900,1966,0,98023,47.3186,-122.36399999999999,2320,13850,2,3,2015,UNK,500,2920
7116000425,11/25/2014,150000.0,2,1.0,720,4120,1.0,0.0,0.0,5,5,720,0,1915,0,98002,47.303000000000004,-122.21700000000001,940,6180,11,25,2014,UNK,-220,-2060
8143100500,12/13/2014,410000.0,3,1.75,1640,17583,1.0,0.0,0.0,3,7,1110,530,1969,0,98034,47.726000000000006,-122.20299999999999,1420,11680,12,13,2014,UNK,220,5903
3735900545,5/23/2014,449950.0,3,2.0,1560,4080,2.0,0.0,0.0,3,7,1560,0,1923,1982,98115,47.6892,-122.319,1900,4080,5,23,2014,Y,-340,0
1443500305,10/13/2014,194990.0,6,2.5,1560,7144,1.0,0.0,0.0,3,6,1060,500,1913,0,98118,47.5335,-122.272,1300,6232,10,13,2014,UNK,260,912
3649100103,1/2/2015,475000.0,4,1.75,1910,8775,1.0,0.0,0.0,3,7,1210,700,1956,0,98028,47.7396,-122.24700000000001,2210,8778,1,2,2015,UNK,-300,-3
6746700605,1/28/2015,530000.0,5,1.75,1570,3000,2.0,0.0,0.0,4,7,1570,0,1908,0,98105,47.6677,-122.316,1610,3000,1,28,2015,UNK,-40,0
7999950020,7/22/2014,319950.0,4,2.5,2038,7643,2.0,0.0,0.0,3,8,2038,0,2011,0,98092,47.3296,-122.18,2634,6824,7,22,2014,N,-596,819
9211500010,3/27/2015,210000.0,3,2.25,1720,9435,1.0,0.0,0.0,4,7,1220,500,1978,0,98023,47.2979,-122.37700000000001,1690,7215,3,27,2015,UNK,30,2220
1324300290,12/26/2014,485000.0,3,2.75,1670,3330,1.5,0.0,0.0,4,7,1670,0,1925,0,98107,47.6551,-122.36,1370,5000,12,26,2014,UNK,300,-1670
8691310380,1/28/2015,774000.0,4,2.75,2830,10240,2.0,0.0,0.0,4,9,2830,0,1998,0,98075,47.5903,-121.986,3490,10240,1,28,2015,UNK,-660,0
4037400430,10/15/2014,478000.0,4,2.0,1690,8208,1.0,0.0,0.0,4,7,1210,480,1958,0,98008,47.6052,-122.126,1620,8496,10,15,2014,UNK,70,-288
254000545,10/23/2014,385000.0,4,2.5,1620,5280,2.0,0.0,0.0,4,7,1620,0,1924,0,98146,47.5132,-122.384,1590,5280,10,23,2014,UNK,30,0
7214780020,4/17/2015,595000.0,4,2.5,2360,43017,2.0,0.0,0.0,3,9,2360,0,1989,0,98077,47.773999999999994,-122.07700000000001,2750,40334,4,17,2015,UNK,-390,2683
114100314,3/18/2015,285000.0,3,1.5,1480,7117,1.0,0.0,0.0,3,7,1170,310,1960,0,98028,47.7766,-122.24799999999999,2230,14775,3,18,2015,UNK,-750,-7658
3629930170,5/14/2014,723000.0,4,2.5,2700,4004,2.0,0.0,0.0,3,9,2700,0,2004,0,98029,47.5521,-121.995,2260,4459,5,14,2014,N,440,-455
2946002140,8/12/2014,279000.0,3,1.5,1780,16000,1.0,0.0,0.0,2,7,1240,540,1960,0,98198,47.419,-122.322,1860,9775,8,12,2014,UNK,-80,6225
1432400525,3/6/2015,195000.0,3,1.5,1430,7560,1.0,0.0,0.0,5,6,1430,0,1958,0,98058,47.4518,-122.179,1150,7560,3,6,2015,UNK,280,0
7011201470,10/15/2014,625000.0,2,1.0,2160,2192,1.0,0.0,0.0,5,8,1170,990,1925,0,98119,47.6364,-122.37100000000001,1150,2152,10,15,2014,UNK,1010,40
7697800170,4/28/2015,270000.0,3,1.75,1800,9314,2.0,0.0,0.0,3,8,1800,0,1979,0,98011,47.7762,-122.198,2100,9658,4,28,2015,UNK,-300,-344
8682291630,10/7/2014,559000.0,2,2.0,1930,5520,1.0,0.0,0.0,3,8,1930,0,2006,0,98053,47.7191,-122.022,1640,4533,10,7,2014,N,290,987
1775800420,2/2/2015,474000.0,4,2.25,1960,14834,1.0,0.0,0.0,4,8,1330,630,1976,0,98072,47.7434,-122.095,1540,15000,2,2,2015,UNK,420,-166
2215901310,11/14/2014,303500.0,4,2.5,1920,7345,2.0,0.0,0.0,3,8,1920,0,1992,0,98038,47.3526,-122.055,1860,7364,11,14,2014,UNK,60,-19
1440500020,12/26/2014,350000.0,3,1.75,1470,8645,1.0,0.0,0.0,3,6,1470,0,1949,0,98155,47.7524,-122.323,1470,7680,12,26,2014,UNK,0,965
6632900574,8/6/2014,367500.0,5,3.0,2980,10064,1.0,0.0,0.0,3,7,1680,1300,1940,0,98155,47.7372,-122.316,1590,7800,8,6,2014,UNK,1390,2264
6632900574,2/25/2015,595000.0,5,3.0,2980,10064,1.0,0.0,0.0,3,7,1680,1300,1940,0,98155,47.7372,-122.316,1590,7800,2,25,2015,UNK,1390,2264
7933510080,10/6/2014,589000.0,3,2.0,2360,118483,1.0,0.0,0.0,3,8,2360,0,1981,0,98024,47.5595,-121.867,2660,91476,10,6,2014,UNK,-300,27007
1926069063,3/6/2015,585000.0,3,1.75,1790,87213,1.0,0.0,0.0,4,7,1790,0,1974,0,98077,47.732,-122.07700000000001,3270,39586,3,6,2015,UNK,-1480,47627
973600020,10/2/2014,482975.0,3,2.25,2130,8801,1.0,0.0,0.0,3,8,1370,760,1976,0,98155,47.7462,-122.29,2820,8801,10,2,2014,UNK,-690,0
9558010190,11/19/2014,365500.0,4,2.5,2030,4499,2.0,0.0,0.0,3,8,2030,0,2003,0,98058,47.4511,-122.119,2030,4539,11,19,2014,UNK,0,-40
267010020,7/11/2014,570000.0,4,2.0,1790,7800,1.0,0.0,0.0,5,8,1790,0,1972,0,98008,47.6266,-122.103,2150,7838,7,11,2014,UNK,-360,-38
8097000170,2/2/2015,335000.0,3,2.5,2260,8040,2.0,0.0,0.0,3,8,2260,0,1990,0,98092,47.3203,-122.184,2390,8040,2,2,2015,UNK,-130,0
9136100420,4/8/2015,767500.0,4,2.0,2350,4815,1.5,0.0,0.0,4,7,1450,900,1914,0,98103,47.6681,-122.338,1640,4013,4,8,2015,UNK,710,802
8929000280,5/19/2014,386591.0,3,2.5,1690,1613,2.0,0.0,0.0,3,8,1150,540,2014,0,98029,47.5518,-121.99799999999999,1690,1662,5,19,2014,N,0,-49
7883603190,7/22/2014,279000.0,3,1.0,1320,5750,1.5,0.0,0.0,3,7,1320,0,1913,0,98108,47.5288,-122.325,1010,5700,7,22,2014,UNK,310,50
203600470,4/9/2015,620000.0,4,2.5,2690,32780,2.0,0.0,0.0,3,9,2690,0,1998,0,98014,47.6612,-121.955,2840,36555,4,9,2015,UNK,-150,-3775
8643200020,5/6/2014,407000.0,4,2.25,2810,23400,1.0,0.0,1.0,3,7,1710,1100,1958,0,98198,47.395,-122.311,1860,14900,5,6,2014,UNK,950,8500
322069153,8/27/2014,364250.0,3,2.5,2280,213879,2.0,0.0,0.0,3,8,2280,0,1994,0,98038,47.4213,-122.03299999999999,2380,178160,8,27,2014,UNK,-100,35719
2473450430,5/27/2014,399000.0,4,2.5,2870,9292,2.0,0.0,0.0,3,8,2540,330,1979,0,98058,47.4522,-122.12299999999999,2590,7533,5,27,2014,UNK,280,1759
7574910780,5/14/2014,766950.0,3,2.5,3030,30007,1.5,0.0,0.0,4,10,3030,0,1992,0,98077,47.743,-122.036,3360,34983,5,14,2014,UNK,-330,-4976
3629980780,9/18/2014,710000.0,4,2.75,2940,4232,2.0,0.0,0.0,3,9,2940,0,2004,0,98029,47.5529,-121.99,2410,4000,9,18,2014,N,530,232
3332000091,2/24/2015,320000.0,3,1.0,1190,4120,1.0,0.0,0.0,3,6,1190,0,1929,0,98118,47.5513,-122.272,1360,4635,2,24,2015,UNK,-170,-515
3395041236,10/23/2014,300000.0,3,2.5,1800,3253,2.0,0.0,0.0,3,7,1800,0,2001,0,98108,47.5401,-122.292,1800,3081,10,23,2014,UNK,0,172
2310030500,7/10/2014,263000.0,3,1.75,1580,9187,1.0,0.0,0.0,3,8,1180,400,1993,0,98038,47.3538,-122.04700000000001,1620,6397,7,10,2014,UNK,-40,2790
8665050080,10/10/2014,445000.0,3,2.5,1730,4408,2.0,0.0,0.0,3,8,1730,0,1996,0,98029,47.5683,-122.005,1730,4408,10,10,2014,UNK,0,0
4037000840,4/6/2015,554000.0,3,2.0,1910,9001,1.0,0.0,0.0,4,7,1910,0,1957,0,98008,47.6037,-122.119,2040,8700,4,6,2015,UNK,-130,301
2856101845,7/24/2014,335000.0,2,1.75,1000,5100,1.0,0.0,0.0,3,6,940,60,1906,0,98117,47.6787,-122.391,1900,5100,7,24,2014,UNK,-900,0
8078550250,12/29/2014,307000.0,4,2.75,2520,6964,1.0,0.0,0.0,4,7,1260,1260,1987,0,98031,47.4038,-122.175,1930,6949,12,29,2014,UNK,590,15
1837000010,3/2/2015,404000.0,3,1.0,1420,8160,1.0,0.0,0.0,3,7,970,450,1947,0,98125,47.7164,-122.306,1340,8160,3,2,2015,UNK,80,0
8691390280,7/31/2014,775000.0,4,3.5,3080,5250,2.0,0.0,0.0,3,9,3080,0,2003,0,98075,47.5992,-121.97200000000001,2980,5509,7,31,2014,UNK,100,-259
2372800050,5/21/2014,220000.0,3,1.0,1060,9126,1.0,0.0,2.0,5,7,1060,0,1956,0,98022,47.201,-121.999,1300,9126,5,21,2014,UNK,-240,0
6600250050,9/3/2014,518000.0,4,2.5,2160,9750,2.0,0.0,0.0,3,8,2160,0,1983,0,98028,47.7438,-122.24600000000001,2840,10535,9,3,2014,UNK,-680,-785
7215900020,12/9/2014,1600000.0,4,3.5,4060,9486,2.0,0.0,0.0,3,10,4060,0,2005,0,98033,47.6634,-122.2,2410,9486,12,9,2014,N,1650,0
6450304600,10/23/2014,315000.0,1,2.25,1940,2550,2.0,0.0,0.0,4,7,1100,840,1979,0,98133,47.7313,-122.34299999999999,1580,5100,10,23,2014,UNK,360,-2550
2541100050,7/31/2014,572650.0,4,2.5,2250,11349,2.0,0.0,0.0,3,8,2250,0,1991,0,98034,47.7111,-122.23899999999999,2110,9964,7,31,2014,UNK,140,1385
1853200080,6/19/2014,350000.0,2,1.0,1620,9205,1.0,0.0,0.0,5,6,850,770,1921,0,98034,47.7119,-122.23,2460,5469,6,19,2014,UNK,-840,3736
3058600050,9/19/2014,285000.0,2,1.0,920,5850,1.0,0.0,0.0,4,6,920,0,1900,0,98108,47.5441,-122.304,1640,5476,9,19,2014,UNK,-720,374
3148750050,3/25/2015,231000.0,3,2.5,1370,7247,2.0,0.0,0.0,3,7,1370,0,1995,0,98032,47.3767,-122.303,1720,8085,3,25,2015,UNK,-350,-838
8651400680,8/13/2014,179000.0,3,1.0,920,5200,1.0,0.0,0.0,4,6,920,0,1969,0,98042,47.3603,-122.085,920,5200,8,13,2014,UNK,0,0
4359100050,3/30/2015,244000.0,3,1.5,1360,9625,1.0,0.0,0.0,3,7,1360,0,1963,0,98030,47.3799,-122.211,1890,9625,3,30,2015,UNK,-530,0
5379806185,3/6/2015,185850.0,3,1.5,1630,11662,1.0,0.0,0.0,3,7,1630,0,1943,1963,98188,47.4455,-122.27799999999999,1700,11662,3,6,2015,Y,-70,0
1737300130,12/22/2014,610000.0,6,2.5,3610,12033,2.0,0.0,0.0,3,8,3210,400,1970,0,98011,47.7692,-122.219,2210,8577,12,22,2014,UNK,1400,3456
2781200010,10/10/2014,419000.0,4,2.5,3010,9155,2.0,0.0,0.0,3,9,3010,0,2005,0,98038,47.3542,-122.027,3010,5762,10,10,2014,N,0,3393
269000221,8/26/2014,779000.0,3,1.75,2320,6400,1.0,0.0,2.0,4,8,1420,900,1957,0,98199,47.6449,-122.389,2540,7680,8,26,2014,UNK,-220,-1280
6421100502,9/15/2014,695000.0,5,3.0,3290,14134,1.0,0.0,0.0,3,7,1870,1420,2004,0,98052,47.6708,-122.14,1970,11470,9,15,2014,N,1320,2664
4136900190,3/20/2015,319900.0,3,2.5,2040,7580,2.0,0.0,2.0,3,8,2040,0,1998,0,98092,47.2618,-122.209,1960,7820,3,20,2015,UNK,80,-240
8731980680,1/12/2015,329000.0,3,2.75,1920,7700,1.0,0.0,0.0,4,8,1320,600,1978,0,98023,47.3213,-122.37799999999999,2040,8000,1,12,2015,UNK,-120,-300
2095800250,8/27/2014,475226.0,3,2.5,2120,4512,2.0,0.0,0.0,3,8,2120,0,1988,0,98011,47.75,-122.18299999999999,2000,4553,8,27,2014,UNK,120,-41
3629920630,3/25/2015,638000.0,3,2.5,2170,5000,2.0,0.0,0.0,3,9,2170,0,2003,0,98029,47.5453,-121.99600000000001,2170,5000,3,25,2015,UNK,0,0
6817800840,3/25/2015,440000.0,2,1.5,1330,15873,1.0,0.0,0.0,3,7,900,430,1984,0,98074,47.6359,-122.03299999999999,1610,12043,3,25,2015,UNK,-280,3830
7520000440,2/9/2015,214000.0,3,2.0,1580,5080,1.0,0.0,0.0,4,6,800,780,1942,0,98146,47.4963,-122.35,1580,7114,2,9,2015,UNK,0,-2034
587550470,4/29/2015,600000.0,3,2.75,3580,14217,2.0,0.0,3.0,4,10,2210,1370,1989,0,98023,47.3244,-122.37899999999999,3990,14674,4,29,2015,UNK,-410,-457
6851700381,4/14/2015,935000.0,4,2.0,2580,4500,2.0,0.0,0.0,4,9,1850,730,1905,0,98102,47.6245,-122.316,2590,4100,4,14,2015,UNK,-10,400
4077800029,10/27/2014,630000.0,4,1.75,1930,10210,1.5,0.0,2.0,3,8,1670,260,1941,0,98125,47.7078,-122.277,2730,6600,10,27,2014,UNK,-800,3610
7202350480,9/30/2014,575000.0,3,2.5,2120,4780,2.0,0.0,0.0,3,7,2120,0,2004,0,98053,47.681000000000004,-122.03200000000001,1690,2650,9,30,2014,N,430,2130
1021079099,11/6/2014,345000.0,3,2.5,1990,20466,1.5,0.0,0.0,4,8,1410,0,1987,0,98010,47.3259,-121.896,1660,93393,11,6,2014,UNK,330,-72927
6075000050,7/16/2014,323000.0,4,1.75,1310,9690,1.0,0.0,0.0,4,7,1310,0,1967,0,98011,47.7559,-122.226,2280,9618,7,16,2014,UNK,-970,72
5467910020,5/16/2014,425000.0,3,2.5,2670,13218,1.0,0.0,0.0,4,10,2670,0,1988,0,98042,47.3683,-122.15299999999999,1960,13130,5,16,2014,UNK,710,88
322069109,5/5/2015,411000.0,2,2.25,1910,108900,1.0,0.0,0.0,4,7,1010,900,1972,0,98038,47.4206,-122.023,2050,108900,5,5,2015,UNK,-140,0
8658300480,7/21/2014,299800.0,4,1.5,1530,9000,1.0,0.0,0.0,4,6,1530,0,1976,0,98014,47.6492,-121.90799999999999,1520,8500,7,21,2014,UNK,10,500
9187200285,5/5/2014,823000.0,6,1.75,2920,5000,2.5,0.0,0.0,4,9,2780,140,1908,0,98122,47.6024,-122.295,2020,5000,5,5,2014,UNK,900,0
3670500605,9/8/2014,200000.0,3,1.0,1010,8108,1.0,0.0,0.0,3,7,1010,0,1955,0,98155,47.735,-122.309,1110,8108,9,8,2014,UNK,-100,0
2141330050,5/20/2014,760000.0,4,1.75,2450,13300,1.0,0.0,0.0,4,9,1630,820,1987,0,98006,47.5564,-122.13,3150,15500,5,20,2014,UNK,-700,-2200
3820350020,4/28/2015,359950.0,4,2.5,1820,3899,2.0,0.0,0.0,3,7,1820,0,1999,0,98019,47.735,-121.985,1820,3899,4,28,2015,UNK,0,0
3291800780,2/3/2015,375000.0,4,2.5,2090,8325,1.0,0.0,0.0,4,7,1470,620,1983,0,98056,47.4888,-122.184,1700,8025,2,3,2015,UNK,390,300
2423069120,5/8/2014,295000.0,2,1.75,2200,89298,1.0,0.0,0.0,3,7,1100,1100,1973,0,98027,47.4633,-121.976,2590,89298,5,8,2014,UNK,-390,0
6918100170,3/19/2015,250000.0,4,3.0,2250,7882,2.0,0.0,0.0,3,8,1570,680,1986,0,98198,47.3703,-122.314,1550,7508,3,19,2015,UNK,700,374
7169200221,10/23/2014,497000.0,3,2.25,1450,1387,3.0,0.0,0.0,3,8,1450,0,2000,0,98115,47.6765,-122.302,1450,1429,10,23,2014,UNK,0,-42
3579000440,8/13/2014,520000.0,4,2.5,2280,8798,2.0,0.0,0.0,4,8,2280,0,1987,0,98028,47.7471,-122.24700000000001,2180,8632,8,13,2014,UNK,100,166
8860500130,7/17/2014,365000.0,4,3.5,2720,6781,2.0,0.0,0.0,3,8,2100,620,1999,0,98055,47.4612,-122.215,2280,5942,7,17,2014,UNK,440,839
1441800010,12/8/2014,459900.0,3,2.25,2250,8000,1.0,0.0,0.0,3,8,1460,790,1976,0,98034,47.7229,-122.20200000000001,1930,9000,12,8,2014,UNK,320,-1000
7129300595,5/6/2015,158000.0,3,2.0,1090,6090,1.0,0.0,0.0,3,7,940,150,1940,0,98118,47.5118,-122.259,1840,6090,5,6,2015,UNK,-750,0
4322300010,6/6/2014,294700.0,3,2.0,1970,9600,1.0,0.0,0.0,4,7,1300,0,1967,0,98003,47.2824,-122.301,1710,7703,6,6,2014,UNK,260,1897
7229800066,8/19/2014,439950.0,4,2.25,2780,15075,2.0,0.0,0.0,3,7,2780,0,1985,0,98059,47.477,-122.116,1650,25542,8,19,2014,UNK,1130,-10467
3625059071,1/8/2015,899000.0,4,2.25,2290,40946,1.0,0.0,3.0,4,8,1550,740,1960,0,98008,47.61600000000001,-122.103,2790,20076,1,8,2015,UNK,-500,20870
9517200480,7/2/2014,535000.0,3,1.75,2330,12141,1.0,0.0,0.0,3,7,1390,940,1983,0,98072,47.7607,-122.146,1850,12141,7,2,2014,UNK,480,0
240000269,1/24/2015,530000.0,4,4.5,4060,10800,2.0,0.0,0.0,3,10,4060,0,2007,0,98188,47.4241,-122.29,1830,9768,1,24,2015,N,2230,1032
9835800840,2/4/2015,215000.0,4,2.0,1470,7000,1.0,0.0,0.0,4,8,1470,0,1967,0,98032,47.3742,-122.289,1640,7000,2,4,2015,UNK,-170,0
8058500005,2/3/2015,290000.0,2,1.0,1620,5400,1.0,0.0,0.0,3,6,920,0,1926,0,98125,47.7069,-122.29899999999999,1540,7245,2,3,2015,UNK,80,-1845
2568200170,3/11/2015,798000.0,5,2.75,3220,5934,2.0,0.0,0.0,3,9,3220,0,2006,0,98052,47.7076,-122.101,3100,5934,3,11,2015,N,120,0
9545250010,11/7/2014,785000.0,4,2.5,3270,9578,2.0,0.0,0.0,3,9,3270,0,1993,0,98027,47.5373,-122.051,3120,8784,11,7,2014,UNK,150,794
4140090420,3/18/2015,433000.0,3,1.75,2160,8565,1.0,0.0,0.0,3,8,1730,430,1971,0,98028,47.7664,-122.262,2910,9570,3,18,2015,UNK,-750,-1005
3334000050,7/21/2014,425000.0,2,1.0,1150,6835,1.0,0.0,1.0,3,7,1010,140,1922,0,98118,47.5567,-122.273,1150,6561,7,21,2014,UNK,0,274
5101404144,7/24/2014,654000.0,4,2.5,2240,7540,1.0,0.0,0.0,3,8,1540,700,1962,0,98115,47.6965,-122.30799999999999,1960,7250,7,24,2014,UNK,280,290
7338001190,10/17/2014,215000.0,3,1.5,1280,5065,2.0,0.0,0.0,4,6,1280,0,1983,0,98002,47.3343,-122.21700000000001,1070,4491,10,17,2014,UNK,210,574
1865810290,3/18/2015,232000.0,3,1.0,840,6540,1.0,0.0,0.0,3,6,840,0,1970,2014,98042,47.3743,-122.116,1010,6600,3,18,2015,Y,-170,-60
2785000290,5/7/2014,675000.0,3,1.75,1680,10500,1.0,0.0,0.0,4,8,1680,0,1959,0,98005,47.6098,-122.169,2250,10400,5,7,2014,UNK,-570,100
7955040080,11/4/2014,665000.0,5,2.75,2330,8000,1.0,0.0,0.0,4,7,1550,780,1972,0,98052,47.6651,-122.14399999999999,1750,8419,11,4,2014,UNK,580,-419
5480900010,6/23/2014,835000.0,4,2.5,3030,29163,2.0,0.0,0.0,3,10,3030,0,1998,0,98053,47.6569,-122.02,2780,40669,6,23,2014,UNK,250,-11506
6362900080,8/14/2014,525000.0,6,3.0,2880,7560,2.0,0.0,0.0,3,7,2880,0,1980,0,98144,47.5959,-122.3,1470,1815,8,14,2014,UNK,1410,5745
4078300050,5/4/2015,780000.0,3,2.75,2910,3094,2.0,0.0,2.0,5,7,2010,900,1939,0,98125,47.7071,-122.27600000000001,2400,7530,5,4,2015,UNK,510,-4436
3528000545,8/15/2014,844000.0,4,3.25,3090,67518,2.0,0.0,0.0,3,10,3090,0,1988,0,98053,47.6674,-122.046,3200,65775,8,15,2014,UNK,-110,1743
710300010,1/27/2015,680000.0,4,2.75,2720,54048,2.0,0.0,0.0,3,8,2720,0,1985,0,98072,47.7181,-122.089,2580,37721,1,27,2015,UNK,140,16327
3764800630,8/25/2014,290000.0,3,1.5,1310,8100,1.0,0.0,0.0,3,7,1310,0,1965,0,98034,47.7328,-122.20100000000001,1330,8100,8,25,2014,UNK,-20,0
6383000825,3/25/2015,560000.0,2,1.0,1790,15783,1.0,0.0,0.0,4,8,1360,430,1959,0,98117,47.691,-122.387,1790,7494,3,25,2015,UNK,0,8289
9465900500,6/17/2014,605500.0,3,2.5,2830,6536,2.0,0.0,0.0,3,9,2830,0,1989,0,98072,47.7462,-122.17200000000001,2710,6954,6,17,2014,UNK,120,-418
2568200290,8/26/2014,762500.0,4,2.5,3150,5979,2.0,0.0,0.0,3,9,3150,0,2005,0,98052,47.7082,-122.101,3150,6595,8,26,2014,N,0,-616
3885808005,3/5/2015,1740000.0,5,3.25,3930,5500,2.0,0.0,0.0,3,9,2910,1020,2014,0,98033,47.6802,-122.208,2040,5115,3,5,2015,N,1890,385
3723800086,6/24/2014,665000.0,6,2.75,2840,8346,1.0,0.0,0.0,5,8,1420,1420,1961,0,98118,47.5518,-122.266,2250,8346,6,24,2014,UNK,590,0
6840701150,3/11/2015,540000.0,5,1.0,2480,4400,1.5,0.0,0.0,3,7,1640,840,1919,0,98122,47.6046,-122.3,1940,4400,3,11,2015,UNK,540,0
7301300050,11/19/2014,375000.0,3,2.5,1930,6180,1.0,0.0,0.0,3,7,1330,600,1961,0,98155,47.7481,-122.32700000000001,1940,6180,11,19,2014,UNK,-10,0
6381500635,5/16/2014,342000.0,3,1.0,1260,6826,1.0,0.0,0.0,3,6,720,540,1944,0,98125,47.731,-122.303,1300,6826,5,16,2014,UNK,-40,0
3980300020,3/10/2015,340000.0,3,1.0,670,23522,1.0,0.0,0.0,4,6,670,0,1968,0,98024,47.5329,-121.89,1880,20270,3,10,2015,UNK,-1210,3252
1923000050,3/30/2015,1250000.0,5,3.25,3930,12719,2.0,0.0,2.0,4,10,2540,1390,1974,0,98040,47.5631,-122.213,3600,15909,3,30,2015,UNK,330,-3190
7215720250,12/10/2014,693000.0,4,2.5,3160,13063,2.0,0.0,0.0,3,10,3160,0,1999,0,98075,47.5996,-122.021,3350,14213,12,10,2014,UNK,-190,-1150
3123049230,4/20/2015,638500.0,4,1.75,1770,12462,1.0,0.0,2.0,4,8,1770,0,1962,0,98166,47.4355,-122.338,2310,14810,4,20,2015,UNK,-540,-2348
8163000020,1/26/2015,805000.0,5,3.0,2240,18265,2.0,0.0,0.0,4,8,2240,0,1963,0,98027,47.5171,-122.029,1990,18265,1,26,2015,UNK,250,0
7893808220,7/9/2014,250000.0,3,1.0,990,8062,1.0,0.0,0.0,4,7,990,0,1960,0,98198,47.4151,-122.334,1420,8790,7,9,2014,UNK,-430,-728
538000440,5/1/2015,325000.0,3,2.5,1580,4698,2.0,0.0,0.0,3,7,1580,0,1998,0,98038,47.3539,-122.025,2070,4698,5,1,2015,UNK,-490,0
7883603390,4/1/2015,270000.0,4,1.75,1560,4290,2.0,0.0,0.0,3,7,1560,0,1994,0,98108,47.5292,-122.323,1250,6000,4,1,2015,UNK,310,-1710
7645900235,7/10/2014,880000.0,6,2.5,2640,3680,2.0,0.0,0.0,5,8,1760,880,1922,0,98126,47.5771,-122.38,1960,3680,7,10,2014,UNK,680,0
9232900050,8/6/2014,300000.0,2,1.75,2120,6350,1.0,0.0,0.0,4,6,1440,680,1924,0,98103,47.6974,-122.35600000000001,1590,6350,8,6,2014,UNK,530,0
7305300500,12/15/2014,290000.0,2,1.0,1200,8750,1.0,0.0,0.0,3,6,1200,0,1948,0,98155,47.7548,-122.32700000000001,1100,8408,12,15,2014,UNK,100,342
6065300840,5/1/2015,2850000.0,4,4.0,5040,17208,1.0,0.0,0.0,5,10,2870,2170,1976,0,98006,47.5701,-122.18799999999999,4050,18647,5,1,2015,UNK,990,-1439
7227500020,1/23/2015,259950.0,3,1.0,1460,5825,1.0,0.0,0.0,5,5,1260,200,1942,0,98056,47.4958,-122.191,1150,5926,1,23,2015,UNK,310,-101
7237501190,10/10/2014,1780000.0,4,3.25,4890,13402,2.0,0.0,0.0,3,13,4890,0,2004,0,98059,47.5303,-122.131,5790,13539,10,10,2014,N,-900,-137
422000010,11/6/2014,299950.0,3,1.0,1580,5250,1.0,0.0,0.0,5,7,1580,0,1954,0,98056,47.4964,-122.16799999999999,1180,5940,11,6,2014,UNK,400,-690
826069127,4/6/2015,483000.0,3,2.25,2100,43560,1.0,0.0,0.0,4,8,1330,770,1977,0,98077,47.7511,-122.072,2100,43560,4,6,2015,UNK,0,0
9413600420,6/12/2014,890000.0,3,2.25,2060,8640,1.0,0.0,0.0,4,8,2060,0,1966,0,98033,47.6534,-122.195,2030,9000,6,12,2014,UNK,30,-360
9151600541,5/8/2014,719000.0,3,2.5,1690,4500,1.5,0.0,1.0,4,8,1690,0,1928,0,98116,47.5841,-122.383,2140,7200,5,8,2014,UNK,-450,-2700
3423059153,10/8/2014,785000.0,4,3.0,3370,100681,1.0,0.0,0.0,5,8,1920,1450,1977,0,98058,47.4319,-122.148,2440,43705,10,8,2014,UNK,930,56976
3630120190,3/26/2015,660000.0,3,2.5,2330,3995,2.0,0.0,0.0,3,9,2330,0,2006,0,98029,47.5542,-122.001,2330,3740,3,26,2015,N,0,255
2787320430,6/18/2014,264000.0,4,1.75,1820,8118,1.0,0.0,0.0,4,7,1080,740,1980,0,98031,47.4104,-122.17200000000001,1810,8050,6,18,2014,UNK,10,68
1672000170,9/8/2014,575000.0,3,1.75,1890,11141,1.0,0.0,0.0,4,8,1890,0,1968,0,98006,47.5697,-122.163,2720,11144,9,8,2014,UNK,-830,-3
2050000020,6/24/2014,1220000.0,4,3.75,3820,53574,1.0,0.0,0.0,3,10,3820,0,1994,0,98072,47.7337,-122.12100000000001,3140,54014,6,24,2014,UNK,680,-440
3221079069,8/15/2014,475000.0,3,2.5,2770,98881,2.0,0.0,0.0,3,9,2770,0,1991,0,98022,47.2568,-121.95200000000001,1830,74923,8,15,2014,UNK,940,23958
7501000080,11/21/2014,845800.0,4,3.5,3020,12750,2.0,0.0,0.0,3,10,3020,0,1990,0,98033,47.6524,-122.184,3120,14351,11,21,2014,UNK,-100,-1601
3500100078,6/11/2014,352500.0,3,1.75,1170,8182,1.0,0.0,0.0,3,7,1170,0,1962,0,98155,47.7368,-122.29799999999999,1610,8183,6,11,2014,UNK,-440,-1
9493200010,6/23/2014,347000.0,3,1.0,1270,8400,1.0,0.0,0.0,3,7,1270,0,1955,0,98011,47.7604,-122.198,1390,8400,6,23,2014,UNK,-120,0
3905081350,1/9/2015,560000.0,4,2.75,1950,6192,2.0,0.0,0.0,3,8,1950,0,1992,0,98029,47.5698,-121.999,2040,5441,1,9,2015,UNK,-90,751
6061000010,5/4/2015,323000.0,4,2.75,2230,50094,1.0,0.0,2.0,4,7,1330,900,1977,0,98092,47.2576,-122.09899999999999,2230,40770,5,4,2015,UNK,0,9324
7635801350,3/6/2015,595000.0,3,1.75,2220,22081,1.5,0.0,0.0,4,7,2220,0,1922,0,98166,47.4693,-122.36399999999999,2010,12360,3,6,2015,UNK,210,9721
7806210380,2/20/2015,257500.0,4,2.0,2060,6400,1.0,0.0,0.0,3,7,1170,890,1977,0,98002,47.2924,-122.197,1890,8736,2,20,2015,UNK,170,-2336
7577700440,5/28/2014,450000.0,3,1.0,1100,4600,1.0,0.0,0.0,3,7,1100,0,1917,0,98116,47.5686,-122.385,1200,5175,5,28,2014,UNK,-100,-575
3876810190,11/13/2014,410000.0,4,1.0,1140,7208,1.0,0.0,0.0,3,7,900,240,1970,0,98072,47.742,-122.17299999999999,1300,7991,11,13,2014,UNK,-160,-783
1224059049,6/13/2014,810000.0,3,1.75,1980,13503,1.0,0.0,2.0,4,9,1320,660,1952,0,98008,47.5867,-122.111,2450,10890,6,13,2014,UNK,-470,2613
3348401319,5/12/2014,372500.0,5,3.0,2480,10090,1.0,0.0,0.0,3,7,1300,1180,2004,0,98178,47.4964,-122.26299999999999,2290,9900,5,12,2014,N,190,190
5589300585,12/3/2014,325000.0,3,1.0,1050,9083,1.0,0.0,0.0,3,7,1050,0,1951,0,98155,47.7533,-122.307,1440,9071,12,3,2014,UNK,-390,12
3293700221,10/21/2014,280000.0,3,1.0,1260,7660,1.0,0.0,0.0,3,6,1260,0,1947,0,98133,47.7476,-122.35,1990,7861,10,21,2014,UNK,-730,-201
2013300050,7/11/2014,258000.0,3,2.0,1680,19978,1.0,0.0,0.0,3,6,880,800,1948,0,98198,47.3924,-122.30799999999999,2150,11588,7,11,2014,UNK,-470,8390
408100050,8/27/2014,329950.0,4,1.0,1360,5900,1.5,0.0,0.0,4,7,1360,0,1949,0,98155,47.7512,-122.318,1050,5900,8,27,2014,UNK,310,0
4178300080,12/12/2014,836000.0,4,2.5,2450,12987,1.0,0.0,0.0,4,9,2030,420,1980,0,98007,47.6197,-122.15,2730,13685,12,12,2014,UNK,-280,-698
2310040020,4/9/2015,365000.0,5,2.5,2260,7040,2.0,0.0,0.0,3,8,2260,0,1999,0,98038,47.352,-122.038,2180,6910,4,9,2015,UNK,80,130
8698100170,2/11/2015,111300.0,2,1.0,1060,6000,1.0,0.0,0.0,4,5,1060,0,1908,0,98002,47.3066,-122.223,940,6000,2,11,2015,UNK,120,0
1330910280,4/27/2015,864000.0,4,2.5,3720,105850,2.0,0.0,0.0,4,10,3720,0,1984,0,98053,47.655,-122.029,2830,88256,4,27,2015,UNK,890,17594
9413600670,6/23/2014,725000.0,3,1.75,1610,8613,1.0,0.0,0.0,5,7,1610,0,1962,0,98033,47.6527,-122.195,2010,8670,6,23,2014,UNK,-400,-57
3825500020,2/18/2015,550000.0,4,2.5,3350,6605,2.0,0.0,0.0,3,8,2670,680,1990,0,98011,47.7498,-122.181,2730,5962,2,18,2015,UNK,620,643
2500600289,4/16/2015,130000.0,2,1.0,790,7500,1.0,0.0,0.0,3,7,790,0,1951,0,98198,47.4007,-122.294,1560,7794,4,16,2015,UNK,-770,-294
4385701440,9/26/2014,765000.0,2,1.75,1660,4000,1.0,0.0,0.0,3,7,990,670,1940,0,98112,47.6394,-122.28,2070,4000,9,26,2014,UNK,-410,0
8645501330,4/21/2015,255000.0,3,1.5,1420,7480,1.0,0.0,0.0,4,7,1420,0,1963,0,98058,47.4651,-122.184,1720,7700,4,21,2015,UNK,-300,-220
2323069073,6/22/2014,439500.0,3,2.5,2050,40003,1.0,0.0,0.0,4,8,1570,0,1977,0,98027,47.47,-122.0,2700,46769,6,22,2014,UNK,-650,-6766
2475200080,9/8/2014,268000.0,3,1.75,1250,5546,1.0,0.0,0.0,4,7,1250,0,1987,0,98055,47.4725,-122.18700000000001,1640,4791,9,8,2014,UNK,-390,755
9533600185,4/1/2015,985000.0,3,1.75,1700,8534,1.0,0.0,0.0,4,7,1700,0,1953,0,98004,47.6276,-122.205,2100,10443,4,1,2015,UNK,-400,-1909
4139440460,11/18/2014,751305.0,4,2.5,2660,8469,2.0,0.0,0.0,3,10,2660,0,1994,0,98006,47.5529,-122.12,2920,10697,11,18,2014,UNK,-260,-2228
1443500725,4/23/2015,280000.0,3,1.0,1350,7553,1.5,0.0,0.0,3,6,1350,0,1914,0,98118,47.5345,-122.274,1380,7470,4,23,2015,UNK,-30,83
984000780,6/16/2014,304000.0,4,2.0,1810,8750,1.0,0.0,0.0,2,7,1110,700,1967,0,98058,47.4307,-122.17,1810,8750,6,16,2014,UNK,0,0
7575610170,4/23/2015,200000.0,4,2.75,2210,13235,2.0,0.0,0.0,3,8,1730,480,1988,0,98003,47.3541,-122.303,1750,7542,4,23,2015,UNK,460,5693
2025800080,2/20/2015,325000.0,3,1.5,2120,41325,1.0,0.0,0.0,4,7,1420,700,1973,0,98092,47.2906,-122.055,1780,42000,2,20,2015,UNK,340,-675
1425059180,3/24/2015,736000.0,3,2.25,2470,11603,2.0,0.0,2.0,3,8,1540,930,1988,0,98052,47.6569,-122.12299999999999,2850,11250,3,24,2015,UNK,-380,353
1310440280,7/10/2014,426500.0,4,2.5,2700,6515,2.0,0.0,0.0,3,9,2700,0,1998,0,98058,47.4356,-122.11,2900,6710,7,10,2014,UNK,-200,-195
2264500425,6/20/2014,640000.0,2,1.75,1760,4400,1.0,0.0,0.0,4,7,880,880,1930,0,98103,47.65,-122.34,1330,4180,6,20,2014,UNK,430,220
1721800470,5/21/2014,230000.0,5,2.0,1930,6120,1.5,0.0,0.0,3,6,1930,0,1941,1969,98146,47.5073,-122.337,1130,6120,5,21,2014,Y,800,0
2589300170,3/24/2015,366350.0,4,1.0,1680,5043,1.5,0.0,0.0,4,6,1680,0,1911,0,98118,47.5354,-122.273,1560,5765,3,24,2015,UNK,120,-722
2338800161,1/6/2015,365000.0,2,1.0,1390,8336,1.0,0.0,0.0,4,6,910,480,1946,0,98166,47.4646,-122.361,1610,7847,1,6,2015,UNK,-220,489
855700170,2/25/2015,482000.0,4,2.25,2240,8322,2.0,0.0,0.0,3,8,2240,0,1979,0,98034,47.728,-122.206,2240,6448,2,25,2015,UNK,0,1874
1431700250,5/16/2014,345000.0,4,1.0,1980,7991,1.5,0.0,0.0,3,7,1980,0,1962,0,98058,47.4604,-122.17,1730,7700,5,16,2014,UNK,250,291
7942601410,5/14/2014,682000.0,3,1.75,1830,5120,1.5,0.0,2.0,5,8,1830,0,1903,0,98122,47.6051,-122.311,2120,5120,5,14,2014,UNK,-290,0
4151800420,8/15/2014,657500.0,3,1.75,980,6002,1.0,0.0,0.0,4,6,980,0,1942,0,98033,47.6643,-122.20299999999999,1150,6054,8,15,2014,UNK,-170,-52
5700003280,4/19/2015,895000.0,6,2.5,3550,6533,2.0,0.0,0.0,3,8,3550,0,1925,0,98144,47.5719,-122.28399999999999,3140,6234,4,19,2015,UNK,410,299
1105000780,4/3/2015,425000.0,3,1.5,1660,5665,1.0,0.0,0.0,5,7,920,740,1918,0,98118,47.5391,-122.274,1530,5665,4,3,2015,UNK,130,0
4046400440,8/6/2014,532500.0,4,2.5,2490,8750,2.0,0.0,0.0,3,8,2040,450,1976,0,98008,47.5931,-122.116,2120,10240,8,6,2014,UNK,370,-1490
1089700010,10/8/2014,540000.0,4,2.5,2329,9436,2.0,0.0,0.0,3,9,2329,0,1995,0,98011,47.7366,-122.204,2660,10252,10,8,2014,UNK,-331,-816
2600040130,7/11/2014,578000.0,3,2.25,1790,9580,2.0,0.0,0.0,3,8,1790,0,1984,0,98006,47.5541,-122.162,2060,9995,7,11,2014,UNK,-270,-415
8121100715,2/9/2015,1090000.0,3,3.0,2830,6041,2.0,0.0,3.0,3,8,1840,990,1915,0,98118,47.5694,-122.28299999999999,3420,6360,2,9,2015,UNK,-590,-319
1771000440,9/4/2014,322500.0,3,1.0,1160,9750,1.0,0.0,0.0,3,7,1160,0,1968,0,98077,47.7429,-122.072,1160,10565,9,4,2014,UNK,0,-815
7875200005,1/15/2015,140000.0,3,1.0,1000,10560,1.0,0.0,0.0,3,7,1000,0,1955,0,98003,47.3217,-122.31700000000001,1190,9375,1,15,2015,UNK,-190,1185
1822069109,9/10/2014,485000.0,3,2.5,2540,51836,1.0,0.0,0.0,4,8,1820,720,1976,0,98042,47.388999999999996,-122.088,1650,51836,9,10,2014,UNK,890,0
9283800050,8/19/2014,575000.0,2,1.5,1750,19709,1.5,0.0,0.0,4,8,1440,310,1978,0,98010,47.3351,-122.044,1950,21075,8,19,2014,UNK,-200,-1366
238000244,6/17/2014,421000.0,3,2.5,2890,21780,2.0,0.0,0.0,3,8,2890,0,2000,0,98188,47.4326,-122.286,2120,8117,6,17,2014,UNK,770,13663
7972600430,3/11/2015,355000.0,4,2.0,1870,3497,1.0,0.0,0.0,3,7,1200,670,1954,0,98106,47.5309,-122.34700000000001,1270,3497,3,11,2015,UNK,600,0
6204200470,3/18/2015,515000.0,4,2.25,2200,6967,2.0,0.0,0.0,3,8,2200,0,1986,0,98011,47.7355,-122.20200000000001,1970,7439,3,18,2015,UNK,230,-472
123039420,4/28/2015,309000.0,3,1.0,1300,7200,1.0,0.0,0.0,4,7,1300,0,1952,0,98146,47.5063,-122.369,1740,7100,4,28,2015,UNK,-440,100
1525059215,2/24/2015,815000.0,5,2.25,3410,35536,2.0,0.0,0.0,3,10,2530,880,1974,0,98005,47.65,-122.155,3140,43453,2,24,2015,UNK,270,-7917
1787600094,11/6/2014,285000.0,3,1.0,1160,7875,1.0,0.0,0.0,3,7,1160,0,1953,0,98125,47.724,-122.323,1600,7875,11,6,2014,UNK,-440,0
2877101100,11/10/2014,700000.0,3,1.75,2100,5000,1.5,0.0,0.0,3,8,2100,0,1916,0,98117,47.6776,-122.36,1830,4200,11,10,2014,UNK,270,800
9406550050,3/30/2015,289000.0,3,2.5,1490,8628,2.0,0.0,0.0,3,7,1490,0,1994,0,98038,47.3643,-122.041,1640,8514,3,30,2015,UNK,-150,114
826069016,12/12/2014,458000.0,4,3.0,3280,62726,1.5,0.0,0.0,3,7,3280,0,1979,0,98077,47.7509,-122.056,3210,73616,12,12,2014,UNK,70,-10890
8732030080,8/18/2014,230000.0,3,1.75,1450,8378,1.0,0.0,0.0,4,8,1450,0,1978,0,98023,47.3093,-122.385,1860,8496,8,18,2014,UNK,-410,-118
2231000020,8/12/2014,432500.0,3,2.5,1930,7120,1.0,0.0,0.0,4,7,1420,510,1961,0,98133,47.7715,-122.34,1600,8352,8,12,2014,UNK,330,-1232
9407000840,7/31/2014,288000.0,3,1.75,1660,10440,1.0,0.0,0.0,3,7,1040,620,1978,0,98045,47.4448,-121.77,1240,10380,7,31,2014,UNK,420,60
1775800290,8/1/2014,354000.0,3,1.75,1260,12330,1.0,0.0,0.0,3,7,1260,0,1968,0,98072,47.7412,-122.095,1320,12800,8,1,2014,UNK,-60,-470
3821200050,6/4/2014,119500.0,3,1.0,1170,11000,1.0,0.0,0.0,2,6,1170,0,1980,0,98019,47.7346,-121.98299999999999,1590,10894,6,4,2014,UNK,-420,106
3224510080,11/20/2014,805000.0,4,3.0,3350,23781,1.0,0.0,0.0,4,9,2020,1330,1979,0,98006,47.56,-122.132,2870,12036,11,20,2014,UNK,480,11745
3626039415,6/11/2014,435000.0,3,2.5,1420,2581,3.0,0.0,0.0,3,7,1420,0,2004,0,98133,47.7027,-122.35700000000001,1420,2509,6,11,2014,N,0,72
9262800294,9/22/2014,260000.0,3,1.75,2170,10018,1.0,0.0,0.0,4,7,1630,540,1978,0,98001,47.3087,-122.264,2049,15263,9,22,2014,UNK,121,-5245
127100005,4/1/2015,377000.0,4,1.75,1800,8385,1.0,0.0,0.0,5,6,900,900,1950,0,98133,47.7744,-122.338,1770,8385,4,1,2015,UNK,30,0
3905040170,3/20/2015,602000.0,4,2.5,2000,7376,2.0,0.0,0.0,3,8,2000,0,1990,0,98029,47.5719,-121.999,1950,5218,3,20,2015,UNK,50,2158
148000680,10/27/2014,530000.0,3,1.75,1660,4800,1.0,0.0,0.0,3,7,960,700,1941,0,98116,47.5734,-122.412,1510,4800,10,27,2014,UNK,150,0
458000235,3/25/2015,525000.0,4,2.0,1540,3740,1.0,0.0,0.0,4,7,770,770,1946,0,98117,47.6886,-122.375,1090,5080,3,25,2015,UNK,450,-1340
1445200050,11/10/2014,250000.0,2,1.5,1160,1086,2.0,0.0,0.0,3,7,890,270,2006,0,98155,47.768,-122.315,1160,1086,11,10,2014,N,0,0
7950300005,5/28/2014,681000.0,3,1.0,1700,6356,1.5,0.0,0.0,3,7,1700,0,1907,0,98118,47.5677,-122.281,2080,6000,5,28,2014,UNK,-380,356
2726049169,9/5/2014,625000.0,3,1.75,1580,20588,1.0,0.0,0.0,3,8,1580,0,1970,0,98125,47.706,-122.29,2080,7800,9,5,2014,UNK,-500,12788
8944550050,5/8/2015,448500.0,3,2.5,2080,3920,2.0,0.0,0.0,3,8,2080,0,2010,0,98118,47.5412,-122.286,2110,3710,5,8,2015,N,-30,210
623049341,10/22/2014,260000.0,3,2.0,1030,7260,1.0,0.0,0.0,3,6,1030,0,1947,0,98146,47.5113,-122.34700000000001,1380,8100,10,22,2014,UNK,-350,-840
7922900380,10/30/2014,538000.0,3,1.75,1770,8050,1.0,0.0,0.0,4,7,1020,750,1963,0,98008,47.5862,-122.118,2000,7875,10,30,2014,UNK,-230,175
2248000080,5/21/2014,385500.0,3,2.0,1540,7947,1.0,0.0,0.0,3,7,1120,420,1961,0,98011,47.7605,-122.21700000000001,1910,7950,5,21,2014,UNK,-370,-3
9406540050,9/5/2014,428400.0,4,2.5,2650,6000,2.0,0.0,0.0,3,9,2650,0,2000,0,98038,47.3768,-122.02799999999999,2630,6381,9,5,2014,UNK,20,-381
5416100190,7/29/2014,346290.0,4,2.75,2690,9240,2.0,0.0,0.0,3,8,2690,0,1998,0,98022,47.1896,-122.014,2640,9240,7,29,2014,UNK,50,0
7215720680,2/3/2015,587000.0,4,2.75,2210,8430,2.0,0.0,0.0,3,9,2210,0,1999,0,98075,47.5994,-122.01700000000001,2460,8069,2,3,2015,UNK,-250,361
4307330280,8/20/2014,355000.0,4,2.5,2390,6775,2.0,0.0,0.0,3,7,2390,0,2003,0,98056,47.4811,-122.182,2560,6346,8,20,2014,UNK,-170,429
1562000050,4/28/2015,650000.0,5,2.75,2580,7865,1.0,0.0,0.0,4,8,1480,1100,1964,0,98007,47.6208,-122.139,2140,8400,4,28,2015,UNK,440,-535
4307320280,7/30/2014,340000.0,4,2.5,2160,5455,2.0,0.0,0.0,3,7,2160,0,2003,0,98056,47.4799,-122.18299999999999,2160,5257,7,30,2014,UNK,0,198
569000050,7/3/2014,565000.0,4,2.5,2230,8624,1.0,0.0,0.0,4,8,1430,0,1969,0,98052,47.6623,-122.152,1970,8402,7,3,2014,UNK,260,222
5700000595,2/19/2015,630000.0,4,2.0,2000,5000,1.5,0.0,0.0,5,7,2000,0,1925,0,98144,47.5787,-122.29299999999999,2200,5000,2,19,2015,UNK,-200,0
8029200190,11/7/2014,227000.0,3,1.0,1280,7198,1.0,0.0,0.0,5,6,1280,0,1916,1983,98022,47.2094,-121.99600000000001,1260,7198,11,7,2014,Y,20,0
2896000680,7/29/2014,600000.0,4,2.75,2810,17674,1.0,0.0,0.0,4,8,1640,1170,1978,0,98052,47.6745,-122.14399999999999,2400,11240,7,29,2014,UNK,410,6434
9328500680,2/2/2015,540400.0,4,1.75,1680,6758,1.0,0.0,0.0,3,8,1680,0,1974,0,98008,47.64100000000001,-122.113,1910,7000,2,2,2015,UNK,-230,-242
3295730050,10/1/2014,569000.0,3,2.5,2150,8060,2.0,0.0,0.0,3,8,2150,0,1995,0,98033,47.6952,-122.18799999999999,2150,7172,10,1,2014,UNK,0,888
3629970130,7/10/2014,735000.0,3,2.5,2820,8159,2.0,0.0,0.0,3,9,2820,0,2004,0,98029,47.5527,-121.992,2910,5000,7,10,2014,N,-90,3159
3574801310,12/16/2014,434000.0,3,2.25,1750,9353,1.0,0.0,0.0,3,7,1210,540,1987,0,98034,47.7305,-122.225,1930,8545,12,16,2014,UNK,-180,808
4083802195,3/19/2015,578888.0,2,2.0,1060,4000,1.0,0.0,0.0,2,7,1000,60,1914,0,98103,47.6626,-122.337,1310,4000,3,19,2015,UNK,-250,0
9238500480,5/23/2014,465425.0,4,2.75,2430,20720,1.0,0.0,0.0,3,7,2430,0,1967,0,98072,47.775,-122.139,2580,26950,5,23,2014,UNK,-150,-6230
9264910280,4/22/2015,280500.0,4,2.75,2660,7754,1.5,0.0,0.0,3,8,1590,1070,1986,0,98023,47.3078,-122.337,2250,7754,4,22,2015,UNK,410,0
3630120380,2/5/2015,539950.0,2,2.0,1670,3507,1.0,0.0,0.0,3,9,1670,0,2007,0,98029,47.5545,-122.00299999999999,2330,3889,2,5,2015,N,-660,-382
424069088,9/4/2014,406430.0,3,2.0,1380,15426,1.0,0.0,0.0,4,7,1380,0,1968,0,98075,47.5951,-122.036,1380,15426,9,4,2014,UNK,0,0
2954400020,2/5/2015,1150000.0,4,3.75,4160,35000,2.0,0.0,0.0,3,11,4160,0,1991,0,98053,47.669,-122.06700000000001,5330,36446,2,5,2015,UNK,-1170,-1446
2154550020,11/11/2014,250000.0,3,2.5,1790,6191,2.0,0.0,0.0,3,8,1790,0,1992,0,98031,47.4102,-122.195,1790,6758,11,11,2014,UNK,0,-567
5420800010,5/8/2014,266000.0,3,2.5,1940,8547,1.0,0.0,0.0,3,7,1460,480,1989,0,98030,47.3491,-122.177,1750,7803,5,8,2014,UNK,190,744
2459950010,7/22/2014,258000.0,3,2.0,1390,7200,1.0,0.0,0.0,3,7,1390,0,1996,0,98058,47.434,-122.154,1630,7340,7,22,2014,UNK,-240,-140
4019301300,12/23/2014,472000.0,3,2.0,2200,21890,1.0,0.0,2.0,3,8,1200,1000,1961,0,98155,47.7584,-122.271,2600,15162,12,23,2014,UNK,-400,6728
3179100480,8/6/2014,530000.0,3,2.25,1264,1536,2.0,0.0,0.0,3,8,1264,0,2003,0,98105,47.6694,-122.279,1264,2067,8,6,2014,UNK,0,-531
7942601155,7/22/2014,302282.0,2,1.0,1095,5120,1.5,0.0,0.0,3,7,1095,0,1901,0,98122,47.6058,-122.31299999999999,1310,5120,7,22,2014,UNK,-215,0
2493200235,3/11/2015,370000.0,2,1.0,850,6213,1.0,0.0,0.0,3,6,750,100,1916,0,98136,47.5282,-122.384,1880,5500,3,11,2015,UNK,-1030,713
6338000014,10/13/2014,625000.0,4,2.0,1760,5307,1.5,0.0,0.0,4,7,1170,590,1948,0,98105,47.6714,-122.28,1850,6600,10,13,2014,UNK,-90,-1293
1735800050,4/9/2015,142500.0,1,1.0,690,6825,1.0,0.0,0.0,4,5,690,0,1917,0,98002,47.3109,-122.225,1330,5381,4,9,2015,UNK,-640,1444
2783100050,1/21/2015,334000.0,3,1.75,1400,7405,1.0,0.0,0.0,3,7,1400,0,1961,0,98133,47.7569,-122.334,1820,7440,1,21,2015,UNK,-420,-35
1604600095,7/8/2014,362000.0,5,3.0,1810,3000,2.0,0.0,0.0,3,7,1810,0,1998,0,98118,47.5622,-122.291,1670,3000,7,8,2014,UNK,140,0
3080000005,4/17/2015,181000.0,2,1.0,1310,4000,1.0,0.0,0.0,3,7,950,360,1942,0,98144,47.5798,-122.306,1310,4000,4,17,2015,UNK,0,0
2268000470,12/31/2014,241500.0,3,1.0,1400,10425,1.0,0.0,0.0,4,7,1400,0,1968,0,98003,47.2738,-122.301,1440,10425,12,31,2014,UNK,-40,0
807800190,2/4/2015,245000.0,3,1.75,2350,12720,1.0,0.0,0.0,4,7,1180,1170,1964,0,98030,47.3594,-122.175,1680,10400,2,4,2015,UNK,670,2320
1274500170,5/6/2015,227500.0,3,1.0,1150,8848,1.0,0.0,0.0,3,7,1150,0,1968,0,98042,47.3626,-122.111,1220,9576,5,6,2015,UNK,-70,-728
8857600780,10/3/2014,158550.0,5,1.5,1710,8100,1.5,0.0,0.0,4,7,1710,0,1961,0,98032,47.3839,-122.288,1480,8025,10,3,2014,UNK,230,75
5145000130,9/25/2014,450000.0,3,2.25,1660,10247,1.0,0.0,0.0,5,7,1130,530,1968,0,98034,47.7262,-122.22200000000001,1680,7637,9,25,2014,UNK,-20,2610
3288200470,2/4/2015,485000.0,3,1.75,1950,10080,1.0,0.0,0.0,4,7,1950,0,1967,0,98034,47.7282,-122.186,2340,8800,2,4,2015,UNK,-390,1280
1771000950,11/6/2014,353000.0,4,1.75,1780,9794,1.0,0.0,0.0,3,7,1780,0,1967,0,98077,47.7419,-122.073,1160,9750,11,6,2014,UNK,620,44
3818400050,4/6/2015,500000.0,4,3.0,2450,4668,2.0,0.0,0.0,3,8,2450,0,2004,0,98028,47.7721,-122.235,2460,4895,4,6,2015,N,-10,-227
537000130,9/8/2014,360000.0,1,2.25,2060,10600,1.5,0.0,0.0,3,7,1560,500,1927,1983,98003,47.3291,-122.304,2060,11880,9,8,2014,Y,0,-1280
5127000420,2/23/2015,357500.0,3,1.5,1540,11858,1.0,0.0,0.0,4,7,1540,0,1966,0,98059,47.4755,-122.15700000000001,1550,11473,2,23,2015,UNK,-10,385
8656300380,5/6/2014,272000.0,3,2.5,1650,13816,2.0,0.0,0.0,3,7,1650,0,1998,0,98014,47.6553,-121.912,1650,15144,5,6,2014,UNK,0,-1328
6632300161,4/28/2015,422000.0,3,1.0,1160,7854,1.0,0.0,0.0,3,7,1160,0,1960,0,98125,47.7304,-122.30799999999999,1300,8317,4,28,2015,UNK,-140,-463
622100130,9/17/2014,365000.0,2,2.0,1440,15000,1.0,0.0,0.0,3,7,1440,0,1985,0,98072,47.7648,-122.15899999999999,1780,15000,9,17,2014,UNK,-340,0
4028900048,8/21/2014,450000.0,3,1.75,2150,13789,1.0,0.0,0.0,4,8,1610,540,1966,0,98155,47.7591,-122.295,2150,15480,8,21,2014,UNK,0,-1691
411100005,9/22/2014,275053.0,2,1.0,1060,6504,1.0,0.0,0.0,3,6,1060,0,1950,0,98155,47.7412,-122.32700000000001,1100,7200,9,22,2014,UNK,-40,-696
6447300225,11/6/2014,1880000.0,3,2.75,2620,17919,1.0,0.0,1.0,4,9,2620,0,1949,0,98039,47.6144,-122.228,3400,14400,11,6,2014,UNK,-780,3519
5739600427,3/11/2015,725000.0,3,1.75,1630,9000,1.0,0.0,0.0,3,7,960,670,1955,0,98004,47.6023,-122.205,1880,9000,3,11,2015,UNK,-250,0
5412310080,6/12/2014,235000.0,3,1.75,1840,9697,1.0,0.0,0.0,4,7,1500,340,1985,0,98030,47.3764,-122.179,1430,8079,6,12,2014,UNK,410,1618
2726049071,12/11/2014,510000.0,2,1.0,820,4206,1.0,0.0,0.0,3,5,820,0,1949,0,98125,47.7076,-122.28399999999999,1810,7200,12,11,2014,UNK,-990,-2994
2726049071,4/8/2015,489950.0,2,1.0,820,4206,1.0,0.0,0.0,3,5,820,0,1949,0,98125,47.7076,-122.28399999999999,1810,7200,4,8,2015,UNK,-990,-2994
3764650050,7/30/2014,463000.0,3,2.5,2010,4195,2.0,0.0,0.0,3,8,2010,0,1998,0,98034,47.732,-122.197,2010,5779,7,30,2014,UNK,0,-1584
3905030480,6/17/2014,536000.0,4,2.25,1990,5948,2.0,0.0,0.0,3,8,1990,0,1991,0,98029,47.5712,-121.995,2150,6459,6,17,2014,UNK,-160,-511
2345700500,10/21/2014,375000.0,4,2.5,2990,6145,2.0,0.0,0.0,3,8,2990,0,2003,0,98003,47.2612,-122.294,2590,6512,10,21,2014,UNK,400,-367
8650300130,9/8/2014,630000.0,4,2.5,2540,4727,2.0,0.0,0.0,3,9,2540,0,1999,0,98034,47.7034,-122.236,3640,5129,9,8,2014,UNK,-1100,-402
2923049372,5/6/2014,362000.0,3,2.25,1640,14374,1.0,0.0,0.0,4,7,1140,500,1963,0,98148,47.4476,-122.33200000000001,2020,10500,5,6,2014,UNK,-380,3874
5437200080,2/4/2015,350000.0,4,2.75,2500,11659,1.0,0.0,2.0,3,9,1490,1010,1979,0,98003,47.3381,-122.33200000000001,2830,9915,2,4,2015,UNK,-330,1744
9808100185,10/3/2014,1690000.0,4,3.5,4020,13515,2.0,0.0,0.0,3,11,4020,0,2001,0,98004,47.6462,-122.212,3930,13515,10,3,2014,UNK,90,0
4337000285,2/24/2015,255000.0,3,2.0,1500,8775,1.0,0.0,0.0,3,6,1390,110,1943,0,98166,47.4809,-122.335,1310,8775,2,24,2015,UNK,190,0
2891000010,8/6/2014,269000.0,4,2.5,1594,7665,1.0,0.0,0.0,5,7,1088,506,1975,0,98002,47.3262,-122.211,1536,6000,8,6,2014,UNK,58,1665
7224000545,8/25/2014,370000.0,4,3.0,2130,4838,1.5,0.0,0.0,4,7,2130,0,1930,0,98055,47.4871,-122.20299999999999,1070,4838,8,25,2014,UNK,1060,0
3243100080,5/1/2015,270000.0,3,1.0,1130,7920,1.0,0.0,0.0,3,7,1130,0,1961,0,98059,47.4852,-122.125,1390,8580,5,1,2015,UNK,-260,-660
3925000020,2/24/2015,265000.0,3,2.0,1690,9516,1.0,0.0,0.0,3,7,1690,0,1997,0,98022,47.2132,-122.001,1850,9516,2,24,2015,UNK,-160,0
546000020,4/29/2015,487000.0,2,1.0,1440,4046,1.0,0.0,0.0,3,7,960,480,1946,0,98117,47.6901,-122.382,1400,4046,4,29,2015,UNK,40,0
8651611060,8/4/2014,835000.0,4,3.25,3270,6027,2.0,0.0,0.0,3,10,3270,0,2001,0,98074,47.6346,-122.06299999999999,3270,6546,8,4,2014,UNK,0,-519
3024079063,7/1/2014,850000.0,4,3.25,4350,112750,1.0,0.0,0.0,3,9,2200,2150,2006,0,98027,47.5435,-121.96600000000001,2180,223027,7,1,2014,N,2170,-110277
3039000050,12/1/2014,575000.0,4,2.75,1610,11201,1.0,0.0,0.0,5,7,1020,590,1982,0,98033,47.7024,-122.198,1610,9000,12,1,2014,UNK,0,2201
1839900080,7/12/2014,335000.0,3,1.0,950,8000,1.0,0.0,0.0,3,7,950,0,1968,0,98034,47.7193,-122.184,2270,8540,7,12,2014,UNK,-1320,-540
4024101434,8/8/2014,318000.0,3,1.0,1010,7200,1.0,0.0,0.0,5,6,1010,0,1948,0,98155,47.7601,-122.307,1590,7663,8,8,2014,UNK,-580,-463
2824069142,4/9/2015,510000.0,3,2.0,1420,11325,1.0,0.0,0.0,3,7,1420,0,1980,0,98027,47.5356,-122.046,2330,3474,4,9,2015,UNK,-910,7851
2618300080,5/2/2014,242500.0,3,1.5,1200,9720,1.0,0.0,0.0,4,7,1200,0,1965,0,98042,47.4225,-122.15299999999999,1380,10284,5,2,2014,UNK,-180,-564
7785000010,12/4/2014,750000.0,5,2.25,2020,8400,1.0,0.0,0.0,4,7,1010,1010,1963,0,98040,47.5763,-122.219,1890,9233,12,4,2014,UNK,130,-833
4307330050,7/21/2014,439900.0,5,3.5,3390,7950,2.0,0.0,2.0,3,7,3390,0,2003,0,98056,47.4792,-122.181,2580,6900,7,21,2014,UNK,810,1050
2867100005,4/7/2015,710000.0,2,1.0,1700,3040,1.5,0.0,0.0,3,8,1460,240,1914,0,98119,47.6442,-122.369,1620,3230,4,7,2015,UNK,80,-190
3880900010,6/4/2014,2400000.0,5,3.25,3410,9088,2.0,0.0,3.0,3,9,2760,650,1912,0,98119,47.6285,-122.361,3540,7100,6,4,2014,UNK,-130,1988
5255710010,12/15/2014,435000.0,3,1.75,2030,13700,1.0,0.0,0.0,3,8,1630,400,1976,0,98011,47.7726,-122.197,2120,11200,12,15,2014,UNK,-90,2500
3213200314,12/26/2014,874000.0,4,2.75,2860,6867,1.0,0.0,1.0,5,7,1560,1300,1946,0,98115,47.6723,-122.26299999999999,2290,5350,12,26,2014,UNK,570,1517
9834200950,6/16/2014,385000.0,4,1.75,1690,4080,1.0,0.0,0.0,4,7,870,820,1984,0,98144,47.571999999999996,-122.289,1320,4080,6,16,2014,UNK,370,0
3806000005,10/30/2014,110000.0,2,1.0,760,4746,1.0,0.0,0.0,3,5,760,0,1930,0,98055,47.4836,-122.214,1360,7810,10,30,2014,UNK,-600,-3064
6204400170,6/20/2014,477000.0,3,1.75,1780,8085,1.0,0.0,0.0,3,7,1210,570,1976,0,98011,47.7357,-122.197,1780,8085,6,20,2014,UNK,0,0
2491200675,9/12/2014,500000.0,3,2.0,1550,6394,1.5,0.0,0.0,5,8,1550,0,1918,0,98126,47.5222,-122.37899999999999,1440,6387,9,12,2014,UNK,110,7
98020480,8/28/2014,885000.0,4,2.5,4090,11225,2.0,0.0,0.0,3,10,4090,0,2005,0,98075,47.581,-121.971,3510,8762,8,28,2014,N,580,2463
8068000585,8/27/2014,235000.0,2,1.0,880,5600,1.0,0.0,0.0,5,7,880,0,1955,0,98178,47.5071,-122.265,1240,7015,8,27,2014,UNK,-360,-1415
4345000170,5/4/2015,210000.0,3,2.75,1320,15236,1.0,0.0,0.0,3,7,880,440,1995,0,98030,47.365,-122.184,1490,8351,5,4,2015,UNK,-170,6885
3101500010,4/20/2015,320000.0,2,1.0,950,4000,1.0,0.0,0.0,3,6,950,0,1910,0,98144,47.5728,-122.31200000000001,1480,4000,4,20,2015,UNK,-530,0
3291800660,3/13/2015,406000.0,3,1.75,1390,7904,1.0,0.0,0.0,3,7,1390,0,1985,0,98056,47.4892,-122.181,1910,7904,3,13,2015,UNK,-520,0
3541600235,10/28/2014,350000.0,3,1.75,1900,10225,1.0,0.0,0.0,4,8,1220,680,1963,0,98166,47.4781,-122.35700000000001,1850,12630,10,28,2014,UNK,50,-2405
2923039217,6/10/2014,350000.0,2,0.75,1392,43710,1.5,0.0,0.0,4,7,1392,0,1978,0,98070,47.4491,-122.45299999999999,1640,99316,6,10,2014,UNK,-248,-55606
7852010290,7/10/2014,720000.0,4,2.5,3340,8930,2.0,0.0,2.0,3,10,3340,0,1999,0,98065,47.535,-121.867,3160,7865,7,10,2014,UNK,180,1065
7695450010,5/22/2014,604700.0,4,2.75,2750,14982,1.0,0.0,3.0,3,9,1720,0,1981,0,98198,47.3566,-122.32,2860,16344,5,22,2014,UNK,-110,-1362
3424069145,9/25/2014,343000.0,3,1.0,1400,5662,1.5,0.0,0.0,5,5,1400,0,1920,0,98027,47.5271,-122.036,1250,14375,9,25,2014,UNK,150,-8713
3578400500,12/9/2014,558000.0,3,2.25,2220,15757,1.0,0.0,0.0,3,8,1280,940,1982,0,98074,47.6212,-122.04299999999999,2020,14098,12,9,2014,UNK,200,1659
4365200895,4/17/2015,364000.0,4,1.0,1210,7740,1.5,0.0,0.0,3,7,1210,0,1922,0,98126,47.5216,-122.374,1100,7740,4,17,2015,UNK,110,0
4027700321,10/28/2014,420000.0,3,1.75,2390,11242,1.0,0.0,0.0,3,7,1290,1100,1959,0,98155,47.7759,-122.272,2270,9650,10,28,2014,UNK,120,1592
7923600250,5/15/2015,450000.0,5,2.0,1870,7344,1.5,0.0,0.0,3,7,1870,0,1960,0,98007,47.5951,-122.14399999999999,1870,7650,5,15,2015,UNK,0,-306
8122100290,8/13/2014,392000.0,2,1.5,940,5000,1.0,0.0,0.0,4,7,810,130,1925,0,98126,47.5375,-122.374,940,5026,8,13,2014,UNK,0,-26
7224000980,6/10/2014,100000.0,4,1.0,1120,2685,1.0,0.0,0.0,3,5,860,260,1939,0,98055,47.4904,-122.20299999999999,1120,4838,6,10,2014,UNK,0,-2153
9521100280,6/12/2014,480000.0,3,2.5,1250,1103,3.0,0.0,2.0,3,8,1250,0,2005,0,98103,47.6619,-122.352,1250,1188,6,12,2014,N,0,-85
7875400050,8/27/2014,212000.0,3,1.5,1060,9225,1.0,0.0,0.0,4,7,1060,0,1955,0,98003,47.3217,-122.318,1270,9375,8,27,2014,UNK,-210,-150
6204420290,12/3/2014,560000.0,5,2.5,2410,8960,1.0,0.0,0.0,5,7,1600,810,1978,0,98011,47.7372,-122.2,2410,11514,12,3,2014,UNK,0,-2554
1041440050,4/28/2015,359950.0,5,2.75,2844,3990,2.0,0.0,0.0,3,8,2844,0,2013,0,98092,47.3259,-122.167,2273,3900,4,28,2015,N,571,90
1626069178,9/10/2014,535000.0,4,2.5,2200,110642,1.0,0.0,0.0,5,7,1330,870,1979,0,98077,47.7409,-122.052,2290,51400,9,10,2014,UNK,-90,59242
3342101937,4/10/2015,980000.0,5,4.0,3460,5400,2.0,0.0,0.0,3,10,2830,630,2012,0,98056,47.5201,-122.204,1890,5400,4,10,2015,N,1570,0
9178601630,11/13/2014,720000.0,2,1.0,1580,2199,2.0,0.0,2.0,3,8,1580,0,1921,1995,98103,47.6541,-122.329,2170,4405,11,13,2014,Y,-590,-2206
5273200080,9/29/2014,619950.0,2,1.0,1520,5400,1.0,0.0,0.0,3,7,920,600,1951,0,98115,47.6796,-122.279,1600,5400,9,29,2014,UNK,-80,0
7701930010,5/30/2014,489000.0,3,2.5,2260,19821,2.0,0.0,0.0,3,9,2260,0,1994,0,98058,47.448,-122.088,2750,22718,5,30,2014,UNK,-490,-2897
6820100010,6/16/2014,415000.0,4,2.0,1800,2970,1.0,0.0,0.0,4,7,1000,800,1923,0,98115,47.6833,-122.31200000000001,1690,3801,6,16,2014,UNK,110,-831
3066400130,4/15/2015,672500.0,4,2.5,2650,11108,2.0,0.0,0.0,3,10,2650,0,1987,0,98074,47.6304,-122.051,2650,11585,4,15,2015,UNK,0,-477
339600010,10/17/2014,352500.0,3,1.0,1000,4171,1.0,0.0,0.0,3,7,1000,0,1985,0,98052,47.6834,-122.09700000000001,1090,3479,10,17,2014,UNK,-90,692
3391900130,9/3/2014,258750.0,4,2.0,2300,8400,1.0,0.0,0.0,4,6,1150,1150,1962,0,98003,47.3282,-122.33200000000001,1230,8400,9,3,2014,UNK,1070,0
7283900010,2/23/2015,350000.0,3,1.0,1080,7000,1.0,0.0,0.0,4,6,1080,0,1916,0,98133,47.7637,-122.351,1410,7214,2,23,2015,UNK,-330,-214
1113000430,7/29/2014,152000.0,3,1.0,902,10464,1.0,0.0,0.0,3,7,902,0,1965,0,98198,47.363,-122.30799999999999,1510,7210,7,29,2014,UNK,-608,3254
5101405276,6/9/2014,378500.0,2,1.0,730,7528,1.0,0.0,0.0,3,7,730,0,1946,0,98115,47.6997,-122.305,1620,7528,6,9,2014,UNK,-890,0
7796100050,7/30/2014,1020000.0,4,1.75,2600,41041,1.5,0.0,0.0,4,8,2600,0,1965,0,98033,47.6634,-122.17200000000001,2750,37318,7,30,2014,UNK,-150,3723
2207200675,5/2/2014,419000.0,3,1.5,1570,6700,1.0,0.0,0.0,4,7,1570,0,1956,0,98007,47.6022,-122.134,1570,7300,5,2,2014,UNK,0,-600
3622910190,5/21/2014,895000.0,5,3.0,2876,13927,1.0,0.0,2.0,4,9,1970,906,1973,0,98040,47.5528,-122.229,3500,14454,5,21,2014,UNK,-624,-527
9346930250,9/26/2014,668500.0,4,2.25,2290,9546,1.0,0.0,0.0,4,8,1780,510,1976,0,98006,47.5617,-122.13,2360,8864,9,26,2014,UNK,-70,682
3886000010,8/21/2014,487000.0,2,2.5,1470,2533,2.0,0.0,0.0,3,8,1470,0,2005,0,98033,47.6874,-122.165,1470,6511,8,21,2014,N,0,-3978
6326000130,12/2/2014,538000.0,3,3.5,2620,10137,2.0,0.0,0.0,3,8,1970,650,1992,0,98146,47.4979,-122.37100000000001,1960,7680,12,2,2014,UNK,660,2457
686900010,5/28/2014,898000.0,5,1.5,2680,28014,1.0,0.0,0.0,4,8,1450,1230,1963,0,98004,47.6348,-122.196,2900,22180,5,28,2014,UNK,-220,5834
1310000130,9/24/2014,315000.0,4,2.0,2020,7767,1.0,0.0,0.0,3,8,2020,0,1995,0,98003,47.3391,-122.309,1940,8239,9,24,2014,UNK,80,-472
139000185,4/28/2015,800000.0,3,2.5,2100,4440,2.0,0.0,4.0,3,7,2100,0,1945,0,98116,47.5865,-122.397,2100,6000,4,28,2015,UNK,0,-1560
4039000050,7/14/2014,516130.0,3,1.75,1510,8250,1.0,0.0,0.0,4,8,1510,0,1962,0,98008,47.6183,-122.113,1770,8250,7,14,2014,UNK,-260,0
9253900417,1/28/2015,1600000.0,3,2.5,2850,19593,1.5,1.0,4.0,3,10,1790,1060,1978,0,98008,47.5894,-122.111,2850,18782,1,28,2015,UNK,0,811
4128500380,4/27/2015,1200000.0,4,2.5,4280,12796,2.0,0.0,0.0,3,11,3400,880,1999,0,98006,47.5588,-122.124,3520,9593,4,27,2015,UNK,760,3203
8159300050,3/12/2015,355425.0,4,2.5,3238,9112,1.0,0.0,2.0,4,8,1678,1560,1979,0,98198,47.4005,-122.311,3056,9668,3,12,2015,UNK,182,-556
1338600185,6/24/2014,1160000.0,3,2.5,2740,5925,2.0,0.0,2.0,3,10,2740,0,1913,1992,98112,47.6313,-122.303,2740,5948,6,24,2014,Y,0,-23
7625703900,9/26/2014,689000.0,4,2.5,2020,9600,2.0,0.0,0.0,4,7,2020,0,1954,0,98136,47.5434,-122.395,2250,8550,9,26,2014,UNK,-230,1050
2767700022,1/13/2015,500000.0,3,3.25,1520,1500,3.0,0.0,0.0,3,7,1520,0,2000,0,98107,47.67,-122.389,1520,1323,1,13,2015,UNK,0,177
3914000095,7/18/2014,430000.0,5,2.5,3860,42733,1.0,0.0,3.0,4,8,2300,1560,1955,0,98001,47.3117,-122.25399999999999,2520,19353,7,18,2014,UNK,1340,23380
7334501410,11/21/2014,299500.0,4,2.25,1600,15312,1.0,0.0,0.0,4,7,1080,520,1979,0,98045,47.4629,-121.743,1620,12375,11,21,2014,UNK,-20,2937
2597710050,6/24/2014,349950.0,4,2.5,2090,5289,2.0,0.0,0.0,3,8,2090,0,1989,0,98058,47.4289,-122.164,2080,7109,6,24,2014,UNK,10,-1820
7933250050,10/28/2014,1420000.0,5,3.25,4020,4500,2.0,0.0,0.0,3,9,3120,900,2010,0,98004,47.6349,-122.204,3550,5775,10,28,2014,N,470,-1275
2600140500,12/16/2014,998000.0,4,2.25,2910,10189,2.0,0.0,0.0,3,9,2910,0,1988,0,98006,47.5465,-122.155,2780,10125,12,16,2014,UNK,130,64
3876810170,5/5/2015,329000.0,3,1.0,900,9600,1.0,0.0,0.0,4,7,900,0,1970,0,98072,47.7423,-122.17299999999999,1220,8240,5,5,2015,UNK,-320,1360
3740000010,10/9/2014,575000.0,3,1.75,1720,5956,2.0,0.0,0.0,3,8,1720,0,1981,0,98033,47.6875,-122.20200000000001,1620,9324,10,9,2014,UNK,100,-3368
6895300050,10/2/2014,529900.0,5,2.25,3030,9430,2.0,0.0,0.0,4,8,2600,430,1961,0,98133,47.7515,-122.353,2230,8425,10,2,2014,UNK,800,1005
6645900010,11/20/2014,1470000.0,4,2.5,3030,10189,1.0,0.0,0.0,3,9,2380,650,2003,0,98004,47.6367,-122.206,1940,10189,11,20,2014,UNK,1090,0
9413600380,8/1/2014,725000.0,4,1.75,2190,9400,1.0,0.0,0.0,4,7,1450,740,1962,0,98033,47.6531,-122.196,1980,9000,8,1,2014,UNK,210,400
2115720500,10/23/2014,286000.0,3,2.5,1680,5000,2.0,0.0,0.0,3,8,1680,0,1987,0,98023,47.3196,-122.395,1720,5000,10,23,2014,UNK,-40,0
2202500255,3/5/2015,335000.0,3,2.0,1210,9926,1.0,0.0,0.0,4,7,1210,0,1954,2015,98006,47.5731,-122.135,1690,9737,3,5,2015,Y,-480,189
2207100255,5/15/2014,395300.0,3,1.5,1120,7000,1.0,0.0,0.0,3,7,1120,0,1955,0,98007,47.5987,-122.146,1470,7950,5,15,2014,UNK,-350,-950
8035350010,7/15/2014,510000.0,4,2.75,3180,13348,2.0,0.0,0.0,3,8,3020,160,2004,0,98019,47.7439,-121.977,3020,10029,7,15,2014,N,160,3319
1555300010,2/6/2015,203000.0,3,1.0,920,7500,1.0,0.0,0.0,4,7,920,0,1970,0,98032,47.3791,-122.289,1660,8000,2,6,2015,UNK,-740,-500
6135300010,12/4/2014,248000.0,2,1.0,700,8301,1.0,0.0,0.0,3,6,700,0,1953,0,98155,47.7712,-122.323,1250,8304,12,4,2014,UNK,-550,-3
1321730470,1/27/2015,265000.0,3,2.25,2540,7216,2.0,0.0,0.0,3,8,2540,0,1991,0,98023,47.2906,-122.34899999999999,2140,7531,1,27,2015,UNK,400,-315
4083306345,5/4/2015,1000000.0,4,1.5,2100,4560,1.5,0.0,0.0,4,8,2100,0,1912,0,98103,47.6497,-122.336,1930,4560,5,4,2015,UNK,170,0
1453602360,4/6/2015,1000000.0,3,1.0,1540,24500,1.5,0.0,0.0,3,7,1540,0,1949,0,98125,47.7213,-122.29,1540,7250,4,6,2015,UNK,0,17250
2025600280,4/6/2015,241400.0,3,2.0,1420,9828,1.0,0.0,0.0,4,7,1420,0,1990,0,98010,47.3287,-122.01100000000001,1550,7227,4,6,2015,UNK,-130,2601
1423800380,3/12/2015,309950.0,4,1.75,1450,10074,1.0,0.0,0.0,4,7,1450,0,1966,0,98058,47.4546,-122.182,1340,8023,3,12,2015,UNK,110,2051
2113701100,8/26/2014,294010.0,3,1.75,1550,4057,1.0,0.0,0.0,3,6,830,720,1945,0,98106,47.5291,-122.351,1100,4116,8,26,2014,UNK,450,-59
3578401060,12/16/2014,345000.0,3,2.25,1920,9672,2.0,0.0,0.0,4,8,1920,0,1984,0,98074,47.6233,-122.046,1950,10125,12,16,2014,UNK,-30,-453
3578401060,5/4/2015,625000.0,3,2.25,1920,9672,2.0,0.0,0.0,4,8,1920,0,1984,0,98074,47.6233,-122.046,1950,10125,5,4,2015,UNK,-30,-453
7691800020,7/9/2014,660000.0,4,2.5,2510,4543,2.0,0.0,0.0,3,8,2510,0,2002,0,98075,47.5962,-122.039,2550,4675,7,9,2014,UNK,-40,-132
8682230950,3/17/2015,559000.0,2,2.0,1660,4500,1.0,0.0,0.0,3,8,1660,0,2003,0,98053,47.7094,-122.031,1670,5580,3,17,2015,UNK,-10,-1080
7202360010,7/7/2014,866000.0,4,3.25,3990,9786,2.0,0.0,0.0,3,9,3990,0,2004,0,98053,47.6784,-122.02600000000001,3920,8200,7,7,2014,N,70,1586
2125049120,5/5/2014,770000.0,3,2.0,2350,5700,1.5,0.0,0.0,4,8,1810,540,1939,0,98112,47.638999999999996,-122.31,2170,6000,5,5,2014,UNK,180,-300
5540000010,8/15/2014,259950.0,3,1.5,1350,7827,1.0,0.0,0.0,4,7,1350,0,1968,0,98030,47.3786,-122.219,1900,7827,8,15,2014,UNK,-550,0
1552800010,3/11/2015,352000.0,5,2.75,2980,9838,1.0,0.0,0.0,3,7,1710,1270,1968,0,98030,47.3807,-122.22200000000001,2240,9838,3,11,2015,UNK,740,0
1118002000,6/24/2014,2470000.0,5,4.75,6390,13180,2.0,0.0,0.0,3,10,4560,1830,1940,0,98112,47.6312,-122.291,4010,8137,6,24,2014,UNK,2380,5043
8564600080,11/6/2014,395000.0,3,2.0,1590,10229,1.0,0.0,0.0,3,7,1590,0,1966,0,98034,47.7239,-122.227,1320,10222,11,6,2014,UNK,270,7
1446800660,3/16/2015,276500.0,4,1.75,1400,6650,1.5,0.0,0.0,4,6,1400,0,1942,0,98168,47.4888,-122.33200000000001,1120,8645,3,16,2015,UNK,280,-1995
2624079022,10/20/2014,530000.0,3,2.25,1880,100623,1.5,0.0,0.0,3,8,1880,0,1987,2007,98024,47.5342,-121.883,2520,21689,10,20,2014,Y,-640,78934
5051800130,7/24/2014,798000.0,4,3.25,3500,10260,2.0,0.0,0.0,3,10,3500,0,1987,0,98008,47.5902,-122.13,3500,10658,7,24,2014,UNK,0,-398
7940700190,8/13/2014,380000.0,2,2.0,1370,5756,1.0,0.0,0.0,3,8,1370,0,1986,0,98034,47.714,-122.205,1380,5444,8,13,2014,UNK,-10,312
5422810010,8/19/2014,350000.0,4,2.5,2810,10433,2.0,0.0,0.0,3,8,2810,0,2001,0,98022,47.1895,-122.015,2640,9240,8,19,2014,UNK,170,1193
3529200190,5/14/2014,325000.0,3,2.5,2220,6049,2.0,0.0,0.0,4,8,2220,0,1990,0,98031,47.3972,-122.182,1980,7226,5,14,2014,UNK,240,-1177
8944320280,4/2/2015,336000.0,3,2.5,2110,4549,2.0,0.0,0.0,4,8,2110,0,1989,0,98042,47.3885,-122.154,2110,4030,4,2,2015,UNK,0,519
3222069153,10/24/2014,286900.0,3,2.25,1720,17235,1.0,0.0,0.0,4,7,1440,280,1974,0,98042,47.3438,-122.073,1990,35048,10,24,2014,UNK,-270,-17813
7211300050,9/30/2014,472000.0,5,2.25,1780,7245,1.0,0.0,0.0,4,8,1330,450,1976,0,98052,47.6946,-122.12,1780,7653,9,30,2014,UNK,0,-408
1545806980,6/30/2014,263000.0,3,1.75,1410,8100,2.0,0.0,0.0,3,7,1410,0,1985,0,98038,47.3617,-122.046,1560,8100,6,30,2014,UNK,-150,0
9297300255,7/16/2014,565000.0,3,3.0,2110,4000,1.0,0.0,2.0,4,7,1110,1000,1965,0,98126,47.5696,-122.375,1730,4000,7,16,2014,UNK,380,0
4139400280,10/8/2014,765000.0,3,2.5,2700,8444,2.0,0.0,0.0,3,10,2700,0,1992,0,98006,47.5597,-122.113,2840,9165,10,8,2014,UNK,-140,-721
9201300020,8/11/2014,1520000.0,3,2.25,2610,9409,1.0,0.0,4.0,4,8,2610,0,1963,0,98075,47.5789,-122.07600000000001,2970,9156,8,11,2014,UNK,-360,253
8663280080,12/23/2014,405000.0,3,2.0,1660,8174,1.0,0.0,0.0,3,7,830,830,1981,0,98034,47.7103,-122.199,1610,9318,12,23,2014,UNK,50,-1144
98000980,4/27/2015,1100000.0,4,3.5,4570,16219,2.0,0.0,0.0,3,11,4570,0,2002,0,98075,47.5859,-121.96799999999999,4700,16500,4,27,2015,UNK,-130,-281
1796100010,9/11/2014,555000.0,3,3.0,3760,188760,1.0,0.0,0.0,4,10,2640,1120,1979,0,98092,47.308,-122.087,2820,50543,9,11,2014,UNK,940,138217
2781280290,4/27/2015,305000.0,3,2.5,1610,3516,2.0,0.0,0.0,3,8,1610,0,2006,0,98055,47.4491,-122.18799999999999,1610,3056,4,27,2015,N,0,460
1448800010,9/1/2014,289950.0,3,2.25,1740,9370,1.0,0.0,0.0,3,7,1390,350,1992,0,98198,47.39100000000001,-122.316,1740,7555,9,1,2014,UNK,0,1815
1526079026,8/13/2014,487500.0,5,3.5,3530,218472,2.0,0.0,0.0,3,7,2380,1150,1999,0,98019,47.7309,-121.905,2110,211404,8,13,2014,UNK,1420,7068
1788800630,10/29/2014,96500.0,3,1.0,840,12091,1.0,0.0,0.0,3,6,840,0,1959,0,98023,47.3281,-122.34299999999999,840,9324,10,29,2014,UNK,0,2767
1788800630,2/25/2015,185000.0,3,1.0,840,12091,1.0,0.0,0.0,3,6,840,0,1959,0,98023,47.3281,-122.34299999999999,840,9324,2,25,2015,UNK,0,2767
8864000250,8/27/2014,150550.0,4,1.0,1470,6061,1.5,0.0,0.0,3,7,1470,0,1945,0,98168,47.4819,-122.289,1230,6175,8,27,2014,UNK,240,-114
7972600670,6/24/2014,339000.0,4,2.0,2470,5080,1.5,0.0,0.0,3,6,1970,500,1948,1988,98106,47.5308,-122.348,1060,5080,6,24,2014,Y,1410,0
4077800094,2/2/2015,675000.0,4,1.75,2220,7230,1.0,0.0,1.0,3,8,1280,940,1950,0,98125,47.7065,-122.279,2210,7230,2,2,2015,UNK,10,0
9834200440,6/24/2014,615000.0,3,1.75,1720,4080,1.0,0.0,0.0,4,7,960,760,1924,0,98144,47.5747,-122.287,1660,4080,6,24,2014,UNK,60,0
1245002125,6/4/2014,837500.0,4,2.5,2700,9320,2.0,0.0,0.0,4,8,2700,0,1994,0,98033,47.6861,-122.198,2120,8056,6,4,2014,UNK,580,1264
5634500170,8/19/2014,250000.0,2,1.0,950,11835,1.0,0.0,0.0,3,5,950,0,1932,0,98028,47.7494,-122.23700000000001,1690,12586,8,19,2014,UNK,-740,-751
1954400500,6/25/2014,583000.0,3,2.5,1790,8144,2.0,0.0,0.0,3,8,1790,0,1989,0,98074,47.6169,-122.045,1800,7503,6,25,2014,UNK,-10,641
9528102771,9/4/2014,499000.0,3,2.5,1610,1728,3.0,0.0,0.0,3,8,1610,0,2000,0,98115,47.6776,-122.318,1540,3090,9,4,2014,UNK,70,-1362
2895600095,7/16/2014,550000.0,3,2.5,2290,6328,2.0,0.0,0.0,3,8,2290,0,2001,0,98146,47.5103,-122.382,1600,6180,7,16,2014,UNK,690,148
2921079027,9/24/2014,400000.0,4,2.5,2170,204296,1.0,0.0,0.0,4,7,2170,0,1980,0,98022,47.28100000000001,-121.93299999999999,1760,154202,9,24,2014,UNK,410,50094
524059323,2/19/2015,990400.0,3,2.5,2100,4097,2.0,0.0,0.0,3,9,2100,0,2008,0,98004,47.5983,-122.2,1820,4764,2,19,2015,N,280,-667
824069173,8/21/2014,600000.0,3,2.5,2320,52272,1.5,0.0,0.0,3,8,2320,0,1974,0,98075,47.586999999999996,-122.068,2200,52272,8,21,2014,UNK,120,0
2678100005,2/12/2015,325000.0,2,1.0,1120,6236,1.0,0.0,0.0,4,6,1120,0,1954,0,98155,47.76300000000001,-122.291,1340,7784,2,12,2015,UNK,-220,-1548
2025700080,7/10/2014,265000.0,3,2.5,1530,6000,2.0,0.0,0.0,4,7,1530,0,1991,0,98038,47.3487,-122.036,1360,6000,7,10,2014,UNK,170,0
6613000585,1/8/2015,1620000.0,3,2.5,3490,9362,1.0,0.0,3.0,5,9,1770,1720,1960,0,98105,47.6605,-122.27,3640,7425,1,8,2015,UNK,-150,1937
2597000006,3/9/2015,347500.0,3,1.5,1180,8353,1.0,0.0,0.0,3,7,1180,0,1960,0,98155,47.7652,-122.274,1710,8748,3,9,2015,UNK,-530,-395
1923300170,1/9/2015,629000.0,5,2.0,2050,3000,1.5,0.0,0.0,3,7,1470,580,1912,1984,98103,47.6864,-122.352,1560,4500,1,9,2015,Y,490,-1500
1224049005,7/8/2014,1090000.0,2,2.0,2360,11340,1.5,0.0,0.0,3,9,2360,0,1997,0,98040,47.5835,-122.227,3030,11340,7,8,2014,UNK,-670,0
4123840050,6/30/2014,397500.0,4,2.5,2570,7859,2.0,0.0,0.0,3,8,2570,0,1992,0,98038,47.3736,-122.045,2150,7284,6,30,2014,UNK,420,575
1937300280,10/30/2014,404500.0,2,1.0,1270,3700,1.5,0.0,0.0,3,7,1270,0,1909,0,98144,47.5949,-122.307,1980,3200,10,30,2014,UNK,-710,500
9183703376,5/13/2014,225000.0,3,1.5,1250,7500,1.0,0.0,0.0,3,7,1250,0,1967,0,98030,47.3719,-122.215,1260,7563,5,13,2014,UNK,-10,-63
9542801310,5/13/2015,267000.0,3,2.25,2510,9900,1.0,0.0,0.0,3,8,1610,900,1978,0,98023,47.2988,-122.374,1940,8510,5,13,2015,UNK,570,1390
2771104830,6/11/2014,800000.0,4,3.75,2690,4000,2.0,0.0,3.0,4,9,2120,570,1909,1989,98119,47.6418,-122.37200000000001,2830,4000,6,11,2014,Y,-140,0
7967650010,2/10/2015,339000.0,4,2.5,2900,6918,2.0,0.0,0.0,3,8,2900,0,2001,0,98001,47.3504,-122.28399999999999,2720,10376,2,10,2015,UNK,180,-3458
6744701310,4/15/2015,1850000.0,4,2.5,3830,11972,1.0,1.0,4.0,3,11,2370,1460,1981,0,98155,47.7404,-122.28399999999999,3080,12297,4,15,2015,UNK,750,-325
3131201310,9/30/2014,525000.0,5,1.0,1280,3876,1.5,0.0,0.0,3,7,1280,0,1923,0,98105,47.6605,-122.324,1420,3825,9,30,2014,UNK,-140,51
3630180500,10/6/2014,1150000.0,5,3.5,4350,6218,2.0,0.0,0.0,3,10,3520,830,2007,0,98027,47.5396,-121.99700000000001,3260,5989,10,6,2014,N,1090,229
7624700050,12/23/2014,565000.0,1,1.0,1370,6250,1.5,0.0,0.0,4,7,1370,0,1921,0,98136,47.5571,-122.385,1450,6250,12,23,2014,UNK,-80,0
3274800460,5/20/2014,387000.0,2,2.25,1230,1280,2.0,0.0,0.0,3,8,960,270,2012,0,98144,47.5942,-122.29799999999999,1130,1357,5,20,2014,N,100,-77
1939000010,6/19/2014,720000.0,4,2.5,2440,34290,2.0,0.0,0.0,3,9,2440,0,1987,0,98053,47.6685,-122.044,2860,38119,6,19,2014,UNK,-420,-3829
4139490190,7/11/2014,1500000.0,4,3.5,4410,12426,2.0,0.0,2.0,3,12,3420,990,1996,0,98006,47.5518,-122.10700000000001,4090,12127,7,11,2014,UNK,320,299
6381500170,8/26/2014,235000.0,2,1.0,910,7617,1.0,0.0,0.0,3,6,910,0,1936,0,98125,47.7332,-122.305,1310,6624,8,26,2014,UNK,-400,993
6381500170,1/16/2015,365000.0,2,1.0,910,7617,1.0,0.0,0.0,3,6,910,0,1936,0,98125,47.7332,-122.305,1310,6624,1,16,2015,UNK,-400,993
1954420170,5/21/2014,368250.0,3,2.5,2150,7484,2.0,0.0,0.0,3,8,2150,0,1988,0,98074,47.6191,-122.04299999999999,2150,6879,5,21,2014,UNK,0,605
1954420170,11/13/2014,580000.0,3,2.5,2150,7484,2.0,0.0,0.0,3,8,2150,0,1988,0,98074,47.6191,-122.04299999999999,2150,6879,11,13,2014,UNK,0,605
623059016,7/17/2014,1100000.0,4,3.25,3190,11774,2.0,1.0,4.0,3,8,2610,580,1956,1991,98178,47.5033,-122.225,2240,8725,7,17,2014,Y,950,3049
6181400470,1/27/2015,215000.0,4,2.5,2130,4496,2.0,0.0,0.0,3,7,2130,0,2004,0,98001,47.3041,-122.28,3220,5400,1,27,2015,N,-1090,-904
3904920980,9/9/2014,648000.0,4,2.5,2740,9959,2.0,0.0,0.0,3,9,2740,0,1989,0,98029,47.5672,-122.01100000000001,2630,9905,9,9,2014,UNK,110,54
7215730430,9/3/2014,705000.0,4,3.0,3150,9318,2.0,0.0,0.0,3,9,3150,0,2001,0,98075,47.5959,-122.01799999999999,3150,9318,9,3,2014,UNK,0,0
475000190,1/9/2015,465000.0,3,2.25,1450,1540,2.0,0.0,0.0,3,8,1180,270,2005,0,98107,47.6685,-122.365,1450,1540,1,9,2015,N,0,0
2877100235,12/22/2014,650000.0,5,2.0,2400,3500,1.5,0.0,0.0,3,8,1900,500,1911,0,98103,47.6762,-122.35600000000001,1520,4000,12,22,2014,UNK,880,-500
7893202340,7/21/2014,335000.0,4,2.25,2280,7500,1.0,0.0,0.0,4,7,1140,1140,1963,0,98198,47.4182,-122.33200000000001,1660,8000,7,21,2014,UNK,620,-500
9238430190,4/28/2015,640000.0,4,2.0,2310,31850,1.5,0.0,0.0,4,8,2310,0,1984,0,98072,47.7713,-122.12200000000001,2710,36042,4,28,2015,UNK,-400,-4192
1939120050,3/3/2015,638250.0,4,2.5,2460,8029,2.0,0.0,0.0,3,9,2460,0,1989,0,98074,47.6262,-122.03,2420,7987,3,3,2015,UNK,40,42
9197800010,10/17/2014,1460000.0,4,3.5,4200,14353,2.0,0.0,2.0,3,12,3640,560,1996,0,98040,47.5331,-122.21700000000001,3750,16316,10,17,2014,UNK,450,-1963
5248800250,4/27/2015,375000.0,4,2.0,1620,4600,2.0,0.0,0.0,3,7,1620,0,1909,0,98108,47.5533,-122.307,1620,4500,4,27,2015,UNK,0,100
4457300630,7/16/2014,842000.0,4,1.75,2170,9525,1.0,0.0,0.0,3,8,2170,0,1960,0,98040,47.5685,-122.21700000000001,1910,9525,7,16,2014,UNK,260,0
2228900161,10/8/2014,499950.0,3,2.25,2880,7200,1.0,0.0,0.0,3,8,1710,1170,1970,0,98133,47.7707,-122.35,1880,10200,10,8,2014,UNK,1000,-3000
6817850050,2/17/2015,810000.0,4,2.5,3280,25211,2.0,0.0,3.0,3,11,3280,0,1985,0,98074,47.6398,-122.05,3280,25211,2,17,2015,UNK,0,0
1775800280,2/26/2015,310000.0,5,2.0,2900,11970,2.0,0.0,0.0,4,7,2900,0,1969,0,98072,47.74100000000001,-122.095,1260,12398,2,26,2015,UNK,1640,-428
263000050,10/31/2014,730000.0,3,2.5,2160,8809,1.0,0.0,0.0,3,9,1540,620,2014,0,98103,47.6994,-122.34899999999999,930,5420,10,31,2014,N,1230,3389
1870400470,11/13/2014,637800.0,4,1.75,2250,4750,1.5,0.0,0.0,4,7,1420,830,1924,0,98115,47.6738,-122.292,1930,4750,11,13,2014,UNK,320,0
7839300185,2/6/2015,225000.0,3,1.0,1340,4800,1.5,0.0,0.0,4,5,1340,0,1903,0,98055,47.477,-122.209,1240,4800,2,6,2015,UNK,100,0
2426039130,6/10/2014,417500.0,4,1.0,1390,10800,1.5,0.0,0.0,4,7,1390,0,1941,0,98177,47.7248,-122.359,1390,9360,6,10,2014,UNK,0,1440
2938200170,3/20/2015,265000.0,4,2.0,1600,10160,1.0,0.0,0.0,4,7,1600,0,1972,0,98022,47.2015,-122.00299999999999,1540,9352,3,20,2015,UNK,60,808
1954440050,7/25/2014,550000.0,4,2.5,2050,8683,2.0,0.0,0.0,3,8,2050,0,1987,0,98074,47.62,-122.04299999999999,2010,8744,7,25,2014,UNK,40,-61
2224079001,1/26/2015,625700.0,3,2.0,2570,159865,1.0,0.0,0.0,5,7,2570,0,1968,0,98024,47.5547,-121.89200000000001,2010,38322,1,26,2015,UNK,560,121543
200520080,8/1/2014,595000.0,3,2.5,2660,10637,2.0,0.0,0.0,3,9,2660,0,1991,0,98011,47.7383,-122.22,2590,8637,8,1,2014,UNK,70,2000
2195900010,7/14/2014,270000.0,3,1.5,1540,13475,1.0,0.0,0.0,4,7,1540,0,1972,0,98059,47.4766,-122.15299999999999,1550,13475,7,14,2014,UNK,-10,0
5707500050,7/18/2014,739375.0,5,3.0,2640,3200,2.0,0.0,0.0,4,7,2140,500,1906,0,98112,47.6188,-122.30799999999999,1540,2242,7,18,2014,UNK,1100,958
8929000130,7/8/2014,357562.0,2,1.75,1210,1032,2.0,0.0,0.0,3,8,1210,0,2014,0,98029,47.5522,-121.999,1210,1090,7,8,2014,N,0,-58
2944000170,6/11/2014,1010000.0,4,2.5,3760,29224,2.0,0.0,0.0,3,11,3760,0,1987,0,98052,47.7203,-122.12799999999999,3930,19916,6,11,2014,UNK,-170,9308
8682262330,9/30/2014,455000.0,2,1.75,1350,4286,1.0,0.0,0.0,3,8,1350,0,2004,0,98053,47.7171,-122.03299999999999,1440,4839,9,30,2014,N,-90,-553
4167800130,5/1/2015,310000.0,5,2.25,2600,9600,1.0,0.0,2.0,4,8,1810,790,1969,0,98023,47.3257,-122.365,2070,9660,5,1,2015,UNK,530,-60
1624079088,8/11/2014,415000.0,3,2.75,3900,111514,2.0,0.0,0.0,3,6,3460,440,1967,0,98024,47.5621,-121.92399999999999,2460,217800,8,11,2014,UNK,1440,-106286
7370600050,8/19/2014,452000.0,2,1.0,1340,8100,1.0,0.0,2.0,3,8,1340,0,1950,0,98177,47.7212,-122.36399999999999,1680,7752,8,19,2014,UNK,-340,348
2025059134,1/13/2015,810000.0,3,2.0,1760,16928,1.0,0.0,0.0,3,7,1760,0,1953,0,98004,47.6363,-122.20200000000001,3430,10059,1,13,2015,UNK,-1670,6869
7522500020,5/27/2014,730001.0,3,2.0,1840,4750,1.0,0.0,0.0,5,7,1010,830,1951,0,98117,47.6862,-122.395,1760,5510,5,27,2014,UNK,80,-760
1125069134,4/30/2015,825000.0,3,2.25,2980,86636,1.0,0.0,0.0,3,9,2230,750,1989,0,98053,47.6627,-122.00299999999999,2980,107157,4,30,2015,UNK,0,-20521
8032700010,7/16/2014,665000.0,3,2.5,1730,3000,2.0,0.0,0.0,3,8,1730,0,1996,0,98103,47.6532,-122.34,1730,1774,7,16,2014,UNK,0,1226
2473370050,6/4/2014,327500.0,4,1.75,1650,7800,1.0,0.0,0.0,3,8,1650,0,1968,0,98058,47.4507,-122.139,1750,10400,6,4,2014,UNK,-100,-2600
3276930050,7/28/2014,699950.0,3,2.5,3370,36218,2.0,0.0,0.0,4,9,3370,0,1988,0,98075,47.5855,-121.98700000000001,2980,31793,7,28,2014,UNK,390,4425
3211230080,7/28/2014,424000.0,3,2.5,2200,34680,2.0,0.0,0.0,3,9,2200,0,1985,0,98092,47.3139,-122.116,2560,35840,7,28,2014,UNK,-360,-1160
7519000471,6/25/2014,657000.0,4,2.5,2180,3375,1.5,0.0,0.0,4,7,1420,760,1926,0,98117,47.6846,-122.361,1560,3375,6,25,2014,UNK,620,0
8563000130,7/17/2014,445000.0,3,1.75,1490,10844,1.0,0.0,0.0,3,7,1210,280,1974,0,98008,47.6208,-122.10600000000001,2090,9944,7,17,2014,UNK,-600,900
2770604103,7/31/2014,450000.0,3,2.5,1530,762,2.0,0.0,0.0,3,8,1050,480,2007,0,98119,47.641999999999996,-122.374,1610,1482,7,31,2014,N,-80,-720
3581000020,9/26/2014,350000.0,3,1.0,1180,7455,1.0,0.0,0.0,4,7,1180,0,1964,0,98034,47.7276,-122.241,1450,8154,9,26,2014,UNK,-270,-699
9432750190,11/12/2014,460000.0,4,2.5,2080,17532,2.0,0.0,0.0,3,9,2080,0,1996,0,98059,47.4835,-122.13600000000001,2550,12560,11,12,2014,UNK,-470,4972
1622059088,6/26/2014,385000.0,4,2.5,3200,22651,1.0,0.0,0.0,5,8,1610,0,1970,0,98031,47.3931,-122.18299999999999,2030,5500,6,26,2014,UNK,1170,17151
5559900080,11/4/2014,272000.0,4,2.25,1880,6160,2.0,0.0,0.0,3,7,1880,0,1993,0,98023,47.3214,-122.34700000000001,1580,6405,11,4,2014,UNK,300,-245
7202260780,1/20/2015,535000.0,3,2.5,2510,5544,2.0,0.0,0.0,3,7,2510,0,2001,0,98053,47.6903,-122.042,2660,5614,1,20,2015,UNK,-150,-70
8651410950,4/30/2015,216500.0,2,1.0,1060,5200,1.0,0.0,0.0,3,6,1060,0,1969,0,98042,47.3688,-122.08,910,5200,4,30,2015,UNK,150,0
7843500080,2/25/2015,325000.0,3,2.5,2130,12245,2.0,0.0,0.0,3,8,2130,0,1989,0,98042,47.3406,-122.057,1910,12216,2,25,2015,UNK,220,29
3205400290,4/6/2015,420200.0,3,1.75,1320,7280,1.0,0.0,0.0,3,7,1320,0,1968,0,98034,47.7229,-122.18,1370,7800,4,6,2015,UNK,-50,-520
7129300420,12/2/2014,258000.0,3,1.75,1040,5650,1.0,0.0,0.0,5,6,1040,0,1951,0,98178,47.5111,-122.256,1290,5650,12,2,2014,UNK,-250,0
263000280,12/2/2014,450000.0,3,2.0,1150,4500,1.5,0.0,0.0,3,7,1150,0,1917,1991,98103,47.6985,-122.348,1230,5400,12,2,2014,Y,-80,-900
2919200280,12/8/2014,720168.0,4,2.25,2120,3794,2.0,0.0,0.0,4,7,1420,700,1926,0,98117,47.6893,-122.359,1420,3840,12,8,2014,UNK,700,-46
2769602880,10/2/2014,652000.0,3,2.0,2130,5000,1.5,0.0,0.0,5,7,1330,800,1925,0,98107,47.6746,-122.36200000000001,2010,5000,10,2,2014,UNK,120,0
8078440050,7/30/2014,569500.0,4,2.5,2340,8248,2.0,0.0,0.0,3,8,2340,0,1989,0,98074,47.6314,-122.03,2140,9963,7,30,2014,UNK,200,-1715
1922069071,4/24/2015,411000.0,4,1.75,2250,292288,1.0,0.0,0.0,4,7,2250,0,1963,0,98042,47.3787,-122.09100000000001,1550,23798,4,24,2015,UNK,700,268490
7518502945,5/19/2014,524950.0,3,1.75,1890,3825,1.0,0.0,0.0,3,7,1290,600,1974,0,98117,47.6831,-122.381,1320,3825,5,19,2014,UNK,570,0
7568700480,3/23/2015,153000.0,2,1.0,1140,10152,1.0,0.0,0.0,3,6,760,380,1942,0,98155,47.7369,-122.321,1340,10141,3,23,2015,UNK,-200,11
9577800005,10/22/2014,775000.0,3,2.5,2780,5467,2.0,0.0,2.0,3,9,2780,0,2000,0,98126,47.5791,-122.37799999999999,2630,5000,10,22,2014,UNK,150,467
7436050170,1/12/2015,338500.0,4,2.5,2390,6111,2.0,0.0,0.0,3,8,2390,0,1997,0,98030,47.3677,-122.17299999999999,2520,6500,1,12,2015,UNK,-130,-389
7200001259,5/1/2015,570000.0,3,1.75,2390,9000,1.0,0.0,0.0,3,8,1500,890,1975,0,98052,47.6809,-122.113,2040,9000,5,1,2015,UNK,350,0
4127000095,10/29/2014,653000.0,3,2.0,2680,8429,1.0,0.0,0.0,4,9,1880,800,1950,1991,98038,47.372,-122.036,1570,8640,10,29,2014,Y,1110,-211
1934800086,11/20/2014,435000.0,2,2.5,1560,1222,2.0,0.0,0.0,3,8,1080,480,2008,0,98122,47.604,-122.307,1560,2081,11,20,2014,N,0,-859
3361401025,11/26/2014,207000.0,2,1.0,1130,8160,1.0,0.0,0.0,4,6,1130,0,1952,0,98168,47.4997,-122.31700000000001,1060,6120,11,26,2014,UNK,70,2040
7430500415,7/25/2014,540000.0,2,1.0,1120,7500,1.0,0.0,2.0,4,7,1120,0,1971,0,98008,47.619,-122.096,3040,16940,7,25,2014,UNK,-1920,-9440
1622049182,6/25/2014,386000.0,4,2.25,2050,9583,2.0,0.0,2.0,3,8,1770,280,1965,0,98198,47.3978,-122.31299999999999,2230,9730,6,25,2014,UNK,-180,-147
7749500250,8/27/2014,265000.0,5,2.25,2600,8075,1.5,0.0,0.0,4,8,2600,0,1969,0,98092,47.2961,-122.18799999999999,2200,8800,8,27,2014,UNK,400,-725
1773101159,1/7/2015,250000.0,3,2.25,1050,572,2.0,0.0,0.0,3,7,740,310,2006,0,98106,47.5549,-122.363,1260,1062,1,7,2015,N,-210,-490
9829200250,1/5/2015,1700000.0,3,2.0,2600,6600,2.0,0.0,4.0,3,10,1930,670,1970,2014,98122,47.6055,-122.285,2670,6270,1,5,2015,Y,-70,330
3303860130,12/3/2014,455000.0,4,2.5,2811,7251,2.0,0.0,0.0,3,9,2811,0,2009,0,98038,47.3686,-122.05799999999999,3040,7250,12,3,2014,N,-229,1
9359100500,5/27/2014,1800000.0,4,3.25,4060,13000,2.0,0.0,3.0,3,11,4060,0,2000,0,98040,47.581,-122.24600000000001,3220,13800,5,27,2014,UNK,840,-800
1250203860,10/30/2014,759000.0,3,2.0,2260,7200,1.0,0.0,3.0,3,7,1130,1130,1941,0,98144,47.5886,-122.288,2260,6000,10,30,2014,UNK,0,1200
2386000170,3/26/2015,970000.0,4,2.75,4430,74358,2.0,0.0,0.0,3,10,4430,0,1990,0,98053,47.6392,-121.988,3820,80875,3,26,2015,UNK,610,-6517
2600000050,8/27/2014,690000.0,3,2.25,2430,8327,1.0,0.0,0.0,4,9,1430,1000,1978,0,98006,47.5534,-122.16,2550,10427,8,27,2014,UNK,-120,-2100
7856640170,7/8/2014,789900.0,3,2.5,3420,25150,1.0,0.0,0.0,4,10,1750,1670,1987,0,98006,47.5706,-122.152,2900,19604,7,8,2014,UNK,520,5546
5540800130,3/18/2015,447500.0,2,1.0,1180,5100,1.5,0.0,0.0,3,7,1180,0,1926,0,98103,47.6947,-122.346,980,5100,3,18,2015,UNK,200,0
7955060010,6/13/2014,440000.0,4,2.25,2010,7575,1.0,0.0,0.0,3,7,1220,790,1974,0,98034,47.7328,-122.2,1820,7831,6,13,2014,UNK,190,-256
7760400470,4/14/2015,278000.0,3,2.0,1230,7789,1.0,0.0,0.0,3,7,1230,0,1994,0,98042,47.3718,-122.073,1470,8670,4,14,2015,UNK,-240,-881
9551202130,7/14/2014,980000.0,5,2.5,2750,6000,1.5,0.0,0.0,3,8,1750,1000,1904,1994,98103,47.6729,-122.334,1520,4158,7,14,2014,Y,1230,1842
4345000050,6/30/2014,245000.0,3,2.75,1300,14197,1.0,0.0,0.0,3,7,860,440,1996,0,98030,47.3652,-122.18299999999999,1550,7596,6,30,2014,UNK,-250,6601
7334501440,10/21/2014,287000.0,3,1.5,1150,11475,1.0,0.0,0.0,3,7,1150,0,1971,0,98045,47.4629,-121.744,1640,11475,10,21,2014,UNK,-490,0
1523069215,6/3/2014,435000.0,3,1.75,2220,132858,1.0,0.0,0.0,3,7,1110,1110,1988,0,98027,47.4853,-122.03399999999999,2130,77536,6,3,2014,UNK,90,55322
5525400430,7/15/2014,585000.0,3,2.5,2050,11690,2.0,0.0,0.0,4,9,2050,0,1989,0,98059,47.5279,-122.161,2410,10172,7,15,2014,UNK,-360,1518
871001611,7/1/2014,616000.0,4,1.75,1700,5846,1.0,0.0,0.0,3,8,1700,0,1957,0,98199,47.6539,-122.40799999999999,1480,5177,7,1,2014,UNK,220,669
1685200190,1/15/2015,203000.0,3,1.75,1610,9000,1.0,0.0,0.0,4,7,1100,510,1978,0,98092,47.3187,-122.179,1610,8000,1,15,2015,UNK,0,1000
1982200675,5/6/2015,860000.0,4,2.75,2720,3840,2.0,0.0,0.0,3,8,1790,930,1920,2009,98107,47.6624,-122.361,1360,3880,5,6,2015,Y,1360,-40
1201500010,3/30/2015,833000.0,4,2.5,2190,12690,1.0,0.0,2.0,3,8,1170,1020,1973,0,98033,47.6627,-122.189,2630,10843,3,30,2015,UNK,-440,1847
1822360080,12/11/2014,565000.0,4,2.75,2730,6856,2.0,0.0,0.0,3,8,2730,0,2003,0,98072,47.7739,-122.164,2520,5569,12,11,2014,UNK,210,1287
4113800500,2/12/2015,572500.0,3,2.5,2490,7589,2.0,0.0,0.0,3,9,2490,0,1991,0,98056,47.5355,-122.179,2500,10386,2,12,2015,UNK,-10,-2797
4299700095,5/16/2014,254000.0,4,2.0,1510,4235,1.0,0.0,0.0,3,7,1510,0,1955,0,98108,47.54600000000001,-122.29299999999999,1510,4268,5,16,2014,UNK,0,-33
3585900500,4/2/2015,1530000.0,4,4.25,4720,21000,3.0,0.0,4.0,5,11,4720,0,1971,0,98177,47.7591,-122.376,3010,20000,4,2,2015,UNK,1710,1000
326069026,1/21/2015,900000.0,4,3.0,3810,217800,2.0,0.0,0.0,3,9,3810,0,2003,0,98077,47.7696,-122.021,2580,217364,1,21,2015,UNK,1230,436
4070700290,2/26/2015,899000.0,3,2.5,1950,3730,2.0,0.0,0.0,3,9,1950,0,1996,0,98033,47.6731,-122.199,2080,4000,2,26,2015,UNK,-130,-270
7625703800,4/24/2015,560000.0,3,2.0,1300,6000,1.0,0.0,0.0,5,7,1300,0,1943,0,98136,47.5482,-122.39200000000001,1230,6000,4,24,2015,UNK,70,0
643400130,3/4/2015,512500.0,3,1.75,1610,7200,1.0,0.0,0.0,3,7,1180,430,1976,0,98007,47.5966,-122.14399999999999,1520,7973,3,4,2015,UNK,90,-773
2877103070,2/23/2015,775000.0,4,2.5,2040,5000,1.5,0.0,0.0,5,7,1180,860,1924,0,98117,47.6786,-122.36,1540,5000,2,23,2015,UNK,500,0
421000185,6/11/2014,200000.0,2,1.0,700,4700,1.0,0.0,0.0,5,5,700,0,1953,0,98056,47.4953,-122.169,960,5200,6,11,2014,UNK,-260,-500
2113700825,7/31/2014,172000.0,3,1.0,970,4700,1.0,0.0,0.0,4,6,720,250,1943,0,98106,47.5285,-122.354,1560,4600,7,31,2014,UNK,-590,100
623049093,5/22/2014,219900.0,3,1.0,910,6000,1.0,0.0,0.0,2,6,910,0,1956,0,98146,47.5065,-122.338,1090,6957,5,22,2014,UNK,-180,-957
4348800080,7/11/2014,641200.0,3,1.0,1060,9123,1.0,0.0,0.0,3,7,1060,0,1952,0,98004,47.6218,-122.193,1620,9121,7,11,2014,UNK,-560,2
3762900010,7/15/2014,473000.0,5,3.25,2180,7200,2.0,0.0,0.0,4,7,2180,0,1982,0,98034,47.7078,-122.234,1840,7644,7,15,2014,UNK,340,-444
3578401700,7/1/2014,540000.0,3,1.75,2050,9580,1.0,0.0,0.0,3,8,1400,650,1984,0,98074,47.6212,-122.038,1740,11952,7,1,2014,UNK,310,-2372
1211000280,5/4/2015,295000.0,2,1.0,750,4500,1.0,0.0,0.0,3,6,750,0,1945,0,98122,47.607,-122.29700000000001,1540,4000,5,4,2015,UNK,-790,500
1324300091,5/28/2014,370000.0,3,1.0,800,2296,1.0,0.0,0.0,4,6,800,0,1908,0,98103,47.6546,-122.35600000000001,1480,1472,5,28,2014,UNK,-680,824
4141800285,7/14/2014,1730000.0,4,2.25,3470,8000,1.5,0.0,1.0,3,9,2360,1110,1906,0,98122,47.6149,-122.287,3010,8000,7,14,2014,UNK,460,0
1524079088,5/9/2014,275000.0,3,1.5,1390,48257,1.0,0.0,0.0,3,6,1390,0,1922,0,98024,47.5603,-121.89399999999999,1440,45302,5,9,2014,UNK,-50,2955
9320900420,10/14/2014,89000.0,3,1.0,900,4750,1.0,0.0,0.0,4,6,900,0,1969,0,98023,47.3026,-122.363,900,3404,10,14,2014,UNK,0,1346
7349800780,8/5/2014,175000.0,2,1.75,1050,9800,1.5,0.0,0.0,4,6,1050,0,1975,0,98019,47.7595,-121.473,1230,12726,8,5,2014,UNK,-180,-2926
1196002948,2/18/2015,490000.0,3,2.5,2410,11900,1.0,0.0,2.0,4,9,1600,810,1989,0,98023,47.3384,-122.34,3090,11902,2,18,2015,UNK,-680,-2
5631500213,5/15/2014,342400.0,3,2.25,1180,9630,2.0,0.0,0.0,3,7,1180,0,1986,0,98028,47.7352,-122.23200000000001,2660,5979,5,15,2014,UNK,-1480,3651
3416601045,6/23/2014,345000.0,3,1.0,1140,4200,2.0,0.0,0.0,4,7,1140,0,1904,0,98144,47.6012,-122.296,1510,4000,6,23,2014,UNK,-370,200
9828701650,11/25/2014,399000.0,2,1.0,700,3400,1.0,0.0,0.0,3,6,700,0,1946,0,98112,47.6212,-122.296,1570,4512,11,25,2014,UNK,-870,-1112
6071300500,8/15/2014,550000.0,4,2.5,2060,9719,1.0,0.0,0.0,4,8,1320,740,1960,0,98006,47.5549,-122.176,2050,9643,8,15,2014,UNK,10,76
6072760670,12/3/2014,652450.0,3,2.25,2230,11835,1.0,0.0,0.0,5,8,1630,600,1974,0,98006,47.563,-122.178,2190,10384,12,3,2014,UNK,40,1451
9141100255,4/29/2015,438000.0,2,2.25,1950,29347,1.0,0.0,0.0,3,8,1350,600,1953,0,98133,47.739,-122.351,2125,7751,4,29,2015,UNK,-175,21596
2824600290,4/3/2015,605000.0,3,1.75,2100,5058,1.0,0.0,2.0,3,7,1340,760,1941,0,98126,47.5743,-122.37799999999999,1640,5000,4,3,2015,UNK,460,58
2787720170,9/29/2014,395000.0,4,2.5,2130,11733,1.0,0.0,0.0,5,7,1330,800,1969,0,98059,47.512,-122.16,1800,9131,9,29,2014,UNK,330,2602
9826701735,11/12/2014,449950.0,3,2.0,1880,3048,2.0,0.0,0.0,4,7,1880,0,1902,0,98122,47.6031,-122.303,1680,3600,11,12,2014,UNK,200,-552
1703050420,3/30/2015,651100.0,4,2.5,2310,5526,2.0,0.0,0.0,3,9,2310,0,2003,0,98074,47.6299,-122.02,2500,5769,3,30,2015,UNK,-190,-243
4060000440,2/4/2015,241000.0,3,1.0,880,6050,1.0,0.0,0.0,3,6,880,0,1945,0,98178,47.4995,-122.24799999999999,1130,6050,2,4,2015,UNK,-250,0
2525049148,10/7/2014,3420000.0,5,5.0,5450,20412,2.0,0.0,0.0,3,11,5450,0,2014,0,98039,47.6209,-122.23700000000001,3160,17825,10,7,2014,N,2290,2587
8857310010,12/19/2014,268500.0,2,1.5,1290,1749,1.0,0.0,0.0,3,8,660,630,1969,0,98008,47.6118,-122.116,1860,1749,12,19,2014,UNK,-570,0
1823049178,1/23/2015,200000.0,2,1.0,1010,7200,1.0,0.0,0.0,3,6,1010,0,1956,0,98166,47.4815,-122.339,1290,9000,1,23,2015,UNK,-280,-1800
4364200250,12/1/2014,400375.0,4,1.75,1690,7680,1.0,0.0,0.0,5,6,890,800,1946,0,98126,47.5296,-122.375,1060,7680,12,1,2014,UNK,630,0
8682260480,5/28/2014,429000.0,2,1.75,1350,6315,1.0,0.0,0.0,3,8,1350,0,2005,0,98053,47.7141,-122.03200000000001,1665,5390,5,28,2014,N,-315,925
1250200345,10/24/2014,230000.0,3,1.0,680,2400,1.0,0.0,0.0,4,6,680,0,1903,0,98144,47.5982,-122.29899999999999,1470,3600,10,24,2014,UNK,-790,-1200
9808590460,2/18/2015,1200000.0,4,2.25,2860,10702,2.0,0.0,0.0,3,10,2860,0,1982,0,98004,47.6451,-122.189,2890,10572,2,18,2015,UNK,-30,130
7818700480,4/9/2015,314200.0,1,1.0,610,6000,1.0,0.0,0.0,4,5,610,0,1918,0,98117,47.6911,-122.367,970,5000,4,9,2015,UNK,-360,1000
2792000010,4/23/2015,513000.0,4,2.5,2660,8887,1.0,0.0,0.0,4,8,1880,780,1967,0,98166,47.43899999999999,-122.34200000000001,1910,9620,4,23,2015,UNK,750,-733
1705400244,4/2/2015,535000.0,2,1.0,1390,5346,1.0,0.0,0.0,5,7,960,430,1908,0,98118,47.5567,-122.279,1450,5040,4,2,2015,UNK,-60,306
9358002375,3/5/2015,420000.0,6,3.0,2290,6344,2.0,0.0,0.0,3,7,2290,0,1980,0,98126,47.565,-122.37,1360,3202,3,5,2015,UNK,930,3142
8944320470,6/23/2014,345950.0,3,2.5,2110,4118,2.0,0.0,0.0,3,8,2110,0,1989,0,98042,47.3878,-122.15299999999999,2110,4044,6,23,2014,UNK,0,74
6372000101,8/20/2014,483500.0,3,2.0,1200,2016,1.0,0.0,1.0,4,7,600,600,1931,0,98116,47.5811,-122.404,1730,4520,8,20,2014,UNK,-530,-2504
2877100655,12/8/2014,695000.0,4,2.25,2360,2500,2.0,0.0,3.0,3,8,1520,840,2001,0,98117,47.6771,-122.35799999999999,1810,3900,12,8,2014,UNK,550,-1400
9378500050,10/6/2014,295000.0,4,2.5,2350,8906,2.0,0.0,0.0,3,7,2350,0,1993,0,98031,47.4205,-122.215,2000,8165,10,6,2014,UNK,350,741
3790600080,4/8/2015,434975.0,3,2.25,1590,9960,1.0,0.0,0.0,3,7,1060,530,1976,0,98155,47.7742,-122.287,1860,9760,4,8,2015,UNK,-270,200
8944360080,7/8/2014,513000.0,3,2.5,1810,4592,2.0,0.0,0.0,3,8,1810,0,1992,0,98029,47.5764,-121.99600000000001,1810,4758,7,8,2014,UNK,0,-166
7979900225,3/23/2015,360000.0,3,1.75,1900,11407,1.0,0.0,0.0,3,8,1900,0,1963,0,98155,47.7455,-122.294,1710,11407,3,23,2015,UNK,190,0
3163600130,3/17/2015,234900.0,3,1.0,1250,8000,1.0,0.0,0.0,3,7,1250,0,1956,0,98146,47.5065,-122.337,1040,6973,3,17,2015,UNK,210,1027
4139380050,6/16/2014,963000.0,4,3.5,3280,6603,2.0,0.0,0.0,3,10,3280,0,2007,0,98027,47.5642,-122.126,3280,7333,6,16,2014,N,0,-730
2749600095,8/19/2014,595000.0,2,1.5,870,4800,1.0,0.0,0.0,3,7,870,0,1924,0,98119,47.6509,-122.37,2090,4800,8,19,2014,UNK,-1220,0
7852160250,10/24/2014,942500.0,4,3.25,3570,14408,2.0,0.0,2.0,3,10,3570,0,2006,0,98065,47.536,-121.85700000000001,4100,14577,10,24,2014,N,-530,-169
3303980500,9/5/2014,1030000.0,4,3.25,3780,11200,2.0,0.0,0.0,3,11,3780,0,2002,0,98059,47.521,-122.15,3720,11813,9,5,2014,UNK,60,-613
1250200605,3/25/2015,350000.0,3,1.0,1190,3600,1.5,0.0,0.0,3,6,1190,0,1904,0,98144,47.5985,-122.29799999999999,1680,3600,3,25,2015,UNK,-490,0
8887001640,11/6/2014,416500.0,4,2.0,2280,39848,2.0,0.0,0.0,4,8,2280,0,1991,0,98070,47.5003,-122.465,1900,38472,11,6,2014,UNK,380,1376
2122059127,9/16/2014,209900.0,3,1.0,1030,60720,1.5,0.0,0.0,3,5,1030,0,1912,0,98042,47.375,-122.166,1330,10342,9,16,2014,UNK,-300,50378
5700001045,6/22/2014,802000.0,3,1.75,2870,5000,1.5,0.0,0.0,4,8,1840,1030,1907,0,98144,47.5788,-122.292,2200,5000,6,22,2014,UNK,670,0
7331900290,7/31/2014,230000.0,4,1.5,1520,8800,1.0,0.0,0.0,4,7,1520,0,1960,0,98002,47.3136,-122.208,1370,8800,7,31,2014,UNK,150,0
7844200415,7/2/2014,489000.0,3,3.0,3700,10375,2.0,0.0,0.0,3,9,3700,0,1982,0,98188,47.4286,-122.291,2130,9132,7,2,2014,UNK,1570,1243
4055700345,7/14/2014,497000.0,3,1.5,2240,28750,1.0,0.0,0.0,3,8,1620,620,1956,0,98034,47.7137,-122.25399999999999,3200,23873,7,14,2014,UNK,-960,4877
2923049421,7/2/2014,250000.0,3,2.25,1920,7738,1.0,0.0,0.0,3,8,1520,400,1965,0,98148,47.4562,-122.33,2170,8452,7,2,2014,UNK,-250,-714
1860600840,8/15/2014,925000.0,3,3.0,2560,3600,2.0,0.0,0.0,3,10,2110,450,1994,0,98119,47.633,-122.37,2160,3600,8,15,2014,UNK,400,0
5095400460,7/23/2014,390000.0,4,2.5,1840,15496,2.0,0.0,0.0,3,8,1840,0,1991,0,98059,47.4683,-122.07,1840,15040,7,23,2014,UNK,0,456
3819750170,3/10/2015,415000.0,3,2.75,2080,9600,1.0,0.0,0.0,3,7,2080,0,1988,0,98028,47.7698,-122.238,2220,9600,3,10,2015,UNK,-140,0
5021900779,4/4/2015,785000.0,3,2.0,1600,9638,1.0,0.0,0.0,5,7,1600,0,1952,0,98040,47.5753,-122.22399999999999,1800,11400,4,4,2015,UNK,-200,-1762
4206901155,9/24/2014,575000.0,3,2.0,2168,4000,1.5,0.0,0.0,3,8,2168,0,1907,0,98105,47.6561,-122.325,1770,4000,9,24,2014,UNK,398,0
6303400290,1/26/2015,170000.0,2,1.0,860,8636,1.0,0.0,0.0,3,6,860,0,1924,0,98146,47.5081,-122.35600000000001,1100,8636,1,26,2015,UNK,-240,0
7871500440,10/14/2014,750000.0,4,1.75,2100,3400,1.0,0.0,0.0,5,7,1100,1000,1915,0,98119,47.6429,-122.37100000000001,1890,3771,10,14,2014,UNK,210,-371
6085000130,3/21/2015,230000.0,3,1.0,1140,9639,1.0,0.0,0.0,4,7,1140,0,1967,0,98001,47.3112,-122.265,1140,9639,3,21,2015,UNK,0,0
1896700080,1/5/2015,855000.0,4,3.0,3090,35074,2.0,0.0,0.0,3,9,3090,0,1978,0,98005,47.6359,-122.15899999999999,3120,35150,1,5,2015,UNK,-30,-76
6197800101,8/5/2014,235000.0,3,1.0,1330,45738,2.0,0.0,0.0,2,6,1330,0,1967,0,98058,47.43600000000001,-122.185,1490,24000,8,5,2014,UNK,-160,21738
7802900380,9/8/2014,335000.0,2,1.0,1360,69260,1.0,0.0,0.0,4,5,1360,0,1937,0,98065,47.5229,-121.838,1460,69260,9,8,2014,UNK,-100,0
3024059126,7/3/2014,1200000.0,5,3.0,3420,18129,2.0,0.0,0.0,3,9,2540,880,1952,2005,98040,47.5333,-122.21700000000001,3750,16316,7,3,2014,Y,-330,1813
7128300630,3/30/2015,677000.0,4,2.0,2180,6000,1.5,0.0,0.0,3,8,2060,120,1927,0,98144,47.5958,-122.306,1370,4500,3,30,2015,UNK,810,1500
7626200305,10/22/2014,575000.0,3,2.0,1800,5000,2.0,0.0,0.0,5,7,1600,200,1925,0,98136,47.5447,-122.389,1640,5000,10,22,2014,UNK,160,0
7950300670,2/18/2015,450000.0,2,1.0,1120,4590,1.0,0.0,0.0,3,7,1120,0,1924,0,98118,47.5663,-122.285,1120,5100,2,18,2015,UNK,0,-510
1233100321,3/27/2015,817250.0,3,2.5,2980,7202,2.0,0.0,0.0,3,8,2980,0,1999,0,98033,47.6769,-122.177,2430,7280,3,27,2015,UNK,550,-78
9238500190,12/2/2014,440000.0,4,2.25,2600,28600,1.0,0.0,0.0,3,8,1810,790,1968,0,98072,47.7757,-122.139,2580,26950,12,2,2014,UNK,20,1650
1972201856,5/7/2014,526000.0,2,2.0,1550,2400,1.5,0.0,0.0,4,7,1550,0,1900,0,98103,47.653999999999996,-122.346,1180,1224,5,7,2014,UNK,370,1176
624110920,7/25/2014,762500.0,3,2.25,3330,15258,2.0,0.0,0.0,3,10,3330,0,1986,0,98077,47.7262,-122.06,3360,14850,7,25,2014,UNK,-30,408
5003600080,4/14/2015,325000.0,4,2.5,2200,7719,2.0,0.0,0.0,3,8,2200,0,2000,0,98030,47.3649,-122.194,2460,7348,4,14,2015,UNK,-260,371
853600020,7/10/2014,840000.0,4,3.5,3840,85728,2.0,0.0,0.0,3,11,3840,0,1998,0,98014,47.615,-121.954,2430,42643,7,10,2014,UNK,1410,43085
7625704317,5/3/2015,377500.0,2,1.0,840,4500,1.0,0.0,0.0,3,6,840,0,1939,0,98136,47.5441,-122.39,1300,5000,5,3,2015,UNK,-460,-500
2946000912,9/23/2014,212500.0,3,1.5,1270,7128,1.0,0.0,0.0,4,6,1270,0,1954,0,98198,47.422,-122.321,1270,7986,9,23,2014,UNK,0,-858
4188000670,5/15/2014,749400.0,4,2.5,3240,20301,2.0,0.0,0.0,3,10,3240,0,1985,0,98052,47.718999999999994,-122.11399999999999,3010,23650,5,15,2014,UNK,230,-3349
5215200010,6/26/2014,663000.0,3,2.5,2480,37843,1.5,0.0,3.0,4,8,2480,0,1974,0,98070,47.4003,-122.42200000000001,2350,42122,6,26,2014,UNK,130,-4279
2911700020,7/21/2014,1480000.0,3,2.25,4470,22518,2.0,0.0,2.0,3,9,3240,1230,1953,0,98006,47.574,-122.18,2930,21837,7,21,2014,UNK,1540,681
185000161,10/15/2014,261000.0,3,1.0,1780,7800,1.0,0.0,0.0,3,7,1060,720,1957,0,98178,47.4932,-122.26299999999999,1450,7800,10,15,2014,UNK,330,0
2140700190,4/10/2015,515000.0,4,2.5,1850,9248,2.0,0.0,0.0,3,8,1850,0,1997,0,98028,47.735,-122.244,2080,8711,4,10,2015,UNK,-230,537
9406600050,5/12/2014,410000.0,3,2.25,2200,16921,2.0,0.0,0.0,3,8,2200,0,1987,0,98038,47.3727,-122.051,2060,16921,5,12,2014,UNK,140,0
2473000470,7/8/2014,336000.0,3,2.25,2760,10160,1.0,0.0,0.0,3,8,2760,0,1969,0,98058,47.4504,-122.15,2760,9600,7,8,2014,UNK,0,560
5100403952,2/25/2015,440000.0,2,1.0,1090,4128,1.0,0.0,0.0,3,7,1090,0,1948,0,98115,47.69600000000001,-122.314,1090,5413,2,25,2015,UNK,0,-1285
2024059127,1/9/2015,908950.0,4,2.75,3090,6200,2.0,0.0,0.0,3,9,3090,0,2014,0,98006,47.5538,-122.189,2890,10108,1,9,2015,N,200,-3908
1483300430,11/25/2014,554000.0,2,1.0,820,3700,1.0,0.0,0.0,5,7,820,0,1968,0,98040,47.588,-122.251,1750,9000,11,25,2014,UNK,-930,-5300
291300170,5/9/2014,387000.0,3,2.25,1445,1606,2.0,0.0,0.0,3,7,1300,145,2003,0,98027,47.5348,-122.072,1410,1286,5,9,2014,UNK,35,320
9117000170,5/5/2015,268643.0,4,2.25,1810,9240,2.0,0.0,0.0,3,7,1810,0,1961,0,98055,47.4362,-122.18700000000001,1660,9240,5,5,2015,UNK,150,0
461004095,7/21/2014,514000.0,3,1.75,1620,5000,1.0,0.0,0.0,3,7,920,700,1954,0,98117,47.681000000000004,-122.37200000000001,1610,5000,7,21,2014,UNK,10,0
9547201850,7/23/2014,420000.0,2,1.75,1060,4182,2.0,0.0,0.0,3,7,1060,0,1977,0,98115,47.6787,-122.30799999999999,1760,4590,7,23,2014,UNK,-700,-408
7942100290,9/10/2014,199000.0,3,1.75,1050,9871,1.0,0.0,0.0,5,7,1050,0,1968,0,98042,47.3816,-122.087,1300,10794,9,10,2014,UNK,-250,-923
4336000050,3/17/2015,225000.0,3,1.0,1010,15701,1.0,0.0,0.0,4,7,1010,0,1949,0,98188,47.4518,-122.292,1260,9800,3,17,2015,UNK,-250,5901
2571910420,8/19/2014,320000.0,4,2.5,2050,8424,2.0,0.0,0.0,4,8,2050,0,1993,0,98022,47.19600000000001,-122.01100000000001,1970,8448,8,19,2014,UNK,80,-24
8802400896,10/23/2014,204995.0,2,1.0,970,8185,1.0,0.0,0.0,5,6,970,0,1904,0,98031,47.4025,-122.20100000000001,1500,12541,10,23,2014,UNK,-530,-4356
3630010020,12/29/2014,376000.0,3,2.0,1540,1827,2.0,0.0,0.0,3,8,1540,0,2005,0,98029,47.5479,-121.999,1560,2058,12,29,2014,N,-20,-231
6793300010,12/15/2014,705000.0,4,2.75,3000,6222,2.0,0.0,0.0,3,9,3000,0,2004,0,98029,47.5582,-122.025,3340,7222,12,15,2014,N,-340,-1000
7852020250,6/2/2014,725995.0,4,2.5,3190,7869,2.0,0.0,2.0,3,9,3190,0,2001,0,98065,47.5317,-121.866,2630,6739,6,2,2014,UNK,560,1130
2473400290,1/26/2015,285000.0,4,2.5,1870,8190,1.0,0.0,0.0,3,7,1100,770,1977,0,98058,47.4521,-122.161,1590,9150,1,26,2015,UNK,280,-960
3328500250,5/2/2014,285000.0,4,2.5,2200,9397,2.0,0.0,0.0,3,8,2200,0,1987,0,98001,47.3406,-122.26899999999999,2310,9176,5,2,2014,UNK,-110,221
629420080,8/20/2014,731000.0,4,2.5,3070,5936,2.0,0.0,0.0,3,9,3070,0,2005,0,98075,47.5902,-121.988,3160,5936,8,20,2014,N,-90,0
2524049215,5/1/2015,1560000.0,4,3.75,3730,17000,2.0,0.0,3.0,4,10,2820,910,1986,0,98040,47.5355,-122.242,3880,15550,5,1,2015,UNK,-150,1450
8663310050,10/6/2014,510000.0,4,2.5,2440,10423,1.0,0.0,0.0,3,7,2440,0,1955,0,98034,47.725,-122.17200000000001,1990,7758,10,6,2014,UNK,450,2665
4083304835,10/23/2014,620000.0,2,1.0,990,4332,1.0,0.0,0.0,3,7,990,0,1909,0,98103,47.6528,-122.331,1920,3420,10,23,2014,UNK,-930,912
8155800050,4/22/2015,1110000.0,3,4.0,4160,31796,2.0,0.0,0.0,3,11,4160,0,1989,0,98053,47.6635,-122.01700000000001,4300,36192,4,22,2015,UNK,-140,-4396
4403200255,7/22/2014,796000.0,4,3.5,3670,4960,2.0,0.0,0.0,3,9,2870,800,2005,0,98177,47.7022,-122.374,1520,6335,7,22,2014,N,2150,-1375
5379800500,9/30/2014,255000.0,3,1.5,910,25500,1.0,0.0,0.0,3,5,910,0,1943,0,98188,47.4565,-122.27600000000001,1580,10019,9,30,2014,UNK,-670,15481
7010700660,4/28/2015,807000.0,3,2.5,1940,4000,2.0,0.0,0.0,4,9,1940,0,2000,0,98199,47.659,-122.398,1410,4000,4,28,2015,UNK,530,0
9406540190,11/10/2014,315000.0,4,2.5,1780,6000,2.0,0.0,0.0,3,9,1780,0,2000,0,98038,47.3774,-122.027,2650,6000,11,10,2014,UNK,-870,0
1795920250,2/27/2015,637000.0,3,2.25,2200,7355,2.0,0.0,0.0,4,8,2200,0,1986,0,98052,47.7266,-122.103,2290,7868,2,27,2015,UNK,-90,-513
5249800010,12/3/2014,2730000.0,4,4.25,6410,43838,2.5,0.0,2.0,4,12,5610,800,1906,0,98144,47.5703,-122.28,2270,6630,12,3,2014,UNK,4140,37208
8651510420,12/11/2014,490000.0,3,2.0,2070,10023,1.0,0.0,0.0,3,8,1220,850,1981,0,98074,47.6492,-122.06200000000001,2130,9694,12,11,2014,UNK,-60,329
1422700080,6/10/2014,253000.0,3,1.75,2040,7281,1.0,0.0,0.0,3,7,1020,1020,1962,0,98188,47.4681,-122.28200000000001,1740,7527,6,10,2014,UNK,300,-246
5468780250,5/8/2014,325900.0,4,2.5,2320,6270,2.0,0.0,0.0,3,8,2320,0,2004,0,98042,47.3501,-122.14,2150,6270,5,8,2014,N,170,0
3723800415,10/15/2014,425000.0,2,2.0,1440,6677,1.0,0.0,0.0,3,7,870,570,1952,0,98118,47.5513,-122.264,2020,7642,10,15,2014,UNK,-580,-965
1545800290,9/5/2014,215000.0,4,2.5,1700,6675,2.0,0.0,0.0,3,7,1700,0,1997,0,98038,47.3638,-122.053,1570,7540,9,5,2014,UNK,130,-865
1545800290,4/8/2015,315000.0,4,2.5,1700,6675,2.0,0.0,0.0,3,7,1700,0,1997,0,98038,47.3638,-122.053,1570,7540,4,8,2015,UNK,130,-865
2804100095,5/16/2014,724800.0,3,2.0,2050,3933,1.0,0.0,0.0,3,8,1180,870,1926,2001,98112,47.6436,-122.303,1940,4000,5,16,2014,Y,110,-67
7282300095,7/9/2014,295000.0,2,1.0,800,6500,1.0,0.0,0.0,4,6,800,0,1953,0,98133,47.7621,-122.35799999999999,1220,7000,7,9,2014,UNK,-420,-500
930000289,3/16/2015,509007.0,3,1.75,1800,7620,1.0,0.0,0.0,3,8,1350,450,1951,0,98177,47.7165,-122.361,1770,7620,3,16,2015,UNK,30,0
2822059181,4/13/2015,306000.0,5,2.0,1460,169448,1.5,0.0,0.0,3,6,1460,0,1910,0,98030,47.3714,-122.177,2250,6059,4,13,2015,UNK,-790,163389
1761100080,7/17/2014,205000.0,3,1.75,1290,7210,1.0,0.0,0.0,3,7,1290,0,1984,0,98023,47.2889,-122.363,1350,7509,7,17,2014,UNK,-60,-299
2953000250,7/31/2014,275000.0,3,1.5,1900,9737,1.0,0.0,0.0,4,7,1200,700,1968,0,98031,47.4125,-122.20700000000001,1670,9737,7,31,2014,UNK,230,0
3416600185,11/6/2014,685000.0,3,1.75,1480,7000,1.0,0.0,2.0,3,8,1480,0,1963,0,98122,47.6018,-122.291,1850,4000,11,6,2014,UNK,-370,3000
927200380,4/20/2015,465000.0,4,2.5,2090,12833,1.0,0.0,0.0,3,7,1220,870,1969,0,98034,47.7266,-122.175,1740,11200,4,20,2015,UNK,350,1633
7922750020,7/8/2014,560000.0,4,2.25,1950,9800,1.0,0.0,0.0,3,8,1330,620,1968,0,98033,47.666000000000004,-122.178,2170,9800,7,8,2014,UNK,-220,0
259600050,2/23/2015,458500.0,3,1.75,1250,9605,1.0,0.0,0.0,3,7,1250,0,1964,0,98008,47.6325,-122.12100000000001,1570,9605,2,23,2015,UNK,-320,0
3298300420,3/31/2015,354000.0,3,1.0,990,7590,1.0,0.0,0.0,3,6,990,0,1959,0,98008,47.6228,-122.12100000000001,1100,7590,3,31,2015,UNK,-110,0
1310440470,1/13/2015,441000.0,3,2.5,2740,7923,2.0,0.0,0.0,3,9,2740,0,1998,0,98058,47.4349,-122.105,2740,8815,1,13,2015,UNK,0,-892
3438502668,8/29/2014,194000.0,3,1.75,1260,10488,1.0,0.0,0.0,2,7,1110,150,1952,0,98106,47.5417,-122.35700000000001,1540,9120,8,29,2014,UNK,-280,1368
5591700290,5/15/2014,316500.0,4,2.5,2150,6807,2.0,0.0,0.0,4,8,2150,0,1991,0,98031,47.4053,-122.189,1910,7240,5,15,2014,UNK,240,-433
4172100050,8/25/2014,524950.0,3,1.75,1750,3250,1.5,0.0,0.0,4,7,1230,520,1929,0,98117,47.6807,-122.366,1480,3600,8,25,2014,UNK,270,-350
9275700005,4/27/2015,1050000.0,3,2.25,2880,6092,2.0,0.0,4.0,4,8,1920,960,1983,0,98116,47.5878,-122.381,2880,5308,4,27,2015,UNK,0,784
1089000190,4/12/2015,925000.0,4,2.25,2590,13894,2.0,0.0,0.0,4,9,2590,0,1975,0,98005,47.6351,-122.165,2720,13894,4,12,2015,UNK,-130,0
9523103000,10/20/2014,780000.0,3,1.75,2430,4524,1.5,0.0,0.0,4,7,1830,600,1924,0,98103,47.674,-122.35,1610,4100,10,20,2014,UNK,820,424
2781270440,5/19/2014,241000.0,2,2.0,1470,3128,2.0,0.0,0.0,3,6,1470,0,2005,0,98038,47.349,-122.021,1180,2576,5,19,2014,N,290,552
2105200050,6/19/2014,519000.0,3,2.75,2020,10744,1.0,0.0,0.0,5,7,1270,750,1954,0,98166,47.4403,-122.34299999999999,2020,11069,6,19,2014,UNK,0,-325
7625703637,8/28/2014,286000.0,2,1.0,610,4000,1.0,0.0,0.0,4,6,610,0,1918,0,98136,47.5469,-122.391,870,5160,8,28,2014,UNK,-260,-1160
2926049408,10/9/2014,400000.0,3,2.0,3000,17800,1.0,0.0,0.0,3,8,1500,1500,1962,0,98125,47.7058,-122.315,2400,8300,10,9,2014,UNK,600,9500
3224079005,10/9/2014,255000.0,2,1.0,920,43560,1.0,0.0,0.0,4,5,920,0,1923,0,98024,47.5245,-121.931,1530,11875,10,9,2014,UNK,-610,31685
5147600095,1/21/2015,152000.0,3,1.75,1070,7754,1.0,0.0,0.0,3,6,1070,0,1953,0,98146,47.5079,-122.344,950,7740,1,21,2015,UNK,120,14
2413900050,12/1/2014,599000.0,4,2.0,3410,15143,2.0,0.0,0.0,4,8,3410,0,1972,1987,98052,47.6709,-122.052,2350,25936,12,1,2014,Y,1060,-10793
3820350050,10/24/2014,330000.0,4,2.5,1820,3905,2.0,0.0,0.0,3,7,1820,0,2001,0,98019,47.7346,-121.985,1820,3863,10,24,2014,UNK,0,42
8910500675,5/19/2014,461000.0,2,1.0,1060,7193,1.0,0.0,0.0,3,7,1060,0,1926,0,98133,47.7102,-122.35600000000001,1980,7560,5,19,2014,UNK,-920,-367
1461200020,3/10/2015,620000.0,5,2.5,3070,34991,2.0,0.0,0.0,3,9,3070,0,1995,0,98059,47.4721,-122.148,2150,19515,3,10,2015,UNK,920,15476
722079056,10/6/2014,352500.0,4,2.5,2300,219106,1.0,0.0,0.0,4,7,1840,460,1958,0,98038,47.4044,-121.963,2120,123710,10,6,2014,UNK,180,95396
8663370020,8/6/2014,435000.0,3,2.0,1610,6911,1.0,0.0,0.0,3,7,1260,350,1988,0,98034,47.7188,-122.177,1630,6911,8,6,2014,UNK,-20,0
2568200130,5/16/2014,725000.0,5,2.75,2830,5310,2.0,0.0,0.0,3,9,2830,0,2006,0,98052,47.7074,-122.101,3150,6581,5,16,2014,N,-320,-1271
8947800080,11/5/2014,300000.0,3,1.0,970,12300,1.0,0.0,0.0,3,7,970,0,1982,0,98028,47.7335,-122.227,2040,9994,11,5,2014,UNK,-1070,2306
1545803390,11/11/2014,252000.0,3,2.5,1680,8284,2.0,0.0,0.0,3,7,1680,0,1989,0,98038,47.3609,-122.04799999999999,1550,8284,11,11,2014,UNK,130,0
1088030010,10/5/2014,464625.0,4,2.75,2040,8996,1.0,0.0,0.0,4,8,1260,780,1974,0,98033,47.666000000000004,-122.185,2470,9180,10,5,2014,UNK,-430,-184
1829700080,12/12/2014,340000.0,3,1.0,1450,9586,2.0,0.0,0.0,3,7,1450,0,1950,0,98155,47.7443,-122.32600000000001,1500,8592,12,12,2014,UNK,-50,994
2125049024,6/20/2014,1330000.0,4,2.25,2870,6280,1.5,0.0,0.0,4,9,1980,890,1905,0,98112,47.6329,-122.31,2370,4760,6,20,2014,UNK,500,1520
5706200020,2/6/2015,455000.0,5,2.0,1870,13970,1.0,0.0,0.0,4,7,1120,0,1969,0,98027,47.5243,-122.042,1860,13970,2,6,2015,UNK,10,0
2316400285,5/13/2015,495000.0,4,3.5,2490,18042,2.0,0.0,0.0,3,8,2490,0,2003,0,98070,47.4161,-122.441,1960,21107,5,13,2015,UNK,530,-3065
7588700080,4/21/2015,925000.0,4,2.5,3350,4501,2.0,0.0,0.0,3,9,2640,710,2002,0,98117,47.688,-122.37899999999999,1000,4500,4,21,2015,UNK,2350,1
7853310380,12/11/2014,587000.0,4,2.75,3190,8737,2.0,0.0,0.0,3,9,3190,0,2006,0,98065,47.523,-121.87700000000001,3240,7131,12,11,2014,N,-50,1606
6821101870,5/5/2014,524000.0,3,1.75,1560,5520,1.0,0.0,0.0,4,6,780,780,1944,0,98199,47.6515,-122.399,1470,6000,5,5,2014,UNK,90,-480
9551201660,6/13/2014,1030000.0,4,2.5,2750,4800,2.0,0.0,0.0,3,9,1960,790,1905,2005,98103,47.6709,-122.337,2400,5300,6,13,2014,Y,350,-500
3530500010,9/30/2014,176000.0,2,1.0,920,2332,1.0,0.0,0.0,4,8,920,0,1980,0,98198,47.3779,-122.32,1310,2853,9,30,2014,UNK,-390,-521
7387500185,5/21/2014,249900.0,2,1.0,1140,5500,1.0,0.0,0.0,3,6,1140,0,1947,0,98106,47.5187,-122.363,1110,5500,5,21,2014,UNK,30,0
1626079132,6/5/2014,499500.0,3,2.5,2520,53143,1.5,0.0,0.0,3,7,2520,0,1988,0,98019,47.743,-121.925,2020,56628,6,5,2014,UNK,500,-3485
8854100130,9/11/2014,600000.0,5,3.5,3150,10542,1.0,0.0,0.0,5,9,1620,1530,1974,0,98011,47.7469,-122.21700000000001,3150,11807,9,11,2014,UNK,0,-1265
2123049142,8/14/2014,294000.0,4,2.5,2040,7800,2.0,0.0,0.0,3,7,2040,0,2003,0,98168,47.473,-122.29299999999999,1860,10954,8,14,2014,UNK,180,-3154
3423059109,4/15/2015,272000.0,4,2.0,1780,19843,1.0,0.0,0.0,3,7,1780,0,1963,0,98058,47.4414,-122.154,2210,13500,4,15,2015,UNK,-430,6343
5631500992,5/15/2014,390000.0,3,2.5,2240,10800,2.0,0.0,0.0,3,8,2240,0,1996,0,98028,47.7433,-122.229,1900,9900,5,15,2014,UNK,340,900
6641800020,1/9/2015,700000.0,4,2.5,3270,9650,1.0,0.0,3.0,4,9,2320,950,1971,0,98166,47.409,-122.333,2340,17357,1,9,2015,UNK,930,-7707
7853301700,4/20/2015,635000.0,5,2.75,3110,6621,2.0,0.0,0.0,3,9,3110,0,2006,0,98065,47.543,-121.88799999999999,3550,7953,4,20,2015,N,-440,-1332
2158900290,4/16/2015,920000.0,4,1.5,1850,3600,2.0,0.0,0.0,3,8,1660,190,1929,0,98112,47.6376,-122.307,1970,3600,4,16,2015,UNK,-120,0
2273600250,8/4/2014,500000.0,3,1.75,1570,8530,1.0,0.0,0.0,4,7,1190,380,1983,0,98033,47.6881,-122.184,1530,8708,8,4,2014,UNK,40,-178
3298700840,8/21/2014,263500.0,2,1.0,750,4515,1.0,0.0,0.0,3,6,750,0,1942,0,98106,47.5198,-122.351,1020,5000,8,21,2014,UNK,-270,-485
5450500010,3/13/2015,975000.0,4,2.25,2240,9990,2.0,0.0,0.0,4,10,2240,0,1967,0,98040,47.5516,-122.21700000000001,2600,11480,3,13,2015,UNK,-360,-1490
3629870020,11/14/2014,575000.0,3,2.5,1870,3485,2.0,0.0,0.0,3,8,1870,0,2001,0,98029,47.5493,-122.00399999999999,1940,3485,11,14,2014,UNK,-70,0
8856700130,6/12/2014,822000.0,4,2.5,2683,40386,2.0,0.0,0.0,4,9,2683,0,1987,0,98052,47.6982,-122.13799999999999,2683,34800,6,12,2014,UNK,0,5586
6381502155,1/16/2015,300000.0,3,1.0,1490,7200,1.0,0.0,0.0,3,7,1490,0,1954,0,98125,47.7276,-122.307,1280,7200,1,16,2015,UNK,210,0
1443550080,3/30/2015,487600.0,4,2.5,2340,12080,2.0,0.0,0.0,3,8,2340,0,1999,0,98019,47.7325,-121.969,2200,12403,3,30,2015,UNK,140,-323
2205700345,7/7/2014,500000.0,4,2.0,1700,8640,1.0,0.0,0.0,3,7,850,850,1955,2010,98006,47.5774,-122.15299999999999,1620,9000,7,7,2014,Y,80,-360
6926700660,9/11/2014,680000.0,2,2.0,1450,989,3.0,0.0,0.0,3,9,1450,0,2014,0,98109,47.6354,-122.346,1490,1240,9,11,2014,N,-40,-251
3279050130,9/10/2014,419000.0,3,2.5,3310,21096,2.0,0.0,2.0,3,9,3310,0,2004,0,98023,47.3049,-122.38600000000001,3310,13835,9,10,2014,N,0,7261
2770606890,8/7/2014,450000.0,4,1.75,1520,5250,1.0,0.0,0.0,3,6,1520,0,1949,0,98199,47.6581,-122.39,1530,5250,8,7,2014,UNK,-10,0
2867100190,6/18/2014,650000.0,5,1.75,1260,4500,1.5,0.0,0.0,3,7,1260,0,1926,0,98119,47.6452,-122.369,1410,4388,6,18,2014,UNK,-150,112
8562600190,6/23/2014,550000.0,3,1.75,1840,8086,1.0,0.0,0.0,4,8,1840,0,1964,0,98052,47.67,-122.155,1840,8060,6,23,2014,UNK,0,26
5680000545,12/3/2014,330000.0,4,2.0,1750,5202,1.0,0.0,1.0,4,6,1070,680,1942,0,98108,47.5677,-122.31700000000001,2090,5400,12,3,2014,UNK,-340,-198
1922059027,1/23/2015,282510.0,4,1.0,1450,32234,1.5,0.0,0.0,4,6,1450,0,1932,0,98030,47.3818,-122.21,1530,10125,1,23,2015,UNK,-80,22109
1725059316,11/20/2014,2390000.0,4,4.0,6330,13296,2.0,0.0,2.0,3,13,4900,1430,2000,0,98033,47.6488,-122.20100000000001,2200,9196,11,20,2014,UNK,4130,4100
3275300440,11/20/2014,230000.0,2,2.0,1260,10200,1.0,0.0,0.0,3,7,1020,240,1983,0,98003,47.2593,-122.31200000000001,1560,10200,11,20,2014,UNK,-300,0
952001735,10/4/2014,750000.0,4,1.75,2100,6613,2.0,0.0,0.0,3,8,2100,0,1909,2004,98116,47.567,-122.385,1630,5750,10,4,2014,Y,470,863
1402950190,9/16/2014,321000.0,4,2.5,2430,5366,2.0,0.0,0.0,3,8,2430,0,2002,0,98092,47.3352,-122.19,2100,5414,9,16,2014,UNK,330,-48
4045100190,10/27/2014,2200000.0,4,3.25,4250,18000,2.0,0.0,3.0,5,10,3350,900,1980,0,98040,47.5612,-122.229,3790,14537,10,27,2014,UNK,460,3463
1207200010,3/18/2015,245000.0,4,2.0,1830,10416,1.0,0.0,0.0,3,7,1370,460,1958,0,98146,47.4878,-122.34100000000001,1830,9271,3,18,2015,UNK,0,1145
6815100095,12/23/2014,510000.0,2,1.0,1310,4000,1.0,0.0,0.0,3,6,1310,0,1913,0,98103,47.6854,-122.329,1550,4000,12,23,2014,UNK,-240,0
3825310130,6/24/2014,751000.0,4,3.25,3090,9571,2.0,0.0,0.0,3,9,2370,720,2004,0,98052,47.7058,-122.131,3630,9110,6,24,2014,N,-540,461
3276930380,5/23/2014,675000.0,4,2.5,2560,36601,2.0,0.0,0.0,4,9,2560,0,1987,0,98075,47.5851,-121.992,2790,36601,5,23,2014,UNK,-230,0
8937600080,1/26/2015,295000.0,3,1.75,1930,13350,1.0,0.0,0.0,3,8,1930,0,1967,0,98023,47.3317,-122.365,2270,13350,1,26,2015,UNK,-340,0
8024200010,10/28/2014,312000.0,2,1.0,1460,6000,1.0,0.0,0.0,2,7,1260,200,1925,0,98115,47.7009,-122.31700000000001,1580,6380,10,28,2014,UNK,-120,-380
624110020,9/25/2014,730000.0,3,3.0,3460,13129,2.0,0.0,0.0,3,9,2560,900,1988,0,98077,47.7315,-122.05799999999999,3460,12568,9,25,2014,UNK,0,561
6192410280,1/2/2015,762500.0,5,3.5,3290,5880,2.0,0.0,0.0,3,9,2670,620,2005,0,98052,47.7067,-122.119,3090,5680,1,2,2015,N,200,200
4302201045,5/28/2014,150000.0,3,1.0,820,7680,1.5,0.0,0.0,3,6,820,0,1910,0,98106,47.528,-122.359,1470,6912,5,28,2014,UNK,-650,768
507100020,3/9/2015,270000.0,3,1.0,1480,7374,1.0,0.0,0.0,3,6,760,720,1954,0,98133,47.7775,-122.336,1480,8934,3,9,2015,UNK,0,-1560
259600280,4/6/2015,400000.0,4,2.0,1420,9301,1.0,0.0,0.0,4,7,1420,0,1963,0,98008,47.6325,-122.12100000000001,1530,8075,4,6,2015,UNK,-110,1226
7691800130,8/26/2014,650000.0,3,2.5,2790,6720,2.0,0.0,0.0,3,8,2790,0,2002,0,98075,47.5958,-122.038,2620,6720,8,26,2014,UNK,170,0
2056100275,10/6/2014,530000.0,2,1.5,1390,5000,1.0,0.0,0.0,4,8,970,420,1954,0,98116,47.5673,-122.40100000000001,1610,5000,10,6,2014,UNK,-220,0
2202500080,6/30/2014,248000.0,3,1.0,950,9400,1.0,0.0,0.0,4,7,950,0,1954,0,98006,47.5746,-122.13600000000001,1260,9400,6,30,2014,UNK,-310,0
3179102155,1/8/2015,760000.0,4,3.5,3000,5300,1.0,0.0,0.0,5,7,1780,1220,1949,0,98115,47.6748,-122.279,1360,5450,1,8,2015,UNK,1640,-150
937000280,2/20/2015,199000.0,4,1.0,1280,10521,1.5,0.0,0.0,3,7,1280,0,1960,0,98198,47.4215,-122.289,1540,9384,2,20,2015,UNK,-260,1137
5379805253,10/20/2014,240000.0,2,1.0,870,8400,1.0,0.0,0.0,3,7,870,0,1960,0,98188,47.4493,-122.28200000000001,1070,12465,10,20,2014,UNK,-200,-4065
6821102340,5/4/2015,415000.0,3,1.5,1360,1795,2.0,0.0,0.0,3,7,1360,0,1945,0,98199,47.6471,-122.397,1580,1795,5,4,2015,UNK,-220,0
7229900250,12/2/2014,228000.0,3,1.0,1000,16376,1.0,0.0,0.0,3,7,1000,0,1959,0,98059,47.4825,-122.10799999999999,1420,16192,12,2,2014,UNK,-420,184
7287100177,2/25/2015,525000.0,4,2.5,2740,12106,1.0,0.0,0.0,3,8,1980,760,1992,0,98133,47.7648,-122.355,2170,11156,2,25,2015,UNK,570,950
8820900670,6/23/2014,399950.0,3,1.75,1560,5223,1.0,0.0,0.0,4,7,810,750,1940,0,98125,47.7175,-122.288,1440,8491,6,23,2014,UNK,120,-3268
3275850020,4/13/2015,781000.0,4,2.5,2590,8571,2.0,0.0,0.0,3,9,2590,0,1988,0,98052,47.691,-122.105,2360,8155,4,13,2015,UNK,230,416
9528100899,4/28/2015,827000.0,3,2.5,1850,1330,2.5,0.0,0.0,3,9,1560,290,2004,0,98115,47.6831,-122.325,1810,2071,4,28,2015,N,40,-741
7016000440,7/16/2014,525000.0,5,2.25,2500,8621,1.5,0.0,0.0,4,7,2500,0,1968,0,98034,47.7379,-122.185,1980,7395,7,16,2014,UNK,520,1226
7202340010,2/24/2015,671300.0,4,2.5,3280,5232,2.0,0.0,0.0,3,7,3280,0,2004,0,98053,47.6798,-122.03299999999999,2600,5080,2,24,2015,N,680,152
6911700066,6/4/2014,175000.0,2,1.0,670,2378,1.0,0.0,0.0,3,5,670,0,1919,0,98126,47.5769,-122.37200000000001,700,2970,6,4,2014,UNK,-30,-592
7511000050,3/2/2015,1100000.0,5,2.75,2890,22547,1.0,0.0,0.0,4,10,2150,740,1963,0,98040,47.5476,-122.219,3010,17809,3,2,2015,UNK,-120,4738
2925059260,5/6/2015,800000.0,5,2.5,3000,10560,1.0,0.0,0.0,3,8,1500,1500,1966,0,98004,47.6249,-122.206,2690,11616,5,6,2015,UNK,310,-1056
3558000170,7/11/2014,329950.0,4,2.5,1920,4600,2.0,0.0,0.0,3,7,1920,0,2002,0,98038,47.3795,-122.023,2200,6600,7,11,2014,UNK,-280,-2000
8651730290,8/5/2014,445000.0,4,3.25,1960,7200,2.0,0.0,0.0,3,7,1960,0,1979,0,98034,47.7291,-122.21799999999999,1980,7529,8,5,2014,UNK,-20,-329
9197100263,8/19/2014,237000.0,3,1.75,2000,12208,1.0,0.0,0.0,3,7,1140,860,1979,0,98032,47.3752,-122.236,1060,8194,8,19,2014,UNK,940,4014
8941100095,9/23/2014,1110000.0,6,4.0,3600,6224,2.0,0.0,0.0,3,9,2610,990,1945,2006,98199,47.6531,-122.405,1430,6224,9,23,2014,Y,2170,0
2781100080,12/10/2014,438900.0,4,2.5,2740,5700,2.0,0.0,0.0,3,9,2740,0,2006,0,98038,47.3535,-122.02600000000001,3010,5281,12,10,2014,N,-270,419
9822700190,8/8/2014,1280000.0,9,4.5,3650,5000,2.0,0.0,0.0,3,8,2530,1120,1915,2010,98105,47.6604,-122.289,2510,5000,8,8,2014,Y,1140,0
3630030290,10/17/2014,600000.0,4,2.5,2310,3866,2.0,0.0,0.0,3,8,2310,0,2005,0,98029,47.5498,-121.99600000000001,1950,4023,10,17,2014,N,360,-157
9510910250,1/20/2015,670000.0,4,2.5,2095,4569,2.0,0.0,0.0,3,9,2095,0,2002,0,98052,47.6603,-122.087,2095,4385,1,20,2015,UNK,0,184
8682231330,5/4/2015,519000.0,2,2.0,1560,4823,1.0,0.0,0.0,3,8,1560,0,2004,0,98053,47.7111,-122.03200000000001,1855,4989,5,4,2015,N,-295,-166
2473480780,3/11/2015,320000.0,3,2.25,1880,7350,1.0,0.0,0.0,3,8,1390,490,1984,0,98058,47.4457,-122.12299999999999,1910,8400,3,11,2015,UNK,-30,-1050
8641500280,5/22/2014,270000.0,2,1.5,840,867,2.0,0.0,0.0,3,7,840,0,2005,0,98115,47.6955,-122.304,840,1322,5,22,2014,N,0,-455
7605800050,6/2/2014,1000000.0,3,2.5,2730,5832,2.0,0.0,0.0,3,9,2730,0,1998,0,98005,47.6216,-122.161,2360,5832,6,2,2014,UNK,370,0
9828200525,8/15/2014,330000.0,1,1.0,860,4800,1.0,0.0,0.0,3,6,860,0,1907,0,98122,47.6146,-122.29899999999999,1380,4800,8,15,2014,UNK,-520,0
7971300050,7/10/2014,657500.0,3,2.0,2320,10960,1.0,0.0,0.0,3,7,1510,810,1956,0,98005,47.6157,-122.17399999999999,2160,10960,7,10,2014,UNK,160,0
126049169,8/28/2014,450000.0,3,1.75,1540,61419,1.0,0.0,0.0,3,7,1540,0,1967,0,98028,47.7663,-122.228,3790,8529,8,28,2014,UNK,-2250,52890
5062300280,4/16/2015,150000.0,3,1.0,890,6488,1.5,0.0,0.0,3,5,890,0,1928,0,98014,47.7087,-121.352,1330,16250,4,16,2015,UNK,-440,-9762
7167000020,6/16/2014,792500.0,4,2.5,4290,175421,2.0,0.0,0.0,3,10,4290,0,2004,0,98010,47.3585,-121.988,3370,63162,6,16,2014,N,920,112259
3303910010,2/20/2015,540000.0,3,2.5,1950,13227,2.0,0.0,0.0,4,9,1950,0,1978,0,98034,47.7217,-122.256,2650,12943,2,20,2015,UNK,-700,284
2268000050,7/21/2014,229900.0,3,1.0,1010,8848,1.0,0.0,0.0,4,7,1010,0,1968,0,98003,47.2742,-122.29899999999999,1380,10650,7,21,2014,UNK,-370,-1802
8857640170,5/6/2015,533000.0,4,2.5,2830,6536,2.0,0.0,0.0,3,8,2830,0,2003,0,98038,47.3888,-122.03200000000001,2830,6872,5,6,2015,UNK,0,-336
7806210190,12/22/2014,239000.0,4,1.75,1500,12560,1.0,0.0,0.0,4,7,1000,500,1977,0,98002,47.2918,-122.197,1700,9020,12,22,2014,UNK,-200,3540
9206700190,3/6/2015,713900.0,3,2.5,3370,167706,1.0,0.0,0.0,3,10,3370,0,2000,0,98038,47.4379,-122.022,3350,213444,3,6,2015,UNK,20,-45738
4136930190,10/28/2014,427500.0,4,2.5,3160,8726,2.0,0.0,0.0,3,9,3160,0,1999,0,98092,47.2582,-122.223,2500,8648,10,28,2014,UNK,660,78
5666300010,7/22/2014,302000.0,3,1.0,1110,7000,1.5,0.0,0.0,4,7,1110,0,1955,0,98133,47.754,-122.34100000000001,1800,7000,7,22,2014,UNK,-690,0
1424059022,7/8/2014,1150000.0,3,2.5,3830,48743,2.0,0.0,0.0,3,11,3830,0,1991,0,98006,47.5663,-122.125,2950,8299,7,8,2014,UNK,880,40444
6204050080,5/28/2014,555000.0,3,2.5,3160,4270,2.0,0.0,0.0,3,8,2650,510,2006,0,98011,47.7453,-122.194,2720,12523,5,28,2014,N,440,-8253
7128300500,12/30/2014,495000.0,3,2.25,2100,3000,2.0,0.0,0.0,3,7,2100,0,1996,0,98144,47.595,-122.306,1650,4500,12,30,2014,UNK,450,-1500
1233100642,7/22/2014,495000.0,3,1.5,2240,13288,1.0,0.0,0.0,3,7,2240,0,1953,0,98033,47.6762,-122.17,2150,9900,7,22,2014,UNK,90,3388
222029026,9/17/2014,340000.0,2,0.75,1060,48292,1.0,1.0,2.0,5,6,560,500,1947,0,98070,47.4285,-122.51100000000001,750,80201,9,17,2014,UNK,310,-31909
9485940290,5/12/2015,464950.0,4,2.25,2350,36116,1.0,0.0,0.0,4,9,2350,0,1983,0,98042,47.3533,-122.08200000000001,2580,36116,5,12,2015,UNK,-230,0
4136890280,3/27/2015,320000.0,4,2.5,1940,7040,2.0,0.0,0.0,3,8,1940,0,1998,0,98092,47.2632,-122.209,2400,7145,3,27,2015,UNK,-460,-105
1775500050,1/29/2015,440000.0,1,1.0,1160,64469,1.0,0.0,0.0,3,7,1160,0,2009,0,98072,47.7433,-122.08200000000001,1580,48352,1,29,2015,N,-420,16117
7611200086,6/2/2014,686000.0,3,1.5,1840,9990,2.0,0.0,0.0,5,8,1840,0,1961,0,98177,47.7145,-122.369,2100,12474,6,2,2014,UNK,-260,-2484
3376600010,12/1/2014,555000.0,4,1.75,2260,11000,1.0,0.0,0.0,3,8,1620,640,1976,0,98008,47.6224,-122.109,1960,10000,12,1,2014,UNK,300,1000
7519001990,10/27/2014,361500.0,2,1.0,840,3860,1.0,0.0,0.0,4,6,840,0,1909,0,98117,47.6842,-122.365,1390,3860,10,27,2014,UNK,-550,0
7613700950,6/10/2014,1240000.0,5,3.0,2830,7500,2.0,0.0,0.0,3,9,2460,370,1923,0,98105,47.6579,-122.277,2900,5000,6,10,2014,UNK,-70,2500
3802000020,7/9/2014,154950.0,4,1.0,1600,10183,1.0,0.0,0.0,4,6,1600,0,1966,0,98002,47.277,-122.211,1410,10416,7,9,2014,UNK,190,-233
1796360470,6/17/2014,247200.0,3,1.75,1370,8719,1.0,0.0,0.0,3,7,1370,0,1982,0,98042,47.3664,-122.087,1370,7525,6,17,2014,UNK,0,1194
8732160050,8/22/2014,250000.0,3,2.25,1960,7414,1.0,0.0,0.0,3,7,1490,470,1984,0,98023,47.2977,-122.374,1580,8038,8,22,2014,UNK,380,-624
5249800345,6/19/2014,590300.0,3,1.5,1470,7200,2.0,0.0,0.0,4,7,1470,0,1907,0,98118,47.5602,-122.28,1530,7200,6,19,2014,UNK,-60,0
6071200545,5/5/2014,541125.0,5,2.75,2740,8426,1.0,0.0,0.0,4,8,1370,1370,1960,0,98006,47.5563,-122.184,2020,8783,5,5,2014,UNK,720,-357
291300280,2/18/2015,310000.0,2,2.5,1090,923,2.0,0.0,0.0,3,7,1090,0,2004,0,98027,47.5347,-122.071,1410,1326,2,18,2015,N,-320,-403
3261000080,3/10/2015,704111.0,4,2.75,2460,9520,1.0,0.0,1.0,3,8,1680,780,1976,0,98034,47.7021,-122.23299999999999,2380,9600,3,10,2015,UNK,80,-80
321049127,10/28/2014,277500.0,3,2.25,1820,19602,1.0,0.0,0.0,4,7,1820,0,1964,0,98001,47.331,-122.286,1520,8773,10,28,2014,UNK,300,10829
5379804393,2/17/2015,325000.0,4,2.75,1960,8937,1.0,0.0,0.0,5,7,980,980,1954,0,98188,47.451,-122.27799999999999,1480,10016,2,17,2015,UNK,480,-1079
1559900080,11/21/2014,289200.0,3,2.25,1760,7023,2.0,0.0,0.0,3,7,1760,0,1995,0,98019,47.7468,-121.98,1760,7082,11,21,2014,UNK,0,-59
7135300275,9/4/2014,185000.0,1,1.0,720,5000,1.0,0.0,0.0,4,6,720,0,1908,0,98118,47.5289,-122.272,1170,5000,9,4,2014,UNK,-450,0
1377300005,4/1/2015,1450000.0,4,3.5,3470,8580,2.0,0.0,0.0,3,11,2500,970,2007,0,98199,47.6433,-122.40299999999999,1940,7920,4,1,2015,N,1530,660
6668900020,3/18/2015,420550.0,4,2.0,1370,8100,1.0,0.0,0.0,2,7,1370,0,1947,0,98155,47.748999999999995,-122.31200000000001,1280,8100,3,18,2015,UNK,90,0
326049024,4/10/2015,603000.0,4,2.25,2370,11310,1.0,0.0,0.0,3,8,1550,820,1968,0,98155,47.7684,-122.289,1890,8621,4,10,2015,UNK,480,2689
7942600006,11/26/2014,345000.0,3,1.0,1390,2640,1.5,0.0,0.0,3,7,1230,160,1903,0,98122,47.6078,-122.307,1780,3920,11,26,2014,UNK,-390,-1280
6430500233,4/16/2015,650000.0,3,2.0,1840,3075,1.0,0.0,0.0,5,7,920,920,1928,0,98103,47.6894,-122.35,1480,3774,4,16,2015,UNK,360,-699
7701800050,6/25/2014,589950.0,5,3.0,2790,19439,1.0,0.0,3.0,5,7,1500,1290,1973,0,98058,47.4088,-122.089,1620,19439,6,25,2014,UNK,1170,0
8165501640,8/19/2014,309950.0,2,2.25,1460,1607,2.0,0.0,0.0,3,8,1460,0,2007,0,98106,47.5395,-122.369,1460,1826,8,19,2014,N,0,-219
2623069069,9/11/2014,775000.0,3,2.5,2620,241200,1.5,0.0,0.0,4,9,2620,0,1998,0,98027,47.4574,-122.01,2620,172933,9,11,2014,UNK,0,68267
8024201870,10/29/2014,590000.0,4,1.5,2230,5109,1.5,0.0,0.0,3,7,1330,900,1918,0,98115,47.6996,-122.31,1630,5109,10,29,2014,UNK,600,0
9126101511,4/28/2015,863500.0,4,3.0,3250,2760,2.5,0.0,0.0,3,8,2420,830,1905,2007,98122,47.6104,-122.303,1260,2780,4,28,2015,Y,1990,-20
1377800010,11/19/2014,517500.0,3,1.0,1190,7000,1.0,0.0,0.0,3,7,1190,0,1943,0,98199,47.6453,-122.40299999999999,1350,7000,11,19,2014,UNK,-160,0
6813600380,12/24/2014,700000.0,3,3.0,2090,7440,1.5,0.0,0.0,5,7,1290,800,1922,0,98103,47.6891,-122.331,1570,4960,12,24,2014,UNK,520,2480
923000280,7/22/2014,699000.0,3,2.5,2580,8154,1.0,0.0,0.0,3,10,2090,490,1956,1997,98177,47.7259,-122.361,1660,8155,7,22,2014,Y,920,-1
255550190,7/22/2014,350000.0,3,2.5,2100,3574,2.0,0.0,0.0,3,7,1690,410,2005,0,98019,47.7453,-121.984,1970,2962,7,22,2014,N,130,612
1829300130,7/17/2014,795000.0,4,2.5,3160,16564,2.0,0.0,0.0,3,10,3160,0,1987,0,98074,47.6365,-122.04,3160,12415,7,17,2014,UNK,0,4149
3645500050,5/14/2014,543000.0,3,2.5,2090,7640,1.0,0.0,0.0,3,7,1360,730,1962,2014,98133,47.7369,-122.338,2090,7668,5,14,2014,Y,0,-28
1518000080,2/23/2015,325000.0,3,2.5,1570,3143,2.0,0.0,0.0,3,7,1570,0,2001,0,98019,47.7364,-121.969,1740,3591,2,23,2015,UNK,-170,-448
7883605915,5/8/2015,337500.0,3,1.0,1020,6000,1.5,0.0,0.0,3,7,1020,0,1900,0,98108,47.5254,-122.318,1240,6000,5,8,2015,UNK,-220,0
1112700170,2/27/2015,425000.0,2,1.0,1300,11080,1.0,0.0,0.0,4,7,1300,0,1955,0,98034,47.7281,-122.23299999999999,1600,9259,2,27,2015,UNK,-300,1821
8965500020,3/17/2015,780000.0,3,2.5,2110,9773,1.0,0.0,0.0,3,9,2110,0,1986,0,98006,47.5628,-122.115,2560,11787,3,17,2015,UNK,-450,-2014
323059167,7/23/2014,259000.0,2,1.0,1210,17389,1.0,0.0,0.0,4,5,1210,0,1948,0,98059,47.5044,-122.148,2140,14419,7,23,2014,UNK,-930,2970
1951700480,8/13/2014,524400.0,4,1.75,1990,12950,1.0,0.0,0.0,4,8,1850,140,1968,0,98006,47.5434,-122.166,2090,12850,8,13,2014,UNK,-100,100
2005950050,5/27/2014,260000.0,3,2.0,1630,8018,1.0,0.0,0.0,3,7,1630,0,2003,0,98001,47.2638,-122.243,1610,8397,5,27,2014,UNK,20,-379
9406500480,4/20/2015,273000.0,2,2.0,1384,1822,2.0,0.0,0.0,3,7,1384,0,1990,0,98028,47.7525,-122.244,1078,1315,4,20,2015,UNK,306,507
3522049063,4/2/2015,639900.0,4,2.5,3380,75794,2.0,0.0,0.0,3,10,3380,0,1997,0,98001,47.3511,-122.266,3710,17913,4,2,2015,UNK,-330,57881
2085700050,8/26/2014,420000.0,4,2.5,2480,8626,2.0,0.0,0.0,3,10,2480,0,2001,0,98001,47.3185,-122.262,2990,9033,8,26,2014,UNK,-510,-407
6751300130,8/13/2014,510500.0,3,1.0,1270,8000,1.0,0.0,0.0,4,7,1270,0,1957,0,98007,47.5874,-122.13600000000001,1470,8000,8,13,2014,UNK,-200,0
2610100020,4/8/2015,290000.0,4,1.0,1010,7200,1.5,0.0,0.0,3,6,1010,0,1947,0,98155,47.742,-122.325,1360,7200,4,8,2015,UNK,-350,0
9476200680,4/28/2015,226000.0,3,1.75,1490,6269,1.0,0.0,0.0,4,6,990,500,1944,0,98056,47.4917,-122.18799999999999,1490,7722,4,28,2015,UNK,0,-1453
6145600285,5/29/2014,300000.0,2,1.0,820,3844,1.0,0.0,0.0,4,6,820,0,1916,0,98133,47.7049,-122.34899999999999,1520,3844,5,29,2014,UNK,-700,0
203900460,7/28/2014,407450.0,3,2.0,1810,10860,1.0,0.0,0.0,3,7,1810,0,1967,0,98053,47.6393,-121.96700000000001,1420,11982,7,28,2014,UNK,390,-1122
7878400022,5/6/2015,390000.0,4,2.25,3060,7920,1.0,0.0,0.0,3,7,1530,1530,1965,0,98178,47.4879,-122.245,1850,7800,5,6,2015,UNK,1210,120
3585900460,5/1/2015,1060000.0,6,2.75,2980,20000,1.0,0.0,4.0,3,8,2130,850,1965,0,98177,47.7599,-122.375,2730,20000,5,1,2015,UNK,250,0
1321720170,8/17/2014,610000.0,3,2.5,3440,18167,2.0,0.0,0.0,3,11,3440,0,1991,0,98023,47.2909,-122.34200000000001,3990,20239,8,17,2014,UNK,-550,-2072
236400130,1/23/2015,239975.0,3,2.5,1820,7242,1.0,0.0,0.0,3,7,1220,600,1959,0,98188,47.4318,-122.292,1350,8214,1,23,2015,UNK,470,-972
4141680190,8/7/2014,375000.0,3,2.5,2320,5760,1.0,0.0,0.0,3,7,1480,840,1987,0,98178,47.504,-122.24799999999999,1660,5762,8,7,2014,UNK,660,-2
3629980440,4/28/2015,742500.0,4,2.5,2620,4400,2.0,0.0,0.0,3,9,2620,0,2004,0,98029,47.5524,-121.991,2640,4554,4,28,2015,N,-20,-154
1223039173,4/29/2015,450000.0,4,1.75,2190,11625,1.0,0.0,0.0,4,8,2020,170,1956,0,98146,47.4979,-122.363,1920,8855,4,29,2015,UNK,270,2770
2473000130,6/26/2014,300000.0,3,2.25,1780,10395,1.0,0.0,0.0,3,8,1780,0,1967,0,98058,47.4539,-122.15,2080,9360,6,26,2014,UNK,-300,1035
2893000280,5/1/2015,216600.0,3,1.75,2200,7700,1.0,0.0,0.0,3,7,1240,960,1975,0,98031,47.4119,-122.181,1770,7360,5,1,2015,UNK,430,340
7977201845,5/14/2014,525000.0,3,1.75,1600,6120,1.5,0.0,0.0,3,7,1600,0,1924,0,98115,47.6847,-122.291,1670,4590,5,14,2014,UNK,-70,1530
4197400005,6/20/2014,455000.0,4,2.25,2450,21000,1.0,0.0,2.0,4,8,1650,800,1954,0,98166,47.4559,-122.344,1820,12480,6,20,2014,UNK,630,8520
5561200980,10/3/2014,390000.0,4,2.25,2680,35218,2.0,0.0,0.0,3,8,2680,0,1986,0,98027,47.4613,-121.99700000000001,2980,35218,10,3,2014,UNK,-300,0
3039000020,9/16/2014,450000.0,3,1.75,1850,8667,1.0,0.0,0.0,4,7,880,970,1982,0,98033,47.7025,-122.198,1450,10530,9,16,2014,UNK,400,-1863
6840701100,12/2/2014,382000.0,4,1.0,1740,4400,1.5,0.0,0.0,3,7,1740,0,1924,0,98122,47.6058,-122.3,1590,4400,12,2,2014,UNK,150,0
2130410050,5/13/2014,287000.0,3,2.25,1490,9600,1.0,0.0,0.0,4,7,1170,320,1987,0,98019,47.7378,-121.977,1590,10104,5,13,2014,UNK,-100,-504
1924079091,1/13/2015,460000.0,4,2.0,1960,190357,1.0,0.0,3.0,2,8,1960,0,1971,0,98027,47.5538,-121.958,2560,189100,1,13,2015,UNK,-600,1257
3570300080,10/28/2014,435000.0,3,2.25,1380,3015,2.0,0.0,0.0,3,7,1380,0,2009,0,98052,47.6783,-122.15700000000001,1930,3612,10,28,2014,N,-550,-597
2321300351,6/12/2014,575000.0,2,1.0,1510,4032,1.5,0.0,0.0,3,8,1310,200,1935,0,98199,47.6371,-122.39299999999999,1700,4042,6,12,2014,UNK,-190,-10
2652501630,5/4/2015,626700.0,3,1.5,1410,3600,1.0,0.0,0.0,3,7,1410,0,1906,0,98109,47.6402,-122.35700000000001,1370,3600,5,4,2015,UNK,40,0
3810000020,3/18/2015,352000.0,4,1.5,1440,8680,1.5,0.0,0.0,3,7,1440,0,1922,0,98178,47.501999999999995,-122.228,1440,9000,3,18,2015,UNK,0,-320
8084400010,3/16/2015,650000.0,3,1.0,920,6750,1.0,0.0,0.0,4,7,920,0,1951,0,98004,47.6322,-122.212,1460,8933,3,16,2015,UNK,-540,-2183
304000380,10/6/2014,197000.0,3,1.0,1090,17630,1.0,0.0,0.0,4,7,1090,0,1962,0,98002,47.288000000000004,-122.196,1300,12000,10,6,2014,UNK,-210,5630
1873400020,7/3/2014,340000.0,8,2.75,2790,6695,1.0,0.0,0.0,3,7,1470,1320,1977,0,98133,47.7565,-122.331,1760,7624,7,3,2014,UNK,1030,-929
4359700080,7/21/2014,560000.0,3,2.0,1840,14985,1.0,0.0,0.0,3,7,1840,0,1968,0,98033,47.6916,-122.15799999999999,2300,16067,7,21,2014,UNK,-460,-1082
1727500010,1/7/2015,354000.0,3,1.75,1340,6300,1.0,0.0,0.0,3,7,1340,0,1972,0,98034,47.7186,-122.21799999999999,1780,7200,1,7,2015,UNK,-440,-900
8651610680,8/1/2014,670000.0,4,2.5,2570,9086,2.0,0.0,0.0,3,9,2570,0,1999,0,98074,47.6373,-122.064,2760,6733,8,1,2014,UNK,-190,2353
3629970190,1/26/2015,769000.0,4,3.5,3010,6202,2.0,0.0,0.0,3,9,3010,0,2005,0,98029,47.5533,-121.993,2520,5001,1,26,2015,N,490,1201
9136102057,9/5/2014,650000.0,4,2.5,2160,3139,1.0,0.0,0.0,3,7,1080,1080,1940,0,98103,47.6662,-122.338,1650,3740,9,5,2014,UNK,510,-601
1266200130,6/15/2014,650000.0,3,1.75,2140,9484,1.0,0.0,0.0,3,7,1290,850,1953,0,98004,47.6234,-122.191,1960,9630,6,15,2014,UNK,180,-146
2787310130,12/12/2014,289950.0,4,1.75,2090,7416,1.0,0.0,0.0,4,7,1050,1040,1970,0,98031,47.4107,-122.179,1710,7527,12,12,2014,UNK,380,-111
8645511350,12/1/2014,300000.0,3,1.75,1810,21138,1.0,0.0,0.0,4,7,1240,570,1977,0,98058,47.4674,-122.178,1850,12200,12,1,2014,UNK,-40,8938
9284801435,12/3/2014,471000.0,4,1.75,1760,5750,1.0,0.0,2.0,5,7,1070,690,1962,0,98126,47.5521,-122.37299999999999,1860,5750,12,3,2014,UNK,-100,0
3905010010,7/18/2014,639000.0,4,2.5,2500,8540,2.0,0.0,0.0,3,9,2500,0,1990,0,98029,47.5759,-121.994,2560,8475,7,18,2014,UNK,-60,65
4058801310,10/9/2014,287000.0,2,1.0,930,6900,1.0,0.0,2.0,3,7,930,0,1952,0,98178,47.506,-122.242,1910,7194,10,9,2014,UNK,-980,-294
6705850020,4/1/2015,740000.0,4,2.5,3030,8335,2.0,0.0,0.0,3,10,3030,0,1992,0,98075,47.578,-122.056,2850,8678,4,1,2015,UNK,180,-343
1623800440,4/17/2015,499922.0,3,2.0,1460,3000,1.0,0.0,0.0,4,7,940,520,1990,0,98117,47.681999999999995,-122.365,1460,3000,4,17,2015,UNK,0,0
3904902500,12/19/2014,675000.0,4,2.5,2940,14071,2.0,0.0,0.0,3,9,2940,0,1986,0,98029,47.5627,-122.01799999999999,2670,10982,12,19,2014,UNK,270,3089
7308600050,9/9/2014,738515.0,5,2.75,3360,9200,2.0,0.0,0.0,3,9,3360,0,2014,0,98011,47.7754,-122.17299999999999,3360,9713,9,9,2014,N,0,-513
5679501310,10/30/2014,445000.0,3,1.75,2110,4800,1.0,0.0,0.0,3,8,1210,900,1956,0,98108,47.567,-122.318,1660,4800,10,30,2014,UNK,450,0
3935900005,5/1/2015,1040000.0,4,2.25,2740,11343,1.0,0.0,2.0,5,10,1980,760,1953,0,98125,47.7117,-122.27799999999999,2790,10027,5,1,2015,UNK,-50,1316
3726800285,10/1/2014,346000.0,2,1.0,1070,2196,1.0,0.0,0.0,4,7,880,190,1917,0,98144,47.5726,-122.30799999999999,1160,3600,10,1,2014,UNK,-90,-1404
1183000005,4/8/2015,450000.0,3,2.0,1680,4886,2.0,0.0,0.0,3,7,1180,500,1940,0,98118,47.5536,-122.286,1400,4900,4,8,2015,UNK,280,-14
5469502780,8/12/2014,350000.0,4,2.5,2260,13755,1.0,0.0,0.0,4,9,2260,0,1975,0,98042,47.3767,-122.161,2650,13650,8,12,2014,UNK,-390,105
9185700440,7/28/2014,2400000.0,4,3.5,5860,7200,2.0,0.0,0.0,5,10,3690,2170,1907,0,98112,47.6287,-122.287,4150,7200,7,28,2014,UNK,1710,0
629600130,8/1/2014,594950.0,4,2.25,2380,35008,1.0,0.0,0.0,3,8,2380,0,1977,0,98075,47.5834,-122.001,2250,34794,8,1,2014,UNK,130,214
9178601660,5/14/2015,1700000.0,5,3.0,3320,5354,2.0,0.0,0.0,3,9,3320,0,2004,0,98103,47.6542,-122.331,2330,4040,5,14,2015,N,990,1314
2191600780,10/10/2014,219000.0,2,1.0,1050,9000,1.5,0.0,0.0,4,7,1050,0,1984,0,98003,47.2887,-122.29899999999999,1550,9600,10,10,2014,UNK,-500,-600
7852180430,4/9/2015,450000.0,4,2.5,2070,3982,2.0,0.0,0.0,3,7,2070,0,2004,0,98065,47.53100000000001,-121.854,2340,4067,4,9,2015,N,-270,-85
8155820080,4/15/2015,402000.0,4,2.25,1790,7311,2.0,0.0,0.0,3,7,1790,0,1992,0,98056,47.5055,-122.189,1400,7203,4,15,2015,UNK,390,108
5248800440,2/17/2015,275000.0,2,1.0,840,4000,1.0,0.0,0.0,3,6,840,0,1942,0,98108,47.5531,-122.307,1100,4000,2,17,2015,UNK,-260,0
9818700430,10/1/2014,421500.0,3,1.5,990,4500,1.0,0.0,0.0,5,7,990,0,1948,0,98122,47.6051,-122.29799999999999,1490,4000,10,1,2014,UNK,-500,500
425079099,5/7/2014,560000.0,3,3.0,4120,60392,2.0,0.0,2.0,3,9,3180,940,1994,0,98014,47.6804,-121.913,2770,64033,5,7,2014,UNK,1350,-3641
5127000670,3/18/2015,314000.0,3,1.75,1620,9600,1.0,0.0,0.0,4,7,1620,0,1966,0,98059,47.4749,-122.155,1660,10200,3,18,2015,UNK,-40,-600
6341000221,4/23/2015,287000.0,4,2.0,1340,8190,1.0,0.0,0.0,4,7,1340,0,1942,0,98146,47.4905,-122.34299999999999,1410,9721,4,23,2015,UNK,-70,-1531
7231501665,4/3/2015,277000.0,4,1.0,1500,5750,1.5,0.0,0.0,3,6,1500,0,1925,0,98055,47.4768,-122.206,1330,5750,4,3,2015,UNK,170,0
5014000225,12/22/2014,337500.0,2,1.0,1300,6731,1.0,0.0,0.0,3,7,1300,0,1950,0,98116,47.5697,-122.395,1240,6731,12,22,2014,UNK,60,0
4401200130,8/19/2014,792000.0,4,2.75,3100,10245,2.0,0.0,0.0,3,10,3100,0,1999,0,98052,47.6858,-122.10700000000001,3140,9028,8,19,2014,UNK,-40,1217
1558500050,11/13/2014,435000.0,3,2.5,3380,7074,2.0,0.0,0.0,3,8,2200,1180,1999,0,98019,47.7462,-121.978,2060,6548,11,13,2014,UNK,1320,526
8899000050,3/25/2015,313100.0,4,2.5,2660,9030,1.0,0.0,0.0,4,7,1450,1210,1977,0,98055,47.4558,-122.212,1870,9030,3,25,2015,UNK,790,0
2877102846,6/25/2014,575000.0,3,2.25,1700,3333,1.5,0.0,0.0,3,7,1100,600,1924,0,98117,47.6784,-122.361,1700,3750,6,25,2014,UNK,0,-417
7280300080,2/2/2015,510000.0,4,2.5,1840,7800,1.0,0.0,2.0,3,8,1240,600,1972,0,98177,47.7762,-122.384,2010,9100,2,2,2015,UNK,-170,-1300
3624039073,3/19/2015,299950.0,2,1.0,890,5200,1.0,0.0,0.0,4,6,890,0,1941,0,98126,47.5311,-122.37299999999999,950,5200,3,19,2015,UNK,-60,0
3271300345,3/23/2015,1030000.0,3,3.0,2800,5800,1.0,0.0,0.0,3,9,1580,1220,1953,2010,98199,47.6493,-122.413,2580,5800,3,23,2015,Y,220,0
6190701483,5/14/2014,364000.0,4,1.75,2010,8625,1.0,0.0,0.0,4,7,1340,670,1957,0,98133,47.7496,-122.355,1500,8400,5,14,2014,UNK,510,225
414100630,7/29/2014,335000.0,3,1.0,1380,7470,1.0,0.0,0.0,5,7,1380,0,1965,0,98133,47.7479,-122.34299999999999,1440,7473,7,29,2014,UNK,-60,-3
7686202275,12/9/2014,219950.0,3,1.0,1210,8000,1.0,0.0,0.0,3,6,1210,0,1954,0,98198,47.4211,-122.314,1430,8000,12,9,2014,UNK,-220,0
5113260170,1/13/2015,215000.0,3,2.0,1280,6994,1.0,0.0,0.0,3,7,1280,0,1991,0,98038,47.3889,-122.04799999999999,1290,7514,1,13,2015,UNK,-10,-520
2421059090,5/11/2015,640000.0,4,2.5,4090,215186,2.0,0.0,0.0,4,8,3670,420,1979,0,98092,47.2964,-122.116,2430,142005,5,11,2015,UNK,1660,73181
2770601734,6/30/2014,535000.0,3,1.0,1580,6300,1.0,0.0,0.0,3,7,1180,400,1925,0,98199,47.6505,-122.384,1560,1601,6,30,2014,UNK,20,4699
4222310290,8/19/2014,253000.0,4,2.0,1910,7826,1.0,0.0,0.0,4,7,1140,770,1973,0,98003,47.3493,-122.306,1540,7826,8,19,2014,UNK,370,0
5016001060,5/30/2014,650000.0,2,2.5,1740,2500,2.0,0.0,2.0,3,8,1210,530,1994,0,98112,47.622,-122.3,1640,2500,5,30,2014,UNK,100,0
5445300050,4/8/2015,672000.0,3,2.25,1130,4445,1.5,0.0,0.0,4,8,1130,0,1930,0,98117,47.6845,-122.375,1330,4445,4,8,2015,UNK,-200,0
7370600020,10/7/2014,606000.0,3,1.75,1970,8540,1.0,0.0,3.0,4,8,1130,840,1950,0,98177,47.7213,-122.365,2280,8540,10,7,2014,UNK,-310,0
5127000470,3/5/2015,292000.0,3,2.25,1780,9720,1.0,0.0,0.0,3,8,1280,500,1981,0,98059,47.4762,-122.156,1710,9790,3,5,2015,UNK,70,-70
1330250010,6/4/2014,289950.0,3,2.0,1670,7757,1.0,0.0,0.0,3,8,1670,0,1992,0,98030,47.3802,-122.20700000000001,2290,7859,6,4,2014,UNK,-620,-102
1898600050,7/22/2014,257500.0,4,1.5,1360,9323,1.0,0.0,0.0,4,7,1360,0,1968,0,98023,47.3168,-122.40100000000001,1180,9611,7,22,2014,UNK,180,-288
9561100010,11/4/2014,380000.0,3,2.5,1840,6985,1.0,0.0,0.0,3,7,1290,550,1971,0,98133,47.7586,-122.34200000000001,2160,7990,11,4,2014,UNK,-320,-1005
9524100050,12/22/2014,360000.0,3,1.75,1255,1113,3.0,0.0,0.0,3,8,1255,0,2010,0,98103,47.6958,-122.34299999999999,1010,1038,12,22,2014,N,245,75
2212200500,6/23/2014,269500.0,3,1.75,1840,7412,1.0,0.0,0.0,4,7,1240,600,1976,0,98031,47.3933,-122.18799999999999,1980,7350,6,23,2014,UNK,-140,62
5416500680,6/30/2014,449000.0,4,2.5,2960,6031,2.0,0.0,0.0,3,9,2960,0,2005,0,98038,47.3596,-122.04,2570,5012,6,30,2014,N,390,1019
6412600005,10/3/2014,375000.0,4,1.5,1430,7232,1.5,0.0,0.0,3,7,1430,0,1948,0,98125,47.7197,-122.32799999999999,1540,7232,10,3,2014,UNK,-110,0
2024069008,6/19/2014,2200000.0,5,4.75,5990,10450,2.0,1.0,4.0,3,11,4050,1940,2002,0,98027,47.5554,-122.07700000000001,3330,14810,6,19,2014,UNK,2660,-4360
2195700050,5/19/2014,810000.0,4,2.5,3480,59242,2.0,0.0,0.0,3,11,3480,0,1988,0,98072,47.7391,-122.102,2930,39400,5,19,2014,UNK,550,19842
1437580480,9/18/2014,994000.0,5,3.25,4260,7861,2.0,0.0,0.0,3,10,4260,0,2005,0,98074,47.611000000000004,-121.992,4020,7528,9,18,2014,N,240,333
2796100680,2/25/2015,275000.0,5,2.25,1820,10500,1.0,0.0,0.0,4,7,1080,740,1979,0,98031,47.4058,-122.177,1820,7500,2,25,2015,UNK,0,3000
7203102140,4/29/2015,300000.0,2,1.0,1290,2482,2.0,0.0,0.0,3,7,1290,0,2008,0,98053,47.6972,-122.025,1290,2482,4,29,2015,N,0,0
40000235,4/14/2015,380000.0,5,2.5,2130,8428,2.0,0.0,0.0,3,7,2130,0,2013,0,98168,47.4726,-122.28200000000001,1500,11810,4,14,2015,N,630,-3382
2946000285,3/2/2015,200000.0,3,2.0,1170,10051,1.0,0.0,0.0,4,7,1170,0,1957,0,98198,47.4229,-122.324,1440,9800,3,2,2015,UNK,-270,251
6848200221,9/2/2014,635000.0,3,3.5,1730,1349,3.0,0.0,0.0,3,9,1350,380,2009,0,98102,47.6224,-122.32600000000001,1830,3300,9,2,2014,N,-100,-1951
952004725,11/6/2014,280000.0,2,1.0,880,5750,1.0,0.0,0.0,3,6,880,0,1939,0,98126,47.5642,-122.37899999999999,1190,5750,11,6,2014,UNK,-310,0
7852110050,6/25/2014,574000.0,3,2.5,2380,6832,2.0,0.0,0.0,3,8,2380,0,2002,0,98065,47.5372,-121.876,2580,6832,6,25,2014,UNK,-200,0
5536100010,2/4/2015,1050000.0,4,1.0,1330,9729,1.0,0.0,0.0,3,6,1330,0,1952,0,98004,47.6223,-122.208,2920,10353,2,4,2015,UNK,-1590,-624
5703000050,5/8/2014,545000.0,3,2.25,1780,191228,2.0,0.0,2.0,3,8,1780,0,1988,0,98045,47.4575,-121.74799999999999,2440,87120,5,8,2014,UNK,-660,104108
6071800480,3/27/2015,271950.0,3,1.5,1220,8400,1.0,0.0,0.0,4,7,1220,0,1962,0,98006,47.5467,-122.17299999999999,2110,9119,3,27,2015,UNK,-890,-719
1954600050,7/16/2014,630000.0,5,1.75,2490,24969,1.0,0.0,2.0,4,8,1540,950,1959,0,98023,47.33600000000001,-122.35,2790,15600,7,16,2014,UNK,-300,9369
3819800280,8/19/2014,400000.0,2,1.0,1180,10800,1.0,0.0,0.0,3,7,1180,0,1984,0,98011,47.7273,-122.236,1600,10800,8,19,2014,UNK,-420,0
7300400170,9/10/2014,334000.0,4,2.5,2310,6200,2.0,0.0,0.0,3,8,2310,0,1998,0,98092,47.3321,-122.17200000000001,2480,6200,9,10,2014,UNK,-170,0
9834201100,12/22/2014,332500.0,4,2.0,1440,4855,2.0,0.0,0.0,4,7,1440,0,1972,0,98144,47.5717,-122.287,1300,4080,12,22,2014,UNK,140,775
8850000509,9/23/2014,525000.0,2,1.5,1620,1444,2.0,0.0,0.0,3,9,1080,540,2007,0,98144,47.5892,-122.309,1660,1642,9,23,2014,N,-40,-198
4123840470,2/24/2015,408000.0,3,2.5,2620,8403,2.0,0.0,0.0,3,8,2620,0,1991,0,98038,47.3675,-122.042,2190,7842,2,24,2015,UNK,430,561
1150900080,4/27/2015,846450.0,4,2.5,3710,7491,2.0,0.0,0.0,3,9,3710,0,2003,0,98029,47.5596,-122.016,3040,7491,4,27,2015,UNK,670,0
514500235,10/20/2014,411100.0,3,1.5,1040,10323,1.0,0.0,0.0,4,7,1040,0,1958,0,98005,47.5882,-122.155,1580,7200,10,20,2014,UNK,-540,3123
1522059120,7/9/2014,409124.0,5,3.25,3320,11340,2.0,0.0,0.0,4,8,2480,840,1999,0,98042,47.3904,-122.154,2330,8339,7,9,2014,UNK,990,3001
2895600680,7/7/2014,335950.0,2,1.5,800,5192,1.0,0.0,0.0,5,7,800,0,1951,0,98146,47.5119,-122.38600000000001,1190,5320,7,7,2014,UNK,-390,-128
8087800480,3/31/2015,480000.0,5,2.5,2040,9597,1.0,0.0,0.0,4,7,1240,800,1963,0,98052,47.6544,-122.134,1800,8553,3,31,2015,UNK,240,1044
7931000066,12/24/2014,280000.0,2,1.75,1960,30144,1.0,0.0,0.0,3,7,980,980,1957,0,98031,47.4234,-122.212,1960,10140,12,24,2014,UNK,0,20004
5406500480,7/21/2014,668000.0,4,2.5,2670,4410,2.0,0.0,0.0,3,8,2670,0,1999,0,98075,47.5978,-122.038,2670,4410,7,21,2014,UNK,0,0
2540820010,4/27/2015,750000.0,4,2.5,2930,8641,2.0,0.0,0.0,3,8,2930,0,2010,0,98034,47.7199,-122.24600000000001,2120,11175,4,27,2015,N,810,-2534
3300700470,5/14/2014,394475.0,2,1.0,830,4000,1.0,0.0,0.0,3,6,830,0,1955,0,98117,47.6929,-122.37899999999999,950,4000,5,14,2014,UNK,-120,0
8823902005,3/26/2015,848000.0,5,1.75,2290,4320,2.0,0.0,0.0,3,7,1980,310,1928,0,98105,47.663999999999994,-122.31,2870,4320,3,26,2015,UNK,-580,0
6003001760,9/24/2014,675000.0,3,1.5,2510,3600,2.5,0.0,0.0,4,8,2510,0,1907,0,98112,47.6195,-122.31299999999999,1740,1885,9,24,2014,UNK,770,1715
1432400095,11/6/2014,175000.0,3,1.0,1280,7572,1.0,0.0,0.0,4,6,1280,0,1958,0,98058,47.4491,-122.176,1170,7667,11,6,2014,UNK,110,-95
2483700095,11/6/2014,560000.0,4,1.5,1810,6000,1.0,0.0,1.0,3,8,1350,460,1952,0,98136,47.5233,-122.38600000000001,2020,6000,11,6,2014,UNK,-210,0
6600220380,5/31/2014,538888.0,5,2.75,2080,13189,2.0,0.0,0.0,3,8,2080,0,1987,0,98074,47.6288,-122.031,2030,11847,5,31,2014,UNK,50,1342
3990200020,9/8/2014,359000.0,4,1.75,1680,9244,2.0,0.0,0.0,3,8,1680,0,1991,0,98166,47.4612,-122.352,1840,9387,9,8,2014,UNK,-160,-143
112900020,7/1/2014,300000.0,3,2.25,1660,5128,2.0,0.0,0.0,3,7,1660,0,2001,0,98019,47.7362,-121.96700000000001,1680,4652,7,1,2014,UNK,-20,476
8700110020,9/17/2014,273000.0,3,2.5,1650,5994,2.0,0.0,0.0,4,7,1650,0,1989,0,98030,47.3603,-122.19,1930,6666,9,17,2014,UNK,-280,-672
9831200221,7/10/2014,670000.0,3,2.5,1420,1438,2.0,0.0,0.0,3,9,1280,140,2003,0,98102,47.6265,-122.323,1490,1439,7,10,2014,UNK,-70,-1
8078400010,11/18/2014,530000.0,4,2.25,2240,8376,1.0,0.0,0.0,3,8,1740,500,1984,0,98074,47.6323,-122.029,1890,7875,11,18,2014,UNK,350,501
9550200225,7/11/2014,625000.0,3,1.5,1230,3060,1.0,0.0,0.0,3,7,910,320,1927,0,98103,47.667,-122.333,1260,4488,7,11,2014,UNK,-30,-1428
2946001950,5/5/2015,248000.0,3,1.0,1260,6000,1.0,0.0,0.0,4,6,1260,0,1954,0,98198,47.4187,-122.323,1520,6600,5,5,2015,UNK,-260,-600
3905050280,8/19/2014,533000.0,3,2.5,2060,4812,2.0,0.0,0.0,3,8,2060,0,1990,0,98029,47.5793,-122.00200000000001,1930,5264,8,19,2014,UNK,130,-452
3026059341,12/11/2014,549950.0,4,3.5,3090,10510,1.0,0.0,0.0,3,8,2190,900,1991,0,98034,47.7176,-122.214,2200,7408,12,11,2014,UNK,890,3102
7292700005,10/14/2014,485000.0,4,1.75,3220,7392,1.0,0.0,0.0,4,8,2010,1210,1959,0,98177,47.7719,-122.361,1660,8363,10,14,2014,UNK,1560,-971
8856970440,5/6/2015,353500.0,3,2.5,2020,4845,2.0,0.0,0.0,3,7,2020,0,2001,0,98038,47.3848,-122.03299999999999,1930,5134,5,6,2015,UNK,90,-289
7504001440,9/15/2014,435000.0,2,1.75,1910,12142,1.0,0.0,0.0,3,9,1910,0,1976,0,98074,47.6276,-122.053,2580,12326,9,15,2014,UNK,-670,-184
8068000305,11/4/2014,241000.0,3,1.0,1150,10000,1.0,0.0,0.0,3,6,1000,150,1951,0,98178,47.5075,-122.262,1340,10000,11,4,2014,UNK,-190,0
1681400010,5/19/2014,885000.0,4,2.75,2730,3560,1.5,0.0,0.0,3,8,1550,1180,1921,0,98115,47.6737,-122.304,1860,3560,5,19,2014,UNK,870,0
6850700670,5/13/2014,799200.0,6,3.0,2890,2370,2.5,0.0,0.0,3,7,2290,600,1906,0,98102,47.6227,-122.323,2180,2460,5,13,2014,UNK,710,-90
1546600020,1/14/2015,760000.0,3,2.5,2280,12746,1.0,0.0,0.0,4,8,1490,790,1973,0,98005,47.6362,-122.175,2100,12746,1,14,2015,UNK,180,0
8071000050,11/13/2014,270000.0,2,1.0,1040,5700,1.0,0.0,0.0,3,6,1040,0,1922,0,98118,47.519,-122.26,1380,5700,11,13,2014,UNK,-340,0
1036000280,2/17/2015,675000.0,4,1.75,2440,7475,1.0,0.0,0.0,4,9,2040,400,1969,0,98052,47.6339,-122.096,2040,8480,2,17,2015,UNK,400,-1005
5422560380,12/22/2014,499000.0,3,2.5,1720,5940,1.0,0.0,0.0,4,8,1000,720,1977,0,98052,47.6631,-122.12899999999999,1720,6136,12,22,2014,UNK,0,-196
1762600280,7/14/2014,1200000.0,3,2.5,3430,28718,1.5,0.0,0.0,3,10,3430,0,1984,0,98033,47.6477,-122.18299999999999,3440,35021,7,14,2014,UNK,-10,-6303
5416500840,6/27/2014,320000.0,4,2.5,2570,4865,2.0,0.0,0.0,3,8,2570,0,2005,0,98038,47.3588,-122.038,2570,4933,6,27,2014,N,0,-68
3523069008,5/5/2015,890000.0,4,3.25,4360,210254,1.0,0.0,0.0,3,10,2320,2040,2000,0,98038,47.4375,-122.008,2410,87120,5,5,2015,UNK,1950,123134
8001210170,8/22/2014,275000.0,4,2.75,2060,7350,1.0,0.0,0.0,3,7,1210,850,1978,0,98001,47.3424,-122.275,1940,7420,8,22,2014,UNK,120,-70
6806300920,6/10/2014,490000.0,4,2.5,3020,8302,2.0,0.0,0.0,4,10,3020,0,1994,0,98042,47.363,-122.12700000000001,3020,8406,6,10,2014,UNK,0,-104
9826701665,7/25/2014,550000.0,3,2.5,2340,4200,1.5,0.0,0.0,3,7,1540,800,1906,0,98122,47.6033,-122.303,1590,4200,7,25,2014,UNK,750,0
2253200010,5/7/2015,390000.0,5,2.0,2400,9537,1.0,0.0,0.0,5,7,1210,1190,1959,0,98056,47.5112,-122.186,1760,9533,5,7,2015,UNK,640,4
1941400080,10/20/2014,277000.0,3,2.25,1610,11920,1.0,0.0,0.0,4,7,1110,500,1968,0,98032,47.3683,-122.279,1690,11839,10,20,2014,UNK,-80,81
3317010130,3/17/2015,236000.0,3,1.75,1090,7647,1.0,0.0,0.0,3,7,1090,0,1994,0,98003,47.2613,-122.302,1660,9219,3,17,2015,UNK,-570,-1572
1721059230,3/4/2015,265953.0,3,1.75,1470,13068,1.0,0.0,0.0,4,7,1470,0,1975,0,98092,47.3096,-122.197,2090,16988,3,4,2015,UNK,-620,-3920
9328500630,3/2/2015,545000.0,3,2.25,1670,6240,1.0,0.0,0.0,4,8,1240,430,1974,0,98008,47.6413,-122.113,1910,7000,3,2,2015,UNK,-240,-760
6301800020,5/6/2014,535000.0,3,2.5,1850,10109,2.0,0.0,0.0,3,8,1850,0,1991,0,98034,47.7163,-122.229,1780,9660,5,6,2014,UNK,70,449
7855000460,10/7/2014,1450000.0,3,2.75,3940,9671,1.0,0.0,4.0,5,9,2140,1800,1967,0,98006,47.5654,-122.15799999999999,3390,9360,10,7,2014,UNK,550,311
9320350020,6/30/2014,490000.0,4,3.0,2330,3497,2.0,0.0,0.0,3,9,1920,410,2003,0,98108,47.553999999999995,-122.30799999999999,2330,5242,6,30,2014,UNK,0,-1745
7849201061,4/8/2015,319950.0,4,2.5,2020,7200,1.5,0.0,0.0,4,6,2020,0,1954,0,98065,47.5223,-121.818,1440,7200,4,8,2015,UNK,580,0
3885805640,7/4/2014,625000.0,3,1.5,1300,7200,1.0,0.0,0.0,5,7,1300,0,1960,0,98033,47.6821,-122.196,2280,7200,7,4,2014,UNK,-980,0
8960200630,2/20/2015,248000.0,3,1.0,1180,6947,1.0,0.0,0.0,4,7,1180,0,1968,0,98031,47.4233,-122.177,1760,8657,2,20,2015,UNK,-580,-1710
1736800920,4/21/2015,475000.0,3,1.75,1320,7840,1.0,0.0,0.0,3,8,1320,0,1966,0,98007,47.6024,-122.14299999999999,2050,7644,4,21,2015,UNK,-730,196
6152900402,6/19/2014,410000.0,6,2.75,2520,9324,1.0,0.0,0.0,4,7,1320,1200,1962,0,98155,47.7636,-122.294,1820,11000,6,19,2014,UNK,700,-1676
9822700255,5/5/2014,670000.0,3,2.5,1680,2000,3.0,0.0,0.0,3,9,1680,0,1909,0,98105,47.6604,-122.29,1950,5000,5,5,2014,UNK,-270,-3000
1423069102,3/31/2015,430000.0,3,2.5,2000,35438,2.0,0.0,0.0,3,7,2000,0,1968,2005,98027,47.4733,-121.994,2000,51836,3,31,2015,Y,0,-16398
5279100675,10/28/2014,313000.0,2,1.0,1180,4900,1.0,0.0,0.0,5,6,1180,0,1954,0,98027,47.5321,-122.029,1650,7121,10,28,2014,UNK,-470,-2221
2524049056,7/14/2014,950000.0,3,3.25,3330,15093,2.5,0.0,0.0,3,9,3330,0,1988,0,98040,47.5395,-122.242,4340,20031,7,14,2014,UNK,-1010,-4938
4232400470,5/27/2014,751750.0,2,2.0,1880,5400,1.5,0.0,0.0,3,8,1880,0,1902,0,98112,47.6238,-122.311,1590,5400,5,27,2014,UNK,290,0
8562740440,9/9/2014,760000.0,4,2.5,2990,5280,2.0,0.0,0.0,3,9,2210,780,2003,0,98027,47.5353,-122.066,2990,6299,9,9,2014,UNK,0,-1019
8114000020,1/28/2015,310650.0,3,1.75,1510,12408,1.0,0.0,0.0,4,7,1510,0,1969,0,98059,47.5069,-122.141,1480,17800,1,28,2015,UNK,30,-5392
6600780130,5/2/2014,367500.0,4,3.0,3110,7231,2.0,0.0,0.0,3,8,3110,0,1997,0,98092,47.3279,-122.191,2820,7311,5,2,2014,UNK,290,-80
5100403947,8/4/2014,580000.0,4,2.5,2150,5000,2.0,0.0,0.0,3,8,2150,0,2001,0,98115,47.6962,-122.314,2030,6380,8,4,2014,UNK,120,-1380
1189000825,7/2/2014,580000.0,3,2.25,1900,3960,1.5,0.0,0.0,3,8,1200,700,1905,0,98122,47.6122,-122.29799999999999,1310,3960,7,2,2014,UNK,590,0
3066400080,6/2/2014,665000.0,4,2.5,2720,10000,2.0,0.0,0.0,3,10,2720,0,1987,0,98074,47.6293,-122.051,2720,10020,6,2,2014,UNK,0,-20
2214800630,11/5/2014,239950.0,3,2.25,1560,8280,2.0,0.0,0.0,4,7,1560,0,1979,0,98001,47.3393,-122.259,1920,8120,11,5,2014,UNK,-360,160
4027701253,8/13/2014,470000.0,4,2.5,1990,30083,2.0,0.0,0.0,3,8,1990,0,1998,0,98155,47.7678,-122.272,2220,11627,8,13,2014,UNK,-230,18456
9547205260,8/15/2014,733000.0,3,1.75,1740,3060,1.0,0.0,0.0,5,8,950,0,1930,2014,98115,47.6816,-122.31,1800,3960,8,15,2014,Y,-60,-900
9320600020,1/30/2015,250000.0,4,2.0,2130,8400,1.0,0.0,0.0,3,7,1350,780,1962,0,98031,47.4133,-122.209,1550,8596,1,30,2015,UNK,580,-196
2807100095,9/8/2014,402000.0,4,1.75,1510,9176,1.0,0.0,0.0,5,7,1510,0,1957,0,98133,47.7651,-122.339,1480,9176,9,8,2014,UNK,30,0
8067000020,6/11/2014,295000.0,5,3.5,2100,5107,2.0,0.0,0.0,3,7,1410,690,1999,0,98178,47.5108,-122.257,1410,5650,6,11,2014,UNK,690,-543
8731980440,10/16/2014,355000.0,5,2.5,2344,8000,1.0,0.0,0.0,4,8,1560,784,1976,0,98023,47.3185,-122.37700000000001,2344,8000,10,16,2014,UNK,0,0
5112800233,9/9/2014,289000.0,3,1.5,1970,22486,1.0,0.0,0.0,4,6,1970,0,1968,0,98058,47.4511,-122.089,1850,20160,9,9,2014,UNK,120,2326
6141600179,11/12/2014,376000.0,3,2.25,1470,9140,2.0,0.0,2.0,3,7,1470,0,1982,0,98133,47.7162,-122.34899999999999,1400,8204,11,12,2014,UNK,70,936
8122100595,6/27/2014,212700.0,2,1.0,940,5040,1.0,0.0,0.0,3,7,940,0,1926,0,98126,47.5375,-122.374,940,5040,6,27,2014,UNK,0,0
5467910190,5/27/2014,325000.0,3,1.75,1780,13095,1.0,0.0,0.0,4,9,1780,0,1983,0,98042,47.367,-122.152,2750,13095,5,27,2014,UNK,-970,0
808300460,8/11/2014,415000.0,4,2.5,2230,5743,2.0,0.0,0.0,3,7,2230,0,2002,0,98019,47.7245,-121.95700000000001,2490,6300,8,11,2014,UNK,-260,-557
7785350010,4/2/2015,935000.0,3,2.5,3570,15151,1.0,0.0,0.0,4,8,2400,1170,1981,0,98177,47.7475,-122.36399999999999,3140,14375,4,2,2015,UNK,430,776
2133020020,1/16/2015,372000.0,3,2.5,1920,15260,2.0,0.0,0.0,3,7,1920,0,1990,0,98019,47.7317,-121.964,2370,15235,1,16,2015,UNK,-450,25
2588800006,10/21/2014,240000.0,3,1.5,1290,8366,1.0,0.0,0.0,3,7,1020,270,1957,0,98168,47.4853,-122.318,1770,8400,10,21,2014,UNK,-480,-34
5169700022,9/15/2014,334950.0,3,1.75,1880,16262,1.0,0.0,0.0,5,7,1880,0,1980,0,98059,47.5089,-122.155,1900,7972,9,15,2014,UNK,-20,8290
5416500660,4/30/2015,426500.0,4,2.5,2960,4640,2.0,0.0,0.0,3,9,2960,0,2005,0,98038,47.3597,-122.04,2750,4623,4,30,2015,N,210,17
6117502745,2/24/2015,430000.0,2,1.75,1840,14874,1.0,0.0,2.0,3,8,1300,540,1952,0,98166,47.4382,-122.348,2920,15084,2,24,2015,UNK,-1080,-210
2624049169,12/11/2014,400000.0,3,1.5,1890,6183,1.0,0.0,0.0,3,7,1090,800,1967,0,98118,47.5396,-122.26899999999999,1750,6183,12,11,2014,UNK,140,0
1426300842,4/28/2015,455850.0,3,2.25,1820,6000,1.0,0.0,0.0,4,7,1120,700,1964,0,98108,47.5684,-122.3,1970,6232,4,28,2015,UNK,-150,-232
824059321,6/2/2014,1970000.0,4,3.5,4370,8510,2.0,0.0,1.0,3,10,3610,760,2003,0,98004,47.5876,-122.204,2960,10347,6,2,2014,UNK,1410,-1837
126049217,6/4/2014,400000.0,3,1.75,1530,10731,1.0,0.0,0.0,3,7,1530,0,1986,0,98028,47.7655,-122.244,2100,12593,6,4,2014,UNK,-570,-1862
2201500185,8/8/2014,397500.0,3,1.0,1030,10480,1.0,0.0,0.0,4,7,1030,0,1954,0,98006,47.5742,-122.139,1480,12200,8,8,2014,UNK,-450,-1720
1972205790,12/11/2014,755000.0,3,2.5,2000,1950,3.0,0.0,0.0,3,8,2000,0,2005,0,98109,47.6476,-122.35600000000001,1560,1340,12,11,2014,N,440,610
6843000080,7/9/2014,287000.0,5,1.5,1730,9230,1.0,0.0,0.0,3,7,1010,720,1962,0,98058,47.4646,-122.184,1730,9230,7,9,2014,UNK,0,0
1442700250,7/16/2014,480000.0,4,2.5,3620,16000,2.0,0.0,0.0,3,9,3620,0,1976,0,98038,47.3711,-122.06,2590,16000,7,16,2014,UNK,1030,0
2607760680,4/16/2015,490000.0,3,2.5,2040,9622,2.0,0.0,0.0,3,8,2040,0,1995,0,98045,47.4833,-121.8,2390,9868,4,16,2015,UNK,-350,-246
3523059056,6/18/2014,365000.0,3,2.5,2640,6715,2.0,0.0,0.0,3,8,1680,960,1991,0,98058,47.441,-122.125,2260,7373,6,18,2014,UNK,380,-658
1657530010,2/24/2015,260000.0,3,2.5,1600,2244,2.0,0.0,0.0,3,7,1600,0,2005,0,98056,47.4899,-122.164,1600,1700,2,24,2015,N,0,544
7276100020,4/14/2015,505000.0,4,1.0,1480,12675,1.5,0.0,0.0,4,7,1480,0,1929,0,98133,47.76300000000001,-122.34200000000001,1820,7995,4,14,2015,UNK,-340,4680
9828200460,6/27/2014,260000.0,2,1.0,700,4800,1.0,0.0,0.0,3,7,700,0,1922,0,98122,47.6147,-122.3,1440,4800,6,27,2014,UNK,-740,0
9828200460,1/6/2015,430000.0,2,1.0,700,4800,1.0,0.0,0.0,3,7,700,0,1922,0,98122,47.6147,-122.3,1440,4800,1,6,2015,UNK,-740,0
5608000840,7/24/2014,905000.0,4,2.5,3520,12193,2.0,0.0,0.0,4,10,3520,0,1993,0,98027,47.5535,-122.095,3470,11318,7,24,2014,UNK,50,875
5422560470,12/3/2014,440000.0,3,2.0,1650,6408,2.0,0.0,0.0,4,8,1650,0,1977,0,98052,47.6638,-122.12799999999999,1750,6402,12,3,2014,UNK,-100,6
446000020,9/13/2014,439500.0,4,1.0,1360,5500,1.5,0.0,0.0,3,7,1360,0,1950,0,98115,47.6878,-122.285,1530,5790,9,13,2014,UNK,-170,-290
9476200545,1/27/2015,270000.0,3,2.0,1350,6696,1.0,0.0,0.0,5,6,680,670,1944,0,98056,47.4919,-122.18700000000001,1350,6700,1,27,2015,UNK,0,-4
8648100130,4/29/2015,306500.0,3,2.5,1970,6291,2.0,0.0,0.0,4,7,1970,0,1998,0,98042,47.3627,-122.073,1980,8852,4,29,2015,UNK,-10,-2561
9358002232,10/19/2014,380000.0,3,2.0,1470,1656,2.0,0.0,0.0,3,8,1310,160,2003,0,98126,47.5653,-122.369,1470,2288,10,19,2014,UNK,0,-632
2212900920,7/22/2014,215000.0,4,1.75,1610,9652,1.0,0.0,0.0,5,7,1610,0,1969,0,98042,47.3281,-122.135,1220,9800,7,22,2014,UNK,390,-148
6149700380,2/6/2015,299900.0,2,1.0,810,6150,1.0,0.0,0.0,3,7,810,0,1950,0,98133,47.7289,-122.34,1080,7200,2,6,2015,UNK,-270,-1050
4340000080,3/27/2015,1450000.0,4,3.5,2820,7809,2.0,0.0,0.0,3,10,2820,0,1995,0,98004,47.622,-122.195,2630,7904,3,27,2015,UNK,190,-95
3751605432,5/13/2014,239950.0,3,1.0,1900,33888,1.5,0.0,0.0,4,5,1900,0,1942,0,98001,47.2738,-122.271,1430,19200,5,13,2014,UNK,470,14688
6384300020,6/23/2014,494000.0,4,2.5,1830,7345,1.0,0.0,0.0,4,8,1540,290,1973,0,98177,47.7741,-122.37299999999999,1990,7700,6,23,2014,UNK,-160,-355
3450300430,1/5/2015,317500.0,4,1.5,1730,7700,1.0,0.0,0.0,4,7,1010,720,1963,0,98059,47.4996,-122.163,1650,8066,1,5,2015,UNK,80,-366
1245001763,3/3/2015,670000.0,4,2.5,2110,7291,2.0,0.0,0.0,4,7,2110,0,1977,0,98033,47.6888,-122.20100000000001,2350,8625,3,3,2015,UNK,-240,-1334
7853240660,8/20/2014,650000.0,3,2.5,3060,7831,2.0,0.0,2.0,3,9,3060,0,2004,0,98065,47.5401,-121.861,3140,7438,8,20,2014,N,-80,393
3723800414,3/20/2015,852000.0,4,2.5,2620,7328,2.0,0.0,0.0,3,8,2620,0,1983,0,98118,47.5514,-122.26299999999999,1670,5080,3,20,2015,UNK,950,2248
5104500020,6/17/2014,250000.0,2,1.5,1088,1360,2.0,0.0,0.0,3,7,1088,0,1983,0,98034,47.7094,-122.213,1098,1469,6,17,2014,UNK,-10,-109
5438000080,12/10/2014,264950.0,3,1.5,1400,10853,1.0,0.0,0.0,4,7,1400,0,1964,0,98055,47.4433,-122.194,1620,10849,12,10,2014,UNK,-220,4
9498200091,9/25/2014,582500.0,2,2.0,1540,6804,1.0,0.0,0.0,5,7,1020,520,1942,0,98177,47.7044,-122.37200000000001,1380,6930,9,25,2014,UNK,160,-126
1498301213,3/11/2015,384000.0,3,2.5,1540,1564,2.0,0.0,0.0,3,7,1300,240,1998,0,98144,47.58600000000001,-122.31299999999999,1540,2875,3,11,2015,UNK,0,-1311
2652500285,10/28/2014,817000.0,3,1.5,2310,3360,1.5,0.0,0.0,3,8,1790,520,1926,0,98119,47.6431,-122.359,1930,4320,10,28,2014,UNK,380,-960
5127000430,12/1/2014,320000.0,4,1.75,1730,9520,1.0,0.0,0.0,4,7,1730,0,1971,0,98059,47.4756,-122.15700000000001,1550,11211,12,1,2014,UNK,180,-1691
4017110020,6/30/2014,445800.0,4,2.25,2070,39446,1.0,0.0,0.0,3,8,1470,600,1977,0,98155,47.7765,-122.27600000000001,2140,12043,6,30,2014,UNK,-70,27403
3336001946,3/7/2015,263300.0,2,1.0,900,4500,1.0,0.0,0.0,3,7,900,0,1951,0,98118,47.5273,-122.265,1175,5320,3,7,2015,UNK,-275,-820
5253300387,1/28/2015,215000.0,3,1.0,860,6635,1.0,0.0,0.0,3,6,860,0,1952,0,98133,47.7508,-122.339,1170,8000,1,28,2015,UNK,-310,-1365
9222400605,11/15/2014,842500.0,5,4.0,2980,4500,1.5,0.0,0.0,3,7,2070,910,1921,0,98115,47.6736,-122.323,1560,4225,11,15,2014,UNK,1420,275
9222400605,4/11/2015,850000.0,5,4.0,2980,4500,1.5,0.0,0.0,3,7,2070,910,1921,0,98115,47.6736,-122.323,1560,4225,4,11,2015,UNK,1420,275
2163300130,10/1/2014,386000.0,5,2.5,2740,12413,2.0,0.0,0.0,3,7,2740,0,1990,0,98031,47.4199,-122.18299999999999,1900,7416,10,1,2014,UNK,840,4997
8662500130,12/9/2014,251100.0,4,2.5,1790,5257,2.0,0.0,0.0,3,7,1790,0,1996,0,98030,47.3849,-122.204,1680,5320,12,9,2014,UNK,110,-63
1770000130,11/26/2014,435000.0,3,1.75,1750,16748,1.0,0.0,0.0,3,7,1330,420,1978,0,98072,47.7421,-122.089,1750,16050,11,26,2014,UNK,0,698
1888120080,9/22/2014,870000.0,4,4.0,3610,12811,2.0,0.0,0.0,3,10,3610,0,2000,0,98075,47.5812,-121.993,3530,11783,9,22,2014,UNK,80,1028
862000020,2/6/2015,800000.0,6,1.0,1430,20620,2.0,0.0,0.0,3,7,1430,0,1954,0,98004,47.6255,-122.209,2450,10080,2,6,2015,UNK,-1020,10540
7199100020,7/14/2014,555000.0,3,1.75,1570,15500,1.0,0.0,0.0,4,7,1570,0,1968,0,98052,47.6916,-122.12200000000001,1610,7500,7,14,2014,UNK,-40,8000
9169600275,7/23/2014,280000.0,2,1.0,2280,37500,2.0,0.0,0.0,3,7,2280,0,1932,0,98136,47.525,-122.389,2360,6000,7,23,2014,UNK,-80,31500
2767601815,3/17/2015,356000.0,3,1.0,940,2366,1.0,0.0,0.0,3,6,940,0,1916,0,98107,47.6744,-122.383,1500,5000,3,17,2015,UNK,-560,-2634
7853221330,12/3/2014,675000.0,4,2.5,2920,6000,2.0,0.0,4.0,3,9,2920,0,2004,0,98065,47.5333,-121.859,3100,6001,12,3,2014,N,-180,-1
7504010780,12/26/2014,605000.0,4,2.25,2260,11900,2.0,0.0,0.0,3,9,2260,0,1976,0,98074,47.6415,-122.057,2470,11900,12,26,2014,UNK,-210,0
5015000190,6/25/2014,690500.0,5,2.0,2000,4211,1.5,0.0,2.0,4,7,1280,720,1908,0,98112,47.6283,-122.301,1680,4000,6,25,2014,UNK,320,211
8682260470,6/19/2014,437000.0,2,1.75,1440,4225,1.0,0.0,0.0,3,8,1440,0,2005,0,98053,47.7143,-122.03200000000001,1680,6200,6,19,2014,N,-240,-1975
4122700020,7/10/2014,850000.0,5,2.0,2310,13430,1.5,0.0,0.0,4,8,2310,0,1966,0,98004,47.6395,-122.20299999999999,2810,13906,7,10,2014,UNK,-500,-476
8850000285,6/12/2014,350000.0,4,2.25,2300,4600,1.5,0.0,0.0,4,7,1340,960,1904,0,98144,47.5895,-122.311,1540,3000,6,12,2014,UNK,760,1600
4174600185,6/22/2014,480000.0,2,2.25,1490,6770,1.5,0.0,0.0,3,8,1490,0,1926,0,98108,47.5577,-122.29700000000001,1820,7875,6,22,2014,UNK,-330,-1105
7229800430,7/23/2014,379500.0,3,2.25,1830,25641,2.0,0.0,0.0,3,8,1830,0,1989,0,98059,47.4786,-122.11200000000001,1500,25641,7,23,2014,UNK,330,0
42000130,9/24/2014,600000.0,5,4.5,4440,9784,2.0,0.0,0.0,3,10,4440,0,2012,0,98168,47.4702,-122.275,2720,10080,9,24,2014,N,1720,-296
4139430250,3/30/2015,1440000.0,4,3.5,4970,16582,2.0,0.0,3.0,4,11,3930,1040,1992,0,98006,47.5496,-122.12,3580,13335,3,30,2015,UNK,1390,3247
9834201470,12/18/2014,303000.0,2,1.5,1000,1075,2.0,0.0,0.0,3,7,840,160,2007,0,98144,47.5708,-122.288,1000,1083,12,18,2014,N,0,-8
4058801702,2/6/2015,800000.0,4,2.5,4940,10037,1.0,0.0,4.0,3,9,3450,1490,1953,0,98178,47.5095,-122.24700000000001,2430,9272,2,6,2015,UNK,2510,765
3363400655,7/24/2014,549000.0,2,2.0,1980,6000,1.5,0.0,0.0,5,7,1220,760,1906,0,98103,47.6809,-122.351,1280,3900,7,24,2014,UNK,700,2100
8700500020,11/26/2014,324950.0,3,2.5,1560,9600,1.0,0.0,0.0,3,7,1210,0,1964,0,98188,47.457,-122.27,2070,9600,11,26,2014,UNK,-510,0
8148600020,9/26/2014,170000.0,2,1.0,870,6537,1.0,0.0,0.0,3,6,870,0,1948,0,98168,47.4906,-122.306,1100,8701,9,26,2014,UNK,-230,-2164
8651430780,7/15/2014,178000.0,3,1.0,840,6500,1.0,0.0,0.0,5,6,840,0,1969,0,98042,47.3704,-122.08,870,5200,7,15,2014,UNK,-30,1300
1432400345,4/21/2015,144000.0,3,1.0,1250,8314,1.0,0.0,0.0,3,6,1250,0,1958,0,98058,47.4522,-122.178,1188,7700,4,21,2015,UNK,62,614
2524049148,3/17/2015,1580000.0,4,2.75,3120,20031,1.0,0.0,2.0,4,9,1980,1140,1954,0,98040,47.5389,-122.242,3330,18777,3,17,2015,UNK,-210,1254
2475900840,4/27/2015,258000.0,2,1.0,750,7000,1.0,0.0,0.0,3,6,750,0,1932,0,98024,47.5655,-121.89,1100,8777,4,27,2015,UNK,-350,-1777
7452500190,10/16/2014,345000.0,3,1.75,710,5050,1.0,0.0,0.0,4,6,710,0,1950,0,98126,47.5194,-122.375,900,5050,10,16,2014,UNK,-190,0
3459000050,6/10/2014,470000.0,3,1.75,2290,14800,1.0,0.0,0.0,3,8,1620,670,1965,0,98155,47.7735,-122.273,2320,12474,6,10,2014,UNK,-30,2326
2624049091,3/13/2015,2900000.0,5,2.5,3750,91681,2.0,1.0,4.0,3,10,3750,0,1925,0,98118,47.5379,-122.264,3540,24293,3,13,2015,UNK,210,67388
1138000250,5/21/2014,350000.0,3,1.5,980,7790,1.0,0.0,0.0,5,7,980,0,1969,0,98034,47.7141,-122.213,1390,7280,5,21,2014,UNK,-410,510
4399210130,6/26/2014,225500.0,2,1.75,1590,11276,1.0,0.0,0.0,4,7,1590,0,1972,0,98002,47.3177,-122.21,1750,10687,6,26,2014,UNK,-160,589
2770601365,2/24/2015,473000.0,2,1.0,940,4000,1.0,0.0,0.0,3,6,720,220,1942,0,98199,47.6488,-122.385,1180,6000,2,24,2015,UNK,-240,-2000
7272000980,2/26/2015,279000.0,3,1.75,1750,9623,1.0,0.0,0.0,3,7,1150,600,1962,0,98198,47.3997,-122.31299999999999,1820,9623,2,26,2015,UNK,-70,0
1566100010,4/14/2015,470000.0,3,1.0,1460,8227,1.0,0.0,0.0,3,6,880,580,1948,0,98125,47.7009,-122.301,1530,8128,4,14,2015,UNK,-70,99
6338000592,8/20/2014,565000.0,3,1.75,1540,4800,1.0,0.0,0.0,4,6,770,770,1925,0,98105,47.67,-122.28399999999999,1510,4080,8,20,2014,UNK,30,720
2815600305,4/22/2015,695000.0,3,2.0,2560,6800,1.0,0.0,1.0,4,8,1380,1180,1952,0,98136,47.5506,-122.395,1780,6800,4,22,2015,UNK,780,0
561500290,7/11/2014,315000.0,3,1.75,1660,37642,1.0,0.0,0.0,4,7,1660,0,1991,0,98022,47.2559,-122.007,2070,54450,7,11,2014,UNK,-410,-16808
3905080280,3/4/2015,529000.0,3,2.5,1880,4499,2.0,0.0,0.0,3,8,1880,0,1993,0,98029,47.5664,-121.999,2130,5114,3,4,2015,UNK,-250,-615
925069071,1/26/2015,750000.0,5,3.75,3500,101494,1.5,0.0,0.0,3,8,3500,0,1967,1990,98053,47.6745,-122.054,3250,38636,1,26,2015,Y,250,62858
2426049174,10/29/2014,481500.0,3,2.25,1840,10500,2.0,0.0,0.0,3,7,1840,0,1993,0,98034,47.7326,-122.234,1840,7374,10,29,2014,UNK,0,3126
9407600250,3/27/2015,211000.0,3,2.0,1060,7412,1.0,0.0,0.0,3,7,1060,0,1987,0,98038,47.3897,-122.051,1080,7093,3,27,2015,UNK,-20,319
7955050170,4/10/2015,455000.0,3,2.25,1790,7500,1.0,0.0,0.0,3,7,1390,400,1973,0,98034,47.7321,-122.198,1940,7192,4,10,2015,UNK,-150,308
7224000950,11/3/2014,238950.0,2,1.0,810,4838,1.0,0.0,0.0,3,5,810,0,1938,0,98055,47.4909,-122.20299999999999,890,4838,11,3,2014,UNK,-80,0
464001025,9/18/2014,722500.0,4,3.5,2600,5100,2.0,0.0,0.0,3,8,1820,780,2003,0,98117,47.6948,-122.395,2000,6720,9,18,2014,UNK,600,-1620
5569700020,7/30/2014,795000.0,4,2.5,3230,19193,1.0,0.0,3.0,4,8,2000,1230,1973,0,98075,47.5755,-122.07,3230,13420,7,30,2014,UNK,0,5773
1310910290,5/7/2015,327500.0,4,2.25,2240,9600,2.0,0.0,0.0,3,8,2240,0,1971,0,98032,47.361000000000004,-122.281,2050,9240,5,7,2015,UNK,190,360
5104531640,3/23/2015,585000.0,4,3.0,3400,5100,2.0,0.0,0.0,3,9,3400,0,2006,0,98038,47.3548,-122.00200000000001,3400,5672,3,23,2015,N,0,-572
1025039145,6/13/2014,775000.0,4,2.0,3140,10875,1.0,0.0,1.0,3,7,1940,1200,1939,1969,98199,47.6656,-122.406,3300,10080,6,13,2014,Y,-160,795
5406500170,10/24/2014,645000.0,4,2.5,2780,4200,2.0,0.0,0.0,3,8,2780,0,2001,0,98075,47.5989,-122.039,2510,4200,10,24,2014,UNK,270,0
1826049426,1/5/2015,445000.0,4,2.75,2320,12368,1.0,0.0,0.0,3,8,1670,650,1968,0,98133,47.7373,-122.35,2070,9575,1,5,2015,UNK,250,2793
2011000010,5/2/2014,257950.0,3,1.75,1370,5858,1.0,0.0,0.0,3,7,1370,0,1987,0,98198,47.3815,-122.31299999999999,1400,7500,5,2,2014,UNK,-30,-1642
9368700006,3/24/2015,375000.0,5,1.75,2230,7560,1.0,0.0,0.0,3,7,1230,1000,1959,0,98178,47.5055,-122.26,1380,6570,3,24,2015,UNK,850,990
8016250080,7/9/2014,245000.0,3,2.5,1610,7223,2.0,0.0,0.0,3,7,1610,0,1994,0,98030,47.3661,-122.17299999999999,1610,7162,7,9,2014,UNK,0,61
4053200285,8/11/2014,725000.0,3,2.5,3410,41022,2.0,0.0,0.0,3,11,3410,0,1990,0,98042,47.3228,-122.08,2150,21429,8,11,2014,UNK,1260,19593
5411600020,3/4/2015,702000.0,4,2.5,2810,4922,2.0,0.0,0.0,3,9,2810,0,2005,0,98074,47.614,-122.041,2920,4922,3,4,2015,N,-110,0
847100078,8/18/2014,330000.0,3,1.75,1850,14986,2.0,0.0,0.0,3,6,1850,0,1943,2005,98059,47.4837,-122.148,2660,10650,8,18,2014,Y,-810,4336
4232903295,4/16/2015,940000.0,3,1.5,1790,4800,1.5,0.0,0.0,3,8,1790,0,1912,0,98119,47.6332,-122.36200000000001,1780,3600,4,16,2015,UNK,10,1200
7979900680,3/5/2015,354500.0,3,1.0,1150,11396,1.5,0.0,0.0,4,7,1150,0,1950,0,98155,47.7435,-122.296,1600,8146,3,5,2015,UNK,-450,3250
492000532,2/22/2015,279950.0,4,2.75,2420,8700,1.5,0.0,0.0,4,7,2420,0,1914,0,98002,47.3109,-122.229,1070,4804,2,22,2015,UNK,1350,3896
2310000430,5/7/2015,284000.0,3,2.25,1580,7034,1.0,0.0,0.0,4,7,1180,400,1989,0,98038,47.3564,-122.04,1470,7358,5,7,2015,UNK,110,-324
8832900780,10/13/2014,480000.0,5,2.0,1760,21562,1.0,0.0,1.0,3,8,1560,200,1959,0,98028,47.7597,-122.26299999999999,2150,12676,10,13,2014,UNK,-390,8886
8832900780,4/8/2015,647500.0,5,2.0,1760,21562,1.0,0.0,1.0,3,8,1560,200,1959,0,98028,47.7597,-122.26299999999999,2150,12676,4,8,2015,UNK,-390,8886
3249500020,4/6/2015,625000.0,3,2.5,2750,35000,2.0,0.0,0.0,3,9,2750,0,1993,0,98077,47.75,-122.024,2780,35862,4,6,2015,UNK,-30,-862
8651442810,7/10/2014,152000.0,3,1.0,920,4875,1.0,0.0,0.0,4,7,920,0,1978,0,98042,47.3623,-122.09,1160,4875,7,10,2014,UNK,-240,0
8564500020,1/27/2015,322000.0,3,1.0,960,10181,1.0,0.0,0.0,3,7,960,0,1961,0,98034,47.7231,-122.229,1740,10194,1,27,2015,UNK,-780,-13
3019300050,7/31/2014,445000.0,3,1.75,1120,4000,1.0,0.0,0.0,4,7,870,250,1916,0,98107,47.6684,-122.368,1470,4000,7,31,2014,UNK,-350,0
2460900020,7/30/2014,595000.0,3,1.0,1560,3960,1.5,0.0,0.0,4,7,1560,0,1907,0,98144,47.5936,-122.301,1280,3960,7,30,2014,UNK,280,0
2698200010,5/13/2015,165000.0,3,1.0,1380,7334,1.0,0.0,0.0,3,7,980,400,1981,0,98055,47.4339,-122.19200000000001,1910,7859,5,13,2015,UNK,-530,-525
104560010,6/10/2014,278500.0,4,2.5,1940,6206,2.0,0.0,0.0,3,7,1940,0,1990,0,98023,47.3063,-122.359,2060,7092,6,10,2014,UNK,-120,-886
5710610430,3/13/2015,517500.0,3,1.75,1810,10625,1.0,0.0,0.0,3,8,1370,440,1973,0,98027,47.5322,-122.04899999999999,2140,10922,3,13,2015,UNK,-330,-297
34000005,6/18/2014,343566.0,2,1.0,1100,4200,1.0,0.0,0.0,3,7,1100,0,1954,0,98136,47.5312,-122.39200000000001,1240,4000,6,18,2014,UNK,-140,200
7349400420,11/5/2014,286285.0,4,2.25,1980,9714,1.0,0.0,0.0,3,7,1170,810,1977,0,98002,47.3207,-122.209,1610,9272,11,5,2014,UNK,370,442
3298300130,2/6/2015,474905.0,4,1.5,1340,6200,1.0,0.0,0.0,5,6,1340,0,1959,0,98008,47.6214,-122.119,1210,7178,2,6,2015,UNK,130,-978
7312400080,7/14/2014,550000.0,3,1.75,1680,4800,1.0,0.0,0.0,4,7,1400,280,1960,0,98126,47.5535,-122.37700000000001,1540,5000,7,14,2014,UNK,140,-200
3356404198,1/29/2015,286000.0,4,2.5,2060,16000,2.0,0.0,0.0,3,6,2060,0,1993,0,98001,47.2849,-122.251,1530,8000,1,29,2015,UNK,530,8000
2344300122,8/8/2014,900000.0,3,3.25,2620,7215,1.0,0.0,0.0,4,8,1770,850,1980,0,98004,47.5836,-122.2,2180,8931,8,8,2014,UNK,440,-1716
3904901330,8/20/2014,449950.0,3,2.25,1610,5159,2.0,0.0,0.0,3,7,1610,0,1985,0,98029,47.5675,-122.01899999999999,1610,5210,8,20,2014,UNK,0,-51
7524100280,6/12/2014,259000.0,4,1.5,1490,7560,2.0,0.0,0.0,3,7,1490,0,1966,0,98198,47.3684,-122.318,1490,7689,6,12,2014,UNK,0,-129
2473390440,12/2/2014,340000.0,3,2.25,1900,8125,1.0,0.0,0.0,3,7,1540,360,1969,0,98058,47.4564,-122.162,1480,8284,12,2,2014,UNK,420,-159
2215800050,4/15/2015,785000.0,4,2.5,3440,56192,2.0,0.0,0.0,3,9,3440,0,1994,0,98053,47.6969,-122.046,3150,44431,4,15,2015,UNK,290,11761
2769602475,5/9/2014,490000.0,2,1.0,1840,3300,1.5,0.0,0.0,4,6,1130,710,1910,0,98107,47.6757,-122.36200000000001,1320,4000,5,9,2014,UNK,520,-700
9183700470,5/27/2014,344950.0,4,2.0,2330,6250,1.0,0.0,0.0,4,7,1400,930,1941,0,98030,47.3782,-122.228,2050,9000,5,27,2014,UNK,280,-2750
1337800284,8/27/2014,950000.0,3,2.0,2250,2975,2.0,0.0,0.0,4,9,1880,370,1905,0,98112,47.6289,-122.309,2690,4800,8,27,2014,UNK,-440,-1825
3867400130,7/9/2014,810000.0,4,1.75,2000,3988,1.0,0.0,4.0,4,7,1000,1000,1958,0,98116,47.5925,-122.391,1690,4144,7,9,2014,UNK,310,-156
7856410020,3/9/2015,998160.0,2,2.5,3010,16050,1.0,0.0,3.0,4,9,1260,1750,1976,0,98006,47.5643,-122.16,3010,11612,3,9,2015,UNK,0,4438
9477730080,12/10/2014,377000.0,3,1.75,1680,7389,1.0,0.0,0.0,3,8,1150,530,1979,0,98056,47.5199,-122.184,2100,10348,12,10,2014,UNK,-420,-2959
3300760020,8/26/2014,595000.0,3,2.0,1530,6773,1.0,0.0,0.0,4,8,1530,0,1984,0,98033,47.6653,-122.194,2240,7201,8,26,2014,UNK,-710,-428
148000440,8/18/2014,313300.0,2,1.0,970,4800,1.0,0.0,0.0,3,6,970,0,1911,1940,98116,47.5754,-122.414,1180,5900,8,18,2014,Y,-210,-1100
1708400595,7/25/2014,360000.0,5,1.75,1550,5225,1.5,0.0,0.0,4,7,1550,0,1941,0,98108,47.553999999999995,-122.306,1220,5225,7,25,2014,UNK,330,0
9264901680,3/23/2015,188000.0,3,1.75,1660,7350,1.0,0.0,0.0,2,8,1660,0,1979,0,98023,47.3118,-122.337,1840,7673,3,23,2015,UNK,-180,-323
3226079091,9/12/2014,755000.0,3,2.5,3680,203860,1.5,0.0,0.0,3,9,3680,0,1994,0,98014,47.6903,-121.929,2410,144183,9,12,2014,UNK,1270,59677
2877104175,9/10/2014,1290000.0,5,3.5,3210,4060,2.0,0.0,2.0,3,10,2290,920,1917,2003,98117,47.6801,-122.35700000000001,1940,5000,9,10,2014,Y,1270,-940
8843900396,7/14/2014,455000.0,3,1.0,1480,13280,2.5,0.0,0.0,3,6,1480,0,1940,0,98027,47.5378,-122.04299999999999,1510,8723,7,14,2014,UNK,-30,4557
1425059193,10/9/2014,817500.0,5,3.5,3600,9312,2.0,0.0,3.0,3,10,2680,920,2005,0,98052,47.6582,-122.12200000000001,3420,9860,10,9,2014,N,180,-548
5694000768,9/22/2014,550000.0,3,2.25,1700,1481,3.0,0.0,0.0,3,8,1700,0,2002,0,98103,47.6598,-122.34899999999999,1560,1350,9,22,2014,UNK,140,131
8732190460,5/5/2015,260000.0,3,1.75,1680,8725,1.0,0.0,0.0,3,8,1240,440,1978,0,98023,47.3107,-122.397,2020,8352,5,5,2015,UNK,-340,373
723099028,6/26/2014,320000.0,3,2.0,1550,34175,1.5,0.0,0.0,3,7,1550,0,1999,0,98045,47.4855,-121.698,2300,35174,6,26,2014,UNK,-750,-999
4139480190,9/16/2014,1150000.0,3,3.25,3780,10623,1.0,0.0,1.0,3,11,2650,1130,1999,0,98006,47.5506,-122.101,3850,11170,9,16,2014,UNK,-70,-547
1133000050,4/20/2015,362000.0,4,2.5,2360,7370,1.0,0.0,0.0,3,7,1460,900,1985,0,98125,47.7201,-122.30799999999999,1590,9906,4,20,2015,UNK,770,-2536
2770601462,4/23/2015,503500.0,3,2.5,1810,1750,2.0,0.0,0.0,3,7,1350,460,1997,0,98199,47.6513,-122.38600000000001,1640,1563,4,23,2015,UNK,170,187
3630120480,6/2/2014,653000.0,3,2.5,2290,3475,2.0,0.0,0.0,3,9,2290,0,2006,0,98029,47.5551,-122.001,2340,3626,6,2,2014,N,-50,-151
624110050,6/4/2014,760000.0,4,2.75,3370,12447,2.0,0.0,0.0,3,10,3370,0,1991,0,98077,47.7309,-122.05799999999999,3700,13129,6,4,2014,UNK,-330,-682
2301400655,11/25/2014,775000.0,4,1.75,2090,5050,1.0,0.0,0.0,4,7,1090,1000,1916,0,98117,47.6802,-122.35799999999999,1760,5000,11,25,2014,UNK,330,50
7936500190,10/21/2014,1340000.0,4,3.75,2130,34689,1.5,1.0,4.0,3,9,2130,0,1955,0,98136,47.5489,-122.398,3030,28598,10,21,2014,UNK,-900,6091
126039323,2/24/2015,417500.0,5,1.75,2060,10911,1.0,0.0,0.0,4,7,1360,700,1954,0,98177,47.7767,-122.365,2060,9688,2,24,2015,UNK,0,1223
9512500460,7/11/2014,525000.0,3,1.5,1560,9350,1.0,0.0,0.0,4,7,1220,340,1969,0,98052,47.6729,-122.148,1870,8671,7,11,2014,UNK,-310,679
7203601405,4/14/2015,217000.0,2,1.0,730,2400,1.0,0.0,1.0,3,4,730,0,1934,0,98198,47.35,-122.322,1220,4382,4,14,2015,UNK,-490,-1982
6204200170,7/9/2014,525000.0,4,2.75,2910,6308,1.0,0.0,0.0,3,8,1640,1270,1985,0,98011,47.7352,-122.20100000000001,1970,7127,7,9,2014,UNK,940,-819
5027800190,3/24/2015,442500.0,4,2.25,2490,8700,1.0,0.0,0.0,3,7,1890,600,1976,0,98155,47.7397,-122.324,1470,7975,3,24,2015,UNK,1020,725
2206500430,7/9/2014,525000.0,4,1.75,1710,10440,1.0,0.0,0.0,4,7,1710,0,1955,0,98006,47.5756,-122.15799999999999,1480,10440,7,9,2014,UNK,230,0
9477001410,2/25/2015,425500.0,4,1.75,1520,10630,1.0,0.0,0.0,4,7,1520,0,1967,0,98034,47.7347,-122.193,1550,8039,2,25,2015,UNK,-30,2591
2324079073,8/15/2014,710000.0,3,2.75,2930,218235,2.0,0.0,2.0,3,8,2930,0,1990,0,98024,47.5481,-121.88600000000001,2450,218235,8,15,2014,UNK,480,0
2817210420,11/14/2014,545000.0,4,3.0,3160,10948,1.0,0.0,3.0,3,8,1930,1230,1991,0,98070,47.3733,-122.42200000000001,2380,13623,11,14,2014,UNK,780,-2675
1402200440,2/12/2015,410000.0,5,2.75,2910,16410,1.5,0.0,0.0,4,8,2910,0,1967,0,98058,47.44,-122.145,1980,18000,2,12,2015,UNK,930,-1590
1545808370,4/22/2015,245000.0,3,2.25,1700,8100,1.0,0.0,0.0,3,7,1200,500,1980,0,98038,47.3601,-122.046,1700,8100,4,22,2015,UNK,0,0
7335400500,7/11/2014,194900.0,2,1.0,810,6697,1.0,0.0,0.0,4,6,810,0,1923,0,98002,47.3057,-122.21600000000001,1140,6695,7,11,2014,UNK,-330,2
1843130980,5/6/2014,284000.0,4,2.5,2000,5390,2.0,0.0,0.0,3,7,2000,0,2003,0,98042,47.3732,-122.12899999999999,2330,5390,5,6,2014,UNK,-330,0
9262800255,8/19/2014,280000.0,2,1.75,1894,52769,1.5,0.0,0.0,4,6,1520,374,1936,0,98001,47.3088,-122.273,1820,50529,8,19,2014,UNK,74,2240
8656800190,10/2/2014,280000.0,3,1.75,2080,87991,1.0,0.0,0.0,3,6,1040,1040,1970,0,98014,47.6724,-121.865,2080,84300,10,2,2014,UNK,0,3691
2113700235,5/12/2014,360000.0,4,2.0,1730,5500,1.0,0.0,0.0,5,7,1010,720,1943,0,98106,47.5304,-122.353,1080,4900,5,12,2014,UNK,650,600
4235400255,9/5/2014,405000.0,2,1.0,720,4323,1.0,0.0,0.0,3,6,720,0,1942,0,98199,47.6604,-122.40100000000001,1460,3300,9,5,2014,UNK,-740,1023
8691360380,4/14/2015,865000.0,4,2.5,3560,13981,2.0,0.0,0.0,3,10,3560,0,2000,0,98075,47.6002,-121.98,3840,13624,4,14,2015,UNK,-280,357
2205500080,6/10/2014,483300.0,4,2.0,1210,11100,1.0,0.0,0.0,4,7,1210,0,1955,0,98006,47.5747,-122.145,1280,11100,6,10,2014,UNK,-70,0
4137000250,3/18/2015,355000.0,4,2.5,2130,9268,2.0,0.0,0.0,4,8,2130,0,1985,0,98092,47.262,-122.22,2100,8400,3,18,2015,UNK,30,868
2310010050,4/30/2015,274950.0,3,2.25,1570,8767,1.0,0.0,0.0,3,7,1180,390,1990,0,98038,47.3568,-122.038,1570,7434,4,30,2015,UNK,0,1333
1370802115,12/5/2014,1930000.0,3,4.5,3950,6134,2.0,0.0,3.0,3,11,2880,1070,1998,0,98199,47.6413,-122.405,3050,5281,12,5,2014,UNK,900,853
6117900010,12/31/2014,755000.0,3,3.25,3450,15586,2.0,0.0,0.0,3,11,2690,760,1989,0,98166,47.4294,-122.34299999999999,3560,15046,12,31,2014,UNK,-110,540
2626069030,2/9/2015,1940000.0,4,5.75,7220,223462,2.0,0.0,4.0,3,12,6220,1000,2000,0,98053,47.7097,-122.01299999999999,2680,7593,2,9,2015,UNK,4540,215869
9407102360,6/16/2014,309212.0,3,1.75,1150,9600,1.0,0.0,0.0,3,7,1150,0,1979,0,98045,47.4434,-121.774,1520,9976,6,16,2014,UNK,-370,-376
104510440,6/4/2014,219950.0,3,2.25,1500,7615,1.0,0.0,0.0,3,7,1150,350,1984,0,98023,47.3146,-122.351,1540,8649,6,4,2014,UNK,-40,-1034
7519000170,7/23/2014,690000.0,3,2.5,1300,5150,1.5,0.0,0.0,4,7,1300,0,1920,0,98117,47.6838,-122.36200000000001,1400,4017,7,23,2014,UNK,-100,1133
2113700500,10/5/2014,250800.0,3,1.75,1290,4000,1.0,0.0,0.0,3,6,1170,120,1943,0,98106,47.5309,-122.354,1140,4000,10,5,2014,UNK,150,0
1560930050,3/25/2015,557500.0,3,2.0,2510,35255,1.0,0.0,2.0,3,9,2510,0,1994,0,98038,47.4012,-122.025,3140,36450,3,25,2015,UNK,-630,-1195
9550204590,6/24/2014,941000.0,4,1.75,2320,3825,1.5,0.0,0.0,5,8,1820,500,1926,0,98105,47.6659,-122.32700000000001,1940,3825,6,24,2014,UNK,380,0
4217402115,4/21/2015,3650000.0,6,4.75,5480,19401,1.5,1.0,4.0,5,11,3910,1570,1936,0,98105,47.6515,-122.277,3510,15810,4,21,2015,UNK,1970,3591
9412710440,4/22/2015,305000.0,4,2.75,2030,8600,1.0,0.0,0.0,4,7,1230,800,1977,0,98042,47.3942,-122.16,1810,8600,4,22,2015,UNK,220,0
6043400006,7/29/2014,815000.0,4,1.5,2060,16110,1.0,0.0,0.0,4,8,2060,0,1949,0,98004,47.5983,-122.20200000000001,2060,16110,7,29,2014,UNK,0,0
1024039049,5/12/2014,1020000.0,3,2.5,2920,34527,1.0,0.0,4.0,4,9,1800,1120,1954,1983,98116,47.5799,-122.4,2480,7933,5,12,2014,Y,440,26594
1250204835,9/8/2014,1240000.0,4,3.0,3330,6990,1.5,0.0,3.0,5,9,2330,1000,1928,0,98144,47.5886,-122.287,2620,5310,9,8,2014,UNK,710,1680
6388920460,12/26/2014,535000.0,3,2.5,2110,8164,2.0,0.0,0.0,3,9,2110,0,1990,0,98056,47.5269,-122.171,2390,7499,12,26,2014,UNK,-280,665
1925059049,7/21/2014,775000.0,3,1.0,1175,10454,1.0,0.0,0.0,4,6,1175,0,1949,0,98004,47.6388,-122.21799999999999,2010,10800,7,21,2014,UNK,-835,-346
7760400420,7/18/2014,255000.0,3,2.0,1590,8670,1.0,0.0,0.0,3,7,1590,0,1994,0,98042,47.3725,-122.073,1590,9253,7,18,2014,UNK,0,-583
6163901271,8/11/2014,327000.0,2,1.0,1070,9750,1.0,0.0,0.0,3,7,1070,0,1947,0,98155,47.7532,-122.318,1500,8775,8,11,2014,UNK,-430,975
5437200050,11/20/2014,560000.0,4,2.0,2720,8819,2.0,0.0,3.0,3,8,2240,480,1976,0,98003,47.338,-122.333,2960,9672,11,20,2014,UNK,-240,-853
3885806565,1/30/2015,1340000.0,4,3.5,2980,6349,2.0,0.0,3.0,3,9,2980,0,1998,0,98033,47.6819,-122.208,2870,6349,1,30,2015,UNK,110,0
8651443190,12/4/2014,199500.0,3,1.75,1160,5200,1.0,0.0,0.0,4,7,1160,0,1977,0,98042,47.3643,-122.09,1470,5200,12,4,2014,UNK,-310,0
1722069145,12/23/2014,760000.0,4,2.5,3580,97574,2.0,0.0,0.0,3,9,3580,0,2004,0,98038,47.3901,-122.071,2510,27068,12,23,2014,N,1070,70506
7883605985,3/30/2015,439000.0,3,2.25,3020,6000,3.0,0.0,2.0,3,8,1980,1040,1994,0,98108,47.5249,-122.319,1150,6000,3,30,2015,UNK,1870,0
4038700190,9/30/2014,527000.0,4,2.25,2380,5250,1.0,0.0,0.0,4,7,1410,970,1961,0,98008,47.6164,-122.115,2150,8560,9,30,2014,UNK,230,-3310
8661000089,7/16/2014,199950.0,3,2.75,2270,13590,1.5,0.0,0.0,4,6,1300,970,1948,0,98022,47.2099,-122.001,1160,13545,7,16,2014,UNK,1110,45
2329800430,2/4/2015,254000.0,3,2.25,1660,8188,2.0,0.0,0.0,4,7,1660,0,1988,0,98042,47.3766,-122.115,1660,7000,2,4,2015,UNK,0,1188
6431500280,3/23/2015,393000.0,2,1.0,830,5000,1.0,0.0,0.0,4,7,830,0,1921,0,98103,47.6914,-122.352,1110,5000,3,23,2015,UNK,-280,0
6204430250,11/21/2014,585000.0,5,2.25,2480,12614,1.0,0.0,0.0,4,8,1860,620,1979,0,98011,47.7393,-122.2,2470,12392,11,21,2014,UNK,10,222
4365200630,7/16/2014,450000.0,2,2.0,1900,7740,1.0,0.0,0.0,4,7,1150,750,1923,0,98126,47.5227,-122.37200000000001,1140,7740,7,16,2014,UNK,760,0
3630120050,6/25/2014,565000.0,2,1.75,1670,4008,1.0,0.0,0.0,3,9,1670,0,2005,0,98029,47.5539,-122.001,2330,3752,6,25,2014,N,-660,256
7844200050,5/22/2014,330000.0,5,2.25,2000,7900,1.0,0.0,0.0,4,7,1300,700,1986,0,98188,47.4291,-122.292,2000,9132,5,22,2014,UNK,0,-1232
1240700006,5/11/2015,870000.0,3,2.0,2320,65340,1.5,0.0,0.0,3,9,2320,0,1992,0,98074,47.6106,-122.055,3100,59603,5,11,2015,UNK,-780,5737
8563000470,7/23/2014,585000.0,4,2.5,1860,8117,1.0,0.0,0.0,4,8,1460,400,1966,0,98008,47.6228,-122.104,2040,8199,7,23,2014,UNK,-180,-82
3221069091,11/6/2014,500000.0,3,2.5,2110,208737,2.0,0.0,3.0,3,9,2110,0,1977,0,98092,47.2674,-122.072,2390,125017,11,6,2014,UNK,-280,83720
8645530010,5/15/2014,225000.0,3,2.0,1400,7384,1.0,0.0,0.0,3,7,1150,250,1979,0,98058,47.4655,-122.17399999999999,1820,7992,5,15,2014,UNK,-420,-608
8645530010,3/25/2015,295000.0,3,2.0,1400,7384,1.0,0.0,0.0,3,7,1150,250,1979,0,98058,47.4655,-122.17399999999999,1820,7992,3,25,2015,UNK,-420,-608
2141300420,6/26/2014,775000.0,3,2.75,2850,14800,1.0,0.0,0.0,4,9,1920,930,1976,0,98006,47.559,-122.146,3300,10809,6,26,2014,UNK,-450,3991
9407101900,7/17/2014,280000.0,3,1.0,1370,11050,1.0,0.0,0.0,3,7,1370,0,1981,0,98045,47.4485,-121.77600000000001,1520,10000,7,17,2014,UNK,-150,1050
1931300425,9/8/2014,539000.0,3,2.5,2170,3200,1.5,0.0,0.0,5,7,1280,890,1923,0,98103,47.6543,-122.34700000000001,1180,1224,9,8,2014,UNK,990,1976
9290800050,3/24/2015,567500.0,3,1.75,2570,14033,1.0,0.0,2.0,4,8,2570,0,1953,0,98166,47.4335,-122.338,2550,16100,3,24,2015,UNK,20,-2067
9421500010,2/5/2015,442500.0,4,2.25,1970,7902,1.0,0.0,0.0,3,8,1310,660,1960,0,98125,47.7249,-122.29799999999999,1860,8021,2,5,2015,UNK,110,-119
3333500151,5/7/2015,598200.0,5,3.75,2980,4635,3.0,0.0,0.0,3,8,2980,0,1997,0,98118,47.5508,-122.26799999999999,1100,5150,5,7,2015,UNK,1880,-515
3759500006,10/14/2014,610000.0,4,2.5,2300,10843,2.0,0.0,0.0,5,8,2300,0,1955,0,98033,47.6988,-122.20200000000001,1780,10843,10,14,2014,UNK,520,0
4221270290,11/21/2014,544900.0,3,2.5,1990,4936,2.0,0.0,0.0,3,8,1990,0,2004,0,98075,47.5911,-122.01799999999999,2250,4815,11,21,2014,N,-260,121
1775801405,12/16/2014,557500.0,4,2.5,2390,38258,2.0,0.0,0.0,3,8,2390,0,2001,0,98072,47.7433,-122.094,1960,17113,12,16,2014,UNK,430,21145
3575302575,8/11/2014,532500.0,3,2.5,2160,7500,1.0,0.0,1.0,3,7,1430,730,1979,0,98074,47.6188,-122.064,1560,7500,8,11,2014,UNK,600,0
2581300010,6/9/2014,1350000.0,4,3.25,3300,15907,2.0,0.0,0.0,5,10,3300,0,1985,0,98040,47.5413,-122.21600000000001,2740,11358,6,9,2014,UNK,560,4549
8805900080,4/30/2015,750000.0,3,2.0,1840,2825,1.0,0.0,0.0,3,7,1040,800,1920,0,98112,47.6428,-122.302,1820,3750,4,30,2015,UNK,20,-925
8121200460,11/19/2014,530000.0,3,2.5,2030,10958,2.0,0.0,0.0,3,8,2030,0,1983,0,98052,47.7251,-122.11,1960,10282,11,19,2014,UNK,70,676
2461900609,7/17/2014,346100.0,3,2.5,1400,2036,2.0,0.0,0.0,3,7,1400,0,2003,0,98136,47.5516,-122.382,1500,2036,7,17,2014,UNK,-100,0
3298600440,8/10/2014,260000.0,4,2.25,2320,16800,2.0,0.0,0.0,4,9,2320,0,1977,0,98092,47.2959,-122.166,2700,15680,8,10,2014,UNK,-380,1120
643300010,8/29/2014,365000.0,3,1.75,1410,9150,1.0,0.0,0.0,5,7,1410,0,1959,0,98006,47.5683,-122.178,1800,9940,8,29,2014,UNK,-390,-790
224069102,9/8/2014,615000.0,3,2.0,1860,42800,1.0,0.0,0.0,4,7,930,930,1983,0,98075,47.5898,-122.00399999999999,1980,11250,9,8,2014,UNK,-120,31550
8856960050,7/24/2014,318400.0,4,2.5,1820,6916,2.0,0.0,0.0,3,7,1820,0,1994,0,98038,47.3862,-122.029,1680,6995,7,24,2014,UNK,140,-79
4024101478,3/3/2015,498500.0,4,2.5,1910,7172,2.0,0.0,0.0,3,8,1910,0,1993,0,98155,47.7615,-122.309,1630,10127,3,3,2015,UNK,280,-2955
1839910470,4/8/2015,450000.0,3,1.75,1540,7490,1.0,0.0,0.0,5,7,1540,0,1971,0,98034,47.7222,-122.177,1270,7350,4,8,2015,UNK,270,140
3668000670,3/27/2015,200000.0,3,2.0,1430,7905,1.0,0.0,0.0,4,7,1430,0,1988,0,98092,47.2757,-122.145,1870,8400,3,27,2015,UNK,-440,-495
1274500420,9/9/2014,234000.0,3,1.0,1010,8906,1.0,0.0,0.0,5,7,1010,0,1968,0,98042,47.3627,-122.10799999999999,1150,10414,9,9,2014,UNK,-140,-1508
8151600470,8/4/2014,121800.0,2,1.0,940,8384,1.0,0.0,0.0,3,5,940,0,1947,0,98146,47.5065,-122.36399999999999,1290,8384,8,4,2014,UNK,-350,0
56000095,6/26/2014,805000.0,3,2.75,2600,5875,1.5,0.0,2.0,5,8,1600,1000,1929,0,98116,47.5773,-122.406,2260,5492,6,26,2014,UNK,340,383
3432500980,7/8/2014,410000.0,4,2.25,2060,7283,1.0,0.0,0.0,3,8,1220,840,1963,2013,98155,47.7435,-122.31700000000001,1500,8134,7,8,2014,Y,560,-851
7940700050,2/18/2015,475000.0,3,2.5,1920,4534,2.0,0.0,0.0,3,8,1920,0,1986,0,98034,47.7144,-122.204,1380,5100,2,18,2015,UNK,540,-566
1025039292,10/30/2014,1340000.0,4,2.5,2900,21074,2.0,0.0,0.0,3,11,2900,0,1986,0,98199,47.6696,-122.416,3390,20000,10,30,2014,UNK,-490,1074
3438503140,9/18/2014,269000.0,1,1.0,1020,7920,1.0,0.0,0.0,3,7,1020,0,1947,1983,98106,47.5385,-122.355,1000,7168,9,18,2014,Y,20,752
7558750190,7/24/2014,573000.0,4,2.25,2150,9520,2.0,0.0,0.0,4,8,2150,0,1979,0,98052,47.6885,-122.113,2000,9520,7,24,2014,UNK,150,0
3395040440,3/27/2015,330000.0,3,2.5,1660,2890,2.0,0.0,0.0,3,7,1660,0,2001,0,98108,47.5434,-122.29299999999999,1540,2890,3,27,2015,UNK,120,0
4338800190,6/26/2014,252750.0,4,1.0,1230,7410,1.5,0.0,0.0,3,7,1230,0,1944,0,98166,47.4798,-122.344,1020,7648,6,26,2014,UNK,210,-238
8682290670,4/6/2015,745000.0,2,2.5,2170,7546,1.0,0.0,0.0,3,8,2170,0,2007,0,98053,47.7242,-122.03200000000001,2170,7083,4,6,2015,N,0,463
5113260430,3/4/2015,280000.0,3,2.0,1280,7633,1.0,0.0,0.0,3,7,1280,0,1991,0,98038,47.3883,-122.05,1450,6783,3,4,2015,UNK,-170,850
387000190,4/30/2015,535000.0,4,2.5,2240,6920,1.0,0.0,0.0,5,8,1380,860,1974,0,98146,47.5011,-122.375,1540,7000,4,30,2015,UNK,700,-80
6844703135,3/12/2015,580000.0,4,1.5,1780,5100,1.0,0.0,0.0,3,7,1320,0,1953,0,98115,47.6944,-122.288,1880,5100,3,12,2015,UNK,-100,0
8899000190,12/12/2014,301000.0,3,1.75,1840,7200,1.0,0.0,0.0,4,7,1220,620,1968,0,98055,47.456,-122.209,1770,8075,12,12,2014,UNK,70,-875
3275760190,6/24/2014,600000.0,4,1.75,1740,7700,1.0,0.0,0.0,5,7,1740,0,1968,0,98008,47.6259,-122.111,1740,8120,6,24,2014,UNK,0,-420
3438500924,8/11/2014,538900.0,5,3.0,3040,6604,2.0,0.0,0.0,3,9,3040,0,2005,0,98106,47.548,-122.35600000000001,1650,6825,8,11,2014,N,1390,-221
5104530430,2/9/2015,366000.0,3,2.5,2370,4375,2.0,0.0,0.0,3,8,2370,0,2006,0,98038,47.354,-121.999,2380,4606,2,9,2015,N,-10,-231
5468770250,8/19/2014,303000.0,4,2.5,2100,6783,2.0,0.0,0.0,3,8,2100,0,2003,0,98042,47.3504,-122.141,2100,6192,8,19,2014,UNK,0,591
4318200440,5/22/2014,432000.0,3,2.25,1470,1578,2.0,0.0,0.0,3,8,1090,380,2007,0,98136,47.5388,-122.387,1470,1668,5,22,2014,N,0,-90
1721800190,4/9/2015,300000.0,2,1.5,1300,6120,1.0,0.0,0.0,3,6,820,480,1945,0,98146,47.5088,-122.338,1250,6120,4,9,2015,UNK,50,0
1250202285,10/20/2014,908800.0,3,3.0,3420,7826,2.0,0.0,0.0,4,8,2430,990,1939,0,98144,47.5873,-122.29,980,6300,10,20,2014,UNK,2440,1526
2767602945,6/25/2014,500000.0,3,1.5,1190,4750,1.0,0.0,0.0,3,7,970,220,1940,0,98107,47.6726,-122.38600000000001,1460,4750,6,25,2014,UNK,-270,0
321049090,6/26/2014,254000.0,5,2.0,2080,16117,1.0,0.0,0.0,5,7,1740,340,1959,0,98001,47.3424,-122.289,1510,13068,6,26,2014,UNK,570,3049
4443801495,9/17/2014,470000.0,5,1.5,2180,4268,1.5,0.0,0.0,4,7,1340,840,1924,0,98117,47.6848,-122.389,1530,3880,9,17,2014,UNK,650,388
3275750290,3/17/2015,480000.0,3,2.0,1460,7860,1.0,0.0,0.0,5,7,1460,0,1967,0,98008,47.6233,-122.10799999999999,1850,8148,3,17,2015,UNK,-390,-288
2273600460,1/30/2015,536000.0,3,1.75,1530,8503,1.0,0.0,0.0,4,7,1150,380,1983,0,98033,47.6872,-122.185,1610,8549,1,30,2015,UNK,-80,-46
8562720420,4/30/2015,1350000.0,4,3.5,4740,8611,2.0,0.0,3.0,3,11,3640,1100,2006,0,98027,47.5375,-122.07,4042,8321,4,30,2015,N,698,290
1330900250,5/15/2014,550000.0,3,2.25,1980,40887,1.0,0.0,0.0,4,8,1980,0,1980,0,98052,47.6478,-122.029,2460,35700,5,15,2014,UNK,-480,5187
1099600250,12/2/2014,260000.0,3,1.75,1710,6400,1.0,0.0,0.0,4,7,1240,470,1976,0,98023,47.3036,-122.37700000000001,1600,6400,12,2,2014,UNK,110,0
1445200190,4/24/2015,284900.0,2,1.5,1160,982,2.0,0.0,0.0,3,7,890,0,2006,0,98155,47.7675,-122.315,1160,1008,4,24,2015,N,0,-26
1929300052,10/29/2014,740000.0,3,2.5,2200,3000,2.0,0.0,0.0,3,9,1530,670,2002,0,98109,47.6451,-122.35,2200,3300,10,29,2014,UNK,0,-300
7626200280,10/2/2014,425000.0,2,1.0,1170,5000,1.0,0.0,0.0,4,7,1030,140,1920,0,98136,47.5449,-122.38799999999999,1170,5850,10,2,2014,UNK,0,-850
7211402115,9/2/2014,230000.0,3,1.0,1120,7500,1.0,0.0,0.0,3,7,1120,0,1965,0,98146,47.5112,-122.359,1120,5000,9,2,2014,UNK,0,2500
324000280,4/13/2015,675000.0,3,1.5,1710,4000,2.0,0.0,0.0,3,8,1710,0,1926,0,98116,47.5714,-122.385,1910,4000,4,13,2015,UNK,-200,0
8091410080,7/29/2014,267500.0,3,1.75,1650,7807,1.0,0.0,0.0,3,7,1650,0,1986,0,98030,47.3514,-122.167,1810,8475,7,29,2014,UNK,-160,-668
6616000010,8/25/2014,814000.0,4,2.5,2840,8820,1.0,0.0,2.0,5,8,1420,1420,1952,0,98118,47.5542,-122.265,2310,8750,8,25,2014,UNK,530,70
1125069102,4/27/2015,1250000.0,4,3.0,3310,217800,1.5,0.0,0.0,3,9,3310,0,1989,0,98053,47.6616,-121.999,2810,217800,4,27,2015,UNK,500,0
6413600151,9/16/2014,460000.0,3,2.0,1860,7232,1.0,0.0,0.0,3,7,1320,540,1985,0,98125,47.7165,-122.319,1830,7220,9,16,2014,UNK,30,12
2607720420,1/20/2015,445000.0,3,2.5,2250,9608,2.0,0.0,0.0,3,8,2250,0,1994,0,98045,47.4865,-121.802,2020,9834,1,20,2015,UNK,230,-226
1854900470,9/24/2014,715000.0,3,2.5,2890,7027,2.0,0.0,0.0,3,8,2890,0,2004,0,98074,47.6111,-122.009,2890,7197,9,24,2014,N,0,-170
8901000911,2/19/2015,425000.0,3,1.75,2120,5992,1.0,0.0,0.0,3,7,1060,1060,1947,0,98125,47.7083,-122.30799999999999,1840,11000,2,19,2015,UNK,280,-5008
3709600190,7/15/2014,370000.0,4,2.5,2130,4750,2.0,0.0,0.0,3,8,2130,0,2009,0,98058,47.4324,-122.184,2130,4071,7,15,2014,N,0,679
537000255,4/29/2015,302000.0,2,1.75,1170,8200,1.0,0.0,0.0,4,6,780,390,1937,0,98003,47.3263,-122.305,1780,9020,4,29,2015,UNK,-610,-820
4036800170,6/23/2014,453000.0,4,1.75,2120,7420,1.0,0.0,0.0,4,7,1060,1060,1956,0,98008,47.6019,-122.13,1540,7420,6,23,2014,UNK,580,0
5127100190,5/20/2014,290000.0,3,1.75,1280,10716,1.0,0.0,0.0,4,7,1280,0,1969,0,98059,47.4755,-122.145,1440,9870,5,20,2014,UNK,-160,846
1762600190,12/29/2014,1040000.0,4,2.5,3170,47502,2.0,0.0,0.0,3,10,3170,0,1988,0,98033,47.6495,-122.185,3190,35110,12,29,2014,UNK,-20,12392
7796100080,5/20/2014,925000.0,4,2.25,2260,41984,1.0,0.0,0.0,4,9,2260,0,1967,0,98033,47.6622,-122.171,2650,37318,5,20,2014,UNK,-390,4666
9465910190,5/29/2014,600000.0,3,1.75,2930,19876,1.0,0.0,0.0,3,9,2030,900,1993,0,98072,47.7443,-122.17,2740,11499,5,29,2014,UNK,190,8377
9284801845,8/5/2014,354000.0,3,1.5,1060,5750,1.0,0.0,2.0,4,7,1060,0,1981,0,98126,47.5512,-122.37100000000001,1060,5750,8,5,2014,UNK,0,0
3210200373,6/17/2014,204950.0,4,1.75,1740,9344,1.0,0.0,0.0,3,7,1180,560,1978,0,98023,47.3196,-122.399,1440,12884,6,17,2014,UNK,300,-3540
1854900430,4/22/2015,675000.0,4,2.5,2990,5400,2.0,0.0,0.0,3,8,2990,0,2005,0,98074,47.6122,-122.009,2890,6538,4,22,2015,N,100,-1138
2944000050,4/22/2015,995000.0,4,3.25,3530,20012,2.0,0.0,0.0,3,11,3530,0,1986,0,98052,47.7193,-122.12700000000001,3850,20707,4,22,2015,UNK,-320,-695
7971300020,3/31/2015,800000.0,5,2.0,2960,10960,1.0,0.0,0.0,4,7,1500,1460,1957,0,98005,47.6162,-122.17399999999999,2160,10960,3,31,2015,UNK,800,0
1542800010,9/9/2014,472500.0,3,2.5,1650,3711,2.0,0.0,0.0,3,8,1650,0,1996,0,98052,47.6863,-122.09299999999999,1760,3762,9,9,2014,UNK,-110,-51
1433500050,12/2/2014,549950.0,4,2.5,2720,13500,1.0,0.0,0.0,3,8,1510,1210,1969,0,98007,47.6191,-122.145,2510,12350,12,2,2014,UNK,210,1150
9482700080,10/13/2014,575575.0,3,1.75,1516,2897,1.0,0.0,0.0,3,7,998,518,1925,0,98103,47.6842,-122.34100000000001,2100,3854,10,13,2014,UNK,-584,-957
3303870050,3/3/2015,545000.0,4,3.25,4386,12275,1.0,0.0,0.0,3,10,2356,2030,2006,0,98092,47.3329,-122.2,3060,10925,3,3,2015,N,1326,1350
2071700010,11/19/2014,340000.0,3,2.25,2580,7434,1.0,0.0,0.0,3,7,1630,950,1963,0,98133,47.7446,-122.33200000000001,1920,7737,11,19,2014,UNK,660,-303
421000430,3/31/2015,225000.0,3,1.0,960,5512,1.0,0.0,0.0,4,6,960,0,1963,0,98056,47.4944,-122.165,1090,5837,3,31,2015,UNK,-130,-325
2787460430,10/28/2014,299950.0,2,1.75,1460,10506,1.0,0.0,0.0,3,7,1460,0,1983,0,98031,47.4048,-122.178,1460,8153,10,28,2014,UNK,0,2353
2436200185,2/23/2015,829900.0,4,3.5,3840,4000,2.0,0.0,0.0,3,8,2640,1200,2001,0,98105,47.6642,-122.291,1620,4000,2,23,2015,UNK,2220,0
9542830440,3/30/2015,340000.0,4,2.5,2090,4200,2.0,0.0,0.0,3,7,2090,0,2007,0,98038,47.3659,-122.01700000000001,2090,4200,3,30,2015,N,0,0
23500190,10/8/2014,515000.0,4,2.25,2470,7800,1.0,0.0,0.0,3,8,1470,1000,1975,0,98052,47.6913,-122.115,2050,8050,10,8,2014,UNK,420,-250
3905030190,7/11/2014,601000.0,4,2.5,2090,6906,2.0,0.0,0.0,4,8,2090,0,1992,0,98029,47.5718,-121.99600000000001,2090,6370,7,11,2014,UNK,0,536
8079050010,5/4/2015,470000.0,3,2.5,2070,8581,2.0,0.0,0.0,3,8,2070,0,1994,0,98059,47.5101,-122.15100000000001,2440,7849,5,4,2015,UNK,-370,732
3172600095,7/8/2014,371500.0,3,1.0,1650,6400,1.0,0.0,0.0,4,7,980,670,1954,0,98106,47.52,-122.365,1230,6400,7,8,2014,UNK,420,0
126059242,11/19/2014,550000.0,3,1.75,1880,45738,1.0,0.0,0.0,4,8,1410,470,1980,0,98072,47.7662,-122.11399999999999,2340,38556,11,19,2014,UNK,-460,7182
2944510080,12/14/2014,242550.0,4,2.5,2060,7720,2.0,0.0,0.0,3,8,2060,0,1995,0,98023,47.2956,-122.374,1630,7720,12,14,2014,UNK,430,0
7019000050,5/6/2014,367500.0,3,1.5,1410,9647,1.0,0.0,0.0,3,8,1410,0,1961,0,98177,47.7608,-122.361,2090,9272,5,6,2014,UNK,-680,375
7212680460,9/24/2014,359000.0,4,3.5,2770,8763,2.0,0.0,0.0,3,8,2100,670,1996,0,98003,47.2625,-122.30799999999999,2030,7242,9,24,2014,UNK,740,1521
5706600170,3/11/2015,204900.0,3,2.0,1390,8245,1.0,0.0,0.0,2,7,1390,0,1984,0,98001,47.2669,-122.25399999999999,1260,8245,3,11,2015,UNK,130,0
3322049005,9/30/2014,850000.0,4,2.75,5440,239580,1.0,0.0,0.0,2,9,2720,2720,1969,0,98001,47.354,-122.29299999999999,1970,40392,9,30,2014,UNK,3470,199188
7338000950,10/21/2014,187000.0,3,1.5,1280,4452,2.0,0.0,0.0,3,6,1280,0,1985,0,98002,47.3344,-122.21600000000001,1070,4366,10,21,2014,UNK,210,86
3323059027,5/28/2014,326000.0,3,2.75,1720,28000,1.0,0.0,0.0,4,7,1720,0,1958,0,98058,47.4375,-122.176,2000,41817,5,28,2014,UNK,-280,-13817
3323059027,2/25/2015,340000.0,3,2.75,1720,28000,1.0,0.0,0.0,4,7,1720,0,1958,0,98058,47.4375,-122.176,2000,41817,2,25,2015,UNK,-280,-13817
5502700005,6/25/2014,330000.0,6,2.25,3040,28535,1.0,0.0,0.0,3,8,1890,1150,1951,0,98030,47.3864,-122.223,1360,8250,6,25,2014,UNK,1680,20285
7205930050,1/2/2015,782000.0,4,3.5,3780,7769,2.0,0.0,0.0,3,9,3110,670,2001,0,98052,47.691,-122.12899999999999,3310,7945,1,2,2015,UNK,470,-176
1853200190,11/3/2014,612000.0,4,2.5,2670,5974,2.0,0.0,0.0,3,8,2670,0,1999,0,98034,47.7122,-122.23100000000001,2140,5729,11,3,2014,UNK,530,245
2697400020,10/31/2014,400000.0,3,2.0,1350,7216,1.0,0.0,0.0,3,7,1350,0,1964,0,98177,47.7616,-122.365,1920,7600,10,31,2014,UNK,-570,-384
226039316,6/3/2014,941500.0,5,3.5,3490,9680,2.0,0.0,4.0,3,9,2460,1030,1980,0,98177,47.7757,-122.391,3080,13489,6,3,2014,UNK,410,-3809
3126049439,1/9/2015,313000.0,2,1.5,870,747,2.0,0.0,0.0,3,8,800,0,2004,0,98103,47.6967,-122.34200000000001,1710,1280,1,9,2015,N,-840,-533
3491300052,4/9/2015,735000.0,4,2.25,2410,4250,1.5,0.0,0.0,5,7,1460,950,1929,0,98117,47.6849,-122.376,1360,5074,4,9,2015,UNK,1050,-824
6662410020,3/19/2015,471000.0,3,1.75,1640,10123,1.0,0.0,0.0,3,8,1340,300,1977,0,98011,47.7698,-122.167,2210,10852,3,19,2015,UNK,-570,-729
6139100086,2/24/2015,350000.0,3,1.0,1540,9800,1.0,0.0,0.0,4,7,1540,0,1950,0,98155,47.7604,-122.329,1560,9450,2,24,2015,UNK,-20,350
5710610670,7/23/2014,530000.0,4,2.5,2370,9601,1.0,0.0,0.0,3,8,1570,800,1976,0,98027,47.5327,-122.054,2550,10500,7,23,2014,UNK,-180,-899
7503000020,5/7/2014,415000.0,4,3.0,1830,9548,2.0,0.0,0.0,3,7,1830,0,1991,0,98028,47.7379,-122.22399999999999,1740,9750,5,7,2014,UNK,90,-202
1795920440,6/21/2014,639500.0,4,2.25,2330,8994,2.0,0.0,0.0,3,8,2330,0,1986,0,98052,47.7264,-122.104,2330,8396,6,21,2014,UNK,0,598
3570000130,6/11/2014,580379.0,4,2.75,2240,27820,1.5,0.0,0.0,4,8,2240,0,1976,0,98075,47.5936,-122.054,2330,20000,6,11,2014,UNK,-90,7820
7853340430,11/19/2014,378000.0,2,2.5,1700,2513,2.0,0.0,0.0,3,8,1700,0,2009,0,98065,47.5163,-121.87799999999999,1760,2891,11,19,2014,N,-60,-378
2473380010,1/15/2015,265000.0,3,2.25,1750,9298,1.0,0.0,0.0,4,7,1410,340,1969,0,98058,47.4579,-122.164,1720,7875,1,15,2015,UNK,30,1423
3306300630,9/24/2014,212000.0,3,1.75,1100,9750,1.0,0.0,0.0,4,6,1100,0,1967,0,98023,47.2955,-122.36200000000001,1100,9900,9,24,2014,UNK,0,-150
3222049120,1/23/2015,400000.0,4,3.0,2320,13068,2.0,0.0,2.0,3,8,2320,0,1998,0,98198,47.3497,-122.31700000000001,2220,25265,1,23,2015,UNK,100,-12197
2425059173,2/6/2015,750000.0,4,2.5,2540,6491,2.0,0.0,0.0,3,8,2540,0,1997,0,98008,47.6363,-122.117,1990,8447,2,6,2015,UNK,550,-1956
1196000007,5/5/2014,384900.0,5,2.5,3090,12750,1.0,0.0,0.0,3,8,1750,1340,1968,0,98023,47.3408,-122.335,1760,25919,5,5,2014,UNK,1330,-13169
8651402910,8/6/2014,176000.0,2,1.0,770,5200,1.0,0.0,0.0,5,6,770,0,1969,0,98042,47.3627,-122.087,1150,5330,8,6,2014,UNK,-380,-130
3558000130,9/9/2014,350000.0,3,2.75,2370,4632,2.0,0.0,0.0,3,7,2370,0,2002,0,98038,47.3794,-122.022,2290,5012,9,9,2014,UNK,80,-380
3830210020,7/29/2014,168000.0,3,1.0,1200,7210,1.0,0.0,0.0,4,6,1200,0,1977,0,98030,47.3729,-122.18299999999999,1200,7650,7,29,2014,UNK,0,-440
7950302210,11/14/2014,358000.0,4,2.0,2200,3060,1.0,0.0,0.0,3,7,1100,1100,1908,0,98118,47.565,-122.28399999999999,1410,5100,11,14,2014,UNK,790,-2040
1774200190,4/28/2015,580000.0,3,2.75,2660,32757,1.0,0.0,0.0,4,8,2660,0,1975,0,98077,47.7649,-122.098,2720,35191,4,28,2015,UNK,-60,-2434
3715500170,6/23/2014,442500.0,3,1.75,1600,10280,1.0,0.0,0.0,3,7,1050,550,1977,0,98034,47.725,-122.17399999999999,1590,8100,6,23,2014,UNK,10,2180
2436700655,3/17/2015,515000.0,2,2.5,1330,1249,3.0,0.0,0.0,3,8,1330,0,2004,0,98105,47.6668,-122.285,1430,1328,3,17,2015,N,-100,-79
5072100095,11/17/2014,554000.0,5,2.5,3440,12900,1.0,0.0,2.0,4,8,1720,1720,1958,0,98166,47.4426,-122.34200000000001,2100,10751,11,17,2014,UNK,1340,2149
305000170,6/10/2014,659000.0,3,2.5,2510,6320,2.0,0.0,0.0,3,9,2510,0,1996,0,98075,47.5868,-122.03299999999999,2518,5819,6,10,2014,UNK,-8,501
2570300130,3/17/2015,414999.0,4,2.5,2150,10098,1.0,0.0,0.0,3,7,1090,1060,1963,0,98034,47.7166,-122.20100000000001,1880,10000,3,17,2015,UNK,270,98
776600130,5/2/2014,275000.0,3,1.5,1180,10277,1.0,0.0,0.0,3,6,1180,0,1983,0,98045,47.488,-121.787,1680,11104,5,2,2014,UNK,-500,-827
5379802181,11/19/2014,193000.0,2,1.0,680,8640,1.0,0.0,0.0,4,5,680,0,1951,0,98188,47.4559,-122.289,1320,13140,11,19,2014,UNK,-640,-4500
9558020380,8/20/2014,525000.0,4,2.5,2840,4750,2.0,0.0,0.0,3,9,2840,0,2002,0,98058,47.4511,-122.12100000000001,2460,4750,8,20,2014,UNK,380,0
3396830020,10/9/2014,424000.0,3,2.5,1820,7500,2.0,0.0,0.0,3,8,1820,0,1985,0,98052,47.7155,-122.104,2040,8304,10,9,2014,UNK,-220,-804
7519001825,1/8/2015,455000.0,2,1.0,1070,5150,1.0,0.0,0.0,4,6,870,200,1908,0,98117,47.6853,-122.366,1520,3860,1,8,2015,UNK,-450,1290
2324039069,8/22/2014,463000.0,2,1.0,1250,5650,2.0,0.0,1.0,4,7,1250,0,1943,0,98126,47.5495,-122.37700000000001,1210,5650,8,22,2014,UNK,40,0
1245500950,5/4/2015,1100000.0,4,2.5,2190,6300,1.0,0.0,3.0,3,7,1240,950,1960,0,98033,47.6918,-122.21600000000001,2730,14659,5,4,2015,UNK,-540,-8359
5100404030,12/8/2014,523000.0,3,1.75,3000,5413,2.0,0.0,0.0,4,8,1900,1100,1963,0,98115,47.6962,-122.31200000000001,1550,5413,12,8,2014,UNK,1450,0
9542000050,8/8/2014,615000.0,4,1.75,2270,9830,1.0,0.0,0.0,4,8,2270,0,1959,0,98005,47.5999,-122.176,2540,11990,8,8,2014,UNK,-270,-2160
5608000630,11/3/2014,1520000.0,4,4.0,4500,11795,2.0,0.0,0.0,3,12,4500,0,1991,0,98027,47.5533,-122.098,3930,11576,11,3,2014,UNK,570,219
475001235,8/8/2014,870000.0,5,4.0,3400,5000,2.0,0.0,0.0,3,8,2320,1080,1900,2013,98107,47.6655,-122.363,1910,5000,8,8,2014,Y,1490,0
2725069150,8/17/2014,710000.0,3,2.5,2830,9680,2.0,0.0,0.0,3,10,2830,0,1991,0,98074,47.6249,-122.024,2970,8691,8,17,2014,UNK,-140,989
9202000080,7/7/2014,215000.0,3,1.0,960,9563,1.0,0.0,0.0,5,7,960,0,1967,0,98023,47.2864,-122.35700000000001,1280,9600,7,7,2014,UNK,-320,-37
225039049,9/8/2014,590000.0,2,1.0,1530,6450,1.0,0.0,0.0,4,7,1530,0,1920,0,98117,47.6833,-122.398,1530,5000,9,8,2014,UNK,0,1450
2212500430,8/14/2014,323000.0,5,2.5,2500,13034,1.0,0.0,0.0,3,7,1300,1200,1962,0,98092,47.3343,-122.194,2440,13300,8,14,2014,UNK,60,-266
2473100010,7/22/2014,279000.0,4,2.0,1560,7569,1.5,0.0,0.0,4,7,1560,0,1966,0,98058,47.4496,-122.155,1480,8755,7,22,2014,UNK,80,-1186
2795000080,9/19/2014,535100.0,3,2.25,2070,7207,1.0,0.0,0.0,3,8,1720,350,1973,0,98177,47.7735,-122.37100000000001,2350,7980,9,19,2014,UNK,-280,-773
9541800010,10/27/2014,830000.0,5,2.25,2710,19800,1.0,0.0,0.0,5,9,1910,800,1959,0,98005,47.5958,-122.175,2120,16400,10,27,2014,UNK,590,3400
2619920010,7/3/2014,815000.0,4,2.5,3150,4203,2.0,0.0,0.0,3,9,3150,0,2002,0,98033,47.688,-122.164,3150,5169,7,3,2014,UNK,0,-966
4046400010,3/9/2015,535900.0,3,2.25,1880,10880,1.0,0.0,0.0,3,8,1480,400,1975,0,98008,47.5937,-122.116,2120,10240,3,9,2015,UNK,-240,640
7642200095,3/9/2015,230000.0,3,1.0,1250,8800,1.0,0.0,0.0,3,7,1250,0,1955,0,98146,47.497,-122.35700000000001,1480,8200,3,9,2015,UNK,-230,600
8899000430,2/17/2015,325500.0,4,1.75,2290,8142,1.0,0.0,0.0,4,7,1490,800,1969,0,98055,47.4564,-122.211,1840,8142,2,17,2015,UNK,450,0
8944750480,1/30/2015,359000.0,3,2.25,1990,4331,2.0,0.0,0.0,3,7,1990,0,1997,0,98056,47.4917,-122.167,1690,3688,1,30,2015,UNK,300,643
7852020660,5/9/2014,505000.0,3,2.5,2100,5824,2.0,0.0,2.0,3,8,2100,0,1999,0,98065,47.5334,-121.867,1890,4140,5,9,2014,UNK,210,1684
7789000080,9/30/2014,253905.0,3,1.0,940,8400,1.0,0.0,0.0,5,7,940,0,1958,0,98056,47.5112,-122.167,950,8400,9,30,2014,UNK,-10,0
6413100122,7/11/2014,369950.0,3,1.75,1640,4860,1.0,0.0,0.0,3,8,1200,440,1965,0,98125,47.7125,-122.32,1480,7200,7,11,2014,UNK,160,-2340
8856960280,1/21/2015,350000.0,3,2.25,1860,8378,2.0,0.0,0.0,3,7,1860,0,1995,0,98038,47.3875,-122.03200000000001,1870,8378,1,21,2015,UNK,-10,0
1868901190,8/7/2014,650000.0,4,2.25,2100,2500,3.0,0.0,0.0,3,8,2100,0,2001,0,98115,47.6726,-122.29799999999999,1660,4000,8,7,2014,UNK,440,-1500
3123039136,8/25/2014,295000.0,3,1.75,1500,15246,1.0,0.0,0.0,3,6,1500,0,1925,0,98070,47.4367,-122.463,1500,16988,8,25,2014,UNK,0,-1742
3585300415,5/7/2015,620000.0,3,1.75,1680,28046,1.0,0.0,3.0,3,8,1180,500,1948,0,98177,47.7648,-122.37,2190,26308,5,7,2015,UNK,-510,1738
2624089007,3/20/2015,2000000.0,2,2.5,3900,920423,2.0,0.0,0.0,3,12,3900,0,2009,0,98065,47.5371,-121.756,2720,411962,3,20,2015,N,1180,508461
4338800170,5/7/2014,246000.0,3,1.0,1400,7410,1.0,0.0,0.0,3,6,1400,0,1944,0,98166,47.4798,-122.34299999999999,1070,7410,5,7,2014,UNK,330,0
4046501300,9/16/2014,430000.0,3,2.75,2600,12860,1.0,0.0,0.0,3,7,1350,1250,1965,0,98014,47.695,-121.91799999999999,2260,12954,9,16,2014,UNK,340,-94
3331001995,1/23/2015,509990.0,3,2.0,1440,4859,2.0,0.0,0.0,2,6,1440,0,1921,0,98118,47.5503,-122.285,1360,4558,1,23,2015,UNK,80,301
802000130,12/9/2014,490000.0,4,1.75,1870,9500,1.0,0.0,0.0,4,7,1090,780,1962,0,98033,47.7012,-122.18700000000001,2010,10000,12,9,2014,UNK,-140,-500
2011400779,12/2/2014,385000.0,4,2.75,2960,10454,1.0,0.0,1.0,3,8,2360,600,1979,0,98198,47.4006,-122.322,1870,10500,12,2,2014,UNK,1090,-46
8651610660,4/29/2015,769000.0,4,2.5,2440,6733,2.0,0.0,0.0,3,9,2440,0,1999,0,98074,47.6374,-122.064,2570,6496,4,29,2015,UNK,-130,237
1788900380,2/12/2015,185000.0,2,1.0,1122,9100,1.0,0.0,0.0,4,6,1122,0,1960,0,98023,47.328,-122.34100000000001,840,9344,2,12,2015,UNK,282,-244
2121000250,5/9/2014,303500.0,3,1.5,1060,10464,1.0,0.0,0.0,4,7,1060,0,1973,0,98034,47.7313,-122.229,1420,10464,5,9,2014,UNK,-360,0
2110900050,2/11/2015,468000.0,4,2.5,2150,8165,1.0,0.0,0.0,3,8,1430,720,1957,0,98177,47.773,-122.37100000000001,2360,7980,2,11,2015,UNK,-210,185
5469503280,7/21/2014,449950.0,4,2.5,3100,10000,2.0,0.0,0.0,3,9,3100,0,1978,0,98042,47.3741,-122.15,1850,9438,7,21,2014,UNK,1250,562
6300000364,6/16/2014,235000.0,2,1.5,880,1805,2.0,0.0,0.0,3,7,880,0,1999,0,98133,47.7064,-122.34200000000001,880,5060,6,16,2014,UNK,0,-3255
2616800050,12/2/2014,520000.0,4,2.5,2490,34947,2.0,0.0,0.0,3,9,2150,340,1985,0,98027,47.4823,-122.031,2490,39639,12,2,2014,UNK,0,-4692
1446400648,11/6/2014,203000.0,2,1.0,1080,9067,1.0,0.0,0.0,3,6,1080,0,1951,0,98168,47.4815,-122.331,1080,6647,11,6,2014,UNK,0,2420
4038700380,8/26/2014,657000.0,5,2.5,2530,10190,1.0,0.0,0.0,4,7,1290,1240,1960,0,98008,47.61600000000001,-122.115,2040,8560,8,26,2014,UNK,490,1630
9109000050,7/9/2014,275000.0,3,1.0,1200,7800,1.0,0.0,0.0,4,7,1200,0,1954,0,98126,47.5196,-122.37100000000001,1230,7070,7,9,2014,UNK,-30,730
9465910380,10/24/2014,540000.0,4,2.25,2850,7453,2.0,0.0,0.0,3,9,2850,0,1991,0,98072,47.7439,-122.17399999999999,2700,8468,10,24,2014,UNK,150,-1015
1137400460,6/24/2014,455000.0,4,2.5,2950,4502,2.0,0.0,0.0,3,7,2950,0,2005,0,98059,47.5002,-122.15100000000001,2360,4502,6,24,2014,N,590,0
2545700020,10/16/2014,458500.0,2,1.75,1160,6828,1.0,0.0,0.0,3,7,860,300,1941,0,98115,47.6937,-122.29799999999999,1250,6828,10,16,2014,UNK,-90,0
3260570290,4/24/2015,549900.0,4,3.5,3420,4751,2.0,0.0,0.0,3,10,3420,0,2003,0,98055,47.4734,-122.193,3490,5700,4,24,2015,UNK,-70,-949
5652600185,5/2/2014,750000.0,3,1.75,2240,10578,2.0,0.0,0.0,5,8,1550,690,1923,0,98115,47.6954,-122.292,1570,10578,5,2,2014,UNK,670,0
7347600507,6/23/2014,235000.0,4,1.75,1450,8891,1.5,0.0,0.0,3,7,1180,270,1962,0,98168,47.478,-122.27799999999999,1450,9013,6,23,2014,UNK,0,-122
1545802850,9/11/2014,286000.0,4,2.5,1820,7930,2.0,0.0,0.0,5,7,1820,0,1989,0,98038,47.358999999999995,-122.05,1490,7930,9,11,2014,UNK,330,0
3126059027,3/18/2015,2650000.0,4,3.5,4700,13730,2.0,0.0,3.0,3,11,3500,1200,1958,1995,98033,47.6899,-122.21700000000001,3210,15306,3,18,2015,Y,1490,-1576
8087800430,2/10/2015,602000.0,4,1.75,2430,14000,1.0,0.0,0.0,4,7,1580,850,1963,0,98052,47.6554,-122.134,1910,8285,2,10,2015,UNK,520,5715
9547200460,8/20/2014,640000.0,3,1.5,1960,4080,1.5,0.0,0.0,3,7,1960,0,1915,0,98115,47.6768,-122.31,1880,4080,8,20,2014,UNK,80,0
3826501060,10/9/2014,267000.0,3,1.75,1440,10920,1.0,0.0,0.0,4,8,1440,0,1977,0,98030,47.3812,-122.16799999999999,1720,8260,10,9,2014,UNK,-280,2660
5406500430,4/21/2015,712000.0,4,2.5,2730,4385,2.0,0.0,0.0,3,8,2730,0,2001,0,98075,47.5975,-122.038,2670,4644,4,21,2015,UNK,60,-259
5417600130,10/10/2014,244500.0,2,1.0,910,9000,1.0,0.0,0.0,3,5,910,0,1923,0,98065,47.526,-121.81,1290,9000,10,10,2014,UNK,-380,0
5417600130,5/12/2015,301000.0,2,1.0,910,9000,1.0,0.0,0.0,3,5,910,0,1923,0,98065,47.526,-121.81,1290,9000,5,12,2015,UNK,-380,0
2138700345,8/18/2014,990000.0,4,2.5,2430,6325,2.0,0.0,0.0,4,8,2020,410,1919,0,98109,47.6413,-122.354,2340,4375,8,18,2014,UNK,90,1950
5611500170,4/22/2015,739999.0,4,2.75,3350,6500,2.0,0.0,0.0,3,10,3350,0,1999,0,98075,47.5838,-122.027,2960,6970,4,22,2015,UNK,390,-470
5700002125,6/10/2014,480000.0,4,1.75,2320,4322,1.0,0.0,0.0,3,7,1140,1180,1910,0,98144,47.5755,-122.289,1820,4322,6,10,2014,UNK,500,0
1473200170,7/29/2014,305000.0,3,2.5,1260,1622,3.0,0.0,0.0,3,8,1260,0,2009,0,98133,47.7325,-122.34299999999999,1340,1188,7,29,2014,N,-80,434
2922702965,1/15/2015,703300.0,3,2.0,1980,3525,1.5,0.0,0.0,4,8,1590,390,1932,0,98117,47.6847,-122.368,1760,3760,1,15,2015,UNK,220,-235
7895500290,3/30/2015,265000.0,4,1.5,1580,8468,2.0,0.0,0.0,4,7,1580,0,1971,0,98001,47.3336,-122.281,1580,8260,3,30,2015,UNK,0,208
7338200170,4/22/2015,600000.0,4,2.5,2710,35009,2.0,0.0,2.0,3,9,2710,0,1992,0,98045,47.4815,-121.714,2330,35040,4,22,2015,UNK,380,-31
6929603769,7/21/2014,253000.0,3,1.0,1400,9750,1.0,0.0,0.0,3,7,1400,0,1968,1998,98198,47.3862,-122.304,1640,8050,7,21,2014,Y,-240,1700
9429000170,3/26/2015,617950.0,4,2.5,2410,7950,2.0,0.0,0.0,3,8,2410,0,1997,0,98034,47.7185,-122.226,1920,7713,3,26,2015,UNK,490,237
2114700190,12/12/2014,385000.0,4,3.25,1790,2460,2.0,0.0,0.0,4,7,1100,690,2000,0,98106,47.534,-122.346,1260,4040,12,12,2014,UNK,530,-1580
323049148,12/19/2014,319000.0,3,2.0,1640,9234,1.0,0.0,0.0,5,7,1060,580,1967,0,98118,47.5162,-122.274,2230,10354,12,19,2014,UNK,-590,-1120
4038700290,4/23/2015,696000.0,3,2.5,1670,8023,1.0,0.0,0.0,5,7,1170,500,1960,0,98008,47.615,-122.117,1960,8964,4,23,2015,UNK,-290,-941
9284802045,6/30/2014,345000.0,2,1.0,970,5750,1.0,0.0,0.0,4,6,970,0,1932,0,98126,47.5518,-122.37,1650,8625,6,30,2014,UNK,-680,-2875
3188100007,10/22/2014,380000.0,3,2.5,1610,1778,3.0,0.0,0.0,3,7,1610,0,2002,0,98115,47.6902,-122.306,1120,2187,10,22,2014,UNK,490,-409
1200019,5/8/2014,647500.0,4,1.75,2060,26036,1.0,0.0,0.0,4,8,1160,900,1947,0,98166,47.4444,-122.351,2590,21891,5,8,2014,UNK,-530,4145
2616800480,9/25/2014,725000.0,3,2.5,3570,35271,2.0,0.0,0.0,3,9,3570,0,1997,0,98027,47.4782,-122.035,3510,37194,9,25,2014,UNK,60,-1923
2310000380,12/19/2014,269950.0,3,1.75,1400,7735,1.0,0.0,0.0,4,7,1400,0,1989,0,98038,47.357,-122.04,1530,7754,12,19,2014,UNK,-130,-19
4054560170,6/11/2014,875000.0,4,2.5,3470,32109,2.0,0.0,0.0,3,10,3470,0,1995,0,98077,47.7311,-122.036,3800,35181,6,11,2014,UNK,-330,-3072
7972601900,5/30/2014,299950.0,3,1.0,1210,9525,1.0,0.0,0.0,3,7,1210,0,1955,0,98106,47.5274,-122.345,1680,7620,5,30,2014,UNK,-470,1905
3391500050,7/3/2014,1880000.0,4,3.25,3930,10929,2.0,0.0,0.0,3,10,3930,0,2006,0,98004,47.6259,-122.194,1780,9999,7,3,2014,N,2150,930
8132700190,6/2/2014,430000.0,2,1.0,990,4802,1.0,0.0,0.0,3,7,990,0,1947,0,98117,47.6876,-122.395,1180,5000,6,2,2014,UNK,-190,-198
3904990430,1/29/2015,495000.0,5,2.5,2200,4942,2.0,0.0,0.0,3,8,2200,0,1989,0,98029,47.5772,-122.001,2200,5924,1,29,2015,UNK,0,-982
5469700052,11/13/2014,275000.0,3,1.5,1510,16200,1.0,0.0,0.0,3,7,1510,0,1970,0,98031,47.3926,-122.167,1650,13950,11,13,2014,UNK,-140,2250
4006000509,9/16/2014,333000.0,3,1.0,1620,5040,1.0,0.0,0.0,3,7,1120,500,1964,0,98118,47.5263,-122.286,1790,6178,9,16,2014,UNK,-170,-1138
9269750460,5/19/2014,247000.0,3,2.25,1580,7941,2.0,0.0,0.0,4,7,1580,0,1986,0,98023,47.2843,-122.35700000000001,1730,8051,5,19,2014,UNK,-150,-110
2721059173,3/9/2015,204555.0,3,1.75,1260,15000,1.5,0.0,0.0,4,7,1260,0,1983,0,98092,47.2737,-122.15299999999999,2400,21715,3,9,2015,UNK,-1140,-6715
3981200660,7/15/2014,432000.0,3,2.0,2190,13673,1.0,0.0,0.0,4,9,2190,0,1994,0,98042,47.3542,-122.098,2770,13804,7,15,2014,UNK,-580,-131
4012800050,5/21/2014,175000.0,3,1.75,1230,13056,1.0,0.0,0.0,4,7,1230,0,1962,0,98001,47.3171,-122.279,1690,15750,5,21,2014,UNK,-460,-2694
3275750050,3/20/2015,556300.0,4,2.5,2030,7140,1.0,0.0,0.0,4,7,1400,630,1968,0,98008,47.6244,-122.109,1800,7565,3,20,2015,UNK,230,-425
8572900275,6/25/2014,286000.0,2,1.0,780,3475,1.0,0.0,0.0,4,5,780,0,1930,0,98045,47.4944,-121.789,1210,6769,6,25,2014,UNK,-430,-3294
993000950,9/6/2014,320000.0,2,1.5,1110,1200,3.0,0.0,0.0,3,8,1110,0,2000,0,98103,47.6931,-122.34200000000001,1110,1363,9,6,2014,UNK,0,-163
426069099,4/20/2015,815000.0,3,2.5,2790,53143,2.0,0.0,0.0,4,9,2790,0,1991,0,98077,47.7687,-122.036,2740,47916,4,20,2015,UNK,50,5227
3276180020,3/27/2015,385000.0,4,1.75,1660,10757,1.0,0.0,0.0,3,7,1000,0,1980,0,98056,47.5071,-122.194,1880,8319,3,27,2015,UNK,-220,2438
5700001640,5/8/2014,1040000.0,4,1.0,3410,5000,2.0,0.0,0.0,5,8,2190,1220,1910,0,98144,47.5807,-122.291,2550,5000,5,8,2014,UNK,860,0
9264940130,10/28/2014,350000.0,4,2.25,2390,13002,2.0,0.0,0.0,3,8,2390,0,1987,0,98023,47.3111,-122.35,2450,11200,10,28,2014,UNK,-60,1802
7300400670,7/29/2014,277000.0,4,2.5,1850,5880,2.0,0.0,0.0,3,8,1850,0,1998,0,98092,47.3322,-122.17299999999999,2370,6500,7,29,2014,UNK,-520,-620
4112100101,2/19/2015,415000.0,6,2.0,2500,5200,1.0,0.0,0.0,3,8,1250,1250,1966,0,98118,47.5517,-122.26799999999999,1800,5200,2,19,2015,UNK,700,0
6163901381,12/4/2014,295000.0,3,1.0,1000,8320,1.0,0.0,0.0,5,6,1000,0,1951,0,98155,47.7548,-122.316,1090,8450,12,4,2014,UNK,-90,-130
7603100020,8/5/2014,969000.0,4,2.0,2450,5000,2.0,0.0,4.0,5,8,2200,250,1919,0,98116,47.5619,-122.405,2360,6090,8,5,2014,UNK,90,-1090
4302200415,11/4/2014,339888.0,4,1.75,1440,6144,1.0,0.0,0.0,5,6,720,720,1947,0,98106,47.5257,-122.35700000000001,960,5160,11,4,2014,UNK,480,984
3876760430,8/22/2014,269950.0,3,2.25,1660,7003,2.0,0.0,0.0,3,7,1660,0,1996,0,98030,47.3599,-122.18799999999999,1840,6680,8,22,2014,UNK,-180,323
3754501235,10/1/2014,1190000.0,3,2.5,2510,4600,2.0,0.0,2.0,3,10,2510,0,2006,0,98034,47.7051,-122.223,2560,7500,10,1,2014,N,-50,-2900
8691330500,12/16/2014,780000.0,4,2.5,3090,12511,2.0,0.0,0.0,4,10,3090,0,1998,0,98075,47.5932,-121.98299999999999,3100,10882,12,16,2014,UNK,-10,1629
8651401680,4/8/2015,198000.0,3,1.0,860,5185,1.0,0.0,0.0,4,6,860,0,1968,0,98042,47.3634,-122.086,1120,5494,4,8,2015,UNK,-260,-309
8011100050,5/8/2015,350000.0,2,1.0,1220,28703,1.0,0.0,0.0,4,7,1220,0,1953,0,98056,47.4952,-122.17200000000001,2740,6720,5,8,2015,UNK,-1520,21983
3768000280,12/1/2014,350000.0,3,1.0,1010,7680,1.0,0.0,0.0,4,7,1010,0,1967,0,98034,47.732,-122.23100000000001,1320,7373,12,1,2014,UNK,-310,307
1321710460,12/6/2014,319000.0,4,2.25,2390,7350,2.0,0.0,0.0,3,8,2390,0,1990,0,98023,47.2938,-122.348,2390,7350,12,6,2014,UNK,0,0
8731981680,9/8/2014,311000.0,4,2.25,3340,8000,2.0,0.0,0.0,4,8,3340,0,1973,0,98023,47.317,-122.385,2230,8000,9,8,2014,UNK,1110,0
7714000250,10/18/2014,394000.0,5,3.25,3620,4650,2.0,0.0,0.0,3,8,2790,0,2004,0,98038,47.3552,-122.02600000000001,2850,4650,10,18,2014,N,770,0
1336800010,6/13/2014,1340000.0,5,2.25,4200,5800,2.5,0.0,0.0,4,9,2910,1290,1906,0,98112,47.6284,-122.31200000000001,3060,5800,6,13,2014,UNK,1140,0
5442300807,6/24/2014,2700000.0,5,2.75,3831,13800,2.0,1.0,4.0,3,9,3831,0,1959,1980,98040,47.5919,-122.251,3850,36563,6,24,2014,Y,-19,-22763
6190701112,11/25/2014,396000.0,3,1.0,1980,9540,1.0,0.0,0.0,3,7,1080,900,1949,0,98133,47.7551,-122.353,1680,9529,11,25,2014,UNK,300,11
2680700280,4/2/2015,809000.0,4,1.75,1790,8372,1.0,0.0,0.0,4,8,1340,450,1976,0,98033,47.6605,-122.189,2180,10500,4,2,2015,UNK,-390,-2128
1025059181,7/22/2014,480000.0,3,2.0,1580,7400,1.0,0.0,0.0,3,7,1050,530,1977,0,98052,47.6715,-122.162,1560,7458,7,22,2014,UNK,20,-58
3856900005,9/9/2014,535000.0,6,1.75,2460,6000,1.0,0.0,0.0,4,7,1230,1230,1913,0,98115,47.6721,-122.323,1560,4275,9,9,2014,UNK,900,1725
4302700425,2/13/2015,425000.0,5,2.75,2110,5120,2.0,0.0,0.0,3,7,1870,240,1947,1983,98106,47.5294,-122.35700000000001,1580,5120,2,13,2015,Y,530,0
6824100005,8/1/2014,408000.0,3,2.5,1470,1204,3.0,0.0,0.0,3,8,1470,0,2006,0,98117,47.6998,-122.366,1460,1245,8,1,2014,N,10,-41
3625600190,4/9/2015,1260000.0,4,2.5,3510,13100,2.0,0.0,0.0,4,10,3510,0,1966,0,98040,47.5306,-122.227,3230,12745,4,9,2015,UNK,280,355
7588700177,4/20/2015,310000.0,1,0.75,520,2885,1.0,0.0,0.0,4,6,520,0,1947,0,98117,47.6886,-122.37799999999999,980,4241,4,20,2015,UNK,-460,-1356
3303950080,11/3/2014,292000.0,3,2.5,1950,7421,2.0,0.0,0.0,3,8,1950,0,1996,0,98038,47.3842,-122.036,2200,4668,11,3,2014,UNK,-250,2753
985000950,2/27/2015,217000.0,2,1.0,770,9715,1.0,0.0,0.0,4,6,770,0,1942,0,98168,47.4924,-122.31200000000001,1140,9715,2,27,2015,UNK,-370,0
8011100005,1/27/2015,398500.0,4,2.5,2250,6064,2.0,0.0,0.0,3,8,2250,0,2005,0,98056,47.4956,-122.17399999999999,1520,7840,1,27,2015,N,730,-1776
5316100980,3/26/2015,2250000.0,3,3.0,4040,7200,1.5,0.0,2.0,4,9,3340,700,1930,0,98112,47.6288,-122.28399999999999,3450,10800,3,26,2015,UNK,590,-3600
6819100345,3/25/2015,700000.0,4,1.75,2360,6000,1.0,0.0,0.0,3,7,1280,1080,1955,0,98109,47.6465,-122.35700000000001,1700,3460,3,25,2015,UNK,660,2540
3276930420,9/12/2014,585000.0,4,2.5,2330,45860,2.0,0.0,0.0,3,9,2330,0,1989,0,98075,47.5842,-121.992,2930,5020,9,12,2014,UNK,-600,40840
6648900005,10/8/2014,399950.0,3,1.0,1720,8910,1.0,0.0,0.0,4,7,1720,0,1954,0,98155,47.7736,-122.296,1870,8640,10,8,2014,UNK,-150,270
6083000050,6/13/2014,235000.0,3,1.75,1900,8540,1.0,0.0,0.0,3,6,950,950,1980,0,98168,47.4868,-122.303,1370,10204,6,13,2014,UNK,530,-1664
1180008315,7/15/2014,212000.0,3,1.0,1040,6800,1.0,0.0,0.0,5,6,1040,0,1951,0,98178,47.492,-122.22399999999999,1430,6080,7,15,2014,UNK,-390,720
8651510380,8/21/2014,310000.0,3,2.0,2070,9195,1.0,0.0,0.0,3,8,1220,850,1982,0,98074,47.6491,-122.061,2080,9551,8,21,2014,UNK,-10,-356
8651510380,12/16/2014,539000.0,3,2.0,2070,9195,1.0,0.0,0.0,3,8,1220,850,1982,0,98074,47.6491,-122.061,2080,9551,12,16,2014,UNK,-10,-356
9826701794,12/5/2014,390000.0,3,3.0,1550,1608,2.0,0.0,0.0,3,8,1280,270,2001,0,98122,47.6042,-122.303,1940,1883,12,5,2014,UNK,-390,-275
2790400380,12/1/2014,560000.0,3,2.5,2020,11935,1.0,0.0,0.0,4,9,2020,0,1976,0,98052,47.632,-122.09200000000001,2410,12350,12,1,2014,UNK,-390,-415
6979940050,9/16/2014,800000.0,5,2.5,3320,9024,2.0,0.0,0.0,3,9,3320,0,1999,0,98075,47.5865,-122.056,3320,7665,9,16,2014,UNK,0,1359
1727001300,6/9/2014,1900000.0,4,3.25,4130,112521,2.0,0.0,0.0,3,11,4130,0,1978,0,98005,47.6392,-122.165,3140,26147,6,9,2014,UNK,990,86374
686100380,10/27/2014,472000.0,5,2.0,2030,9804,1.0,0.0,0.0,3,7,1110,920,1963,0,98008,47.6297,-122.11399999999999,1930,7990,10,27,2014,UNK,100,1814
4037400280,9/23/2014,502550.0,3,1.75,1770,7875,1.0,0.0,0.0,4,7,1170,600,1958,0,98008,47.606,-122.125,1670,8000,9,23,2014,UNK,100,-125
8691400010,3/27/2015,830000.0,4,3.25,3330,7809,2.0,0.0,0.0,3,9,3330,0,2004,0,98075,47.5977,-121.976,3100,6465,3,27,2015,N,230,1344
1450300050,7/23/2014,224950.0,4,2.5,2260,9686,1.0,0.0,0.0,4,7,1520,740,1965,0,98002,47.286,-122.21799999999999,1750,9916,7,23,2014,UNK,510,-230
4024101440,6/18/2014,375000.0,3,2.5,1950,6871,2.0,0.0,0.0,3,8,1950,0,1997,0,98155,47.7603,-122.307,1950,7663,6,18,2014,UNK,0,-792
624100010,12/8/2014,645000.0,3,2.5,2930,19900,1.5,0.0,0.0,3,9,2930,0,1983,0,98077,47.7234,-122.066,3160,20492,12,8,2014,UNK,-230,-592
9523102580,5/23/2014,599000.0,3,2.75,1960,2500,1.5,0.0,0.0,5,7,1410,550,1926,0,98103,47.6744,-122.353,2040,5000,5,23,2014,UNK,-80,-2500
7429000130,5/9/2015,515000.0,4,2.5,2980,12534,2.0,0.0,0.0,3,9,2980,0,1996,0,98031,47.3999,-122.211,2630,12534,5,9,2015,UNK,350,0
7335400345,5/28/2014,135000.0,2,1.0,780,6685,1.0,0.0,0.0,4,5,780,0,1948,0,98002,47.305,-122.215,880,6695,5,28,2014,UNK,-100,-10
7215721330,10/23/2014,485000.0,3,2.5,1650,4218,2.0,0.0,0.0,3,8,1650,0,2000,0,98075,47.5998,-122.016,1650,4559,10,23,2014,UNK,0,-341
3117100130,7/14/2014,890000.0,3,3.25,4030,12765,2.0,0.0,0.0,4,9,2800,1230,1975,0,98005,47.6331,-122.166,2670,13447,7,14,2014,UNK,1360,-682
2868900020,4/8/2015,215000.0,3,1.0,1010,10125,1.0,0.0,0.0,4,7,1010,0,1972,0,98042,47.3423,-122.088,1230,10125,4,8,2015,UNK,-220,0
5703500130,12/17/2014,299500.0,3,1.0,1190,9600,1.0,0.0,0.0,3,7,1190,0,1981,0,98045,47.4805,-121.762,1360,10140,12,17,2014,UNK,-170,-540
3025059136,8/13/2014,800000.0,2,1.0,1050,8750,1.0,0.0,0.0,4,7,1050,0,1951,0,98004,47.6294,-122.215,3360,20115,8,13,2014,UNK,-2310,-11365
6679000130,2/9/2015,275000.0,3,2.5,1560,4244,2.0,0.0,0.0,3,7,1560,0,2002,0,98038,47.3834,-122.027,1670,4251,2,9,2015,UNK,-110,-7
4222500020,2/19/2015,256400.0,3,1.5,1490,7800,1.0,0.0,0.0,3,7,1010,480,1963,0,98003,47.3431,-122.304,1570,7800,2,19,2015,UNK,-80,0
3997500130,2/24/2015,310000.0,2,1.0,770,8149,1.0,0.0,0.0,4,6,770,0,1948,0,98155,47.7439,-122.301,820,8149,2,24,2015,UNK,-50,0
9834201205,3/4/2015,385000.0,1,1.0,620,5100,1.0,0.0,0.0,3,6,620,0,1954,0,98144,47.5699,-122.287,1540,2676,3,4,2015,UNK,-920,2424
806000020,3/10/2015,203000.0,3,1.5,1200,9120,1.0,0.0,0.0,3,7,1000,200,1963,0,98055,47.4545,-122.18700000000001,1640,9200,3,10,2015,UNK,-440,-80
507100005,3/10/2015,285000.0,4,2.0,2120,6865,1.0,0.0,0.0,3,7,1060,1060,1954,0,98133,47.7775,-122.337,1460,7780,3,10,2015,UNK,660,-915
8635760480,1/27/2015,473975.0,3,2.5,2330,3610,2.0,0.0,0.0,3,8,2330,0,1999,0,98074,47.6022,-122.021,1830,2948,1,27,2015,UNK,500,662
1328330190,7/14/2014,320000.0,3,1.75,2000,9760,1.0,0.0,0.0,4,8,1400,600,1978,0,98058,47.4417,-122.134,1890,8089,7,14,2014,UNK,110,1671
2919702040,6/12/2014,599000.0,5,2.75,2820,4608,1.0,0.0,0.0,3,7,1450,1370,1967,0,98117,47.6886,-122.361,1620,3840,6,12,2014,UNK,1200,768
3095000095,7/14/2014,580000.0,3,2.0,2040,4800,1.0,0.0,0.0,4,7,1020,1020,1925,0,98126,47.5561,-122.37700000000001,1640,4800,7,14,2014,UNK,400,0
304100010,12/9/2014,269500.0,4,2.25,1700,7056,2.0,0.0,0.0,3,7,1700,0,1999,0,98001,47.3385,-122.262,1650,6025,12,9,2014,UNK,50,1031
617000089,11/17/2014,274000.0,2,1.0,820,6200,1.0,0.0,0.0,4,6,820,0,1954,0,98166,47.4163,-122.34,1410,14000,11,17,2014,UNK,-590,-7800
3582750280,3/26/2015,347000.0,2,1.75,1315,2162,2.0,0.0,0.0,4,8,1315,0,1974,0,98028,47.751999999999995,-122.25299999999999,1640,2128,3,26,2015,UNK,-325,34
3438500430,5/21/2014,270000.0,3,1.75,1390,10905,1.0,0.0,0.0,3,6,860,530,1957,0,98106,47.5517,-122.36,1390,10839,5,21,2014,UNK,0,66
8964800225,3/3/2015,1430000.0,3,2.0,1890,12017,1.0,0.0,2.0,3,8,1890,0,1949,0,98004,47.6203,-122.21,2000,12210,3,3,2015,UNK,-110,-193
2013801350,2/20/2015,220000.0,3,1.75,1460,7226,1.0,0.0,0.0,3,7,1460,0,1993,0,98198,47.3839,-122.321,1760,7226,2,20,2015,UNK,-300,0
1320069163,3/4/2015,243000.0,3,1.0,1480,15416,1.0,0.0,2.0,4,8,1480,0,1955,0,98022,47.2142,-121.98700000000001,1190,10758,3,4,2015,UNK,290,4658
7549800168,5/27/2014,457500.0,3,1.75,1840,4030,1.0,0.0,0.0,5,7,1050,790,1925,0,98108,47.5549,-122.311,1840,5040,5,27,2014,UNK,0,-1010
3226049466,12/19/2014,340000.0,2,1.75,1880,7208,1.0,0.0,0.0,3,7,940,940,1951,0,98115,47.6946,-122.32799999999999,1880,8051,12,19,2014,UNK,0,-843
9822700285,9/18/2014,657500.0,4,1.5,1910,5000,1.5,0.0,0.0,3,7,1610,300,1912,0,98105,47.6597,-122.29,2170,5000,9,18,2014,UNK,-260,0
538000250,1/12/2015,332500.0,4,2.5,2220,4720,2.0,0.0,0.0,3,7,2220,0,1998,0,98038,47.3541,-122.024,2090,4717,1,12,2015,UNK,130,3
5702450250,7/17/2014,340000.0,3,2.0,1410,10015,1.0,0.0,3.0,3,6,1410,0,1993,0,98045,47.4948,-121.77600000000001,1570,10485,7,17,2014,UNK,-160,-470
8835900086,9/2/2014,350000.0,4,3.0,3380,16133,1.0,0.0,1.0,3,8,2330,1050,1959,0,98118,47.5501,-122.26100000000001,2500,11100,9,2,2014,UNK,880,5033
3333002302,2/13/2015,428000.0,4,2.5,1950,5602,1.0,0.0,0.0,5,7,1120,830,1966,0,98118,47.5437,-122.291,2000,6050,2,13,2015,UNK,-50,-448
7787120500,5/4/2015,515055.0,4,2.5,2400,8320,2.0,0.0,0.0,3,8,2400,0,1999,0,98045,47.4808,-121.781,2430,9258,5,4,2015,UNK,-30,-938
8563010420,2/4/2015,450000.0,3,1.75,1560,8968,1.0,0.0,0.0,4,8,1560,0,1972,0,98008,47.6243,-122.1,1990,8034,2,4,2015,UNK,-430,934
3361400190,2/26/2015,190000.0,3,1.0,1040,8910,1.0,0.0,0.0,3,6,1040,0,1943,0,98168,47.5024,-122.32,1330,9720,2,26,2015,UNK,-290,-810
1024039001,7/17/2014,1000000.0,4,2.75,3090,16538,3.0,0.0,0.0,4,8,2590,500,1919,0,98116,47.5803,-122.40299999999999,1500,5130,7,17,2014,UNK,1590,11408
6806100420,11/19/2014,299000.0,3,2.5,1850,4600,2.0,0.0,0.0,3,7,1850,0,2005,0,98058,47.4661,-122.145,2160,4751,11,19,2014,N,-310,-151
3204300225,11/3/2014,508000.0,2,1.0,1200,2500,2.0,0.0,2.0,3,7,1090,110,1927,0,98112,47.6304,-122.301,2690,4800,11,3,2014,UNK,-1490,-2300
8857640420,10/1/2014,294000.0,4,2.25,2190,3746,2.0,0.0,0.0,3,8,2190,0,2005,0,98038,47.3896,-122.03399999999999,2200,3591,10,1,2014,N,-10,155
4443800130,10/24/2014,320000.0,2,1.0,1380,5820,1.0,0.0,0.0,3,7,1380,0,1918,1976,98117,47.6875,-122.39200000000001,1540,4076,10,24,2014,Y,-160,1744
3449800290,4/6/2015,641000.0,5,2.75,3710,8674,2.0,0.0,0.0,3,9,3710,0,1996,0,98056,47.513999999999996,-122.176,3250,8678,4,6,2015,UNK,460,-4
2426059071,10/21/2014,675000.0,3,2.5,2320,98445,1.0,0.0,0.0,4,8,1380,940,1978,0,98072,47.7323,-122.116,2830,54014,10,21,2014,UNK,-510,44431
2618300190,12/24/2014,255000.0,3,1.5,1110,10296,1.0,0.0,0.0,5,7,1110,0,1964,0,98042,47.422,-122.15299999999999,1330,10296,12,24,2014,UNK,-220,0
6181400920,4/30/2015,286651.0,3,2.5,1830,4997,2.0,0.0,0.0,3,7,1830,0,2004,0,98001,47.3035,-122.28299999999999,2488,4998,4,30,2015,N,-658,-1
424069150,2/13/2015,607500.0,4,2.5,2460,45738,1.0,0.0,0.0,4,8,1650,810,1969,0,98075,47.5952,-122.056,2550,32040,2,13,2015,UNK,-90,13698
856000255,2/3/2015,765000.0,3,1.0,1270,6500,1.0,0.0,0.0,4,7,1270,0,1956,0,98033,47.6874,-122.214,2260,7200,2,3,2015,UNK,-990,-700
1841500050,10/20/2014,334950.0,4,1.75,1700,40973,1.0,0.0,0.0,3,8,1700,0,1961,0,98031,47.3439,-122.198,2760,40973,10,20,2014,UNK,-1060,0
3226059071,8/19/2014,426000.0,3,1.0,1130,9147,1.0,0.0,0.0,5,7,1130,0,1952,0,98033,47.7006,-122.197,1930,9906,8,19,2014,UNK,-800,-759
524059093,8/25/2014,775000.0,3,1.75,1640,18730,1.5,0.0,0.0,4,7,1640,0,1946,0,98004,47.5975,-122.196,1670,12154,8,25,2014,UNK,-30,6576
1568100225,12/4/2014,343000.0,2,1.5,1040,8526,1.0,0.0,0.0,5,6,1040,0,1953,0,98155,47.7349,-122.295,1310,8504,12,4,2014,UNK,-270,22
4027700726,9/8/2014,470101.0,4,2.5,2320,7800,2.0,0.0,0.0,3,8,2320,0,1986,0,98028,47.7738,-122.266,2090,5721,9,8,2014,UNK,230,2079
5198600005,5/5/2015,195000.0,3,1.5,1200,7800,1.0,0.0,0.0,4,7,1200,0,1958,0,98002,47.3137,-122.212,1390,8415,5,5,2015,UNK,-190,-615
7677300010,3/3/2015,772500.0,4,1.0,1720,4410,1.5,0.0,2.0,3,7,1720,0,1928,0,98117,47.6791,-122.402,2140,4500,3,3,2015,UNK,-420,-90
7979900006,6/25/2014,450000.0,3,1.5,2330,11740,1.0,0.0,0.0,3,8,1330,1000,1954,0,98155,47.7481,-122.292,2630,11740,6,25,2014,UNK,-300,0
1102000527,9/2/2014,1440000.0,4,3.75,4410,9231,3.0,0.0,3.0,3,11,4410,0,2001,0,98118,47.5427,-122.265,2160,6600,9,2,2014,UNK,2250,2631
1115800440,9/18/2014,525000.0,4,1.75,1650,8560,1.0,0.0,0.0,3,8,1650,0,1970,0,98052,47.6652,-122.146,1700,8560,9,18,2014,UNK,-50,0
9407110680,10/8/2014,280000.0,3,1.5,1370,11400,2.0,0.0,0.0,3,7,1370,0,1980,0,98045,47.4477,-121.77,1390,9600,10,8,2014,UNK,-20,1800
6084601060,7/18/2014,270000.0,3,2.5,1770,8640,1.0,0.0,0.0,3,7,1420,350,1986,0,98001,47.326,-122.273,1894,7974,7,18,2014,UNK,-124,666
993001330,5/5/2014,406100.0,3,2.25,1410,1332,3.0,0.0,0.0,3,8,1410,0,2005,0,98103,47.6916,-122.34,1430,1448,5,5,2014,N,-20,-116
2475200290,10/20/2014,332544.0,2,1.75,1710,4187,1.0,0.0,0.0,3,7,1710,0,1987,0,98055,47.4732,-122.18799999999999,1760,4084,10,20,2014,UNK,-50,103
5381000048,4/27/2015,110000.0,2,1.0,790,8250,1.0,0.0,0.0,3,6,790,0,1947,0,98188,47.4523,-122.286,900,8250,4,27,2015,UNK,-110,0
5605000595,12/9/2014,685000.0,6,2.25,2770,5854,1.5,0.0,0.0,3,8,2120,650,1921,0,98112,47.6466,-122.304,2300,5450,12,9,2014,UNK,470,404
1124000050,7/29/2014,461000.0,4,1.0,1260,8505,1.5,0.0,0.0,5,7,1260,0,1951,0,98177,47.7181,-122.37100000000001,1480,8100,7,29,2014,UNK,-220,405
3558900430,4/14/2015,615000.0,3,2.25,2300,8067,1.0,0.0,0.0,4,8,1300,1000,1979,0,98034,47.7091,-122.198,2120,9524,4,14,2015,UNK,180,-1457
2708100130,5/3/2015,550000.0,2,1.0,1070,3000,1.0,0.0,0.0,4,7,870,200,1926,0,98103,47.6828,-122.353,1890,3300,5,3,2015,UNK,-820,-300
1236300290,10/22/2014,1060000.0,4,3.5,3850,8100,2.0,0.0,1.0,3,11,2430,1420,1995,0,98033,47.6855,-122.19,2620,9346,10,22,2014,UNK,1230,-1246
525069099,10/22/2014,685000.0,3,2.5,2320,219978,2.0,0.0,0.0,4,8,2320,0,1993,0,98053,47.6847,-122.064,2340,88862,10,22,2014,UNK,-20,131116
3262300235,11/26/2014,1560000.0,5,2.5,2870,16238,2.0,0.0,0.0,4,8,2870,0,1962,0,98039,47.6308,-122.238,2870,16238,11,26,2014,UNK,0,0
5104510130,6/3/2014,312000.0,4,2.5,1830,5175,2.0,0.0,0.0,3,7,1830,0,2003,0,98038,47.3565,-122.016,1830,5175,6,3,2014,UNK,0,0
7197350050,7/1/2014,507500.0,3,1.75,1990,9594,1.0,0.0,0.0,3,8,1190,800,1977,0,98052,47.6617,-122.137,1930,9765,7,1,2014,UNK,60,-171
2822049148,9/18/2014,217000.0,3,1.0,1110,9827,1.0,0.0,0.0,3,7,1110,0,1966,0,98198,47.369,-122.311,1540,10187,9,18,2014,UNK,-430,-360
7558300170,12/12/2014,439000.0,3,2.25,1830,13477,1.0,0.0,3.0,4,7,1170,660,1981,0,98034,47.7243,-122.21,1960,11344,12,12,2014,UNK,-130,2133
7852190050,6/26/2014,620000.0,6,3.5,3600,6875,2.0,0.0,0.0,3,8,2740,860,2004,0,98065,47.5401,-121.87899999999999,3150,6663,6,26,2014,N,450,212
1277000020,8/12/2014,915000.0,4,2.5,3210,8532,2.0,0.0,0.0,3,10,3210,0,1998,0,98007,47.625,-122.14399999999999,2950,6753,8,12,2014,UNK,260,1779
567000660,12/4/2014,425000.0,4,2.0,1490,5300,1.0,0.0,0.0,3,7,1110,380,1977,0,98144,47.5949,-122.296,1330,1499,12,4,2014,UNK,160,3801
9214400396,2/27/2015,435000.0,2,1.0,990,5643,1.0,0.0,0.0,3,7,870,120,1947,0,98115,47.6802,-122.29799999999999,1280,5700,2,27,2015,UNK,-290,-57
9406520290,12/29/2014,305000.0,3,2.25,1646,12414,2.0,0.0,0.0,3,7,1646,0,1996,0,98038,47.363,-122.035,1654,8734,12,29,2014,UNK,-8,3680
2112700895,3/26/2015,276000.0,2,1.0,720,4000,1.0,0.0,0.0,3,6,720,0,1918,0,98106,47.5346,-122.353,1630,4000,3,26,2015,UNK,-910,0
2474400250,6/30/2014,327500.0,3,2.25,2310,7200,2.0,0.0,0.0,3,8,2310,0,1990,0,98031,47.4051,-122.193,1960,7201,6,30,2014,UNK,350,-1
3889100029,6/17/2014,810000.0,3,2.5,2670,10481,2.0,0.0,0.0,3,9,2670,0,2003,0,98033,47.6673,-122.176,2620,8895,6,17,2014,UNK,50,1586
11501310,11/21/2014,715000.0,3,3.25,3060,9055,2.0,0.0,0.0,3,10,2460,600,1994,0,98052,47.6971,-122.101,2990,9598,11,21,2014,UNK,70,-543
5672000020,8/5/2014,272000.0,3,1.5,1380,11760,1.0,0.0,0.0,4,7,1380,0,1963,0,98055,47.4243,-122.20200000000001,1650,9855,8,5,2014,UNK,-270,1905
6668900005,4/21/2015,266000.0,2,1.0,700,5559,1.0,0.0,0.0,5,6,700,0,1949,0,98155,47.7492,-122.311,1230,8100,4,21,2015,UNK,-530,-2541
2346800005,4/27/2015,543000.0,3,1.5,1710,8364,2.0,0.0,2.0,3,7,1710,0,1944,0,98136,47.5175,-122.39299999999999,2430,9040,4,27,2015,UNK,-720,-676
2872900050,10/7/2014,400000.0,3,2.5,1450,8064,1.0,0.0,0.0,3,8,1450,0,1984,0,98074,47.6256,-122.037,1710,9554,10,7,2014,UNK,-260,-1490
4040600190,8/6/2014,509500.0,5,2.25,2060,9000,1.0,0.0,0.0,4,7,1320,740,1961,0,98007,47.6122,-122.137,2050,8800,8,6,2014,UNK,10,200
7129301578,5/21/2014,495000.0,3,3.5,2380,6250,2.0,0.0,3.0,3,8,1670,710,1997,0,98118,47.5137,-122.25200000000001,2540,4010,5,21,2014,UNK,-160,2240
3955900500,3/13/2015,424950.0,4,2.5,2760,5564,2.0,0.0,0.0,3,7,2760,0,2001,0,98056,47.4814,-122.189,2670,5626,3,13,2015,UNK,90,-62
7788400170,9/26/2014,230000.0,3,1.0,940,10875,1.0,0.0,0.0,3,7,940,0,1957,0,98056,47.5121,-122.16799999999999,1250,11200,9,26,2014,UNK,-310,-325
3831000010,8/6/2014,235000.0,4,1.5,1760,6150,1.5,0.0,0.0,3,7,1760,0,1951,0,98031,47.3871,-122.22399999999999,1760,8276,8,6,2014,UNK,0,-2126
3885803895,3/9/2015,763000.0,3,2.0,1360,8752,1.0,0.0,2.0,4,6,1360,0,1942,0,98033,47.6879,-122.208,2530,7680,3,9,2015,UNK,-1170,1072
3810000480,9/19/2014,350000.0,3,1.75,2010,6150,2.0,0.0,0.0,5,7,2010,0,1939,0,98178,47.4975,-122.23100000000001,1770,7380,9,19,2014,UNK,240,-1230
6169901197,11/26/2014,900000.0,3,1.5,2160,2260,2.0,0.0,2.0,5,8,1620,540,1917,0,98119,47.6321,-122.37100000000001,2570,2400,11,26,2014,UNK,-410,-140
6882520050,10/7/2014,250000.0,3,1.0,930,6060,1.0,0.0,0.0,4,6,930,0,1973,0,98118,47.5289,-122.28,1640,6364,10,7,2014,UNK,-710,-304
2608300103,1/26/2015,225000.0,3,2.5,1020,2040,2.0,0.0,0.0,3,7,720,300,2004,0,98106,47.5294,-122.361,1060,1478,1,26,2015,N,-40,562
3530400080,12/26/2014,255000.0,2,2.0,1360,5433,1.0,0.0,0.0,3,8,1360,0,1974,2003,98198,47.3804,-122.32,1160,5264,12,26,2014,Y,200,169
1099760470,6/4/2014,161700.0,4,1.75,1720,7200,1.0,0.0,0.0,3,7,1220,500,1974,0,98023,47.306000000000004,-122.375,1790,7200,6,4,2014,UNK,-70,0
4327600010,2/2/2015,336000.0,3,3.0,1790,13350,1.0,0.0,0.0,3,7,1190,600,1988,0,98178,47.4958,-122.262,1740,10624,2,2,2015,UNK,50,2726
6150200005,10/23/2014,410500.0,3,1.0,1150,6800,1.0,0.0,0.0,3,7,1150,0,1954,0,98133,47.727,-122.339,1210,6800,10,23,2014,UNK,-60,0
4019300480,11/11/2014,502700.0,4,3.5,2710,14016,2.0,0.0,0.0,4,8,2710,0,1968,0,98155,47.7601,-122.286,1590,27903,11,11,2014,UNK,1120,-13887
6855100010,9/23/2014,505000.0,3,2.5,2400,9601,1.0,0.0,0.0,5,7,1390,1010,1977,0,98034,47.7256,-122.211,2010,9943,9,23,2014,UNK,390,-342
5249801440,12/16/2014,250000.0,3,1.0,1660,7650,1.5,0.0,0.0,3,7,1350,310,1910,0,98118,47.5576,-122.277,1750,5760,12,16,2014,UNK,-90,1890
5249801440,4/22/2015,570000.0,3,1.0,1660,7650,1.5,0.0,0.0,3,7,1350,310,1910,0,98118,47.5576,-122.277,1750,5760,4,22,2015,UNK,-90,1890
7524350080,3/18/2015,349900.0,4,2.5,2290,8796,2.0,0.0,0.0,3,8,2290,0,1994,0,98198,47.3762,-122.318,2130,8796,3,18,2015,UNK,160,0
1137800460,12/9/2014,465000.0,3,2.5,2870,25663,2.0,0.0,0.0,3,10,2870,0,1988,0,98003,47.2769,-122.333,2950,24347,12,9,2014,UNK,-80,1316
587550280,5/30/2014,625000.0,4,3.25,4240,25639,2.0,0.0,3.0,3,10,3550,690,1989,0,98023,47.3241,-122.37799999999999,3590,24967,5,30,2014,UNK,650,672
871001365,2/19/2015,655000.0,3,1.75,1800,5102,1.0,0.0,0.0,3,7,1170,630,1952,0,98199,47.6514,-122.40700000000001,1720,5102,2,19,2015,UNK,80,0
1430800279,3/27/2015,469000.0,4,1.75,2960,11347,1.0,0.0,0.0,4,8,1570,1390,1946,0,98166,47.4738,-122.353,1660,8911,3,27,2015,UNK,1300,2436
1226039130,10/9/2014,355000.0,3,2.25,1980,7200,1.0,0.0,0.0,3,8,1300,680,1964,0,98177,47.7625,-122.36,1820,8250,10,9,2014,UNK,160,-1050
7254000050,2/24/2015,596000.0,3,2.5,1730,2631,2.0,0.0,0.0,3,8,1730,0,2001,0,98005,47.5878,-122.165,1730,2751,2,24,2015,UNK,0,-120
3530200020,4/2/2015,790000.0,4,2.5,3020,36893,2.0,0.0,0.0,3,9,3020,0,1986,2007,98077,47.768,-122.09200000000001,3020,36444,4,2,2015,Y,0,449
2386000020,10/8/2014,885000.0,4,2.25,4470,86225,2.0,0.0,0.0,3,10,4470,0,1991,0,98053,47.6377,-121.985,3850,97049,10,8,2014,UNK,620,-10824
6738700225,9/12/2014,1030000.0,4,3.25,2830,4000,2.0,0.0,0.0,3,9,1910,920,1912,0,98144,47.5845,-122.291,2740,4000,9,12,2014,UNK,90,0
6821600005,4/3/2015,710000.0,4,1.75,2120,5400,1.0,0.0,0.0,4,8,1060,1060,1941,0,98199,47.6501,-122.395,2052,6000,4,3,2015,UNK,68,-600
3579000010,8/14/2014,428040.0,3,2.5,2150,9266,2.0,0.0,0.0,3,8,2150,0,1988,0,98028,47.7445,-122.24799999999999,2150,12550,8,14,2014,UNK,0,-3284
9359100101,4/14/2015,1370000.0,5,2.25,3510,13843,1.0,0.0,2.0,3,8,1850,1660,1959,0,98040,47.5817,-122.24600000000001,2680,8750,4,14,2015,UNK,830,5093
6819100122,6/5/2014,546000.0,2,1.0,970,3400,1.0,0.0,0.0,3,7,970,0,1924,0,98109,47.6444,-122.35700000000001,1180,3600,6,5,2014,UNK,-210,-200
3908100020,8/3/2014,540000.0,4,1.0,1360,5766,1.5,0.0,0.0,5,7,1360,0,1951,0,98115,47.6827,-122.289,1500,5704,8,3,2014,UNK,-140,62
6392001950,9/8/2014,435000.0,3,2.5,1470,3000,1.0,0.0,0.0,3,7,930,540,1985,0,98115,47.6832,-122.286,1470,5588,9,8,2014,UNK,0,-2588
2872900280,4/6/2015,540000.0,4,2.25,3040,10283,1.0,0.0,0.0,4,8,1430,1610,1984,0,98074,47.6268,-122.038,1870,11074,4,6,2015,UNK,1170,-791
6437400101,11/13/2014,284000.0,2,1.0,860,7204,1.0,0.0,0.0,3,7,860,0,1918,0,98106,47.5361,-122.351,1200,7500,11,13,2014,UNK,-340,-296
7227502155,7/14/2014,208000.0,2,1.0,820,5700,1.0,0.0,0.0,5,5,820,0,1942,0,98056,47.4915,-122.184,1000,5700,7,14,2014,UNK,-180,0
1115100169,12/3/2014,315000.0,3,1.75,1900,7076,1.0,0.0,0.0,3,7,1130,770,1977,0,98155,47.7569,-122.32600000000001,1540,10113,12,3,2014,UNK,360,-3037
2919702705,7/31/2014,417500.0,2,1.0,1330,5510,1.0,0.0,0.0,3,6,850,480,1910,0,98117,47.6901,-122.36200000000001,1200,4150,7,31,2014,UNK,130,1360
7302000500,9/17/2014,345000.0,3,1.75,1240,38095,1.0,0.0,0.0,3,7,1240,0,1978,0,98053,47.6522,-121.97,2060,38552,9,17,2014,UNK,-820,-457
6021503656,9/2/2014,375000.0,3,2.5,1330,1064,3.0,0.0,0.0,3,8,1330,0,2004,0,98117,47.6835,-122.387,1330,1113,9,2,2014,N,0,-49
8665200020,6/23/2014,389800.0,3,1.75,1880,12821,1.0,0.0,0.0,3,7,1880,0,1959,0,98155,47.7681,-122.305,1540,12868,6,23,2014,UNK,340,-47
3288301330,4/8/2015,475000.0,3,1.75,1890,7560,1.0,0.0,0.0,3,8,1430,460,1973,0,98034,47.7322,-122.185,1890,9095,4,8,2015,UNK,0,-1535
2621700010,5/8/2014,569000.0,4,2.25,2250,41688,2.0,0.0,0.0,3,8,2250,0,1980,0,98053,47.6695,-122.05,2350,37920,5,8,2014,UNK,-100,3768
1824079073,3/31/2015,985000.0,5,4.25,4650,108464,2.0,0.0,0.0,3,10,3260,1390,1999,0,98024,47.5669,-121.956,2810,155509,3,31,2015,UNK,1840,-47045
1954440080,1/29/2015,532000.0,3,2.5,1830,8022,2.0,0.0,0.0,3,8,1830,0,1987,0,98074,47.6198,-122.044,2030,7736,1,29,2015,UNK,-200,286
7452500285,8/11/2014,280000.0,2,1.0,720,5000,1.0,0.0,0.0,5,6,720,0,1951,0,98126,47.5195,-122.374,810,5000,8,11,2014,UNK,-90,0
7937600380,2/17/2015,435000.0,4,2.0,1960,50112,1.0,0.0,0.0,4,7,1050,910,1963,0,98058,47.4353,-122.084,2340,44967,2,17,2015,UNK,-380,5145
5153200651,3/16/2015,223000.0,3,1.0,1220,71191,1.0,0.0,0.0,3,6,1220,0,1952,0,98023,47.3261,-122.353,1960,15378,3,16,2015,UNK,-740,55813
2323069022,1/15/2015,390000.0,2,1.0,1800,119790,1.0,0.0,0.0,4,7,1200,600,1947,0,98027,47.4617,-122.012,2320,79208,1,15,2015,UNK,-520,40582
1328340380,10/27/2014,315000.0,3,1.75,1340,12800,1.0,0.0,0.0,3,7,880,460,1981,0,98058,47.4437,-122.137,1500,7875,10,27,2014,UNK,-160,4925
2256500005,10/14/2014,612000.0,3,3.0,1740,3700,1.0,0.0,0.0,3,7,1740,0,1982,0,98122,47.6102,-122.309,1830,2480,10,14,2014,UNK,-90,1220
9828200545,5/13/2014,591000.0,3,1.75,1680,2400,1.0,0.0,0.0,5,7,870,810,1922,0,98122,47.6155,-122.3,1440,3600,5,13,2014,UNK,240,-1200
686450080,7/11/2014,800000.0,4,2.25,3220,8436,2.0,0.0,0.0,3,8,3220,0,1968,0,98008,47.6381,-122.116,2500,7632,7,11,2014,UNK,720,804
2571900380,1/22/2015,225000.0,3,2.0,1610,8400,1.0,0.0,0.0,3,8,1610,0,1990,0,98022,47.1958,-122.009,1930,8459,1,22,2015,UNK,-320,-59
1026069120,5/8/2014,589900.0,2,3.0,3160,66646,2.0,0.0,0.0,3,7,3160,0,1993,0,98077,47.7479,-122.03399999999999,3140,38790,5,8,2014,UNK,20,27856
3882320010,11/26/2014,565000.0,4,2.5,2520,13156,1.0,0.0,0.0,3,8,1520,1000,1979,0,98052,47.6558,-122.135,2050,10940,11,26,2014,UNK,470,2216
1377300020,2/19/2015,650000.0,3,1.5,2120,8448,1.0,0.0,0.0,3,7,1060,1060,1940,0,98199,47.6438,-122.40299999999999,1620,7920,2,19,2015,UNK,500,528
1124000005,9/18/2014,499000.0,3,2.5,2090,8505,2.0,0.0,0.0,3,8,2090,0,1951,1977,98177,47.7195,-122.37100000000001,1640,8100,9,18,2014,Y,450,405
1151100010,5/15/2014,280000.0,3,1.0,1330,20562,1.5,0.0,0.0,3,5,1330,0,1959,0,98045,47.4807,-121.775,1350,20562,5,15,2014,UNK,-20,0
7997200130,1/28/2015,649950.0,3,2.5,2420,7500,1.0,0.0,2.0,4,8,1210,1210,1944,0,98117,47.6949,-122.389,2340,7500,1,28,2015,UNK,80,0
2419600005,7/9/2014,420000.0,3,1.75,1510,6360,1.0,0.0,0.0,4,7,1510,0,1954,0,98133,47.7321,-122.353,1480,7260,7,9,2014,UNK,30,-900
5727000010,12/15/2014,319990.0,4,2.5,2120,5293,2.0,0.0,0.0,3,7,2120,0,2003,0,98031,47.4217,-122.20100000000001,1990,5313,12,15,2014,UNK,130,-20
8656300080,8/12/2014,265000.0,3,2.0,1850,16535,1.0,0.0,0.0,3,7,1850,0,1992,0,98014,47.6565,-121.912,1528,13295,8,12,2014,UNK,322,3240
9517200290,2/23/2015,482000.0,3,1.75,2300,16474,1.0,0.0,0.0,3,7,1220,1080,1984,0,98072,47.7609,-122.14399999999999,1940,15601,2,23,2015,UNK,360,873
3123049142,8/5/2014,452000.0,3,2.25,2600,14810,1.0,0.0,2.0,4,8,1490,1110,1956,0,98166,47.4326,-122.34100000000001,2450,16715,8,5,2014,UNK,150,-1905
4139500080,7/18/2014,1490000.0,4,4.25,5180,13077,2.0,0.0,3.0,3,12,4280,900,1998,0,98006,47.5513,-122.109,5030,15069,7,18,2014,UNK,150,-1992
6150200280,8/21/2014,375000.0,2,1.0,1810,8527,1.5,0.0,0.0,4,7,1810,0,1943,0,98133,47.7275,-122.336,1490,6800,8,21,2014,UNK,320,1727
6021500840,7/3/2014,588000.0,5,3.0,2190,4900,2.0,0.0,0.0,5,7,1490,700,1940,0,98117,47.6892,-122.38600000000001,1370,4606,7,3,2014,UNK,820,294
8691310420,4/24/2015,635000.0,4,2.5,2500,10215,2.0,0.0,0.0,3,9,2500,0,1998,0,98075,47.5912,-121.986,2890,10240,4,24,2015,UNK,-390,-25
1402900380,7/3/2014,280500.0,4,2.5,1890,6962,2.0,0.0,0.0,3,8,1890,0,1997,0,98092,47.3328,-122.18700000000001,2170,6803,7,3,2014,UNK,-280,159
2345500010,9/25/2014,210500.0,2,1.75,2040,8600,1.0,0.0,0.0,4,6,1430,610,1985,0,98003,47.2755,-122.30799999999999,1310,7859,9,25,2014,UNK,730,741
3279000460,9/26/2014,196500.0,3,2.0,1310,7000,1.0,0.0,0.0,4,7,1310,0,1979,0,98023,47.303000000000004,-122.383,1390,7500,9,26,2014,UNK,-80,-500
723000114,5/5/2014,1400000.0,5,3.5,4010,8510,2.0,0.0,1.0,5,9,2850,1160,1971,0,98105,47.6578,-122.286,2610,6128,5,5,2014,UNK,1400,2382
5145100080,2/6/2015,475000.0,3,1.75,1780,8033,1.0,0.0,0.0,2,7,1210,570,1977,0,98034,47.7275,-122.219,1630,7508,2,6,2015,UNK,150,525
8078410280,5/4/2015,550000.0,3,2.5,1980,9061,2.0,0.0,0.0,4,8,1980,0,1987,0,98074,47.6366,-122.029,1930,8869,5,4,2015,UNK,50,192
3885806105,5/21/2014,1580000.0,3,3.25,3690,7200,2.0,0.0,0.0,3,11,3690,0,2007,0,98033,47.6815,-122.2,1880,7200,5,21,2014,N,1810,0
5702380780,4/22/2015,240000.0,3,1.75,1540,6687,1.0,0.0,0.0,3,7,1200,340,1991,0,98022,47.1938,-121.98100000000001,1540,7242,4,22,2015,UNK,0,-555
3826000280,4/29/2015,272000.0,3,1.0,1130,8100,1.5,0.0,0.0,3,6,1130,0,1934,0,98168,47.4935,-122.306,1080,8100,4,29,2015,UNK,50,0
1421079007,3/24/2015,408506.0,3,2.75,2480,209199,1.5,0.0,0.0,3,8,1870,610,2000,0,98010,47.3085,-121.88799999999999,2040,219229,3,24,2015,UNK,440,-10030
3702900185,8/18/2014,640000.0,3,2.5,2580,7500,2.0,0.0,0.0,3,9,2580,0,1991,0,98116,47.5577,-122.396,910,6500,8,18,2014,UNK,1670,1000
4136880460,5/14/2014,316000.0,4,2.5,2010,7226,2.0,0.0,0.0,3,8,2010,0,1995,0,98092,47.2588,-122.21,2160,7696,5,14,2014,UNK,-150,-470
7885100005,8/20/2014,299000.0,4,2.0,2320,12000,1.0,0.0,0.0,3,7,1720,600,1943,2014,98108,47.5246,-122.325,1390,6000,8,20,2014,Y,930,6000
3037200010,3/5/2015,447500.0,2,2.25,1180,2090,2.0,0.0,0.0,3,7,1180,0,2004,0,98122,47.6032,-122.31,1550,2812,3,5,2015,N,-370,-722
4309710250,5/5/2014,736500.0,4,2.5,3180,21904,2.0,0.0,3.0,3,9,3180,0,2000,0,98059,47.515,-122.117,3715,29170,5,5,2014,UNK,-535,-7266
3401700185,7/28/2014,665000.0,4,2.0,2970,52567,2.0,0.0,0.0,3,8,2970,0,1924,1985,98072,47.7333,-122.12799999999999,3280,46676,7,28,2014,Y,-310,5891
2141300080,4/24/2015,707000.0,5,2.5,3050,13212,1.0,0.0,0.0,4,8,1590,0,1975,0,98006,47.5596,-122.14200000000001,2550,10826,4,24,2015,UNK,500,2386
3387800380,8/29/2014,215000.0,4,1.75,1630,8000,1.0,0.0,0.0,3,7,1630,0,1959,0,98031,47.3948,-122.20100000000001,1630,7700,8,29,2014,UNK,0,300
2310000280,12/11/2014,275000.0,3,2.25,1620,6415,2.0,0.0,0.0,4,7,1620,0,1989,0,98038,47.3577,-122.038,1640,7253,12,11,2014,UNK,-20,-838
1687900170,3/25/2015,648000.0,4,2.25,2170,8240,2.0,0.0,1.0,4,8,2170,0,1983,0,98006,47.5634,-122.12799999999999,2600,9898,3,25,2015,UNK,-430,-1658
8079000190,10/28/2014,415000.0,4,2.5,2150,8173,2.0,0.0,0.0,3,8,2150,0,1987,0,98059,47.511,-122.15299999999999,2080,7620,10,28,2014,UNK,70,553
1710400005,11/19/2014,690000.0,3,2.0,1770,1800,3.0,0.0,0.0,3,8,1770,0,1999,0,98122,47.6102,-122.314,1890,3200,11,19,2014,UNK,-120,-1400
2473420170,9/24/2014,320000.0,4,2.75,2110,13260,1.0,0.0,0.0,4,7,1290,820,1979,0,98058,47.4513,-122.16,1980,11016,9,24,2014,UNK,130,2244
1056200010,9/2/2014,750000.0,3,1.75,1590,8285,1.0,0.0,0.0,4,8,1590,0,1956,0,98004,47.5855,-122.194,1970,8970,9,2,2014,UNK,-380,-685
263000359,6/30/2014,355000.0,3,2.25,1370,1524,3.0,0.0,0.0,3,8,1370,0,2005,0,98103,47.6982,-122.34700000000001,1370,1418,6,30,2014,N,0,106
6624010170,5/8/2014,246000.0,3,1.75,1390,7399,1.0,0.0,0.0,4,7,1390,0,1975,0,98031,47.4183,-122.182,1460,7800,5,8,2014,UNK,-70,-401
824059265,10/1/2014,1160000.0,3,1.75,1640,10464,1.0,0.0,2.0,4,8,1640,0,1968,0,98004,47.5873,-122.205,2630,18872,10,1,2014,UNK,-990,-8408
2869100080,6/6/2014,744000.0,3,2.5,2670,12187,2.0,0.0,0.0,3,8,2670,0,1986,0,98052,47.6677,-122.15,2400,8999,6,6,2014,UNK,270,3188
203100440,9/11/2014,1210000.0,3,3.75,5400,24740,2.0,0.0,0.0,3,11,5400,0,1997,0,98053,47.6426,-121.955,1690,20000,9,11,2014,UNK,3710,4740
9542800290,12/10/2014,217000.0,3,2.0,1690,6750,1.0,0.0,0.0,3,7,1210,480,1977,0,98023,47.3021,-122.375,1930,7350,12,10,2014,UNK,-240,-600
3342100780,7/9/2014,583000.0,3,2.5,2600,5100,2.0,0.0,1.0,3,8,2600,0,1998,0,98056,47.5175,-122.205,2270,5400,7,9,2014,UNK,330,-300
475000080,11/11/2014,515000.0,2,1.5,1400,5000,1.0,0.0,0.0,4,7,1150,250,1904,0,98107,47.6681,-122.36200000000001,1530,4200,11,11,2014,UNK,-130,800
1562100380,3/19/2015,594000.0,4,1.75,2140,8000,1.0,0.0,0.0,4,8,1410,730,1965,0,98007,47.622,-122.139,2080,8000,3,19,2015,UNK,60,0
3878900185,10/22/2014,303100.0,3,1.5,1640,5650,1.0,0.0,0.0,3,8,1640,0,1952,0,98178,47.50899999999999,-122.251,1640,5650,10,22,2014,UNK,0,0
6791100280,10/10/2014,430000.0,3,1.75,1720,15225,1.0,0.0,0.0,4,7,1020,0,1970,0,98075,47.57899999999999,-122.051,1860,13588,10,10,2014,UNK,-140,1637
1926059099,12/8/2014,708000.0,5,3.25,3060,11778,2.0,0.0,0.0,3,8,3060,0,2004,0,98034,47.7212,-122.22200000000001,1840,10403,12,8,2014,N,1220,1375
2881700547,8/13/2014,221000.0,3,1.0,1150,7260,1.0,0.0,0.0,3,7,1150,0,1959,0,98133,47.7344,-122.333,1200,7888,8,13,2014,UNK,-50,-628
3260800190,3/24/2015,325000.0,3,2.5,2000,7205,2.0,0.0,0.0,3,8,2000,0,1998,0,98003,47.3499,-122.302,2180,7611,3,24,2015,UNK,-180,-406
7715600050,2/19/2015,385000.0,3,1.75,1560,5950,1.0,0.0,0.0,4,6,780,780,1944,0,98125,47.718999999999994,-122.307,1320,7830,2,19,2015,UNK,240,-1880
3158500460,3/27/2015,359500.0,3,2.5,2070,4689,2.0,0.0,0.0,3,8,2070,0,2013,0,98038,47.3545,-122.056,1880,4593,3,27,2015,N,190,96
4027700797,8/7/2014,433000.0,3,2.0,1920,7200,1.0,0.0,0.0,3,7,1300,620,1984,0,98028,47.7703,-122.265,2010,7200,8,7,2014,UNK,-90,0
9161100460,3/23/2015,525000.0,2,1.0,1000,4950,1.0,0.0,0.0,3,7,800,200,1948,0,98116,47.5671,-122.39399999999999,1060,5500,3,23,2015,UNK,-60,-550
8069000216,7/22/2014,356200.0,3,2.0,1690,10062,1.0,0.0,2.0,5,7,940,750,1928,0,98178,47.5102,-122.241,2390,6650,7,22,2014,UNK,-700,3412
3401700255,7/29/2014,595000.0,4,2.0,3090,87120,1.0,0.0,0.0,4,7,1590,1500,1974,0,98072,47.7275,-122.12200000000001,2560,88426,7,29,2014,UNK,530,-1306
4083306720,9/15/2014,560000.0,4,1.5,1790,3420,1.0,0.0,0.0,4,7,1020,770,1923,0,98103,47.6489,-122.337,1680,3420,9,15,2014,UNK,110,0
6377200010,12/8/2014,2180000.0,4,3.0,4750,21701,1.5,0.0,0.0,5,11,4750,0,1976,0,98004,47.6454,-122.21799999999999,3120,18551,12,8,2014,UNK,1630,3150
2767601100,10/27/2014,513000.0,4,2.0,2090,4000,1.0,0.0,0.0,3,7,1480,610,1951,0,98107,47.6751,-122.37899999999999,1510,5000,10,27,2014,UNK,580,-1000
2856100185,7/21/2014,365000.0,2,1.0,680,2550,1.0,0.0,0.0,4,5,680,0,1901,0,98117,47.6767,-122.38799999999999,1120,5100,7,21,2014,UNK,-440,-2550
3438500797,7/8/2014,368000.0,4,1.75,2100,11942,1.0,0.0,0.0,3,7,1030,1070,1964,0,98106,47.55,-122.35600000000001,1170,6986,7,8,2014,UNK,930,4956
6738700275,6/25/2014,870000.0,4,2.75,2840,4000,1.5,0.0,0.0,5,8,1960,880,1912,0,98144,47.5846,-122.291,2750,4000,6,25,2014,UNK,90,0
1761100190,7/24/2014,225000.0,3,2.25,1470,6808,1.0,0.0,0.0,3,7,1160,310,1984,0,98023,47.2884,-122.365,1570,7881,7,24,2014,UNK,-100,-1073
713500020,4/21/2015,1390000.0,4,4.5,4490,24767,2.0,0.0,2.0,3,11,3800,690,1998,0,98006,47.5544,-122.147,3370,32700,4,21,2015,UNK,1120,-7933
5412310170,6/19/2014,177000.0,3,1.75,1150,8079,1.0,0.0,0.0,4,7,1150,0,1983,0,98030,47.3766,-122.18,1540,7399,6,19,2014,UNK,-390,680
7751800080,1/27/2015,465000.0,3,1.5,1460,9879,1.0,0.0,0.0,3,7,1460,0,1956,0,98008,47.6346,-122.12700000000001,1610,10050,1,27,2015,UNK,-150,-171
1121000414,9/27/2014,750000.0,4,2.75,3150,6343,1.0,0.0,3.0,3,8,1810,1340,1976,0,98126,47.5424,-122.381,2250,6343,9,27,2014,UNK,900,0
4239400920,9/22/2014,149000.0,3,1.0,1090,2800,1.0,0.0,0.0,3,6,1090,0,1969,0,98092,47.3162,-122.18299999999999,1040,2960,9,22,2014,UNK,50,-160
9408300380,6/9/2014,605000.0,3,2.5,2670,47480,2.0,0.0,3.0,3,9,2670,0,1981,0,98072,47.7443,-122.11399999999999,2760,42800,6,9,2014,UNK,-90,4680
6865200095,10/24/2014,725000.0,3,2.0,2110,5800,1.5,0.0,0.0,4,7,1990,120,1927,0,98103,47.6645,-122.34200000000001,1620,4300,10,24,2014,UNK,490,1500
6669080010,9/22/2014,413900.0,4,2.25,1770,5236,2.0,0.0,0.0,3,7,1770,0,2007,0,98056,47.5137,-122.189,2470,5064,9,22,2014,N,-700,172
1446400670,7/31/2014,199950.0,3,1.5,1510,6600,1.0,0.0,0.0,3,6,1510,0,1938,0,98168,47.4821,-122.331,990,6600,7,31,2014,UNK,520,0
203100460,9/24/2014,400000.0,1,1.0,530,13679,1.0,0.0,0.0,4,6,530,0,1949,0,98053,47.6422,-121.954,1930,20624,9,24,2014,UNK,-1400,-6945
9523102750,8/12/2014,870000.0,3,1.5,2420,5000,2.0,0.0,0.0,4,8,2200,220,1925,0,98103,47.6744,-122.353,2070,5000,8,12,2014,UNK,350,0
8078570380,6/5/2014,292000.0,5,2.5,2490,7666,1.0,0.0,0.0,4,7,1490,1000,1989,0,98031,47.4022,-122.171,1930,7415,6,5,2014,UNK,560,251
1423800080,5/12/2014,225000.0,3,1.0,990,8012,1.0,0.0,0.0,4,7,990,0,1966,0,98058,47.4557,-122.181,1260,9060,5,12,2014,UNK,-270,-1048
9259900010,3/16/2015,466750.0,4,2.0,1730,9139,2.0,0.0,0.0,3,8,1730,0,1957,0,98125,47.7181,-122.316,1410,7311,3,16,2015,UNK,320,1828
4223400050,3/23/2015,330000.0,2,1.5,1440,11954,1.0,0.0,0.0,4,8,1440,0,1978,0,98002,47.2909,-122.219,1460,9730,3,23,2015,UNK,-20,2224
686400380,10/2/2014,770000.0,7,2.25,3260,8145,2.0,0.0,0.0,5,8,3260,0,1967,0,98008,47.6336,-122.115,2340,8145,10,2,2014,UNK,920,0
1102001112,2/13/2015,802500.0,4,2.25,1950,7000,1.0,0.0,1.0,3,8,1450,500,1957,0,98118,47.5426,-122.262,1840,6440,2,13,2015,UNK,110,560
241900020,7/18/2014,378800.0,5,2.5,2740,5400,2.0,0.0,0.0,3,8,2740,0,2005,0,98031,47.4036,-122.205,2900,5476,7,18,2014,N,-160,-76
8691300380,5/1/2015,795000.0,3,2.75,2940,12487,2.0,0.0,0.0,3,10,2940,0,1997,0,98075,47.5879,-121.973,3110,10837,5,1,2015,UNK,-170,1650
3426049132,4/22/2015,460000.0,3,2.0,1200,7320,1.0,0.0,0.0,3,7,1200,0,1955,0,98115,47.6986,-122.286,1750,8220,4,22,2015,UNK,-550,-900
3904901190,12/19/2014,567000.0,3,2.5,2070,10908,2.0,0.0,0.0,3,8,2070,0,1986,0,98029,47.5665,-122.023,2220,10975,12,19,2014,UNK,-150,-67
1789900080,7/22/2014,209950.0,3,1.75,1570,15570,1.0,0.0,0.0,3,7,1570,0,1981,0,98023,47.3207,-122.36200000000001,2000,28200,7,22,2014,UNK,-430,-12630
1021049022,5/20/2014,415000.0,2,1.0,1050,60113,1.0,0.0,0.0,4,7,1050,0,1943,0,98001,47.3226,-122.287,1380,27442,5,20,2014,UNK,-330,32671
5634500179,12/15/2014,424500.0,4,1.5,1830,6985,1.0,0.0,0.0,3,7,1080,750,1967,0,98028,47.7494,-122.236,1650,9501,12,15,2014,UNK,180,-2516
795002455,5/5/2015,261000.0,2,1.0,970,12500,1.0,0.0,0.0,3,6,970,0,1941,0,98168,47.5102,-122.33,1280,6250,5,5,2015,UNK,-310,6250
6666860170,8/27/2014,365000.0,3,2.5,2200,9696,2.0,0.0,0.0,3,8,2200,0,1987,0,98031,47.4197,-122.205,2200,9915,8,27,2014,UNK,0,-219
9828200605,4/8/2015,631000.0,4,2.0,1930,3240,1.5,0.0,0.0,4,7,1930,0,1911,0,98122,47.6156,-122.29899999999999,1480,3600,4,8,2015,UNK,450,-360
853200010,7/1/2014,3800000.0,5,5.5,7050,42840,1.0,0.0,2.0,4,13,4320,2730,1978,0,98004,47.6229,-122.22,5070,20570,7,1,2014,UNK,1980,22270
4449800345,10/8/2014,584000.0,3,2.5,1790,3962,2.0,0.0,0.0,3,8,1790,0,1992,0,98117,47.6894,-122.391,1340,3960,10,8,2014,UNK,450,2
2522029136,7/29/2014,310000.0,3,1.75,1560,82328,1.0,0.0,0.0,3,7,1560,0,1974,0,98070,47.3674,-122.50299999999999,2100,205603,7,29,2014,UNK,-540,-123275
1149900050,3/12/2015,717000.0,4,2.5,2780,7985,2.0,0.0,0.0,4,10,2780,0,1992,0,98029,47.5608,-122.016,2650,8094,3,12,2015,UNK,130,-109
6908200080,6/16/2014,667000.0,3,1.5,1720,8100,2.0,0.0,0.0,3,8,1720,0,1907,0,98107,47.6746,-122.4,2210,8100,6,16,2014,UNK,-490,0
3395800660,12/30/2014,190000.0,3,1.0,1640,8100,1.0,0.0,0.0,3,6,1040,600,1939,0,98146,47.482,-122.34,1600,8100,12,30,2014,UNK,40,0
9414610010,6/17/2014,430000.0,3,2.0,1730,9000,1.0,0.0,0.0,3,8,1370,360,1978,0,98027,47.5202,-122.04700000000001,2390,10000,6,17,2014,UNK,-660,-1000
5379805120,4/24/2015,213000.0,2,1.0,740,7380,1.0,0.0,0.0,4,6,740,0,1951,0,98188,47.4481,-122.27799999999999,1500,10075,4,24,2015,UNK,-760,-2695
1530900290,10/7/2014,475000.0,3,2.5,2280,3710,1.0,0.0,0.0,3,8,1550,730,1990,0,98072,47.735,-122.15899999999999,2030,3710,10,7,2014,UNK,250,0
8886000005,3/9/2015,649000.0,2,2.75,2090,23962,2.0,0.0,3.0,4,8,2090,0,1988,0,98070,47.4145,-122.44,1820,32340,3,9,2015,UNK,270,-8378
8965400010,6/6/2014,715000.0,3,2.5,2550,13458,2.0,0.0,0.0,3,9,2550,0,1990,0,98006,47.5586,-122.12100000000001,3180,13458,6,6,2014,UNK,-630,0
8644210470,3/18/2015,845000.0,4,3.5,3350,19487,1.0,0.0,0.0,3,11,2460,890,1992,0,98075,47.5796,-121.99799999999999,3360,19460,3,18,2015,UNK,-10,27
1545805980,11/10/2014,390000.0,3,2.5,2770,8820,1.0,0.0,0.0,3,7,1900,870,1980,2004,98038,47.3685,-122.04799999999999,1850,10920,11,10,2014,Y,920,-2100
2841500010,9/24/2014,390000.0,4,3.0,2860,5724,1.0,0.0,0.0,3,7,1730,1130,1983,0,98108,47.5427,-122.302,2340,7200,9,24,2014,UNK,520,-1476
1328330290,7/29/2014,328000.0,4,1.75,1990,7194,1.0,0.0,0.0,4,8,1400,590,1978,0,98058,47.4417,-122.135,1820,7400,7,29,2014,UNK,170,-206
4222100280,12/5/2014,239999.0,3,2.75,1740,8436,1.0,0.0,0.0,3,7,1140,600,1967,0,98003,47.3456,-122.305,1550,8436,12,5,2014,UNK,190,0
4222200280,10/21/2014,225000.0,3,2.0,1460,7740,1.0,0.0,0.0,3,7,1460,0,1968,0,98003,47.3467,-122.306,1540,7644,10,21,2014,UNK,-80,96
3224510290,10/16/2014,920000.0,3,1.75,3670,11884,1.0,0.0,2.0,4,9,1950,1720,1979,0,98006,47.5604,-122.133,3020,9747,10,16,2014,UNK,650,2137
5196420290,3/17/2015,940000.0,4,2.75,3270,9231,2.0,0.0,0.0,3,10,3270,0,1995,0,98052,47.6539,-122.12100000000001,3380,10154,3,17,2015,UNK,-110,-923
1703900005,5/1/2015,465000.0,3,1.0,1210,4872,1.0,0.0,0.0,4,6,1210,0,1949,0,98118,47.5551,-122.273,1070,4872,5,1,2015,UNK,140,0
3329530480,7/1/2014,241000.0,3,2.0,1770,7000,1.0,0.0,0.0,3,7,1770,0,1986,0,98001,47.3321,-122.26100000000001,1510,10462,7,1,2014,UNK,260,-3462
1541700170,6/9/2014,307550.0,4,2.5,1980,5909,2.0,0.0,0.0,3,8,1980,0,2003,0,98031,47.3913,-122.185,2550,5487,6,9,2014,UNK,-570,422
8833510190,10/31/2014,490000.0,4,2.5,2650,9627,1.0,0.0,3.0,4,8,1610,1040,1976,0,98028,47.7684,-122.25399999999999,2650,9221,10,31,2014,UNK,0,406
8961970190,5/12/2014,647000.0,4,2.5,3040,6887,2.0,0.0,0.0,3,8,3040,0,1999,0,98074,47.6073,-122.015,2790,7196,5,12,2014,UNK,250,-309
323069120,8/27/2014,780000.0,4,2.75,3640,231739,1.5,0.0,0.0,3,10,3640,0,1999,0,98027,47.5078,-122.01799999999999,2670,91040,8,27,2014,UNK,970,140699
8944360170,11/14/2014,517500.0,3,2.5,1810,4332,2.0,0.0,0.0,3,8,1810,0,1992,0,98029,47.5776,-121.99600000000001,1740,4332,11,14,2014,UNK,70,0
2546500020,6/18/2014,295000.0,3,2.0,1380,8682,1.0,0.0,0.0,4,7,1380,0,1966,0,98148,47.4238,-122.322,1410,10594,6,18,2014,UNK,-30,-1912
1338801060,12/4/2014,560000.0,4,1.5,1810,3400,2.0,0.0,0.0,3,8,1810,0,1926,0,98112,47.6264,-122.302,1770,3600,12,4,2014,UNK,40,-200
3747600050,11/5/2014,319450.0,5,2.0,2250,5472,1.5,0.0,0.0,5,7,1750,500,1930,0,98002,47.3065,-122.219,1540,5472,11,5,2014,UNK,710,0
327000050,12/12/2014,1500000.0,4,3.25,3860,7199,2.0,0.0,1.0,3,9,2870,990,2005,0,98115,47.6855,-122.26899999999999,2940,9600,12,12,2014,N,920,-2401
1898900280,9/19/2014,340000.0,4,3.0,2380,20277,1.0,0.0,0.0,3,8,1500,880,1999,0,98023,47.3046,-122.39200000000001,2370,15440,9,19,2014,UNK,10,4837
1423400005,8/15/2014,249950.0,3,1.0,1370,11658,1.0,0.0,0.0,4,6,1370,0,1958,0,98058,47.4576,-122.182,1080,9198,8,15,2014,UNK,290,2460
9521100585,6/13/2014,499950.0,3,1.0,1830,3000,1.5,0.0,0.0,3,7,1430,400,1926,0,98103,47.6619,-122.351,1510,2500,6,13,2014,UNK,320,500
2025059150,7/2/2014,1040000.0,4,1.75,1440,13296,1.0,0.0,0.0,4,8,1440,0,1967,0,98004,47.63399999999999,-122.204,3520,10802,7,2,2014,UNK,-2080,2494
8941500010,2/16/2015,750000.0,4,2.5,2510,17200,1.0,0.0,2.0,4,9,1540,970,1977,0,98052,47.6287,-122.089,2370,14621,2,16,2015,UNK,140,2579
1425069071,3/23/2015,875000.0,4,2.5,3230,256132,2.0,0.0,0.0,3,9,3230,0,2006,0,98053,47.6544,-121.99799999999999,3080,217800,3,23,2015,N,150,38332
686400670,4/14/2015,678000.0,3,1.75,1670,7210,1.0,0.0,0.0,5,8,1670,0,1967,0,98008,47.6344,-122.116,2200,7210,4,14,2015,UNK,-530,0
2624049073,7/29/2014,360000.0,2,1.0,780,4200,1.0,0.0,0.0,3,6,780,0,1920,0,98118,47.5381,-122.26700000000001,1620,6000,7,29,2014,UNK,-840,-1800
1523059180,9/23/2014,354900.0,3,1.0,1720,16552,1.0,0.0,0.0,4,7,1720,0,1971,0,98059,47.4772,-122.15299999999999,1550,15457,9,23,2014,UNK,170,1095
8016300250,8/27/2014,632000.0,5,2.5,2260,10087,1.0,0.0,0.0,3,8,1520,740,1967,0,98008,47.5982,-122.12799999999999,2500,9440,8,27,2014,UNK,-240,647
7694600143,12/18/2014,350000.0,3,1.75,1480,9375,1.0,0.0,0.0,4,7,1480,0,1957,0,98146,47.5076,-122.366,1370,9000,12,18,2014,UNK,110,375
269000950,7/30/2014,990000.0,3,4.0,2550,3900,2.0,0.0,2.0,3,8,2050,500,1940,2003,98199,47.6415,-122.39200000000001,2340,6400,7,30,2014,Y,210,-2500
2724079090,1/5/2015,1650000.0,4,3.25,3920,881654,3.0,0.0,3.0,3,11,3920,0,2002,0,98024,47.5385,-121.896,2970,112384,1,5,2015,UNK,950,769270
3342103369,7/7/2014,481000.0,4,2.5,2286,8269,2.0,0.0,0.0,3,8,2286,0,2002,0,98056,47.5174,-122.194,2110,4711,7,7,2014,UNK,176,3558
7104100050,6/24/2014,485000.0,3,2.5,1500,5412,1.0,0.0,0.0,5,7,900,600,1920,0,98136,47.5499,-122.39399999999999,1090,5412,6,24,2014,UNK,410,0
8944360290,4/13/2015,477000.0,3,2.5,1740,4960,2.0,0.0,0.0,3,8,1740,0,1992,0,98029,47.5772,-121.99799999999999,1740,5021,4,13,2015,UNK,0,-61
6072500050,7/29/2014,560000.0,5,2.5,2880,9000,1.0,0.0,0.0,5,8,1440,1440,1966,0,98006,47.5456,-122.179,2010,9000,7,29,2014,UNK,870,0
1066000290,11/17/2014,600000.0,6,3.0,2600,9350,1.0,0.0,0.0,4,8,1340,1260,1963,0,98008,47.6198,-122.105,2090,9102,11,17,2014,UNK,510,248
2817260130,6/13/2014,622500.0,5,2.75,3320,23760,2.0,0.0,0.0,4,8,2190,1130,1975,0,98072,47.7498,-122.146,2520,36720,6,13,2014,UNK,800,-12960
3582750170,4/29/2015,410000.0,2,2.25,1660,2128,2.0,0.0,0.0,4,8,1660,0,1974,0,98028,47.7528,-122.25200000000001,1640,2128,4,29,2015,UNK,20,0
255370420,4/2/2015,318200.0,3,2.5,1990,3644,2.0,0.0,0.0,3,7,1990,0,2010,0,98038,47.3531,-122.01700000000001,2580,3800,4,2,2015,N,-590,-156
2571910380,6/5/2014,289000.0,3,2.0,1680,8424,1.0,0.0,0.0,3,7,1680,0,1993,0,98022,47.1969,-122.01100000000001,1990,8545,6,5,2014,UNK,-310,-121
3832150190,5/20/2014,263000.0,3,1.75,1570,7775,2.0,0.0,0.0,3,7,1570,0,1982,0,98031,47.3876,-122.21600000000001,1580,8622,5,20,2014,UNK,-10,-847
5279100680,6/5/2014,240000.0,3,1.0,1150,4825,1.0,0.0,0.0,4,6,1150,0,1957,0,98027,47.5321,-122.029,1760,7121,6,5,2014,UNK,-610,-2296
7889601870,4/7/2015,281500.0,3,1.0,1270,7500,1.0,0.0,0.0,3,7,1270,0,1953,0,98146,47.4921,-122.339,1340,3000,4,7,2015,UNK,-70,4500
5694001061,6/20/2014,587206.0,3,3.5,1890,1710,2.0,0.0,0.0,3,8,1640,250,1999,0,98103,47.6592,-122.34899999999999,1680,1562,6,20,2014,UNK,210,148
1912100882,7/30/2014,482000.0,2,2.25,1350,1248,2.0,0.0,0.0,3,7,1180,170,2000,0,98102,47.6399,-122.32,1760,3360,7,30,2014,UNK,-410,-2112
8563020170,3/10/2015,485000.0,3,1.75,1650,9500,1.0,0.0,0.0,3,8,1650,0,1967,0,98052,47.631,-122.098,1880,9375,3,10,2015,UNK,-230,125
8656800020,2/12/2015,309000.0,3,2.5,1450,11480,2.0,0.0,0.0,3,7,1450,0,1990,0,98014,47.672,-121.86399999999999,2080,87991,2,12,2015,UNK,-630,-76511
3876540780,6/19/2014,221000.0,3,2.25,1640,7350,1.0,0.0,0.0,3,7,1140,500,1984,0,98003,47.2625,-122.3,1480,8041,6,19,2014,UNK,160,-691
8563030280,5/13/2014,700000.0,3,2.5,2030,8398,2.0,0.0,0.0,4,9,2030,0,1975,0,98008,47.6272,-122.095,2450,8104,5,13,2014,UNK,-420,294
2114300290,9/29/2014,411500.0,5,3.0,2420,7740,1.0,0.0,0.0,5,7,1360,1060,1929,1969,98106,47.536,-122.35799999999999,1840,6780,9,29,2014,Y,580,960
9141100005,10/28/2014,285000.0,4,3.5,2770,10505,2.0,0.0,0.0,3,8,2770,0,1940,2015,98133,47.7412,-122.355,1760,10505,10,28,2014,Y,1010,0
5727500019,6/5/2014,395000.0,4,3.0,1980,7931,1.0,0.0,0.0,4,7,1160,820,1983,0,98133,47.7513,-122.334,1910,7931,6,5,2014,UNK,70,0
1796360080,7/9/2014,237950.0,2,1.75,1460,7926,1.0,0.0,0.0,4,7,1460,0,1987,0,98042,47.3665,-122.09200000000001,1680,8206,7,9,2014,UNK,-220,-280
9485800050,3/10/2015,680000.0,3,2.5,1610,8064,1.0,0.0,2.0,4,7,1160,450,1981,0,98033,47.6818,-122.189,2260,8328,3,10,2015,UNK,-650,-264
5560000680,12/26/2014,199950.0,2,1.0,1010,10057,1.0,0.0,0.0,3,6,1010,0,1961,0,98023,47.3286,-122.336,1040,8591,12,26,2014,UNK,-30,1466
9297300480,12/12/2014,765000.0,4,3.5,2760,4000,2.0,0.0,2.0,3,8,2000,760,1926,2014,98126,47.5687,-122.374,1690,4000,12,12,2014,Y,1070,0
6813600415,5/8/2014,515000.0,2,1.0,1060,4960,1.0,0.0,0.0,3,7,1060,0,1926,0,98103,47.6896,-122.331,1420,4960,5,8,2014,UNK,-360,0
6751300255,6/16/2014,470000.0,3,1.5,1510,8000,1.0,0.0,0.0,4,7,1510,0,1956,0,98007,47.5865,-122.135,1430,8000,6,16,2014,UNK,80,0
3300700480,8/20/2014,330000.0,2,1.0,880,4000,1.0,0.0,0.0,3,6,780,100,1937,0,98117,47.6931,-122.37899999999999,950,4000,8,20,2014,UNK,-70,0
5379800446,2/26/2015,284000.0,3,2.5,2150,9375,1.0,0.0,0.0,3,8,1550,600,1968,0,98188,47.4578,-122.274,1950,9100,2,26,2015,UNK,200,275
9558200080,9/12/2014,295000.0,3,2.5,1660,8125,1.0,0.0,0.0,3,7,1150,510,1999,0,98148,47.4373,-122.333,1250,8125,9,12,2014,UNK,410,0
6817801150,3/30/2015,555000.0,4,2.5,2160,10987,1.0,0.0,0.0,4,8,1440,720,1981,0,98074,47.6333,-122.03399999999999,1280,11617,3,30,2015,UNK,880,-630
1454100005,8/6/2014,350000.0,3,1.0,1370,8162,1.5,0.0,0.0,3,6,1370,0,1949,0,98125,47.7263,-122.289,1560,8250,8,6,2014,UNK,-190,-88
104540840,12/3/2014,240000.0,3,2.25,1460,5818,1.0,0.0,0.0,3,7,1140,320,1986,0,98023,47.3113,-122.35799999999999,1490,6031,12,3,2014,UNK,-30,-213
2207100635,2/4/2015,419900.0,3,1.5,1450,7000,1.0,0.0,0.0,3,7,1450,0,1955,0,98007,47.5983,-122.15,1490,7245,2,4,2015,UNK,-40,-245
2489200250,4/30/2015,528000.0,3,2.0,1560,6300,1.0,0.0,0.0,3,7,1560,0,1924,0,98126,47.5407,-122.37899999999999,1620,6300,4,30,2015,UNK,-60,0
5130000080,3/11/2015,481000.0,4,2.5,2480,9869,1.0,0.0,0.0,4,8,1240,1240,1963,0,98028,47.7612,-122.229,2230,10310,3,11,2015,UNK,250,-441
6150700169,6/9/2014,304700.0,2,1.0,740,5995,1.0,0.0,0.0,4,7,740,0,1949,0,98133,47.7291,-122.337,1140,5995,6,9,2014,UNK,-400,0
8691350130,2/4/2015,715000.0,4,2.5,2927,12171,2.0,0.0,0.0,3,10,2927,0,1998,0,98075,47.5948,-121.98299999999999,2967,12166,2,4,2015,UNK,-40,5
6189200345,8/20/2014,738950.0,4,2.75,2260,12005,1.0,0.0,0.0,4,8,2260,0,1956,1989,98005,47.6342,-122.171,1870,10800,8,20,2014,Y,390,1205
2222059099,10/22/2014,215000.0,3,1.5,1240,9405,1.0,0.0,0.0,4,7,1240,0,1966,0,98042,47.3727,-122.162,2260,7611,10,22,2014,UNK,-1020,1794
7227800660,5/22/2014,300000.0,6,2.0,2040,10812,1.0,0.0,0.0,4,5,2040,0,1943,0,98056,47.4919,-122.181,1440,10200,5,22,2014,UNK,600,612
1148000005,6/23/2014,346000.0,3,1.75,1270,8100,1.0,0.0,0.0,3,6,880,390,1950,0,98146,47.4828,-122.344,1650,8173,6,23,2014,UNK,-380,-73
6055000430,3/27/2015,473000.0,4,3.5,4370,37193,2.0,0.0,3.0,3,8,2780,1590,1996,0,98022,47.24100000000001,-121.979,2860,39356,3,27,2015,UNK,1510,-2163
7616200050,1/5/2015,500000.0,3,1.75,1700,6120,1.0,0.0,0.0,3,7,1700,0,1952,0,98116,47.5807,-122.397,1330,6120,1,5,2015,UNK,370,0
7234601440,9/25/2014,750000.0,2,1.5,1300,7632,1.0,0.0,2.0,3,7,1300,0,1943,0,98122,47.6134,-122.30799999999999,1420,1676,9,25,2014,UNK,-120,5956
8563020380,5/20/2014,519900.0,4,2.0,1820,9350,1.0,0.0,0.0,4,8,1820,0,1967,0,98052,47.6288,-122.098,2260,9299,5,20,2014,UNK,-440,51
1454100480,8/19/2014,378500.0,2,1.0,880,6171,1.0,0.0,0.0,4,7,880,0,1949,0,98125,47.7262,-122.285,2260,12769,8,19,2014,UNK,-1380,-6598
5151600285,5/7/2014,314500.0,3,1.75,1870,12381,1.0,0.0,0.0,4,8,1870,0,1957,0,98003,47.3358,-122.32,1950,12667,5,7,2014,UNK,-80,-286
2155000480,4/29/2015,499950.0,3,1.5,1350,9315,1.0,0.0,0.0,3,7,1350,0,1968,0,98052,47.6587,-122.124,1840,9920,4,29,2015,UNK,-490,-605
1024049024,12/3/2014,1740000.0,5,3.5,4870,7700,2.5,0.0,3.0,5,10,3650,1220,1929,0,98144,47.5832,-122.29,3220,7700,12,3,2014,UNK,1650,0
1026069163,4/22/2015,630000.0,3,2.5,2460,38794,2.0,0.0,0.0,3,9,2460,0,1999,0,98077,47.7602,-122.022,2470,51400,4,22,2015,UNK,-10,-12606
4427100095,6/23/2014,360000.0,4,1.5,1720,6417,1.0,0.0,0.0,3,7,1720,0,1953,0,98125,47.7268,-122.311,1430,6240,6,23,2014,UNK,290,177
4047200380,5/26/2014,460000.0,2,1.5,2730,19877,1.0,0.0,0.0,4,8,1570,1160,1976,0,98019,47.7698,-121.898,1450,19509,5,26,2014,UNK,1280,368
3222049024,5/22/2014,361000.0,3,1.0,1100,4046,1.5,0.0,4.0,4,6,1100,0,1922,0,98198,47.343999999999994,-122.331,2550,7847,5,22,2014,UNK,-1450,-3801
2287000010,7/10/2014,713400.0,3,2.25,1810,9845,1.0,0.0,0.0,4,8,1810,0,1959,1991,98040,47.5505,-122.221,1900,10083,7,10,2014,Y,-90,-238
3692900010,10/28/2014,445000.0,2,1.0,930,3150,1.0,0.0,0.0,5,6,930,0,1918,0,98115,47.6783,-122.29799999999999,1900,5000,10,28,2014,UNK,-970,-1850
320069049,5/14/2014,305000.0,4,1.5,1590,131551,1.0,0.0,3.0,4,7,1590,0,1966,0,98022,47.2558,-122.024,2280,108028,5,14,2014,UNK,-690,23523
868002335,3/4/2015,1430000.0,3,2.75,2710,9204,1.5,0.0,4.0,3,9,1480,1230,1975,0,98177,47.7039,-122.385,2960,10080,3,4,2015,UNK,-250,-876
8945100050,4/24/2015,222000.0,3,1.0,1460,8400,1.0,0.0,0.0,4,6,1460,0,1962,0,98023,47.3086,-122.365,1060,8563,4,24,2015,UNK,400,-163
7853250080,2/16/2015,510000.0,5,3.25,3400,4499,2.0,0.0,0.0,3,8,2740,660,2005,0,98065,47.5385,-121.88,3400,6163,2,16,2015,N,0,-1664
6713700250,6/4/2014,500000.0,5,3.0,2920,11440,2.0,0.0,0.0,3,8,2920,0,2003,0,98133,47.7607,-122.354,1720,9348,6,4,2014,UNK,1200,2092
4232901990,5/16/2014,605000.0,2,1.0,910,3600,1.0,0.0,0.0,4,7,910,0,1909,0,98119,47.6341,-122.361,1720,3600,5,16,2014,UNK,-810,0
3578401760,8/20/2014,393000.0,3,2.0,1320,10720,2.0,0.0,0.0,3,8,1320,0,1981,0,98074,47.6203,-122.037,1910,13639,8,20,2014,UNK,-590,-2919
9113200290,6/25/2014,725000.0,4,2.5,2490,5170,2.0,0.0,0.0,4,9,2490,0,2000,0,98052,47.6836,-122.162,2490,5170,6,25,2014,UNK,0,0
5116000250,7/7/2014,320000.0,3,1.75,2220,11646,1.0,0.0,0.0,3,7,1270,950,1950,0,98028,47.7762,-122.27,1490,10003,7,7,2014,UNK,730,1643
1099600010,6/12/2014,210000.0,4,1.5,1130,7840,1.0,0.0,0.0,4,7,1130,0,1970,0,98023,47.2986,-122.37700000000001,1690,7840,6,12,2014,UNK,-560,0
5416500980,7/29/2014,419900.0,4,2.5,2750,5767,2.0,0.0,0.0,3,9,2750,0,2005,0,98038,47.3595,-122.038,2800,5376,7,29,2014,N,-50,391
7312100010,3/2/2015,410000.0,4,2.5,2240,4447,2.0,0.0,0.0,3,7,2240,0,2006,0,98059,47.4868,-122.15899999999999,2000,3800,3,2,2015,N,240,647
7936000562,12/16/2014,721000.0,3,2.25,2680,10440,1.0,0.0,1.0,3,8,1540,1140,1963,0,98116,47.56100000000001,-122.398,2140,7560,12,16,2014,UNK,540,2880
9839300545,7/14/2014,605000.0,2,2.0,1270,5500,1.5,0.0,0.0,4,8,1270,0,1921,0,98122,47.6121,-122.294,1870,4400,7,14,2014,UNK,-600,1100
6837700005,12/3/2014,738000.0,3,1.75,1520,5500,1.5,0.0,0.0,5,7,1520,0,1936,0,98116,47.5839,-122.383,2310,5500,12,3,2014,UNK,-790,0
6918720080,4/2/2015,725000.0,6,3.0,2480,12000,2.0,0.0,0.0,3,8,2480,0,1972,0,98007,47.6131,-122.145,2220,8580,4,2,2015,UNK,260,3420
9407001700,8/19/2014,255000.0,2,1.0,960,20954,1.0,0.0,0.0,3,7,960,0,1977,0,98045,47.4485,-121.774,1240,9752,8,19,2014,UNK,-280,11202
1473200130,3/20/2015,303000.0,3,2.25,1340,873,3.0,0.0,0.0,3,8,1340,0,2009,0,98133,47.7325,-122.34299999999999,1340,1186,3,20,2015,N,0,-313
4037200585,7/23/2014,394950.0,3,2.5,1090,7700,1.0,0.0,0.0,4,7,1090,0,1957,0,98008,47.607,-122.12,1740,7700,7,23,2014,UNK,-650,0
5249803870,9/2/2014,530000.0,4,3.0,2240,5580,2.0,0.0,0.0,5,7,1830,410,1949,0,98118,47.5598,-122.27,1530,4800,9,2,2014,UNK,710,780
9558050170,5/13/2014,475000.0,4,2.5,3740,8700,1.0,0.0,0.0,3,10,2260,1480,2004,0,98058,47.4587,-122.117,2650,6333,5,13,2014,N,1090,2367
1545808110,6/17/2014,250000.0,4,2.5,1800,8100,2.0,0.0,0.0,3,7,1800,0,1998,0,98038,47.3611,-122.04700000000001,1590,8100,6,17,2014,UNK,210,0
1604601155,12/8/2014,180000.0,3,1.0,780,3540,1.0,0.0,0.0,2,6,780,0,1920,0,98118,47.565,-122.291,1260,3540,12,8,2014,UNK,-480,0
2754700170,8/4/2014,443500.0,2,1.0,1330,4140,1.0,0.0,0.0,4,7,930,400,1919,1940,98115,47.6802,-122.306,1410,5100,8,4,2014,Y,-80,-960
3622059180,7/3/2014,390000.0,4,2.0,1900,76877,1.0,0.0,0.0,3,8,1900,0,2004,0,98042,47.3491,-122.113,1740,34848,7,3,2014,N,160,42029
7201600190,2/20/2015,430000.0,4,1.75,1570,7650,1.0,0.0,0.0,3,7,1100,470,1975,0,98052,47.6801,-122.10600000000001,1580,7650,2,20,2015,UNK,-10,0
3450300280,2/25/2015,460000.0,5,4.5,3100,7260,2.0,0.0,0.0,3,8,3100,0,1963,2000,98059,47.5004,-122.162,1650,7700,2,25,2015,Y,1450,-440
1036450170,3/12/2015,660000.0,3,3.5,2740,3785,2.0,0.0,0.0,3,9,2190,550,2001,0,98034,47.7195,-122.182,2060,3457,3,12,2015,UNK,680,328
8965000050,7/29/2014,515000.0,3,1.75,1570,10939,1.0,0.0,0.0,3,8,1200,370,1974,0,98052,47.6389,-122.102,1760,10200,7,29,2014,UNK,-190,739
4354700010,4/21/2015,482500.0,3,2.0,1330,6490,1.0,0.0,0.0,4,7,1330,0,1954,0,98125,47.7181,-122.30799999999999,1580,7202,4,21,2015,UNK,-250,-712
4057300170,6/2/2014,305000.0,2,1.5,1140,2980,2.0,0.0,0.0,3,7,1140,0,1988,0,98029,47.5707,-122.01799999999999,1150,2981,6,2,2014,UNK,-10,-1
4217400185,6/3/2014,835000.0,4,2.75,1550,4000,1.5,0.0,0.0,3,9,1550,0,1930,0,98105,47.6596,-122.28,2120,4000,6,3,2014,UNK,-570,0
8155750010,12/4/2014,237000.0,3,2.0,1290,7952,1.0,0.0,0.0,3,7,1290,0,1998,0,98030,47.3867,-122.19,1670,7280,12,4,2014,UNK,-380,672
2159900020,11/26/2014,445000.0,2,1.5,1510,2001,2.0,0.0,0.0,4,8,1510,0,1985,0,98007,47.6211,-122.15299999999999,1510,2055,11,26,2014,UNK,0,-54
2487700130,4/6/2015,710000.0,4,2.5,2720,8000,1.0,0.0,0.0,4,7,1360,1360,1955,0,98136,47.5237,-122.391,1790,8000,4,6,2015,UNK,930,0
2085200545,8/21/2014,180000.0,3,1.0,840,5700,1.0,0.0,0.0,4,5,840,0,1945,0,98038,47.3948,-122.02799999999999,1430,12600,8,21,2014,UNK,-590,-6900
9432900380,10/23/2014,280017.0,3,2.5,1850,8770,2.0,0.0,0.0,3,8,1850,0,1996,0,98022,47.2091,-122.009,2350,8606,10,23,2014,UNK,-500,164
2591850080,6/30/2014,436500.0,4,2.5,2290,11173,2.0,0.0,0.0,4,8,2290,0,1988,0,98058,47.4314,-122.164,2290,10404,6,30,2014,UNK,0,769
1025049174,5/15/2014,1260000.0,4,2.5,3200,7535,2.0,0.0,0.0,3,9,3200,0,2006,0,98105,47.666000000000004,-122.27600000000001,1650,6850,5,15,2014,N,1550,685
5628400080,12/18/2014,420000.0,3,2.25,1800,9800,1.0,0.0,0.0,4,7,1300,500,1959,0,98028,47.7393,-122.244,1680,9545,12,18,2014,UNK,120,255
7657000225,7/19/2014,205000.0,3,1.0,860,7467,1.0,0.0,0.0,3,6,860,0,1944,0,98178,47.4947,-122.23700000000001,1280,7467,7,19,2014,UNK,-420,0
6151800080,9/2/2014,570000.0,3,1.5,1980,10203,1.0,0.0,0.0,4,7,1680,300,1946,0,98010,47.3402,-122.046,1980,13664,9,2,2014,UNK,0,-3461
6154900095,7/11/2014,565000.0,4,1.75,2140,7102,1.0,0.0,0.0,4,7,1070,1070,1948,0,98177,47.7042,-122.37,1950,7102,7,11,2014,UNK,190,0
9542800050,12/11/2014,287000.0,2,2.5,2410,7500,1.0,0.0,0.0,3,7,1550,860,1978,0,98023,47.3078,-122.374,1840,8800,12,11,2014,UNK,570,-1300
526059224,9/23/2014,260000.0,4,1.75,1650,7276,1.0,0.0,0.0,3,7,1010,640,1977,0,98011,47.7721,-122.206,1840,8550,9,23,2014,UNK,-190,-1274
526059224,2/6/2015,470000.0,4,1.75,1650,7276,1.0,0.0,0.0,3,7,1010,640,1977,0,98011,47.7721,-122.206,1840,8550,2,6,2015,UNK,-190,-1274
3275850190,9/5/2014,700000.0,3,2.5,2410,9916,2.0,0.0,0.0,4,10,2410,0,1989,0,98052,47.6911,-122.103,2310,8212,9,5,2014,UNK,100,1704
4137000460,2/25/2015,249000.0,3,1.75,1520,7500,1.0,0.0,0.0,3,8,1520,0,1985,0,98092,47.2646,-122.219,2180,7506,2,25,2015,UNK,-660,-6
7936000403,6/9/2014,568000.0,3,1.75,2050,3520,1.0,0.0,0.0,4,7,1070,980,1977,0,98136,47.5536,-122.399,2050,16083,6,9,2014,UNK,0,-12563
1175000073,6/6/2014,500000.0,4,1.0,1720,4011,1.5,0.0,0.0,4,7,1720,0,1904,0,98107,47.6719,-122.396,1580,3784,6,6,2014,UNK,140,227
8645540290,11/26/2014,358000.0,5,2.5,2390,8775,1.0,0.0,0.0,4,7,1270,1120,1980,0,98058,47.4639,-122.17,1800,8000,11,26,2014,UNK,590,775
7137960460,5/28/2014,225000.0,3,2.5,1680,6755,2.0,0.0,0.0,3,8,1680,0,1994,0,98092,47.3293,-122.17,1860,7257,5,28,2014,UNK,-180,-502
8805400010,2/26/2015,275500.0,3,1.0,1060,7246,1.0,0.0,0.0,4,6,1060,0,1981,0,98056,47.4936,-122.165,1090,6694,2,26,2015,UNK,-30,552
1036450290,2/2/2015,495000.0,3,2.5,1860,3150,2.0,0.0,0.0,3,8,1860,0,2001,0,98034,47.718999999999994,-122.182,2050,3375,2,2,2015,UNK,-190,-225
7613700660,3/26/2015,758800.0,5,2.25,1750,5000,1.0,0.0,0.0,3,8,960,790,1940,0,98105,47.6589,-122.27600000000001,2580,5000,3,26,2015,UNK,-830,0
8648210050,4/3/2015,280000.0,3,1.75,1480,8165,1.0,0.0,0.0,4,7,1480,0,1985,0,98042,47.3624,-122.079,1450,7939,4,3,2015,UNK,30,226
1565950670,2/25/2015,380500.0,3,2.5,1900,7361,2.0,0.0,0.0,3,8,1900,0,1994,0,98055,47.4324,-122.191,2100,7361,2,25,2015,UNK,-200,0
7159200005,5/7/2014,3200000.0,7,4.5,6210,8856,2.5,0.0,2.0,5,11,4760,1450,1910,0,98109,47.6307,-122.354,2940,5400,5,7,2014,UNK,3270,3456
8687800010,6/17/2014,260000.0,3,1.75,1440,12888,1.0,0.0,2.0,3,7,1090,350,1958,0,98168,47.471000000000004,-122.262,1710,12888,6,17,2014,UNK,-270,0
4242900285,8/5/2014,630000.0,4,2.5,1910,1502,3.0,0.0,0.0,3,8,1910,0,2014,0,98107,47.6747,-122.39299999999999,1520,3888,8,5,2014,N,390,-2386
7834800225,8/20/2014,875000.0,3,2.0,2010,4000,1.0,0.0,0.0,5,7,1210,800,1915,0,98103,47.6638,-122.329,1770,4000,8,20,2014,UNK,240,0
5649600225,4/3/2015,457500.0,3,1.0,960,4600,1.5,0.0,0.0,4,6,960,0,1927,0,98118,47.5553,-122.286,1380,5175,4,3,2015,UNK,-420,-575
1959702045,11/19/2014,900000.0,2,1.0,1240,5500,1.0,0.0,0.0,3,7,1240,0,1954,0,98102,47.6461,-122.31700000000001,2080,4400,11,19,2014,UNK,-840,1100
717000225,10/28/2014,235000.0,2,2.0,870,6450,1.0,0.0,0.0,4,6,740,130,1954,0,98118,47.5354,-122.27799999999999,1640,5775,10,28,2014,UNK,-770,675
792500190,6/27/2014,410000.0,3,2.0,1400,45738,2.0,0.0,0.0,4,8,1400,0,1981,0,98070,47.3624,-122.455,2390,56628,6,27,2014,UNK,-990,-10890
3820100284,8/27/2014,355000.0,3,3.0,1850,9600,1.0,0.0,0.0,3,7,1230,620,1981,0,98028,47.7717,-122.25,1970,10000,8,27,2014,UNK,-120,-400
3629890190,6/6/2014,1300000.0,4,4.0,4270,6002,2.0,0.0,3.0,3,10,3180,1090,2004,0,98029,47.5443,-121.994,4280,5942,6,6,2014,N,-10,60
6868200029,9/29/2014,467500.0,3,1.75,2260,8512,1.0,0.0,0.0,3,7,1130,1130,1948,0,98125,47.7129,-122.304,2240,8040,9,29,2014,UNK,20,472
8901000143,11/25/2014,500000.0,4,4.5,2690,7350,1.5,0.0,0.0,5,7,2690,0,1949,0,98125,47.7062,-122.311,1660,9000,11,25,2014,UNK,1030,-1650
2927600630,4/16/2015,995000.0,4,3.5,2780,9550,2.0,0.0,4.0,5,10,2530,250,1978,0,98166,47.45399999999999,-122.37299999999999,2724,10634,4,16,2015,UNK,56,-1084
3432501315,8/27/2014,277000.0,3,1.0,1140,8144,1.0,0.0,0.0,3,7,1140,0,1956,0,98155,47.7464,-122.31700000000001,1150,8144,8,27,2014,UNK,-10,0
5101407250,12/17/2014,630000.0,4,2.25,2900,9680,2.0,0.0,0.0,3,7,1990,910,1947,0,98125,47.7037,-122.30799999999999,1850,7540,12,17,2014,UNK,1050,2140
3999200780,11/21/2014,628000.0,5,2.75,2830,11795,1.0,0.0,0.0,4,7,1710,1120,1960,0,98008,47.5828,-122.118,2460,10880,11,21,2014,UNK,370,915
2826079145,8/14/2014,655000.0,5,2.5,2560,46786,2.0,0.0,0.0,3,8,2560,0,1995,0,98019,47.7125,-121.915,2430,46929,8,14,2014,UNK,130,-143
1446403145,1/22/2015,170000.0,2,1.0,1240,9900,1.0,0.0,0.0,3,7,940,300,1950,0,98168,47.4862,-122.32600000000001,1050,9375,1,22,2015,UNK,190,525
5137000170,12/17/2014,352500.0,4,2.5,2100,10750,1.0,0.0,2.0,4,8,2100,0,1967,0,98023,47.3338,-122.337,2310,10425,12,17,2014,UNK,-210,325
2896310420,2/19/2015,615000.0,4,2.75,3120,34040,2.0,0.0,0.0,3,9,3120,0,1997,0,98010,47.3431,-122.03,2420,25201,2,19,2015,UNK,700,8839
1446400725,6/10/2014,165000.0,3,1.0,970,6600,1.0,0.0,0.0,3,7,970,0,1965,0,98168,47.4836,-122.33200000000001,1200,6600,6,10,2014,UNK,-230,0
4030500130,9/23/2014,243500.0,4,2.5,2300,15188,2.0,0.0,0.0,4,7,2300,0,1966,0,98042,47.3683,-122.164,1820,10125,9,23,2014,UNK,480,5063
3319500299,8/6/2014,304000.0,2,1.5,950,676,2.0,0.0,0.0,3,7,850,100,2003,0,98144,47.6005,-122.306,950,1280,8,6,2014,UNK,0,-604
7139800020,10/16/2014,369000.0,3,1.5,2110,5195,1.0,0.0,0.0,3,7,1210,900,1959,0,98118,47.5283,-122.286,1950,5195,10,16,2014,UNK,160,0
9433000460,10/7/2014,779950.0,4,2.75,2990,4298,2.0,0.0,0.0,3,9,2990,0,2014,0,98052,47.7101,-122.10799999999999,2990,4837,10,7,2014,N,0,-539
1326049130,7/2/2014,605000.0,4,2.25,2940,48788,1.0,0.0,0.0,5,7,1520,1420,1961,0,98028,47.7422,-122.245,2470,14900,7,2,2014,UNK,470,33888
7137960440,12/23/2014,292500.0,4,2.5,1860,8709,2.0,0.0,0.0,3,8,1860,0,1994,0,98092,47.3289,-122.17,1990,6825,12,23,2014,UNK,-130,1884
3946900010,3/23/2015,500007.0,2,1.75,1820,6050,1.0,0.0,0.0,3,7,910,910,1950,0,98115,47.6928,-122.323,1730,6050,3,23,2015,UNK,90,0
5592050080,4/29/2015,449999.0,4,2.5,1950,4947,2.0,0.0,0.0,3,8,1950,0,2000,0,98056,47.5042,-122.193,1760,5611,4,29,2015,UNK,190,-664
3288020050,6/27/2014,355000.0,4,2.5,1890,7867,2.0,0.0,0.0,3,8,1890,0,1996,0,98038,47.3788,-122.031,2250,7867,6,27,2014,UNK,-360,0
2459000020,11/25/2014,258000.0,4,3.0,2710,7199,1.0,0.0,0.0,4,7,1710,1000,1967,0,98030,47.3789,-122.213,2070,9271,11,25,2014,UNK,640,-2072
126049167,6/19/2014,380000.0,4,2.25,2150,20181,1.0,0.0,0.0,3,7,1090,1060,1963,0,98028,47.7627,-122.245,2150,10480,6,19,2014,UNK,0,9701
1525079069,7/8/2014,650000.0,4,3.0,3720,57499,1.0,0.0,0.0,3,9,1880,1840,2003,0,98014,47.6469,-121.897,2560,26372,7,8,2014,UNK,1160,31127
1786200010,5/14/2015,456500.0,4,2.5,2580,11780,2.0,0.0,0.0,3,9,2580,0,2003,0,98038,47.3658,-122.04,2410,8403,5,14,2015,UNK,170,3377
5602000275,8/25/2014,259950.0,4,2.0,1540,10212,1.5,0.0,0.0,5,7,1540,0,1948,0,98022,47.2056,-121.999,1480,10212,8,25,2014,UNK,60,0
1446403617,7/2/2014,123000.0,2,1.0,1050,6600,1.5,0.0,0.0,3,6,1050,0,1964,0,98168,47.4828,-122.324,1330,6600,7,2,2014,UNK,-280,0
2767603649,7/30/2014,520000.0,3,2.25,1210,1250,3.0,0.0,0.0,3,8,1210,0,2014,0,98107,47.6722,-122.384,1780,5000,7,30,2014,N,-570,-3750
3649100387,4/16/2015,506000.0,4,2.25,2040,12000,1.0,0.0,0.0,4,7,1300,740,1963,0,98028,47.7362,-122.241,1930,12000,4,16,2015,UNK,110,0
5249802660,7/30/2014,425000.0,3,1.0,980,4800,1.5,0.0,0.0,3,7,980,0,1926,0,98118,47.5663,-122.274,2030,7200,7,30,2014,UNK,-1050,-2400
2592400470,12/5/2014,438000.0,5,2.5,1990,6840,2.0,0.0,0.0,4,7,1990,0,1974,0,98034,47.7162,-122.166,1990,7150,12,5,2014,UNK,0,-310
6448000020,1/29/2015,1490000.0,4,2.5,2420,18480,1.0,0.0,0.0,4,9,2420,0,1967,0,98004,47.6214,-122.227,3330,19910,1,29,2015,UNK,-910,-1430
1211000185,6/16/2014,375000.0,4,2.0,1240,3000,1.0,0.0,0.0,3,7,1040,200,1908,0,98122,47.6076,-122.29799999999999,1480,3500,6,16,2014,UNK,-240,-500
7399300780,4/29/2015,337500.0,3,2.25,1530,6600,1.0,0.0,0.0,4,7,1240,290,1968,0,98055,47.461999999999996,-122.18799999999999,1500,7700,4,29,2015,UNK,30,-1100
984100010,9/30/2014,300000.0,4,2.25,2080,7700,1.0,0.0,0.0,3,7,1450,630,1968,0,98058,47.4349,-122.17,1900,7980,9,30,2014,UNK,180,-280
6127010670,7/28/2014,627000.0,5,3.25,3570,5425,2.0,0.0,0.0,3,7,3570,0,2005,0,98075,47.5933,-122.007,2690,5347,7,28,2014,N,880,78
1245002391,10/22/2014,1400000.0,5,4.25,4230,6907,2.0,0.0,0.0,3,10,3450,780,2008,0,98033,47.6866,-122.205,2650,8076,10,22,2014,N,1580,-1169
3904921100,5/12/2015,674725.0,4,2.5,2700,10160,2.0,0.0,0.0,3,9,2700,0,1988,0,98029,47.5685,-122.012,2760,9219,5,12,2015,UNK,-60,941
2473381150,6/18/2014,325000.0,3,2.75,2200,7000,1.0,0.0,0.0,4,7,1280,920,1977,0,98058,47.4574,-122.169,1670,7000,6,18,2014,UNK,530,0
9269750010,4/2/2015,230000.0,5,2.0,1210,12538,2.0,0.0,0.0,3,7,1210,0,1982,0,98023,47.2848,-122.361,1510,7700,4,2,2015,UNK,-300,4838
1924069071,7/29/2014,485000.0,5,1.75,2140,43124,1.0,0.0,2.0,4,7,1220,920,1962,0,98027,47.5516,-122.085,2520,14677,7,29,2014,UNK,-380,28447
2571900430,9/23/2014,315000.0,4,2.5,2740,8400,1.5,0.0,2.0,3,8,2740,0,1993,0,98022,47.1947,-122.008,2030,8638,9,23,2014,UNK,710,-238
8673400052,4/3/2015,560000.0,3,2.75,1370,1193,3.0,0.0,0.0,3,8,1370,0,2003,0,98107,47.67,-122.39200000000001,1320,1180,4,3,2015,UNK,50,13
5104511630,8/12/2014,444000.0,4,3.0,2800,7198,2.0,0.0,0.0,3,8,2800,0,2002,0,98038,47.3538,-122.01299999999999,3610,7845,8,12,2014,UNK,-810,-647
3438500168,5/7/2015,325000.0,3,1.5,1060,7488,1.0,0.0,0.0,5,7,1060,0,1977,0,98106,47.5549,-122.35600000000001,1300,6780,5,7,2015,UNK,-240,708
1446403850,9/16/2014,118125.0,2,1.0,790,7153,1.0,0.0,0.0,4,6,790,0,1944,0,98168,47.4869,-122.324,810,7128,9,16,2014,UNK,-20,25
1446403850,1/14/2015,212000.0,2,1.0,790,7153,1.0,0.0,0.0,4,6,790,0,1944,0,98168,47.4869,-122.324,810,7128,1,14,2015,UNK,-20,25
5416500950,3/9/2015,428900.0,4,2.5,2820,5056,2.0,0.0,0.0,3,9,2820,0,2006,0,98038,47.3591,-122.038,2820,5150,3,9,2015,N,0,-94
8096600050,1/23/2015,510000.0,3,2.0,1850,9600,1.0,0.0,0.0,3,7,1850,0,1968,1998,98011,47.7671,-122.225,1770,9600,1,23,2015,Y,80,0
1473000020,5/23/2014,416000.0,3,1.5,1110,9762,1.0,0.0,0.0,4,7,1110,0,1963,0,98052,47.676,-122.15,1900,9720,5,23,2014,UNK,-790,42
722039049,10/9/2014,950000.0,4,3.0,3230,438213,2.0,0.0,0.0,3,9,3230,0,1999,0,98070,47.4141,-122.47,1600,144619,10,9,2014,UNK,1630,293594
2212210660,2/27/2015,204000.0,3,1.5,1460,7140,1.0,0.0,0.0,4,7,980,480,1980,0,98031,47.3954,-122.191,1400,8572,2,27,2015,UNK,60,-1432
6762700020,10/13/2014,7700000.0,6,8.0,12050,27600,2.5,0.0,3.0,4,13,8570,3480,1910,1987,98102,47.6298,-122.323,3940,8800,10,13,2014,Y,8110,18800
5608010980,10/7/2014,878000.0,4,2.5,3480,13421,2.0,0.0,0.0,3,11,3480,0,1995,0,98027,47.5504,-122.09700000000001,3290,9642,10,7,2014,UNK,190,3779
5015001045,8/26/2014,1050000.0,4,3.0,3560,4000,3.0,0.0,2.0,3,9,2970,590,1996,0,98112,47.6265,-122.3,1190,4000,8,26,2014,UNK,2370,0
1005000250,1/30/2015,350000.0,2,1.0,840,5551,1.0,0.0,0.0,3,6,840,0,1952,0,98118,47.5354,-122.28,1270,4652,1,30,2015,UNK,-430,899
7974700122,6/10/2014,659500.0,3,1.75,1820,5500,1.0,0.0,0.0,4,8,1620,200,1957,0,98115,47.6737,-122.28299999999999,2330,6050,6,10,2014,UNK,-510,-550
1775910460,3/13/2015,395000.0,3,2.5,1630,15200,1.0,0.0,0.0,3,7,1120,510,1988,0,98072,47.7454,-122.103,2050,15200,3,13,2015,UNK,-420,0
3797300190,7/8/2014,308950.0,4,2.5,1920,8562,2.0,0.0,2.0,4,7,1920,0,1994,0,98022,47.1932,-122.008,1820,8628,7,8,2014,UNK,100,-66
6450300605,5/1/2015,410000.0,3,2.0,1750,2550,1.0,0.0,0.0,3,7,1750,0,1955,0,98133,47.7329,-122.34299999999999,1370,1533,5,1,2015,UNK,380,1017
3918400143,10/16/2014,710000.0,4,3.0,2750,7500,1.0,0.0,0.0,5,8,1630,1120,1966,0,98177,47.7134,-122.361,2440,7500,10,16,2014,UNK,310,0
1022049182,4/28/2015,175000.0,1,1.0,620,8685,1.0,0.0,0.0,4,5,620,0,1976,0,98198,47.4095,-122.29,1300,12150,4,28,2015,UNK,-680,-3465
3578400780,3/27/2015,508800.0,3,2.0,1720,10098,1.0,0.0,0.0,4,8,1140,580,1981,0,98074,47.6231,-122.04299999999999,1840,10098,3,27,2015,UNK,-120,0
6905200050,10/9/2014,606400.0,3,3.0,1800,5000,1.5,0.0,2.0,3,8,1500,300,1929,0,98119,47.6475,-122.37100000000001,1670,5000,10,9,2014,UNK,130,0
303100080,5/28/2014,245100.0,3,1.75,1300,7958,1.0,0.0,0.0,3,7,1300,0,1996,0,98092,47.3162,-122.194,1640,8698,5,28,2014,UNK,-340,-740
123039642,5/1/2015,540000.0,3,2.5,1970,14876,1.0,0.0,0.0,3,7,1320,650,1981,0,98146,47.5031,-122.37200000000001,2030,8008,5,1,2015,UNK,-60,6868
8718500095,5/7/2015,415000.0,3,1.5,1740,9046,1.0,0.0,0.0,3,7,1740,0,1956,0,98028,47.7402,-122.255,1830,9513,5,7,2015,UNK,-90,-467
1774000780,1/5/2015,469500.0,4,2.75,1930,13041,1.0,0.0,0.0,4,8,1180,750,1980,0,98072,47.7502,-122.085,1880,10234,1,5,2015,UNK,50,2807
2421039075,11/6/2014,195000.0,3,1.75,1190,14777,1.0,0.0,0.0,4,7,1190,0,1965,0,98023,47.2933,-122.37700000000001,2240,8325,11,6,2014,UNK,-1050,6452
4139470010,10/6/2014,1620000.0,4,3.25,4250,12281,2.0,0.0,4.0,3,12,3020,1230,1996,0,98006,47.5507,-122.113,4940,12941,10,6,2014,UNK,-690,-660
629800380,10/13/2014,1450000.0,4,3.5,4360,24603,2.0,0.0,0.0,3,12,4360,0,1998,0,98074,47.6035,-122.005,4770,27521,10,13,2014,UNK,-410,-2918
8965520190,10/30/2014,1200000.0,3,2.5,3420,16622,1.0,0.0,4.0,3,10,2410,1010,1991,0,98006,47.5638,-122.105,3460,14566,10,30,2014,UNK,-40,2056
925059193,7/9/2014,1070000.0,4,3.75,4260,9800,2.0,0.0,0.0,3,10,4260,0,2008,0,98033,47.6739,-122.17200000000001,1950,8970,7,9,2014,N,2310,830
1245500250,5/7/2015,555500.0,2,1.0,920,10000,1.0,0.0,0.0,4,7,920,0,1981,0,98033,47.6938,-122.21,1340,10000,5,7,2015,UNK,-420,0
9828700005,5/12/2015,440000.0,3,1.0,1040,4000,1.0,0.0,0.0,3,7,1040,0,1950,0,98122,47.6178,-122.292,1170,4000,5,12,2015,UNK,-130,0
5101402312,4/23/2015,485000.0,3,1.0,1260,7250,1.0,0.0,2.0,3,7,960,300,1940,0,98115,47.6947,-122.311,1540,7250,4,23,2015,UNK,-280,0
339200130,5/31/2014,693000.0,3,2.5,2460,12028,2.0,0.0,0.0,3,9,2460,0,1996,0,98052,47.691,-122.095,2540,12229,5,31,2014,UNK,-80,-201
6145602125,7/24/2014,295000.0,3,1.0,830,3386,1.0,0.0,0.0,3,6,830,0,1942,0,98133,47.7027,-122.355,1300,3844,7,24,2014,UNK,-470,-458
9346910500,3/30/2015,700000.0,3,2.5,2060,10650,1.0,0.0,0.0,5,8,1050,1010,1976,0,98006,47.5627,-122.137,2690,8850,3,30,2015,UNK,-630,1800
7986401305,12/16/2014,767500.0,2,1.75,2210,9374,1.0,0.0,3.0,4,8,1560,650,1951,0,98107,47.6634,-122.359,2140,5640,12,16,2014,UNK,70,3734
922059169,12/1/2014,800000.0,6,4.25,5480,189050,2.0,0.0,0.0,4,10,5140,340,1991,0,98031,47.412,-122.16799999999999,2470,10429,12,1,2014,UNK,3010,178621
123059071,7/8/2014,440000.0,3,2.0,1860,217800,2.0,0.0,2.0,3,8,1860,0,1998,0,98059,47.5157,-122.10700000000001,2500,217800,7,8,2014,UNK,-640,0
1626069069,10/29/2014,600000.0,3,2.5,1350,187313,1.0,0.0,0.0,4,7,1350,0,1997,0,98077,47.7369,-122.04899999999999,2310,49222,10,29,2014,UNK,-960,138091
5605000430,9/17/2014,1160000.0,4,2.5,2790,5450,2.0,0.0,0.0,3,10,1930,860,1925,0,98112,47.6453,-122.303,2320,5450,9,17,2014,UNK,470,0
7640400250,6/19/2014,506000.0,2,1.0,1570,8210,1.0,0.0,0.0,4,8,1150,420,1952,0,98177,47.7221,-122.37100000000001,1680,8196,6,19,2014,UNK,-110,14
4477000290,3/11/2015,474950.0,4,1.75,2030,15400,1.0,0.0,1.0,3,9,1130,900,1975,0,98166,47.4603,-122.365,2040,12425,3,11,2015,UNK,-10,2975
8127700440,12/11/2014,654000.0,3,2.5,2570,5500,1.0,0.0,0.0,4,7,1320,1250,1961,0,98199,47.6417,-122.397,1460,6250,12,11,2014,UNK,1110,-750
6822100780,9/11/2014,710000.0,2,1.0,1210,6000,1.0,0.0,0.0,4,7,1000,210,1942,0,98199,47.6482,-122.402,1840,6000,9,11,2014,UNK,-630,0
9195700380,8/11/2014,620000.0,4,2.25,1530,7845,1.0,0.0,0.0,4,7,1030,500,1981,0,98027,47.5589,-122.08200000000001,1710,7627,8,11,2014,UNK,-180,218
1425059174,10/28/2014,390000.0,3,2.0,1510,10827,2.0,0.0,0.0,3,7,1510,0,1984,0,98052,47.653999999999996,-122.12700000000001,1900,10908,10,28,2014,UNK,-390,-81
2155000290,6/30/2014,550000.0,3,2.25,1720,9600,1.0,0.0,0.0,4,7,1220,500,1967,0,98052,47.6581,-122.126,1720,9600,6,30,2014,UNK,0,0
4058200630,10/2/2014,353000.0,3,1.75,2190,7021,1.0,0.0,2.0,4,7,1390,800,1953,0,98178,47.5033,-122.23200000000001,2180,7155,10,2,2014,UNK,10,-134
5561400440,8/27/2014,465000.0,4,2.5,3030,47958,1.0,0.0,0.0,3,8,1660,1370,1980,0,98027,47.4598,-122.00399999999999,2740,36017,8,27,2014,UNK,290,11941
4178500440,1/28/2015,279900.0,3,2.0,1410,6600,1.0,0.0,0.0,4,7,1410,0,1990,0,98042,47.3596,-122.089,1750,7150,1,28,2015,UNK,-340,-550
1923039022,11/20/2014,700000.0,2,1.75,1679,577605,2.0,0.0,0.0,3,9,1679,0,2001,0,98070,47.463,-122.475,1850,358934,11,20,2014,UNK,-171,218671
9412200660,6/19/2014,395000.0,4,1.0,1980,10350,1.0,0.0,0.0,4,7,1430,550,1968,0,98027,47.5226,-122.045,1890,13140,6,19,2014,UNK,90,-2790
2780700020,9/10/2014,375000.0,4,2.5,1900,9428,2.0,0.0,0.0,3,8,1900,0,1978,0,98028,47.7628,-122.244,1830,10480,9,10,2014,UNK,70,-1052
1868901815,6/17/2014,547000.0,4,1.0,1720,2800,1.5,0.0,0.0,4,7,1200,520,1926,0,98115,47.6743,-122.29899999999999,1530,3500,6,17,2014,UNK,190,-700
4022902715,4/3/2015,525000.0,5,3.25,2480,10277,2.0,0.0,0.0,5,8,1640,840,1993,0,98155,47.7726,-122.286,2270,10277,4,3,2015,UNK,210,0
225039145,6/19/2014,285000.0,3,1.0,1210,4731,1.5,0.0,0.0,3,7,1210,0,1901,0,98117,47.6865,-122.397,1450,5264,6,19,2014,UNK,-240,-533
9274203390,5/20/2014,570000.0,2,1.75,1540,4025,1.0,0.0,0.0,4,7,1190,350,1908,0,98116,47.5876,-122.391,1950,4420,5,20,2014,UNK,-410,-395
4397000020,3/24/2015,409000.0,3,2.5,2740,9168,2.0,0.0,0.0,3,9,2740,0,1991,0,98042,47.3835,-122.148,2690,10554,3,24,2015,UNK,50,-1386
9415950020,6/8/2014,260000.0,4,2.5,1811,4381,2.0,0.0,0.0,3,8,1811,0,2007,0,98055,47.45399999999999,-122.19,1811,4150,6,8,2014,N,0,231
2591830020,9/16/2014,348000.0,4,2.5,2720,7697,1.0,0.0,0.0,4,8,2120,600,1987,0,98058,47.4391,-122.161,2340,7700,9,16,2014,UNK,380,-3
3211200460,8/6/2014,389000.0,4,1.0,1520,9800,1.5,0.0,0.0,4,7,1520,0,1971,0,98034,47.7303,-122.236,1540,7700,8,6,2014,UNK,-20,2100
2297400250,12/17/2014,445000.0,4,2.75,2160,7200,1.0,0.0,0.0,4,7,1220,940,1976,0,98034,47.7177,-122.22399999999999,1790,7614,12,17,2014,UNK,370,-414
9268200440,7/21/2014,400000.0,3,1.75,1390,4602,1.0,0.0,0.0,3,7,930,460,1981,0,98117,47.6944,-122.366,1230,4800,7,21,2014,UNK,160,-198
255580190,9/15/2014,302000.0,4,2.5,1740,7895,2.0,0.0,0.0,3,7,1740,0,1999,0,98001,47.3401,-122.28200000000001,1720,6813,9,15,2014,UNK,20,1082
6352600680,10/21/2014,798000.0,3,2.5,2849,9588,2.0,0.0,0.0,3,10,2849,0,2001,0,98074,47.6487,-122.079,3190,8897,10,21,2014,UNK,-341,691
1829700050,7/24/2014,335000.0,2,1.0,1440,8842,1.0,0.0,0.0,3,7,840,600,1950,0,98155,47.7443,-122.325,1650,8461,7,24,2014,UNK,-210,381
7859960250,1/7/2015,585000.0,4,2.5,3000,6892,2.0,0.0,0.0,3,8,3000,0,2005,0,98072,47.7623,-122.165,3000,6589,1,7,2015,N,0,303
6072800170,4/28/2015,2500000.0,4,4.0,3330,24354,1.0,0.0,0.0,4,10,3330,0,1961,0,98006,47.5708,-122.19200000000001,3880,25493,4,28,2015,UNK,-550,-1139
6373000130,12/1/2014,555000.0,4,2.25,1720,2300,1.0,0.0,0.0,3,7,860,860,1940,2014,98116,47.5762,-122.412,1720,4680,12,1,2014,Y,0,-2380
4131900066,8/25/2014,3100000.0,3,3.0,3920,13085,2.0,1.0,4.0,4,11,3920,0,1996,0,98040,47.5716,-122.204,3450,13287,8,25,2014,UNK,470,-202
8965450190,2/18/2015,295000.0,3,2.5,1500,3060,2.0,0.0,0.0,3,7,1500,0,1994,0,98006,47.5605,-122.117,2700,7734,2,18,2015,UNK,-1200,-4674
1311200460,6/18/2014,265000.0,4,1.5,2050,7100,1.0,0.0,0.0,3,7,1050,1000,1963,0,98001,47.3395,-122.28,1950,7350,6,18,2014,UNK,100,-250
3764800250,1/5/2015,330000.0,4,2.0,1180,7275,1.0,0.0,0.0,3,7,1180,0,1965,0,98034,47.7301,-122.2,1210,7275,1,5,2015,UNK,-30,0
6607000095,2/18/2015,286000.0,4,1.5,1600,5750,2.0,0.0,0.0,4,6,1600,0,1902,0,98118,47.5437,-122.28,1690,5750,2,18,2015,UNK,-90,0
4358700188,3/31/2015,305000.0,3,2.5,1260,895,3.0,0.0,0.0,3,7,1160,0,2009,0,98133,47.7072,-122.336,1190,1095,3,31,2015,N,70,-200
5101403915,4/3/2015,970000.0,2,1.0,1290,5376,1.0,0.0,0.0,3,6,1290,0,1945,0,98115,47.6966,-122.315,1180,5376,4,3,2015,UNK,110,0
7844200425,4/14/2015,525000.0,4,2.0,2680,14157,1.0,0.0,0.0,3,8,1460,1220,1966,0,98188,47.4286,-122.292,2100,9199,4,14,2015,UNK,580,4958
9407001330,12/2/2014,355000.0,3,1.75,2370,9750,1.0,0.0,0.0,4,7,1280,1090,1979,0,98045,47.4459,-121.773,1230,9775,12,2,2014,UNK,1140,-25
7905370440,10/10/2014,469950.0,5,2.5,2310,8303,1.0,0.0,0.0,3,7,1300,1010,1975,0,98034,47.7212,-122.211,1930,8303,10,10,2014,UNK,380,0
2202500290,5/2/2014,435000.0,4,1.0,1450,8800,1.0,0.0,0.0,4,7,1450,0,1954,0,98006,47.5746,-122.135,1260,8942,5,2,2014,UNK,190,-142
3374500250,9/22/2014,363500.0,4,2.5,2680,7700,2.0,0.0,0.0,4,8,2680,0,1990,0,98031,47.4094,-122.17,2400,7700,9,22,2014,UNK,280,0
5244800895,5/23/2014,595000.0,2,1.5,1030,4500,1.0,0.0,0.0,3,7,830,200,1924,0,98109,47.6455,-122.352,1250,4000,5,23,2014,UNK,-220,500
100100050,11/12/2014,275000.0,3,1.0,1320,11090,1.0,0.0,0.0,3,7,1320,0,1955,0,98155,47.7748,-122.304,1320,8319,11,12,2014,UNK,0,2771
7454001060,4/8/2015,295000.0,2,1.0,670,7952,1.0,0.0,0.0,4,6,670,0,1942,0,98146,47.5124,-122.37200000000001,1080,9525,4,8,2015,UNK,-410,-1573
7215400280,1/16/2015,345000.0,3,2.25,2670,37089,2.0,0.0,0.0,3,9,2670,0,1990,0,98042,47.3347,-122.07700000000001,2290,36284,1,16,2015,UNK,380,805
203101330,7/1/2014,485000.0,3,2.25,2440,47916,2.0,0.0,0.0,3,8,2090,350,1991,0,98053,47.6347,-121.958,2150,24000,7,1,2014,UNK,290,23916
2450000290,12/15/2014,1250000.0,5,2.5,3370,8113,2.0,0.0,0.0,3,9,3370,0,2005,0,98004,47.5812,-122.196,2470,8113,12,15,2014,N,900,0
5101402472,1/29/2015,340500.0,2,1.0,940,5413,1.0,0.0,0.0,3,7,940,0,1923,0,98115,47.6956,-122.304,1340,5296,1,29,2015,UNK,-400,117
4310700020,10/10/2014,280000.0,3,1.0,1100,5132,1.0,0.0,0.0,3,6,840,0,1948,0,98103,47.7011,-122.336,1280,5132,10,10,2014,UNK,-180,0
7967600285,12/11/2014,449888.0,3,2.25,2520,78408,2.0,0.0,0.0,3,9,2520,0,1988,0,98001,47.3514,-122.279,1490,29972,12,11,2014,UNK,1030,48436
7905200381,10/28/2014,483000.0,2,1.75,1400,4720,1.0,0.0,0.0,4,7,820,580,1927,0,98116,47.5705,-122.39200000000001,1330,6786,10,28,2014,UNK,70,-2066
3992700585,11/20/2014,445500.0,3,1.75,1880,9360,1.0,0.0,0.0,4,7,940,940,1941,0,98125,47.7131,-122.28299999999999,1390,7200,11,20,2014,UNK,490,2160
7972601950,6/17/2014,379900.0,5,3.5,2800,7350,2.0,0.0,0.0,3,7,2800,0,1995,0,98106,47.5273,-122.345,2190,7620,6,17,2014,UNK,610,-270
6870310010,7/2/2014,599950.0,4,3.5,2500,3080,2.0,0.0,0.0,3,8,1810,690,2008,0,98052,47.6749,-122.14,2060,3295,7,2,2014,N,440,-215
2970800130,10/9/2014,215000.0,3,1.0,810,5240,1.0,0.0,0.0,3,6,810,0,1942,0,98166,47.4734,-122.35,1700,5245,10,9,2014,UNK,-890,-5
6084600660,7/18/2014,263000.0,3,2.5,1720,6847,2.0,0.0,0.0,3,7,1720,0,1987,0,98001,47.3266,-122.272,1610,7790,7,18,2014,UNK,110,-943
325059126,2/9/2015,565000.0,4,1.0,2170,12100,1.0,0.0,0.0,5,7,2170,0,1961,0,98033,47.6893,-122.164,1270,12844,2,9,2015,UNK,900,-744
526069024,5/12/2014,950000.0,5,3.0,4530,258746,1.5,0.0,0.0,4,9,3200,1330,2003,0,98077,47.7702,-122.066,3430,83199,5,12,2014,UNK,1100,175547
6163901261,9/9/2014,395000.0,4,1.0,1440,8320,1.5,0.0,0.0,3,7,1440,0,1946,0,98155,47.7529,-122.318,1440,9230,9,9,2014,UNK,0,-910
4289900005,12/30/2014,1540000.0,4,3.25,2850,4100,2.0,0.0,3.0,3,10,1820,1030,1908,0,98122,47.6147,-122.285,2130,4200,12,30,2014,UNK,720,-100
2818100255,10/29/2014,922000.0,4,2.5,2620,14126,1.0,0.0,4.0,4,8,1620,1000,1941,0,98117,47.6983,-122.397,2620,8905,10,29,2014,UNK,0,5221
1389310130,12/12/2014,330000.0,3,2.5,1676,18778,2.0,0.0,0.0,3,7,1676,0,1997,0,98014,47.6521,-121.905,1410,18778,12,12,2014,UNK,266,0
4139910250,2/10/2015,1530000.0,4,3.75,5850,35070,2.0,0.0,0.0,4,12,4410,1440,1990,0,98006,47.5485,-122.124,4830,36200,2,10,2015,UNK,1020,-1130
5416100020,12/9/2014,323000.0,3,1.75,1910,8329,1.0,0.0,0.0,3,8,1910,0,2004,0,98022,47.19,-122.016,2510,9259,12,9,2014,N,-600,-930
8682261650,7/10/2014,554000.0,2,2.0,1670,4996,1.0,0.0,0.0,3,8,1670,0,2004,0,98053,47.7141,-122.031,1670,4996,7,10,2014,N,0,0
8100400170,4/10/2015,500000.0,3,2.0,2050,11454,1.0,0.0,0.0,3,8,2050,0,1987,0,98052,47.6389,-122.11,1980,11424,4,10,2015,UNK,70,30
1604590190,5/13/2015,775000.0,5,3.5,3730,16679,1.0,0.0,0.0,3,10,2760,970,1990,0,98075,47.5987,-122.029,3280,16679,5,13,2015,UNK,450,0
6882510020,7/15/2014,340000.0,4,1.75,1800,5210,1.0,0.0,0.0,5,7,1080,720,1979,0,98118,47.5298,-122.28,1870,5365,7,15,2014,UNK,-70,-155
3459800020,4/6/2015,560000.0,4,1.75,2230,6838,1.0,0.0,0.0,3,7,1320,910,1985,0,98008,47.5742,-122.118,1580,7500,4,6,2015,UNK,650,-662
5437600010,4/6/2015,304000.0,3,2.5,1670,5298,2.0,0.0,0.0,3,8,1670,0,2002,0,98042,47.3925,-122.165,1920,5298,4,6,2015,UNK,-250,0
1395500020,11/7/2014,279900.0,3,1.0,1400,10800,1.0,0.0,0.0,3,6,1400,0,1962,0,98034,47.718999999999994,-122.20200000000001,1430,10000,11,7,2014,UNK,-30,800
807800020,3/4/2015,315000.0,5,3.0,2110,10766,2.0,0.0,0.0,3,7,2110,0,2005,0,98030,47.3599,-122.176,1460,10400,3,4,2015,N,650,366
1563102880,6/21/2014,849000.0,4,2.0,2160,6300,1.5,0.0,1.0,4,8,2160,0,1928,0,98116,47.5662,-122.404,1980,5152,6,21,2014,UNK,180,1148
8937500020,2/10/2015,325000.0,3,1.75,2420,14862,1.0,0.0,0.0,3,8,1380,1040,1977,0,98023,47.3301,-122.365,2550,14675,2,10,2015,UNK,-130,187
629420480,9/26/2014,786000.0,4,3.5,3320,8808,2.0,0.0,0.0,3,9,3320,0,2005,0,98075,47.592,-121.98899999999999,3160,9226,9,26,2014,N,160,-418
8961950250,9/15/2014,384000.0,5,2.75,3220,8160,2.0,0.0,0.0,3,9,3220,0,1999,0,98001,47.3154,-122.25399999999999,2876,11521,9,15,2014,UNK,344,-3361
4217400420,11/24/2014,907000.0,3,1.5,1340,6000,1.5,0.0,1.0,3,9,1340,0,1927,0,98105,47.66,-122.28200000000001,2600,6000,11,24,2014,UNK,-1260,0
3121500020,7/2/2014,700000.0,3,2.5,2490,23891,2.0,0.0,0.0,3,9,2490,0,1993,0,98053,47.6716,-122.029,2900,34705,7,2,2014,UNK,-410,-10814
2025700430,8/26/2014,269500.0,3,2.0,1640,8395,1.0,0.0,0.0,4,7,1640,0,1991,0,98038,47.348,-122.035,1510,7180,8,26,2014,UNK,130,1215
739800250,2/22/2015,269000.0,3,2.25,1420,7297,1.0,0.0,0.0,3,7,1130,0,1984,0,98031,47.4046,-122.194,1730,7419,2,22,2015,UNK,-310,-122
8647600020,11/11/2014,749950.0,4,2.5,3340,123600,2.0,0.0,0.0,3,10,3340,0,2005,0,98053,47.6101,-121.955,3730,123600,11,11,2014,N,-390,0
1518000290,3/16/2015,325000.0,3,2.75,1580,4007,2.0,0.0,0.0,3,7,1580,0,2001,0,98019,47.7367,-121.969,1770,3799,3,16,2015,UNK,-190,208
8917100020,6/6/2014,1150000.0,3,1.5,2170,16600,1.0,1.0,2.0,3,10,1130,1040,1979,0,98052,47.6307,-122.088,3130,13875,6,6,2014,UNK,-960,2725
3205100010,12/16/2014,406000.0,3,1.5,1370,7853,1.0,0.0,0.0,4,7,1370,0,1962,0,98056,47.5409,-122.18,1730,9465,12,16,2014,UNK,-360,-1612
2405500050,6/6/2014,650000.0,4,2.5,2840,9354,2.0,0.0,0.0,3,10,2840,0,1990,0,98074,47.6274,-122.04,2540,10200,6,6,2014,UNK,300,-846
7823700005,7/7/2014,295000.0,3,1.75,1940,7500,1.5,0.0,0.0,4,8,1940,0,1918,1985,98022,47.2062,-121.993,1650,7500,7,7,2014,Y,290,0
8642600170,10/9/2014,375000.0,4,2.0,1757,19370,1.0,0.0,2.0,5,7,1757,0,1955,0,98198,47.3974,-122.31200000000001,1850,11125,10,9,2014,UNK,-93,8245
7518502960,2/27/2015,395000.0,2,1.0,980,5100,1.0,0.0,0.0,4,6,980,0,1907,0,98117,47.6824,-122.38,1190,5100,2,27,2015,UNK,-210,0
4279600080,12/31/2014,609000.0,6,3.0,2470,9267,2.0,0.0,0.0,3,8,2470,0,1982,0,98007,47.6025,-122.152,2470,9151,12,31,2014,UNK,0,116
6421100592,9/10/2014,510000.0,3,1.75,1610,11950,1.0,0.0,2.0,3,7,1210,400,1984,0,98052,47.6705,-122.13799999999999,1610,9363,9,10,2014,UNK,0,2587
7967200290,5/30/2014,190000.0,3,2.25,1590,11745,1.0,0.0,0.0,3,7,1090,500,1978,0,98001,47.3553,-122.28,1540,12530,5,30,2014,UNK,50,-785
7228501903,8/5/2014,250000.0,1,1.0,780,1033,1.0,0.0,0.0,3,7,780,0,1922,1985,98122,47.6155,-122.306,1040,1319,8,5,2014,Y,-260,-286
9275200080,11/7/2014,295000.0,3,1.5,720,7450,1.0,0.0,1.0,1,5,720,0,1924,0,98126,47.583999999999996,-122.375,2600,7360,11,7,2014,UNK,-1880,90
8825900095,4/21/2015,740000.0,3,1.5,1630,4080,1.5,0.0,0.0,4,8,1630,0,1927,0,98115,47.6756,-122.30799999999999,1950,4080,4,21,2015,UNK,-320,0
7849201100,2/17/2015,323000.0,3,1.0,1590,7759,2.0,0.0,0.0,4,7,1590,0,1912,1984,98065,47.5217,-121.819,1600,7200,2,17,2015,Y,-10,559
8562790980,3/3/2015,713000.0,3,2.75,2310,1850,2.0,0.0,0.0,3,10,2020,290,2011,0,98027,47.5304,-122.073,2340,2155,3,3,2015,N,-30,-305
1370801435,11/5/2014,1070000.0,3,1.75,2320,6090,2.0,0.0,3.0,3,8,2040,280,1939,0,98199,47.643,-122.412,3110,7052,11,5,2014,UNK,-790,-962
3897100275,10/27/2014,460000.0,3,1.75,1660,9900,2.0,0.0,0.0,3,8,1660,0,1978,0,98033,47.6704,-122.184,1720,6600,10,27,2014,UNK,-60,3300
6745700190,4/7/2015,880000.0,3,1.75,2070,5000,1.5,0.0,0.0,3,8,2070,0,1920,0,98144,47.5828,-122.291,2630,5000,4,7,2015,UNK,-560,0
2770600795,3/2/2015,585000.0,4,1.75,2500,7000,1.0,0.0,0.0,3,7,1250,1250,1947,0,98199,47.648,-122.38600000000001,1680,7000,3,2,2015,UNK,820,0
1148000190,5/22/2014,249950.0,2,1.0,940,8532,1.0,0.0,0.0,4,7,940,0,1959,0,98166,47.4814,-122.34299999999999,1050,8100,5,22,2014,UNK,-110,432
5039300305,11/7/2014,450000.0,3,2.5,1990,3478,2.0,0.0,0.0,3,10,1520,470,1990,0,98199,47.6361,-122.399,1710,6157,11,7,2014,UNK,280,-2679
3981200250,9/26/2014,450000.0,3,2.5,2620,14096,2.0,0.0,0.0,4,9,2620,0,1989,0,98042,47.3513,-122.1,3010,14096,9,26,2014,UNK,-390,0
5457300095,1/7/2015,1780000.0,4,3.25,3730,7071,3.0,0.0,2.0,3,11,3730,0,1985,0,98109,47.6292,-122.355,3730,7680,1,7,2015,UNK,0,-609
1862400479,9/23/2014,350000.0,3,3.25,1600,1298,3.0,0.0,0.0,3,8,1600,0,1999,0,98117,47.6954,-122.375,1600,1348,9,23,2014,UNK,0,-50
8669160010,3/25/2015,292500.0,3,2.5,2095,3438,2.0,0.0,0.0,3,7,2095,0,2008,0,98002,47.3523,-122.213,1805,3402,3,25,2015,N,290,36
2481630290,6/26/2014,879000.0,4,2.75,4230,31747,2.0,0.0,0.0,4,10,4230,0,1985,0,98072,47.731,-122.132,4080,35576,6,26,2014,UNK,150,-3829
8925100255,6/12/2014,1180000.0,4,2.5,3200,7500,1.5,0.0,1.0,5,8,1860,1340,1948,0,98115,47.6826,-122.274,2500,6500,6,12,2014,UNK,700,1000
424069130,2/13/2015,584999.0,4,2.75,2050,17859,1.0,0.0,0.0,4,7,1300,750,1967,0,98075,47.5945,-122.056,2960,20908,2,13,2015,UNK,-910,-3049
2231800020,11/20/2014,366000.0,4,2.75,2020,8093,1.0,0.0,0.0,5,7,1300,720,1961,0,98133,47.7685,-122.33200000000001,1920,8089,11,20,2014,UNK,100,4
3625700080,1/8/2015,987500.0,4,2.25,3270,15760,1.0,0.0,0.0,4,10,2000,1270,1974,0,98040,47.5295,-122.229,4100,15760,1,8,2015,UNK,-830,0
3343901188,3/23/2015,300000.0,3,1.0,1320,7200,1.0,0.0,0.0,4,7,1320,0,1959,0,98056,47.5048,-122.19,1720,7249,3,23,2015,UNK,-400,-49
1328330430,4/8/2015,299000.0,2,1.75,1270,7800,1.0,0.0,0.0,4,7,890,380,1981,0,98058,47.4438,-122.134,2020,8025,4,8,2015,UNK,-750,-225
2464400500,7/14/2014,560000.0,4,1.75,1980,2700,1.5,0.0,0.0,3,8,1210,770,1931,0,98115,47.6865,-122.32,1720,2910,7,14,2014,UNK,260,-210
4054710190,7/1/2014,695000.0,3,2.5,2620,51354,2.0,0.0,0.0,3,9,2620,0,1998,0,98077,47.7211,-122.02799999999999,2620,37042,7,1,2014,UNK,0,14312
5095400630,12/5/2014,360000.0,4,1.75,1750,18810,1.0,0.0,0.0,3,7,1220,530,1977,0,98059,47.4719,-122.074,1840,17424,12,5,2014,UNK,-90,1386
1788300020,7/8/2014,183500.0,3,1.0,1040,8892,1.0,0.0,0.0,4,6,800,240,1958,0,98023,47.3273,-122.34899999999999,820,9000,7,8,2014,UNK,220,-108
3336001470,6/19/2014,311000.0,3,1.75,1900,3000,1.5,0.0,0.0,5,7,1070,830,1903,0,98118,47.5255,-122.265,1130,6000,6,19,2014,UNK,770,-3000
1310960190,10/21/2014,263000.0,3,1.75,1660,7210,1.0,0.0,0.0,4,7,1660,0,1977,0,98032,47.3609,-122.274,2150,7350,10,21,2014,UNK,-490,-140
1545803340,2/24/2015,269000.0,3,1.75,1530,7930,1.0,0.0,0.0,5,7,1530,0,1986,0,98038,47.3609,-122.05,1610,7930,2,24,2015,UNK,-80,0
524059148,6/6/2014,1600000.0,4,3.5,4280,9583,2.0,0.0,0.0,3,11,4280,0,2005,0,98004,47.5979,-122.197,2360,10031,6,6,2014,N,1920,-448
7852190290,3/3/2015,564000.0,4,2.5,2870,6658,2.0,0.0,0.0,3,8,2870,0,2004,0,98065,47.5394,-121.87799999999999,2770,6658,3,3,2015,N,100,0
2385200050,6/20/2014,425000.0,3,2.5,2540,5612,2.0,0.0,0.0,3,9,2540,0,1999,0,98059,47.4965,-122.15700000000001,2380,6303,6,20,2014,UNK,160,-691
8827901060,7/9/2014,679000.0,4,2.75,2100,4480,1.5,0.0,0.0,4,7,1780,320,1928,0,98105,47.6691,-122.294,2050,4480,7,9,2014,UNK,50,0
6456200020,8/26/2014,410000.0,3,2.0,1740,9300,1.0,0.0,0.0,4,7,1740,0,1952,0,98166,47.4526,-122.35700000000001,1540,9638,8,26,2014,UNK,200,-338
4166800080,10/20/2014,340000.0,4,2.5,2441,7316,2.0,0.0,0.0,3,8,2441,0,2007,0,98023,47.3237,-122.337,2724,7357,10,20,2014,N,-283,-41
1591600307,5/11/2015,360000.0,3,1.75,1810,7200,1.0,0.0,0.0,5,7,1030,780,1959,0,98146,47.4993,-122.36399999999999,1950,8384,5,11,2015,UNK,-140,-1184
926069132,5/20/2014,450000.0,3,1.5,2060,44866,1.0,0.0,0.0,3,8,2060,0,1953,0,98077,47.7503,-122.051,2320,43995,5,20,2014,UNK,-260,871
7130300170,3/26/2015,552000.0,4,2.75,3160,8429,1.0,0.0,3.0,4,7,1620,1540,1982,0,98178,47.511,-122.251,1760,6780,3,26,2015,UNK,1400,1649
2599200460,8/5/2014,294000.0,4,2.0,2930,12840,1.5,0.0,0.0,4,8,2930,0,1965,0,98092,47.2957,-122.18700000000001,1960,10920,8,5,2014,UNK,970,1920
7214400005,3/13/2015,663500.0,2,1.0,1310,5200,1.0,0.0,0.0,3,7,910,400,1946,0,98115,47.6784,-122.304,1320,4794,3,13,2015,UNK,-10,406
5017000470,7/10/2014,1980000.0,6,4.5,4800,9097,2.0,0.0,0.0,3,10,3580,1220,2007,0,98112,47.6259,-122.291,2180,6037,7,10,2014,N,2620,3060
8651402660,10/8/2014,175409.0,4,1.5,1450,5530,1.0,0.0,0.0,4,6,1450,0,1969,0,98042,47.3613,-122.087,1060,5200,10,8,2014,UNK,390,330
8665900328,1/23/2015,459000.0,4,3.0,1900,9077,2.0,0.0,0.0,3,7,1900,0,1954,2015,98155,47.7684,-122.304,1900,12868,1,23,2015,Y,0,-3791
3881900321,5/14/2014,339950.0,3,1.0,1050,5402,1.5,0.0,0.0,4,7,1050,0,1906,0,98144,47.5867,-122.311,1510,4685,5,14,2014,UNK,-460,717
1524079028,10/29/2014,393000.0,5,1.75,1610,15246,1.0,0.0,0.0,3,6,1610,0,1936,0,98024,47.5654,-121.89399999999999,1410,10500,10,29,2014,UNK,200,4746
626049091,6/27/2014,275500.0,2,1.0,720,11400,1.0,0.0,0.0,5,6,720,0,1951,0,98133,47.7641,-122.34100000000001,1690,8075,6,27,2014,UNK,-970,3325
6073200020,4/13/2015,485000.0,3,1.0,1020,9835,1.0,0.0,0.0,5,7,1020,0,1955,0,98006,47.5728,-122.179,1210,9622,4,13,2015,UNK,-190,213
3243100050,7/22/2014,250000.0,3,1.0,1250,7920,1.0,0.0,0.0,4,7,1250,0,1960,0,98059,47.4853,-122.126,1440,9648,7,22,2014,UNK,-190,-1728
1693600080,10/30/2014,935100.0,4,3.5,3200,8049,1.0,0.0,0.0,3,8,2700,500,1980,0,98005,47.5841,-122.17200000000001,1640,8506,10,30,2014,UNK,1560,-457
7140600020,4/14/2015,245000.0,3,1.0,990,9599,1.0,0.0,0.0,4,6,990,0,1959,0,98002,47.2934,-122.215,1216,10364,4,14,2015,UNK,-226,-765
6388910280,4/29/2015,670000.0,4,2.5,2850,25993,2.0,0.0,0.0,4,9,2850,0,1989,0,98056,47.5318,-122.17,2480,12672,4,29,2015,UNK,370,13321
2524000050,12/12/2014,1390000.0,3,3.5,4240,21578,2.0,0.0,0.0,3,10,3500,740,1994,0,98040,47.5614,-122.215,3120,16440,12,12,2014,UNK,1120,5138
2223069120,8/20/2014,440000.0,4,1.75,2800,49149,1.0,0.0,0.0,4,7,1400,1400,1978,0,98027,47.4649,-122.03399999999999,2560,61419,8,20,2014,UNK,240,-12270
1732801300,10/8/2014,1250000.0,2,2.5,2310,3313,2.0,0.0,0.0,3,9,2310,0,2006,0,98119,47.6318,-122.365,2700,5670,10,8,2014,N,-390,-2357
1685200020,8/27/2014,203000.0,3,1.75,1490,8000,1.0,0.0,0.0,4,7,1200,290,1978,0,98092,47.3187,-122.18,1540,8000,8,27,2014,UNK,-50,0
9510970050,9/1/2014,583000.0,4,2.5,1840,4011,2.0,0.0,0.0,3,9,1840,0,2005,0,98052,47.6662,-122.083,2120,4011,9,1,2014,N,-280,0
7156200005,4/2/2015,575000.0,3,1.0,1740,9163,1.0,0.0,0.0,3,7,1740,0,1954,0,98125,47.705,-122.29899999999999,1490,6509,4,2,2015,UNK,250,2654
5316100780,9/22/2014,2580000.0,4,3.5,3280,3800,2.0,0.0,0.0,3,11,2880,400,2011,0,98112,47.6299,-122.28,2050,3800,9,22,2014,N,1230,0
9362000080,3/16/2015,1600000.0,5,3.5,4050,20925,2.0,0.0,3.0,3,10,3020,1030,1973,2005,98040,47.5348,-122.241,3880,18321,3,16,2015,Y,170,2604
2221800080,4/16/2015,312500.0,4,2.5,2160,8755,2.0,0.0,0.0,3,7,2160,0,1993,0,98030,47.3585,-122.195,1990,7971,4,16,2015,UNK,170,784
2722059075,8/11/2014,455000.0,3,2.75,2720,31314,3.0,0.0,2.0,3,8,2720,0,1986,0,98042,47.3689,-122.163,2290,15188,8,11,2014,UNK,430,16126
3459600440,11/25/2014,1310000.0,5,3.0,3650,16600,1.0,0.0,3.0,4,9,1860,1790,1978,0,98006,47.56,-122.14399999999999,3150,10400,11,25,2014,UNK,500,6200
6844700415,3/16/2015,605000.0,4,2.25,1750,6120,1.0,0.0,0.0,3,7,1150,0,1962,0,98115,47.6958,-122.29,1350,6120,3,16,2015,UNK,400,0
1223089016,7/18/2014,325000.0,3,2.25,2450,49658,1.0,0.0,0.0,3,7,1770,680,1978,0,98045,47.486000000000004,-121.726,1340,121097,7,18,2014,UNK,1110,-71439
8044700010,4/27/2015,630000.0,3,1.75,1940,7306,1.0,0.0,0.0,3,8,1470,470,1982,0,98052,47.6632,-122.15299999999999,2360,8865,4,27,2015,UNK,-420,-1559
2024059130,1/9/2015,928950.0,4,3.75,3280,6000,2.0,0.0,0.0,3,9,3280,0,2014,0,98006,47.553999999999995,-122.19,2900,10108,1,9,2015,N,380,-4108
8019700010,10/10/2014,489950.0,3,1.75,2480,10804,1.0,0.0,0.0,3,8,1800,680,1976,0,98177,47.7721,-122.367,2480,10400,10,10,2014,UNK,0,404
1785400780,4/15/2015,550000.0,3,2.25,2120,18255,1.0,0.0,0.0,3,8,1590,530,1984,0,98074,47.6279,-122.037,2120,12997,4,15,2015,UNK,0,5258
4222200380,8/5/2014,237000.0,3,2.0,1710,7920,1.0,0.0,0.0,3,8,1260,450,1968,0,98003,47.3473,-122.305,1760,8120,8,5,2014,UNK,-50,-200
7503000050,8/7/2014,390000.0,3,2.5,1690,10113,1.0,0.0,0.0,3,7,1310,380,1991,0,98028,47.7381,-122.223,1690,10113,8,7,2014,UNK,0,0
1592000680,5/28/2014,665000.0,3,2.5,2190,10370,2.0,0.0,0.0,3,9,2190,0,1987,0,98074,47.6218,-122.03,2470,10472,5,28,2014,UNK,-280,-102
4303200130,2/10/2015,277000.0,4,3.0,1960,5160,1.0,0.0,0.0,3,7,1170,790,2001,0,98106,47.5313,-122.36,1960,5160,2,10,2015,UNK,0,0
7731100066,6/12/2014,545000.0,3,1.0,1510,5000,1.5,0.0,0.0,3,7,1510,0,1909,0,98105,47.6708,-122.29700000000001,1680,4000,6,12,2014,UNK,-170,1000
2770602335,4/7/2015,615000.0,3,2.5,1490,1410,2.0,0.0,0.0,3,10,1300,190,2008,0,98199,47.6478,-122.383,1490,1715,4,7,2015,N,0,-305
6706200130,4/15/2015,343000.0,3,1.75,2210,7920,1.0,0.0,0.0,3,7,1400,810,1966,0,98178,47.4968,-122.23700000000001,2220,7920,4,15,2015,UNK,-10,0
6632300567,7/30/2014,597000.0,4,2.5,2340,7877,2.0,0.0,0.0,3,9,2340,0,2004,0,98125,47.73,-122.315,1920,9116,7,30,2014,N,420,-1239
7000100635,7/15/2014,600000.0,3,1.0,940,19000,1.0,0.0,0.0,3,6,940,0,1945,0,98004,47.5828,-122.19,2280,19000,7,15,2014,UNK,-1340,0
1954420420,3/13/2015,479000.0,3,1.75,1470,6018,1.0,0.0,0.0,3,8,1470,0,1987,0,98074,47.6171,-122.044,1720,6584,3,13,2015,UNK,-250,-566
7809200005,12/16/2014,292000.0,3,1.75,1650,14633,1.0,0.0,0.0,4,7,1650,0,1958,0,98056,47.4984,-122.176,1370,12495,12,16,2014,UNK,280,2138
3056000050,9/12/2014,265000.0,3,1.5,1400,6527,1.0,0.0,0.0,3,7,1110,290,1957,0,98166,47.4535,-122.35799999999999,1690,7597,9,12,2014,UNK,-290,-1070
7214780050,4/20/2015,623000.0,4,2.5,2710,49044,2.0,0.0,0.0,3,9,2710,0,1988,0,98077,47.773999999999994,-122.08,2560,38190,4,20,2015,UNK,150,10854
3210950080,5/14/2014,486000.0,4,2.5,2150,39449,1.0,0.0,0.0,3,7,1420,730,1978,0,98024,47.5531,-121.89200000000001,2010,35717,5,14,2014,UNK,140,3732
6914700130,6/15/2014,520500.0,3,2.0,1900,8100,1.0,0.0,0.0,4,7,950,950,1940,0,98115,47.6997,-122.319,1400,6380,6,15,2014,UNK,500,1720
7237550130,5/20/2014,1300000.0,4,3.5,4380,74052,1.0,0.0,0.0,3,11,4380,0,2001,0,98053,47.6587,-122.009,5170,62291,5,20,2014,UNK,-790,11761
1250202660,9/24/2014,825000.0,4,1.0,2290,6300,1.5,0.0,4.0,4,7,2150,140,1921,0,98144,47.5917,-122.29,2390,6300,9,24,2014,UNK,-100,0
3546000380,9/28/2014,259900.0,3,1.75,1690,7953,1.0,0.0,0.0,3,7,1690,0,1986,0,98030,47.3556,-122.175,1680,7425,9,28,2014,UNK,10,528
5451200280,4/2/2015,1170000.0,5,2.75,3090,12031,1.0,0.0,0.0,5,9,1600,1490,1968,0,98040,47.5342,-122.226,2280,10800,4,2,2015,UNK,810,1231
7129301851,9/23/2014,245000.0,2,1.0,1120,5650,1.0,0.0,1.0,3,6,720,400,1904,0,98118,47.5155,-122.255,2160,6480,9,23,2014,UNK,-1040,-830
582000010,3/20/2015,830200.0,3,2.5,2680,4990,1.0,0.0,0.0,5,8,1440,1240,1951,0,98199,47.6538,-122.39299999999999,2320,6000,3,20,2015,UNK,360,-1010
8078360080,6/23/2014,650000.0,4,2.5,2400,7351,2.0,0.0,0.0,3,9,2400,0,1990,0,98029,47.5707,-122.022,2330,7756,6,23,2014,UNK,70,-405
2658000373,1/22/2015,305000.0,4,2.0,1610,6250,1.0,0.0,0.0,4,7,1610,0,1952,0,98118,47.5293,-122.271,1310,6000,1,22,2015,UNK,300,250
7504400290,3/5/2015,599000.0,5,2.5,3470,12003,2.0,0.0,0.0,3,8,3470,0,1978,0,98074,47.623999999999995,-122.04799999999999,2220,12283,3,5,2015,UNK,1250,-280
7137950460,9/26/2014,272000.0,4,2.5,2070,6175,2.0,0.0,0.0,3,8,2070,0,1993,0,98092,47.3262,-122.17399999999999,1940,6175,9,26,2014,UNK,130,0
3303950130,11/13/2014,415000.0,3,2.5,2420,10733,2.0,0.0,0.0,3,8,2420,0,1996,0,98038,47.3835,-122.035,1950,8534,11,13,2014,UNK,470,2199
6648500440,11/21/2014,319000.0,4,2.25,2380,7400,1.0,0.0,0.0,4,8,1760,620,1979,0,98042,47.3555,-122.149,1940,7400,11,21,2014,UNK,440,0
3824100235,7/24/2014,425000.0,4,1.75,2120,15920,1.0,0.0,0.0,4,7,1060,1060,1960,0,98028,47.771,-122.258,2200,12580,7,24,2014,UNK,-80,3340
8732020440,4/28/2015,297500.0,4,2.5,2190,8100,1.0,0.0,0.0,4,8,1250,940,1978,0,98023,47.3131,-122.39200000000001,2100,8840,4,28,2015,UNK,90,-740
8649900480,5/27/2014,725000.0,4,2.5,2740,12899,2.0,0.0,0.0,4,10,2740,0,1990,0,98075,47.5811,-122.02799999999999,2830,9453,5,27,2014,UNK,-90,3446
7708250010,1/7/2015,325000.0,3,2.5,1830,7585,2.0,0.0,0.0,4,8,1830,0,1995,0,98042,47.3893,-122.154,2070,7585,1,7,2015,UNK,-240,0
7955040130,8/5/2014,460000.0,3,1.75,1370,8467,1.0,0.0,0.0,4,7,970,400,1972,0,98052,47.6644,-122.145,1650,8472,8,5,2014,UNK,-280,-5
3424069215,2/17/2015,396480.0,3,1.0,1000,10800,1.0,0.0,0.0,3,7,1000,0,1959,0,98027,47.52,-122.03,1140,16846,2,17,2015,UNK,-140,-6046
1337801060,3/5/2015,1030000.0,3,1.0,2050,4800,2.0,0.0,0.0,3,8,1950,100,1922,0,98112,47.6315,-122.311,2220,4800,3,5,2015,UNK,-170,0
2225300585,11/20/2014,370000.0,3,2.75,1750,9166,1.0,0.0,0.0,4,7,1170,580,1979,0,98155,47.7696,-122.325,1810,8760,11,20,2014,UNK,-60,406
2525300380,4/16/2015,260656.0,3,1.0,1620,13803,1.0,0.0,0.0,4,6,1620,0,1969,0,98038,47.3631,-122.02799999999999,1260,10370,4,16,2015,UNK,360,3433
5634500415,7/15/2014,431000.0,3,2.5,1710,12677,2.0,0.0,0.0,3,8,1710,0,1996,0,98028,47.75,-122.234,1610,12160,7,15,2014,UNK,100,517
2113700780,1/13/2015,320000.0,3,1.0,1060,5000,1.0,0.0,0.0,3,7,1060,0,1958,0,98106,47.5294,-122.354,1220,4600,1,13,2015,UNK,-160,400
1310970380,5/19/2014,296500.0,3,2.75,2170,7900,1.0,0.0,0.0,4,8,1380,790,1978,0,98032,47.361999999999995,-122.277,2170,7700,5,19,2014,UNK,0,200
8562500380,3/9/2015,679000.0,4,2.5,3080,8451,1.0,0.0,0.0,3,7,1540,1540,1969,0,98052,47.674,-122.154,1550,8125,3,9,2015,UNK,1530,326
567000680,8/1/2014,359000.0,3,3.0,1320,1071,2.0,0.0,0.0,3,7,1080,240,2003,0,98144,47.5942,-122.296,1780,7715,8,1,2014,UNK,-460,-6644
1623049174,4/2/2015,330000.0,4,3.0,1920,12040,1.0,0.0,0.0,3,7,1920,0,1962,0,98168,47.4805,-122.301,1530,10230,4,2,2015,UNK,390,1810
9406590280,5/16/2014,350000.0,4,2.5,2440,4000,2.0,0.0,0.0,3,7,2440,0,2009,0,98038,47.3841,-122.036,2410,4502,5,16,2014,N,30,-502
3275800050,10/22/2014,242000.0,3,1.5,1640,8922,1.0,0.0,0.0,4,7,1640,0,1963,0,98146,47.495,-122.34200000000001,1540,9040,10,22,2014,UNK,100,-118
326069027,3/26/2015,692500.0,3,2.5,2420,198198,2.0,0.0,0.0,3,9,2420,0,1997,0,98077,47.772,-122.022,2780,179467,3,26,2015,UNK,-360,18731
825049073,6/30/2014,441000.0,2,1.5,1190,3400,1.0,0.0,0.0,3,7,990,200,1919,0,98115,47.6726,-122.32,1410,3150,6,30,2014,UNK,-220,250
3275870080,12/12/2014,765000.0,4,2.5,2910,15016,2.0,0.0,0.0,3,10,2910,0,1990,0,98052,47.69,-122.09700000000001,2870,13992,12,12,2014,UNK,40,1024
6837700170,9/3/2014,375000.0,2,1.0,1010,4050,1.0,0.0,0.0,3,7,1010,0,1950,0,98116,47.5838,-122.382,2310,5000,9,3,2014,UNK,-1300,-950
243000380,3/26/2015,365000.0,3,1.75,2080,7800,1.0,0.0,0.0,5,7,1220,860,1955,0,98166,47.4536,-122.355,1770,7860,3,26,2015,UNK,310,-60
582000675,9/8/2014,580000.0,2,1.5,1990,6000,1.0,0.0,0.0,3,6,1430,560,1944,0,98199,47.6521,-122.398,1350,6000,9,8,2014,UNK,640,0
2655500235,4/10/2015,1610000.0,4,3.5,3920,19088,1.0,0.0,1.0,3,10,2240,1680,2005,0,98040,47.576,-122.214,3800,13749,4,10,2015,N,120,5339
4178300040,2/19/2015,841000.0,4,2.5,3080,13870,2.0,0.0,0.0,4,9,3080,0,1981,0,98007,47.6197,-122.149,2920,12221,2,19,2015,UNK,160,1649
3526059115,4/21/2015,515000.0,5,3.0,2670,11761,1.0,0.0,0.0,3,7,1370,1300,1981,0,98052,47.6895,-122.12899999999999,2580,10703,4,21,2015,UNK,90,1058
1722069052,10/24/2014,565000.0,5,2.5,4320,107157,1.0,0.0,0.0,4,8,2160,2160,1967,0,98038,47.4009,-122.059,2480,107157,10,24,2014,UNK,1840,0
5101404698,12/15/2014,365000.0,2,1.5,1200,6380,1.0,0.0,0.0,3,7,1200,0,1929,0,98115,47.696999999999996,-122.319,1290,6598,12,15,2014,UNK,-90,-218
13002495,7/7/2014,295000.0,3,1.5,1640,7222,2.0,0.0,0.0,4,7,1640,0,1908,0,98108,47.5215,-122.33,1240,5100,7,7,2014,UNK,400,2122
2391600555,6/30/2014,406500.0,2,1.0,870,5750,1.0,0.0,0.0,4,7,870,0,1947,0,98116,47.5637,-122.395,1100,5750,6,30,2014,UNK,-230,0
1133000144,2/12/2015,614905.0,3,2.5,2410,7225,2.0,0.0,0.0,3,8,2410,0,1991,0,98125,47.7211,-122.31,1940,8347,2,12,2015,UNK,470,-1122
2525049133,4/2/2015,1400000.0,5,2.25,2640,14959,1.0,0.0,0.0,4,7,1770,870,1929,0,98039,47.6191,-122.234,3240,17904,4,2,2015,UNK,-600,-2945
345700180,7/16/2014,250000.0,2,1.0,990,10556,2.0,0.0,0.0,3,7,990,0,1981,0,98056,47.5118,-122.18799999999999,1350,7295,7,16,2014,UNK,-360,3261
7518504775,11/12/2014,549000.0,5,1.0,1500,3978,2.0,0.0,0.0,3,7,1500,0,1929,0,98117,47.6811,-122.383,1350,4080,11,12,2014,UNK,150,-102
3056800230,8/20/2014,397000.0,4,2.5,1790,6590,2.0,0.0,0.0,3,7,1790,0,2005,0,98059,47.4829,-122.12799999999999,1950,5180,8,20,2014,N,-160,1410
6143600580,5/5/2014,184000.0,3,1.75,1490,10125,1.0,0.0,0.0,4,7,1490,0,1962,0,98001,47.3075,-122.28399999999999,2488,4981,5,5,2014,UNK,-998,5144
9471200265,5/5/2015,2500000.0,4,3.25,3960,16224,2.0,0.0,2.0,3,12,3100,860,1938,0,98105,47.6701,-122.259,3960,15050,5,5,2015,UNK,0,1174
8024200855,7/28/2014,499100.0,3,1.5,1620,5108,1.0,0.0,0.0,3,7,1620,0,1954,0,98115,47.6978,-122.316,1380,6130,7,28,2014,UNK,240,-1022
3178100065,9/25/2014,676101.0,4,1.5,2270,6010,1.0,0.0,0.0,3,8,1290,980,1954,0,98115,47.6743,-122.26899999999999,2120,5987,9,25,2014,UNK,150,23
3432501295,6/23/2014,290000.0,3,1.0,1150,8145,1.0,0.0,0.0,4,6,990,160,1932,0,98155,47.7471,-122.31700000000001,1200,8145,6,23,2014,UNK,-50,0
5467500040,3/4/2015,390000.0,4,1.75,2180,7560,1.0,0.0,0.0,4,7,1560,620,1962,0,98133,47.757,-122.336,1810,7352,3,4,2015,UNK,370,208
2872100245,6/4/2014,465000.0,3,1.0,910,4500,1.0,0.0,0.0,3,7,910,0,1948,0,98117,47.6828,-122.395,1370,5000,6,4,2014,UNK,-460,-500
1154100515,9/26/2014,470000.0,3,2.75,2770,54707,1.5,0.0,0.0,3,8,2370,400,1938,0,98155,47.7555,-122.289,1640,54707,9,26,2014,UNK,1130,0
3298300210,2/19/2015,435000.0,3,1.0,940,7590,1.0,0.0,0.0,4,6,940,0,1959,0,98008,47.6231,-122.12,1250,7590,2,19,2015,UNK,-310,0
2473002700,6/27/2014,415000.0,3,1.75,2410,8944,1.0,0.0,0.0,4,8,1860,550,1967,0,98058,47.4494,-122.139,2750,9600,6,27,2014,UNK,-340,-656
7544800395,2/25/2015,450000.0,3,2.0,1010,2820,1.5,0.0,0.0,3,7,1010,0,1905,0,98122,47.6066,-122.304,1330,3000,2,25,2015,UNK,-320,-180
822039111,3/27/2015,645000.0,3,2.5,2120,196995,1.0,0.0,1.0,3,9,2120,0,1997,0,98070,47.4089,-122.459,1304,92423,3,27,2015,UNK,816,104572
2223059052,5/29/2014,231000.0,4,2.0,1530,6375,2.0,0.0,0.0,3,7,1530,0,1942,1983,98058,47.4692,-122.162,1500,8712,5,29,2014,Y,30,-2337
1320069223,6/24/2014,358000.0,3,1.5,1810,100188,1.0,0.0,0.0,5,7,1810,0,1969,0,98022,47.2175,-121.995,1540,40415,6,24,2014,UNK,270,59773
2551500220,8/15/2014,330000.0,3,1.0,1040,11900,1.0,0.0,0.0,5,6,1040,0,1972,0,98070,47.4332,-122.446,1250,9600,8,15,2014,UNK,-210,2300
1049000740,11/20/2014,229950.0,2,1.5,1160,1848,2.0,0.0,0.0,3,7,1160,0,1972,0,98034,47.7366,-122.176,1160,1566,11,20,2014,UNK,0,282
9324800180,10/16/2014,403250.0,2,1.5,1430,8137,1.0,0.0,0.0,3,7,1130,300,1934,0,98125,47.7307,-122.29,1430,8137,10,16,2014,UNK,0,0
7853220690,9/12/2014,470000.0,3,2.5,2280,6134,2.0,0.0,0.0,3,8,2280,0,2004,0,98065,47.5335,-121.854,2640,6167,9,12,2014,N,-360,-33
1545803980,4/25/2015,239000.0,3,1.0,1200,7810,1.0,0.0,0.0,4,7,1200,0,1967,0,98038,47.3631,-122.05,1590,7800,4,25,2015,UNK,-390,10
2484700015,3/27/2015,579000.0,4,1.5,2480,6000,1.0,0.0,0.0,3,8,1520,960,1955,0,98136,47.5233,-122.38600000000001,1810,6000,3,27,2015,UNK,670,0
993000873,3/18/2015,380500.0,3,2.0,1270,1348,3.0,0.0,0.0,3,8,1270,0,2003,0,98103,47.6929,-122.34200000000001,1180,1360,3,18,2015,UNK,90,-12
9520900210,12/31/2014,614285.0,5,2.75,2730,6401,2.0,0.0,0.0,3,8,2730,0,2015,0,98072,47.7685,-122.16,2520,6126,12,31,2014,N,210,275
3629960590,4/7/2015,376000.0,2,2.0,1340,1635,2.0,0.0,0.0,3,8,1340,0,2003,0,98029,47.5476,-122.005,1410,1375,4,7,2015,UNK,-70,260
9558200210,2/17/2015,290000.0,3,1.0,1240,9300,1.0,0.0,0.0,3,7,1240,0,1954,0,98148,47.4363,-122.333,1250,9300,2,17,2015,UNK,-10,0
3876000910,1/29/2015,487000.0,4,2.25,2400,7000,1.0,0.0,0.0,4,8,1800,600,1965,0,98034,47.7207,-122.184,2210,7210,1,29,2015,UNK,190,-210
7228501745,2/19/2015,935000.0,4,2.0,1220,7489,2.0,0.0,0.0,3,7,1220,0,1903,0,98122,47.6133,-122.306,1220,3750,2,19,2015,UNK,0,3739
8856004328,3/27/2015,255000.0,4,2.5,2163,5882,2.0,0.0,0.0,3,7,2163,0,2006,0,98001,47.2736,-122.251,1760,9600,3,27,2015,N,403,-3718
253600150,8/26/2014,380000.0,2,2.5,1860,3504,2.0,0.0,0.0,3,7,1860,0,2000,0,98028,47.776,-122.23899999999999,1860,4246,8,26,2014,UNK,0,-742
5101400934,4/24/2015,450000.0,2,1.0,810,4368,1.0,0.0,0.0,3,6,810,0,1958,0,98115,47.6915,-122.31200000000001,1890,5253,4,24,2015,UNK,-1080,-885
9202650100,10/10/2014,622000.0,3,2.5,1950,7481,2.0,0.0,0.0,3,8,1950,0,1987,0,98027,47.56399999999999,-122.09100000000001,1980,8479,10,10,2014,UNK,-30,-998
2310030490,3/23/2015,292500.0,3,2.25,1390,6004,2.0,0.0,0.0,3,8,1390,0,1993,0,98038,47.3536,-122.04700000000001,1630,6397,3,23,2015,UNK,-240,-393
1860600535,12/20/2014,1320000.0,4,3.0,2120,3600,2.0,0.0,3.0,4,8,1830,290,1908,1996,98119,47.6344,-122.369,2120,3600,12,20,2014,Y,0,0
1250201130,2/6/2015,410000.0,4,2.0,1510,3240,1.0,0.0,0.0,5,7,870,640,1901,0,98144,47.5972,-122.296,1420,5160,2,6,2015,UNK,90,-1920
3298700820,10/24/2014,160000.0,3,1.75,1010,5355,1.0,0.0,0.0,3,6,1010,0,1950,0,98106,47.5202,-122.351,750,4515,10,24,2014,UNK,260,840
1339300025,6/2/2014,809000.0,4,1.5,1840,4337,2.0,0.0,0.0,4,8,1840,0,1917,0,98112,47.6312,-122.307,2250,4337,6,2,2014,UNK,-410,0
4006000571,3/12/2015,183750.0,5,2.75,1650,5453,1.0,0.0,0.0,3,7,1650,0,1970,0,98118,47.5293,-122.285,1670,5885,3,12,2015,UNK,-20,-432
9310300300,10/13/2014,411000.0,5,1.75,2860,12293,1.0,0.0,0.0,4,8,1430,1430,1947,0,98133,47.7385,-122.348,1920,18110,10,13,2014,UNK,940,-5817
5332200515,2/9/2015,1050000.0,3,1.75,2650,5512,2.0,0.0,0.0,3,9,2250,400,1984,0,98112,47.6265,-122.295,1440,5100,2,9,2015,UNK,1210,412
809001565,8/22/2014,625000.0,2,1.0,1100,4160,1.0,0.0,0.0,3,7,1100,0,1919,0,98109,47.6352,-122.352,1900,4000,8,22,2014,UNK,-800,160
9406520580,8/19/2014,305000.0,3,2.25,1646,9519,2.0,0.0,0.0,3,7,1646,0,1994,0,98038,47.3646,-122.036,1975,8889,8,19,2014,UNK,-329,630
1323059143,4/23/2015,915000.0,4,4.5,5250,48352,2.0,0.0,0.0,3,10,5250,0,1998,0,98059,47.4858,-122.111,2500,48352,4,23,2015,UNK,2750,0
2131701020,3/11/2015,317000.0,3,1.5,1390,8300,1.0,0.0,0.0,4,7,1390,0,1974,0,98019,47.7383,-121.98299999999999,1470,7500,3,11,2015,UNK,-80,800
3438503045,1/20/2015,165000.0,2,1.0,780,6380,1.0,0.0,0.0,3,6,780,0,1947,0,98106,47.5423,-122.351,1270,6960,1,20,2015,UNK,-490,-580
3204300705,5/15/2014,575000.0,2,1.0,1490,6000,1.0,0.0,0.0,3,7,1090,400,1946,0,98112,47.6296,-122.3,1590,6000,5,15,2014,UNK,-100,0
7941600220,6/10/2014,219900.0,3,1.0,970,7742,1.0,0.0,0.0,4,6,970,0,1967,0,98003,47.3173,-122.32700000000001,970,7650,6,10,2014,UNK,0,92
3885805175,10/1/2014,1490000.0,4,3.25,3730,7200,2.0,0.0,0.0,3,10,2810,920,2006,0,98033,47.6824,-122.199,2490,7200,10,1,2014,N,1240,0
1237500120,5/20/2014,300000.0,3,1.0,1090,9900,1.0,0.0,0.0,4,7,1090,0,1955,0,98052,47.6755,-122.16,1720,10419,5,20,2014,UNK,-630,-519
322069020,6/19/2014,520000.0,3,1.75,1940,219527,1.0,0.0,0.0,3,7,1940,0,1991,0,98038,47.4214,-122.02,2060,108900,6,19,2014,UNK,-120,110627
1310700330,5/7/2015,310000.0,4,2.25,1780,8820,1.0,0.0,0.0,4,8,1480,300,1966,0,98032,47.3618,-122.289,1780,8625,5,7,2015,UNK,0,195
423059207,2/23/2015,322500.0,3,2.0,1190,6445,1.0,0.0,0.0,3,7,1190,0,1996,0,98056,47.5057,-122.17200000000001,1920,8195,2,23,2015,UNK,-730,-1750
7205000180,4/17/2015,320000.0,4,2.25,2000,10374,2.0,0.0,1.0,4,7,2000,0,1967,0,98023,47.3342,-122.34,2170,10374,4,17,2015,UNK,-170,0
7852180530,4/3/2015,440000.0,3,2.5,1390,4997,2.0,0.0,0.0,3,7,1390,0,2004,0,98065,47.5303,-121.855,2340,4125,4,3,2015,N,-950,872
6021501780,8/18/2014,578000.0,3,1.0,1500,4500,1.0,0.0,0.0,3,7,1120,380,1938,0,98117,47.6873,-122.385,1440,4500,8,18,2014,UNK,60,0
8673400061,11/19/2014,382000.0,2,1.5,1070,877,3.0,0.0,0.0,3,8,1070,0,2005,0,98107,47.6699,-122.39299999999999,1320,1193,11,19,2014,N,-250,-316
3905100220,5/28/2014,535000.0,3,2.5,1720,4006,2.0,0.0,0.0,3,8,1720,0,1994,0,98029,47.568999999999996,-122.007,1780,3974,5,28,2014,UNK,-60,32
5104540330,5/8/2015,679000.0,4,2.5,3680,7236,2.0,0.0,0.0,3,10,3680,0,2006,0,98038,47.3543,-122.005,3310,7180,5,8,2015,N,370,56
6752300120,12/1/2014,258900.0,3,2.25,1400,10436,1.0,0.0,0.0,4,7,1040,360,1985,0,98058,47.4261,-122.14399999999999,1860,9318,12,1,2014,UNK,-460,1118
4077800412,3/16/2015,563000.0,3,1.5,1730,9509,2.0,0.0,0.0,3,8,1270,460,1955,0,98125,47.7067,-122.28200000000001,1810,8795,3,16,2015,UNK,-80,714
2787250090,6/18/2014,562000.0,5,3.0,2795,15101,2.0,0.0,0.0,3,8,2795,0,1996,0,98019,47.7301,-121.97200000000001,2750,14567,6,18,2014,UNK,45,534
461002150,1/5/2015,725000.0,4,1.75,2000,3750,1.0,0.0,0.0,5,8,1120,880,1950,0,98117,47.6816,-122.374,1370,5000,1,5,2015,UNK,630,-1250
1898310100,2/20/2015,236775.0,3,2.5,1830,8372,2.0,0.0,0.0,3,8,1830,0,1987,0,98023,47.3116,-122.4,1770,8372,2,20,2015,UNK,60,0
3886902950,9/11/2014,860000.0,4,3.5,3380,8098,1.0,0.0,1.0,5,9,1690,1690,1952,0,98033,47.6839,-122.19,1890,8400,9,11,2014,UNK,1490,-302
4427100025,5/9/2014,270000.0,3,1.5,1500,6337,1.0,0.0,0.0,5,7,1500,0,1953,0,98125,47.7276,-122.31200000000001,1420,6337,5,9,2014,UNK,80,0
4038700730,12/30/2014,621000.0,4,2.75,1950,6930,1.0,0.0,2.0,4,7,1250,700,1960,0,98008,47.61600000000001,-122.113,1950,8560,12,30,2014,UNK,0,-1630
7852011020,3/27/2015,527900.0,3,2.5,2490,5928,2.0,0.0,2.0,3,8,2490,0,1998,0,98065,47.5385,-121.87,2420,6381,3,27,2015,UNK,70,-453
126059018,1/8/2015,395000.0,4,2.25,1780,10748,2.0,0.0,0.0,4,8,1780,0,1964,0,98072,47.762,-122.11,2070,37680,1,8,2015,UNK,-290,-26932
9407001340,5/22/2014,320000.0,3,2.0,1110,10500,1.0,0.0,0.0,5,7,1110,0,1978,0,98045,47.4456,-121.773,1230,10395,5,22,2014,UNK,-120,105
2799800750,4/16/2015,300000.0,4,2.5,2500,4750,2.0,0.0,0.0,3,8,2500,0,2003,0,98042,47.3666,-122.12200000000001,2690,4750,4,16,2015,UNK,-190,0
192000120,5/20/2014,320000.0,3,1.75,1480,7225,1.0,0.0,0.0,4,7,1480,0,1965,0,98056,47.51300000000001,-122.185,1430,7201,5,20,2014,UNK,50,24
625069064,5/7/2015,625000.0,3,2.25,2570,47480,1.0,0.0,0.0,3,9,2570,0,1979,0,98053,47.6854,-122.079,2570,106722,5,7,2015,UNK,0,-59242
2391600330,4/10/2015,505000.0,2,1.0,810,5060,1.0,0.0,0.0,3,6,810,0,1941,0,98116,47.5635,-122.39399999999999,900,5060,4,10,2015,UNK,-90,0
4180400090,6/13/2014,300000.0,4,2.5,2700,10814,1.0,0.0,0.0,4,8,1560,1140,1966,0,98030,47.369,-122.177,2460,6310,6,13,2014,UNK,240,4504
50300220,2/12/2015,363000.0,4,2.5,2180,9281,2.0,0.0,0.0,3,8,2180,0,2004,0,98042,47.3673,-122.072,2520,9520,2,12,2015,N,-340,-239
4141010110,8/8/2014,1700000.0,4,3.5,4330,15335,2.0,0.0,0.0,4,11,3230,1100,1988,0,98040,47.5315,-122.23100000000001,3840,14311,8,8,2014,UNK,490,1024
6641040100,5/15/2014,1150000.0,4,3.5,4210,10308,2.0,0.0,0.0,3,10,4210,0,2006,0,98008,47.5905,-122.117,3860,10200,5,15,2014,N,350,108
7922720040,3/17/2015,680000.0,4,2.5,2880,9202,1.0,0.0,0.0,3,8,1780,1100,1977,0,98052,47.6658,-122.139,2500,10265,3,17,2015,UNK,380,-1063
8825900245,12/9/2014,678940.0,5,2.25,2610,4080,2.0,0.0,0.0,5,7,1750,860,1909,0,98115,47.6757,-122.309,2160,4080,12,9,2014,UNK,450,0
3883100220,1/20/2015,299000.0,3,1.75,2010,8065,1.0,0.0,0.0,4,7,1090,920,1984,0,98031,47.4171,-122.20200000000001,1560,8065,1,20,2015,UNK,450,0
3649100306,5/6/2014,379900.0,4,1.75,1500,11600,1.0,0.0,0.0,4,7,1000,500,1955,0,98028,47.7373,-122.241,1740,11600,5,6,2014,UNK,-240,0
1099600090,6/13/2014,205000.0,3,1.0,1290,6566,1.0,0.0,0.0,5,7,1290,0,1976,0,98023,47.3004,-122.37700000000001,1690,6860,6,13,2014,UNK,-400,-294
9828201725,5/20/2014,387500.0,4,1.0,1320,4440,1.5,0.0,0.0,3,7,1320,0,1929,0,98122,47.6145,-122.295,1260,4440,5,20,2014,UNK,60,0
9352901085,2/4/2015,256000.0,3,1.0,1290,4720,1.0,0.0,0.0,3,6,790,500,1948,0,98106,47.5186,-122.35799999999999,1110,4720,2,4,2015,UNK,180,0
4104910040,7/1/2014,548000.0,4,2.5,2440,11005,2.0,0.0,0.0,3,9,2440,0,1994,0,98056,47.5318,-122.176,2590,14754,7,1,2014,UNK,-150,-3749
6147600040,2/24/2015,163000.0,3,1.75,1290,4811,1.0,0.0,0.0,3,7,1290,0,1996,0,98032,47.3912,-122.234,1310,4811,2,24,2015,UNK,-20,0
6371000026,1/22/2015,367500.0,2,2.0,1030,600,2.0,0.0,0.0,3,8,680,350,2004,0,98116,47.5788,-122.41,1120,1267,1,22,2015,N,-90,-667
8121100147,7/14/2014,390000.0,3,2.25,1640,2875,2.0,0.0,0.0,3,6,1240,400,1983,0,98118,47.5686,-122.286,1500,3960,7,14,2014,UNK,140,-1085
6152900332,8/1/2014,415000.0,4,2.5,1160,16008,1.0,0.0,0.0,4,7,1160,0,1989,0,98155,47.7643,-122.295,1570,12645,8,1,2014,UNK,-410,3363
9522600120,10/22/2014,449000.0,4,2.25,2230,8440,2.0,0.0,0.0,4,8,2230,0,1968,0,98011,47.7558,-122.21700000000001,2160,9412,10,22,2014,UNK,70,-972
2207200405,7/16/2014,460000.0,5,2.0,1910,12264,1.0,0.0,0.0,4,7,1010,900,1963,0,98007,47.601000000000006,-122.134,1700,9179,7,16,2014,UNK,210,3085
203900690,12/23/2014,395000.0,4,2.0,1980,15354,1.0,0.0,0.0,3,7,1980,0,1977,0,98053,47.63800000000001,-121.96799999999999,1420,12300,12,23,2014,UNK,560,3054
252000300,1/20/2015,300000.0,3,2.0,1470,16500,1.0,0.0,0.0,3,7,1470,0,1961,0,98042,47.3617,-122.061,1720,14406,1,20,2015,UNK,-250,2094
8899100230,3/11/2015,345000.0,3,1.75,1520,7439,1.0,0.0,0.0,4,7,1520,0,1969,0,98055,47.457,-122.208,1650,7500,3,11,2015,UNK,-130,-61
685000265,1/2/2015,825000.0,3,1.75,1930,8442,1.0,0.0,0.0,4,7,1930,0,1953,0,98004,47.6313,-122.204,1790,8442,1,2,2015,UNK,140,0
2705600068,3/27/2015,539950.0,3,2.5,1330,2180,3.0,0.0,0.0,3,8,1330,0,2014,0,98117,47.6987,-122.365,1330,5000,3,27,2015,N,0,-2820
3326059191,6/16/2014,410000.0,4,2.0,1580,9581,1.0,0.0,0.0,3,7,1580,0,1953,0,98033,47.692,-122.165,1580,10552,6,16,2014,UNK,0,-971
1207000025,8/1/2014,245000.0,3,1.0,1370,6000,1.0,0.0,0.0,3,7,1370,0,1955,0,98146,47.4879,-122.339,1370,9520,8,1,2014,UNK,0,-3520
3288301050,8/19/2014,482000.0,4,2.75,3010,15750,1.0,0.0,0.0,4,8,1560,1450,1973,0,98034,47.7336,-122.18299999999999,2110,9450,8,19,2014,UNK,900,6300
9407001500,8/11/2014,270000.0,3,1.75,1390,9000,1.0,0.0,0.0,4,7,1390,0,1978,0,98045,47.4469,-121.772,1400,9697,8,11,2014,UNK,-10,-697
3882300090,12/26/2014,475000.0,3,1.75,1330,14560,1.0,0.0,0.0,3,7,1330,0,1983,0,98052,47.6599,-122.135,1510,9890,12,26,2014,UNK,-180,4670
2926049221,10/14/2014,445800.0,3,2.0,1320,6500,1.0,0.0,0.0,3,7,1320,0,1947,0,98125,47.7119,-122.319,1110,6592,10,14,2014,UNK,210,-92
2121000300,2/19/2015,518000.0,4,3.0,2430,11670,1.0,0.0,0.0,4,7,1330,1100,1978,0,98034,47.7307,-122.228,1580,10464,2,19,2015,UNK,850,1206
3885801970,8/12/2014,785000.0,2,0.75,1260,4800,1.5,0.0,2.0,4,6,1080,180,1942,0,98033,47.6843,-122.212,2660,7200,8,12,2014,UNK,-1400,-2400
3869900120,2/26/2015,430000.0,3,2.5,1690,1310,2.0,0.0,0.0,3,8,1140,550,2004,0,98136,47.5404,-122.387,1640,1321,2,26,2015,N,50,-11
4077800026,5/30/2014,715000.0,4,1.75,3420,7200,1.0,0.0,3.0,5,8,1770,1650,1947,0,98125,47.7081,-122.277,2450,6200,5,30,2014,UNK,970,1000
9324800450,10/9/2014,560000.0,3,1.5,2790,6900,1.0,0.0,2.0,3,8,1700,1090,1955,0,98125,47.7328,-122.288,2410,8100,10,9,2014,UNK,380,-1200
1250201194,11/7/2014,449000.0,3,1.75,1270,6600,1.5,0.0,0.0,5,7,1270,0,1903,0,98144,47.5976,-122.295,1490,3600,11,7,2014,UNK,-220,3000
2597520580,10/8/2014,805000.0,4,2.5,2910,9000,2.0,0.0,0.0,3,9,2910,0,1989,0,98006,47.5451,-122.14200000000001,2530,9000,10,8,2014,UNK,380,0
6679000720,9/24/2014,296000.0,3,2.5,1560,5845,2.0,0.0,0.0,3,7,1560,0,2003,0,98038,47.3851,-122.029,1860,5752,9,24,2014,UNK,-300,93
7312400325,6/25/2014,275000.0,2,1.0,770,4840,1.0,0.0,0.0,4,7,770,0,1927,0,98126,47.551,-122.376,930,4840,6,25,2014,UNK,-160,0
2473500110,1/12/2015,419950.0,3,1.75,1770,16909,1.0,0.0,0.0,5,8,1770,0,1977,0,98058,47.4458,-122.134,1960,9100,1,12,2015,UNK,-190,7809
1773100123,10/2/2014,285000.0,3,1.75,1100,1307,2.0,0.0,0.0,3,7,780,320,2008,0,98106,47.5601,-122.363,1170,4800,10,2,2014,N,-70,-3493
6791050100,7/21/2014,775000.0,3,2.5,2890,8470,2.0,0.0,0.0,3,10,2890,0,1996,0,98075,47.5785,-122.054,3000,8879,7,21,2014,UNK,-110,-409
1823059106,4/28/2015,288250.0,3,1.75,2110,15400,1.0,0.0,0.0,3,7,1380,730,1963,0,98178,47.4861,-122.226,2110,9800,4,28,2015,UNK,0,5600
3644100065,4/27/2015,257000.0,2,1.75,1220,2268,1.0,0.0,0.0,4,6,610,610,1909,0,98144,47.592,-122.295,1240,1675,4,27,2015,UNK,-20,593
5652601075,8/25/2014,377000.0,1,1.0,950,10585,1.5,0.0,0.0,3,6,950,0,1929,0,98115,47.6968,-122.29700000000001,1400,7056,8,25,2014,UNK,-450,3529
2769601250,5/12/2015,550000.0,2,1.0,1420,3100,1.0,0.0,0.0,3,7,820,600,1924,0,98107,47.6737,-122.365,1420,3915,5,12,2015,UNK,0,-815
9842300540,6/24/2014,339000.0,3,1.0,1100,4128,1.0,0.0,0.0,4,7,720,380,1942,0,98126,47.5296,-122.37899999999999,1510,4538,6,24,2014,UNK,-410,-410
7818700410,11/6/2014,481500.0,3,1.75,2140,6000,1.0,0.0,0.0,3,7,1070,1070,1948,0,98117,47.6913,-122.366,1240,4650,11,6,2014,UNK,900,1350
5437810360,11/7/2014,224500.0,3,1.75,1300,7735,1.0,0.0,0.0,4,7,1300,0,1980,0,98022,47.1983,-122.0,1300,8941,11,7,2014,UNK,0,-1206
5163700085,8/26/2014,260000.0,3,1.0,1790,11884,1.0,0.0,0.0,3,7,1790,0,1951,0,98031,47.3887,-122.22,1660,11513,8,26,2014,UNK,130,371
1794500360,4/23/2015,865000.0,2,1.0,1470,5400,1.5,0.0,0.0,3,8,1470,0,1912,0,98119,47.6391,-122.36,1760,3573,4,23,2015,UNK,-290,1827
1777600450,5/5/2015,730000.0,5,3.0,2500,11779,1.0,0.0,0.0,4,8,1550,950,1971,0,98006,47.5696,-122.12700000000001,2580,12055,5,5,2015,UNK,-80,-276
4083800555,3/26/2015,550000.0,2,1.0,980,3080,1.5,0.0,0.0,3,7,980,0,1910,1946,98103,47.6646,-122.339,1450,3333,3,26,2015,Y,-470,-253
3359500096,8/20/2014,645000.0,3,2.0,2130,4000,2.0,0.0,0.0,3,7,2130,0,1908,0,98115,47.6741,-122.323,2010,4000,8,20,2014,UNK,120,0
4024100090,10/8/2014,250000.0,3,1.75,1360,16000,1.0,0.0,0.0,3,7,1360,0,1978,0,98155,47.7583,-122.306,1360,12939,10,8,2014,UNK,0,3061
7228501910,1/22/2015,507200.0,3,3.5,1630,1329,2.0,0.0,0.0,3,9,1360,270,2000,0,98122,47.6159,-122.306,1580,1319,1,22,2015,UNK,50,10
7183000120,8/12/2014,380000.0,4,2.5,2500,11070,1.0,0.0,2.0,4,8,1300,1200,1964,0,98003,47.33600000000001,-122.334,2500,11070,8,12,2014,UNK,0,0
7527000090,8/14/2014,540000.0,4,1.75,2260,19500,1.0,0.0,2.0,3,8,1450,810,1971,0,98074,47.6555,-122.086,2980,19500,8,14,2014,UNK,-720,0
8682281080,6/17/2014,738500.0,3,2.5,2300,6009,1.0,0.0,0.0,3,8,2300,0,2005,0,98053,47.7067,-122.01299999999999,1640,5931,6,17,2014,N,660,78
2525310040,1/29/2015,206000.0,3,1.0,1060,10350,1.0,0.0,0.0,4,7,1060,0,1980,0,98038,47.365,-122.02799999999999,1500,9660,1,29,2015,UNK,-440,690
5589300210,3/17/2015,265000.0,2,1.0,940,9458,1.0,0.0,0.0,3,6,940,0,1948,0,98155,47.7523,-122.311,1450,9458,3,17,2015,UNK,-510,0
4008400515,1/20/2015,190000.0,1,0.75,780,77603,1.0,0.0,0.0,1,5,780,0,1945,0,98058,47.4396,-122.104,1750,30847,1,20,2015,UNK,-970,46756
3268000040,6/28/2014,339900.0,3,1.0,1200,9087,1.0,0.0,0.0,5,7,1200,0,1969,0,98056,47.5234,-122.177,1250,11826,6,28,2014,UNK,-50,-2739
1022059123,12/26/2014,250000.0,6,2.5,2590,10890,1.0,0.0,0.0,4,7,1340,1250,1970,0,98042,47.4126,-122.165,2474,10454,12,26,2014,UNK,116,436
3013300968,8/1/2014,416500.0,3,1.0,1100,4184,1.0,0.0,0.0,4,7,1100,0,1965,0,98136,47.5309,-122.382,1630,4366,8,1,2014,UNK,-530,-182
7853220740,4/7/2015,575000.0,4,2.5,2890,9775,2.0,0.0,2.0,3,8,2890,0,2004,0,98065,47.5339,-121.854,2640,7184,4,7,2015,N,250,2591
3574801490,6/9/2014,385000.0,3,1.75,1230,7500,1.0,0.0,0.0,3,7,1230,0,1987,0,98034,47.7316,-122.22399999999999,1930,8747,6,9,2014,UNK,-700,-1247
2987400025,10/9/2014,253000.0,3,1.0,1030,6250,1.0,0.0,0.0,3,7,1030,0,1960,1997,98056,47.4988,-122.16799999999999,1160,7250,10,9,2014,Y,-130,-1000
625049313,9/2/2014,460000.0,3,1.0,1140,4600,1.0,0.0,0.0,3,7,1140,0,1942,0,98103,47.6897,-122.337,1370,5000,9,2,2014,UNK,-230,-400
6169901085,8/7/2014,1450000.0,4,2.5,3200,3600,3.0,0.0,3.0,4,9,2600,600,1997,0,98119,47.632,-122.369,2490,4080,8,7,2014,UNK,710,-480
9212900300,3/4/2015,492000.0,2,1.0,950,6000,1.0,0.0,0.0,3,7,950,0,1942,0,98115,47.6897,-122.294,1440,6000,3,4,2015,UNK,-490,0
2520069100,10/16/2014,275000.0,4,2.0,1960,30480,1.0,0.0,2.0,4,7,1060,900,1972,0,98022,47.1924,-121.988,1460,8914,10,16,2014,UNK,500,21566
2623069031,5/21/2014,542500.0,5,3.25,3010,1074218,1.5,0.0,0.0,5,8,2010,1000,1931,0,98027,47.4564,-122.00399999999999,2450,68825,5,21,2014,UNK,560,1005393
7625703945,7/1/2014,345000.0,2,1.0,1080,7775,1.0,0.0,0.0,3,6,1080,0,1955,0,98136,47.5447,-122.39399999999999,1730,7350,7,1,2014,UNK,-650,425
9238480120,4/21/2015,575000.0,4,2.75,2730,35075,1.0,0.0,0.0,3,8,1530,1200,1979,0,98072,47.7726,-122.139,2310,35000,4,21,2015,UNK,420,75
626049058,5/4/2015,275000.0,5,2.5,2570,17234,1.0,0.0,0.0,3,7,1300,1270,1959,0,98133,47.7753,-122.355,1760,7969,5,4,2015,UNK,810,9265
125059138,7/22/2014,510000.0,6,4.5,3300,7561,2.0,0.0,0.0,3,8,3300,0,1980,0,98052,47.6795,-122.104,2470,7561,7,22,2014,UNK,830,0
9185700485,4/1/2015,2540000.0,4,3.5,4350,6000,2.0,0.0,0.0,5,10,2970,1380,1908,0,98112,47.6277,-122.286,4190,7200,4,1,2015,UNK,160,-1200
2523089110,9/9/2014,830000.0,3,3.5,3820,145054,2.0,0.0,3.0,3,9,2870,950,1999,0,98045,47.4419,-121.736,2500,95950,9,9,2014,UNK,1320,49104
3825310540,11/21/2014,640000.0,4,2.5,2260,5172,2.0,0.0,0.0,3,9,2260,0,2004,0,98052,47.7047,-122.12799999999999,2680,5172,11,21,2014,N,-420,0
7202340590,10/14/2014,702000.0,4,2.75,3880,15025,2.0,0.0,0.0,3,7,3880,0,2004,0,98053,47.6777,-122.035,2620,5300,10,14,2014,N,1260,9725
1952200410,11/19/2014,960000.0,3,2.5,2010,6857,1.0,0.0,0.0,4,9,1450,560,1955,0,98102,47.6402,-122.314,2380,6370,11,19,2014,UNK,-370,487
7137900410,4/29/2015,190000.0,3,1.0,950,7610,1.0,0.0,0.0,3,7,950,0,1983,0,98092,47.3188,-122.17399999999999,1360,7938,4,29,2015,UNK,-410,-328
7105600085,10/9/2014,500000.0,3,2.25,1730,13040,1.0,0.0,0.0,4,8,1290,440,1988,0,98052,47.6809,-122.119,1730,11016,10,9,2014,UNK,0,2024
1461200040,7/14/2014,529000.0,3,2.5,3070,22098,2.0,0.0,0.0,3,9,3070,0,1995,0,98059,47.4724,-122.147,3070,21803,7,14,2014,UNK,0,295
6675500035,6/13/2014,435000.0,3,1.75,1500,8173,1.0,0.0,0.0,3,7,1500,0,1997,0,98034,47.7293,-122.227,1970,8173,6,13,2014,UNK,-470,0
4322500110,3/3/2015,670000.0,3,1.75,2160,5760,1.0,0.0,0.0,4,8,1260,900,1954,0,98136,47.5346,-122.391,2090,5760,3,3,2015,UNK,70,0
6064800090,5/7/2015,365000.0,3,2.25,1960,1985,2.0,0.0,0.0,3,7,1750,210,2003,0,98118,47.5419,-122.289,1760,1985,5,7,2015,UNK,200,0
8085400355,12/4/2014,1270000.0,5,3.0,3950,9520,1.0,0.0,0.0,3,9,2250,1700,1953,2002,98004,47.6363,-122.20700000000001,1890,9520,12,4,2014,Y,2060,0
943100220,9/25/2014,465000.0,3,1.0,1100,145490,1.5,0.0,0.0,4,6,1100,0,1915,0,98024,47.5697,-121.898,1100,11610,9,25,2014,UNK,0,133880
854000165,1/7/2015,285000.0,3,1.5,1400,7582,1.0,0.0,0.0,3,7,1400,0,1956,0,98148,47.4536,-122.33,1280,7872,1,7,2015,UNK,120,-290
1443500905,2/5/2015,219950.0,3,1.0,1020,4960,1.5,0.0,0.0,3,6,920,100,1926,0,98118,47.5328,-122.275,1230,7335,2,5,2015,UNK,-210,-2375
4031700210,11/17/2014,220000.0,3,1.5,1600,10548,1.0,0.0,0.0,4,7,1600,0,1962,0,98001,47.2925,-122.28399999999999,2880,13609,11,17,2014,UNK,-1280,-3061
6169900580,7/9/2014,1470000.0,6,4.5,4230,6420,2.0,0.0,3.0,4,8,2360,1870,1916,0,98119,47.6301,-122.369,3450,4085,7,9,2014,UNK,780,2335
4232401265,10/20/2014,1110000.0,5,3.5,3090,3600,2.0,0.0,0.0,3,9,2060,1030,2000,0,98112,47.6217,-122.309,2240,3904,10,20,2014,UNK,850,-304
8682290410,4/17/2015,694000.0,2,2.5,2320,9311,1.0,0.0,0.0,3,8,2320,0,2007,0,98053,47.7226,-122.03,1680,4765,4,17,2015,N,640,4546
3904902430,4/3/2015,620000.0,3,2.5,2440,10363,2.0,0.0,0.0,3,9,2440,0,1988,0,98029,47.5634,-122.016,2500,10728,4,3,2015,UNK,-60,-365
114101540,8/21/2014,415000.0,3,1.0,2020,19210,1.0,0.0,0.0,3,6,1760,260,1949,0,98028,47.7552,-122.229,1780,14469,8,21,2014,UNK,240,4741
1025069106,2/23/2015,765000.0,3,3.0,3270,38088,2.0,0.0,0.0,3,10,3270,0,1992,0,98053,47.6692,-122.02799999999999,1870,37457,2,23,2015,UNK,1400,631
3179101945,7/15/2014,864000.0,4,1.75,2260,6600,1.0,0.0,0.0,5,8,1220,1040,1948,0,98115,47.6753,-122.27799999999999,2240,6600,7,15,2014,UNK,20,0
3083000355,12/4/2014,385000.0,5,2.0,2020,4000,2.0,0.0,0.0,3,7,2020,0,1950,0,98144,47.5799,-122.305,1960,4000,12,4,2014,UNK,60,0
1741700040,1/13/2015,725000.0,3,1.0,1000,19969,1.0,0.0,0.0,3,7,1000,0,1951,0,98033,47.6745,-122.197,1370,7962,1,13,2015,UNK,-370,12007
1828001130,6/17/2014,545000.0,4,2.25,2030,11585,1.0,0.0,0.0,4,7,1590,440,1967,0,98052,47.6561,-122.13,1960,8977,6,17,2014,UNK,70,2608
3211580210,4/11/2015,299900.0,3,1.75,1730,9893,1.0,0.0,0.0,4,9,1730,0,1988,0,98042,47.3747,-122.164,2120,9108,4,11,2015,UNK,-390,785
1036000610,5/7/2015,639500.0,3,1.75,2010,8072,1.0,0.0,0.0,4,8,2010,0,1974,0,98052,47.6327,-122.09700000000001,2030,8055,5,7,2015,UNK,-20,17
3378100100,3/17/2015,345000.0,4,1.5,1540,7168,1.0,0.0,0.0,3,7,1160,380,1964,0,98055,47.455,-122.198,1540,7176,3,17,2015,UNK,0,-8
9286000150,3/30/2015,1130000.0,6,4.0,5330,18116,2.0,0.0,0.0,3,11,3950,1380,2000,0,98006,47.5503,-122.137,4590,16900,3,30,2015,UNK,740,1216
7254200040,3/16/2015,345000.0,2,1.0,960,2700,1.0,0.0,0.0,3,6,780,180,1904,0,98144,47.6013,-122.29899999999999,1400,3000,3,16,2015,UNK,-440,-300
8827900690,4/21/2015,600000.0,3,2.0,1460,2800,1.0,0.0,0.0,4,7,730,730,1921,0,98105,47.67,-122.295,1780,4560,4,21,2015,UNK,-320,-1760
9202500150,11/4/2014,355000.0,4,1.75,2160,7417,1.0,0.0,0.0,4,7,1360,800,1983,0,98056,47.5122,-122.181,1880,8022,11,4,2014,UNK,280,-605
1786810040,9/9/2014,698000.0,3,2.75,2640,11957,1.5,0.0,0.0,3,9,2260,380,1978,0,98052,47.6491,-122.12,2640,12641,9,9,2014,UNK,0,-684
8078410210,6/16/2014,566000.0,4,2.25,2170,7737,2.0,0.0,0.0,3,8,2170,0,1987,0,98074,47.637,-122.029,1850,8869,6,16,2014,UNK,320,-1132
3905100210,7/23/2014,449950.0,3,2.5,1530,3840,2.0,0.0,0.0,3,8,1530,0,1994,0,98029,47.5691,-122.007,1720,3985,7,23,2014,UNK,-190,-145
5592900015,1/16/2015,404600.0,3,1.0,1570,7727,1.0,0.0,2.0,4,8,1270,300,1958,0,98056,47.4821,-122.19200000000001,2440,7727,1,16,2015,UNK,-870,0
7522700110,6/24/2014,258000.0,3,1.0,1490,7435,1.0,0.0,0.0,3,7,1120,370,1969,0,98198,47.368,-122.314,1490,7530,6,24,2014,UNK,0,-95
5253300243,4/29/2015,415000.0,4,2.0,1960,10559,2.0,0.0,0.0,4,7,1960,0,1955,0,98133,47.7494,-122.337,1580,7769,4,29,2015,UNK,380,2790
6669020490,8/12/2014,320000.0,4,2.25,2190,9020,2.0,0.0,0.0,3,8,2190,0,1978,0,98032,47.3742,-122.28399999999999,2170,8400,8,12,2014,UNK,20,620
5104510540,11/26/2014,295000.0,3,2.5,1690,4102,2.0,0.0,0.0,3,7,1690,0,2003,0,98038,47.3552,-122.015,1830,4733,11,26,2014,UNK,-140,-631
3579700100,5/27/2014,389000.0,5,2.0,2330,10750,1.0,0.0,0.0,4,7,1190,1140,1962,0,98028,47.7325,-122.245,1830,10180,5,27,2014,UNK,500,570
8643200035,8/21/2014,299900.0,3,1.75,1470,27000,1.0,0.0,0.0,3,7,1470,0,1958,0,98198,47.3943,-122.311,2230,14186,8,21,2014,UNK,-760,12814
2781250100,4/15/2015,394000.0,3,2.5,2550,5349,2.0,0.0,0.0,3,7,2550,0,2004,0,98038,47.3504,-122.02600000000001,2640,5400,4,15,2015,N,-90,-51
3885807255,2/2/2015,762000.0,4,2.0,2130,5500,1.5,0.0,0.0,5,7,2130,0,1939,0,98033,47.6807,-122.199,1490,6000,2,2,2015,UNK,640,-500
1774230090,6/13/2014,697000.0,4,2.75,3650,48351,1.5,0.0,0.0,4,8,3650,0,1978,0,98077,47.7632,-122.089,2820,53143,6,13,2014,UNK,830,-4792
3521069146,3/30/2015,485000.0,3,2.5,3340,70131,2.0,0.0,0.0,3,9,2420,920,1994,0,98022,47.2666,-122.015,2760,116740,3,30,2015,UNK,580,-46609
424500100,10/8/2014,189900.0,2,1.0,800,5600,1.0,0.0,0.0,5,6,800,0,1955,0,98056,47.4959,-122.17200000000001,1100,6000,10,8,2014,UNK,-300,-400
3761700053,1/5/2015,2150000.0,3,2.75,3470,9610,3.0,0.0,4.0,3,11,3470,0,1989,0,98034,47.7205,-122.26,4130,11875,1,5,2015,UNK,-660,-2265
2685600090,11/18/2014,345000.0,3,1.5,1030,6969,1.0,0.0,0.0,4,6,1030,0,1921,0,98108,47.5492,-122.3,1420,6000,11,18,2014,UNK,-390,969
6381500065,7/29/2014,376500.0,3,2.0,1630,7800,1.0,0.0,0.0,5,7,1630,0,1950,0,98125,47.7326,-122.307,1470,7800,7,29,2014,UNK,160,0
9294300515,10/24/2014,775000.0,3,2.0,2010,7017,2.0,0.0,3.0,3,7,2010,0,1951,1988,98115,47.6828,-122.26700000000001,2450,6045,10,24,2014,Y,-440,972
2769602840,10/16/2014,450000.0,3,1.0,1360,3737,1.5,0.0,0.0,4,6,1360,0,1910,0,98107,47.6751,-122.36200000000001,1820,4500,10,16,2014,UNK,-460,-763
2526039156,12/10/2014,760000.0,4,2.25,2040,8315,1.0,0.0,0.0,4,8,1480,560,1958,0,98177,47.7077,-122.37100000000001,2330,8940,12,10,2014,UNK,-290,-625
7852140100,10/7/2014,569000.0,4,2.5,2830,10954,2.0,0.0,0.0,3,8,2830,0,2003,0,98065,47.5396,-121.882,2470,10443,10,7,2014,UNK,360,511
5522600205,9/17/2014,500000.0,3,1.5,2040,6750,1.0,0.0,0.0,3,7,1280,760,1950,0,98117,47.7013,-122.369,1970,6750,9,17,2014,UNK,70,0
1370802620,12/11/2014,592500.0,2,2.0,1340,5350,1.5,0.0,0.0,3,8,1340,0,1941,0,98199,47.6384,-122.40299999999999,2210,5350,12,11,2014,UNK,-870,0
8079100210,3/4/2015,620000.0,4,2.5,2130,9139,2.0,0.0,0.0,3,9,2130,0,1988,0,98029,47.5648,-122.01,2150,8178,3,4,2015,UNK,-20,961
644200040,5/15/2014,1000000.0,5,4.25,3920,16258,2.0,0.0,0.0,3,9,2900,1020,1990,0,98004,47.5871,-122.19200000000001,2540,12131,5,15,2014,UNK,1380,4127
9808640090,3/19/2015,815000.0,3,2.5,2415,2186,2.0,0.0,1.0,3,9,2415,0,1981,0,98033,47.6506,-122.20200000000001,2660,2165,3,19,2015,UNK,-245,21
5104531120,3/23/2015,775000.0,5,2.75,3750,12077,2.0,0.0,4.0,3,10,3750,0,2005,0,98038,47.3525,-122.00200000000001,3120,7255,3,23,2015,N,630,4822
3575303970,7/16/2014,340000.0,3,1.0,1010,7500,1.0,0.0,0.0,4,7,1010,0,1975,0,98074,47.6169,-122.06200000000001,1230,7500,7,16,2014,UNK,-220,0
6413100090,9/15/2014,458000.0,2,1.75,990,5850,1.0,0.0,0.0,4,6,990,0,1942,0,98125,47.7132,-122.321,840,6110,9,15,2014,UNK,150,-260
2475200870,9/17/2014,250000.0,2,1.5,1200,5773,2.0,0.0,0.0,3,7,1200,0,1985,0,98055,47.4723,-122.19,1530,4576,9,17,2014,UNK,-330,1197
3423059081,10/9/2014,151600.0,2,1.0,1060,16988,1.0,0.0,0.0,3,6,1060,0,1954,0,98058,47.4305,-122.15700000000001,2320,10580,10,9,2014,UNK,-1260,6408
1137410040,5/27/2014,515000.0,4,2.5,3200,6473,2.0,0.0,0.0,3,7,3200,0,2005,0,98059,47.5012,-122.15,2480,6140,5,27,2014,N,720,333
3352400330,3/27/2015,216000.0,2,1.0,1810,10360,1.0,0.0,0.0,3,6,1010,800,1946,0,98178,47.5039,-122.266,1810,10360,3,27,2015,UNK,0,0
2781320100,3/9/2015,245000.0,3,1.75,1670,24650,1.0,0.0,0.0,4,7,1670,0,1974,0,98022,47.1764,-122.02600000000001,1810,19465,3,9,2015,UNK,-140,5185
8894000040,6/25/2014,645000.0,3,2.75,1850,16960,1.0,0.0,2.0,4,8,1850,0,1953,0,98177,47.7128,-122.365,2470,13761,6,25,2014,UNK,-620,3199
3333000775,9/3/2014,249900.0,3,1.0,1100,5000,1.0,0.0,0.0,3,7,1100,0,1960,0,98118,47.5433,-122.28299999999999,1020,5000,9,3,2014,UNK,80,0
9274204230,7/9/2014,410000.0,3,1.75,1660,6250,1.0,0.0,0.0,3,7,830,830,1980,0,98116,47.5859,-122.385,1660,5750,7,9,2014,UNK,0,500
3972900025,3/13/2015,499000.0,6,1.75,2400,7500,1.5,0.0,0.0,3,7,1400,1000,1975,0,98155,47.7661,-122.31299999999999,1980,7500,3,13,2015,UNK,420,0
1159400220,5/29/2014,790000.0,5,3.25,2900,12160,1.0,0.0,0.0,4,8,1890,1010,1967,0,98005,47.6154,-122.16799999999999,2590,12160,5,29,2014,UNK,310,0
3876313030,5/20/2014,458000.0,1,2.25,2140,10350,1.0,0.0,0.0,3,7,1470,670,1976,0,98072,47.7352,-122.17,1980,8400,5,20,2014,UNK,160,1950
2856100515,8/5/2014,925000.0,4,2.5,2670,5100,2.0,0.0,0.0,3,8,1940,730,1929,2010,98117,47.6768,-122.39,1470,4080,8,5,2014,Y,1200,1020
4239400730,6/25/2014,152000.0,3,1.0,1090,3264,1.0,0.0,0.0,4,6,1090,0,1969,0,98092,47.3155,-122.182,1090,3330,6,25,2014,UNK,0,-66
1826059042,9/23/2014,402000.0,3,2.5,1970,12205,2.0,0.0,0.0,4,8,1970,0,1990,0,98011,47.7397,-122.209,2640,9636,9,23,2014,UNK,-670,2569
3869900155,3/26/2015,340000.0,2,2.0,1250,1178,2.0,0.0,0.0,3,7,980,270,1996,0,98136,47.5426,-122.387,1270,1242,3,26,2015,UNK,-20,-64
2600010220,3/26/2015,1250000.0,4,2.5,4040,11350,2.0,0.0,2.0,4,10,3690,350,1984,0,98006,47.559,-122.162,3770,12382,3,26,2015,UNK,270,-1032
9290870040,11/17/2014,775000.0,4,2.5,3220,38448,2.0,0.0,0.0,3,10,3220,0,1993,0,98053,47.6854,-122.053,3090,38448,11,17,2014,UNK,130,0
5347200175,3/19/2015,299800.0,2,1.0,1310,2814,1.0,0.0,0.0,3,6,810,500,1944,0,98126,47.5185,-122.376,1300,1344,3,19,2015,UNK,10,1470
3810000455,9/8/2014,340000.0,4,2.25,2060,8400,1.0,0.0,0.0,3,7,1300,760,1960,0,98178,47.4984,-122.23,1990,7383,9,8,2014,UNK,70,1017
1962200037,5/2/2014,626000.0,3,2.25,1750,1572,2.5,0.0,0.0,3,9,1470,280,2005,0,98102,47.6498,-122.321,2410,3050,5,2,2014,N,-660,-1478
795001930,10/7/2014,324950.0,2,1.0,1150,9186,1.0,0.0,0.0,3,7,1150,0,1946,0,98168,47.5081,-122.33,1390,10690,10,7,2014,UNK,-240,-1504
3905080730,2/23/2015,535500.0,3,2.5,2050,4976,2.0,0.0,0.0,3,8,2050,0,1994,0,98029,47.5689,-121.995,2050,5153,2,23,2015,UNK,0,-177
8651611110,9/5/2014,817500.0,3,3.25,3230,7639,2.0,0.0,0.0,3,10,3230,0,1999,0,98074,47.6338,-122.06299999999999,3230,7772,9,5,2014,UNK,0,-133
5411600210,8/12/2014,810000.0,4,3.5,4170,4322,2.0,0.0,0.0,3,9,2940,1230,2005,0,98074,47.6136,-122.041,2970,4922,8,12,2014,N,1200,-600
7519000665,4/8/2015,565000.0,5,1.5,1940,3430,1.5,0.0,0.0,4,6,1220,720,1926,0,98117,47.6853,-122.36200000000001,1830,4120,4,8,2015,UNK,110,-690
4217400120,11/25/2014,978000.0,3,1.5,2390,4000,1.5,0.0,0.0,3,9,1690,700,1936,0,98105,47.6604,-122.28,2350,4000,11,25,2014,UNK,40,0
3586500665,1/12/2015,530000.0,3,1.0,1440,27505,1.0,0.0,0.0,3,8,1440,0,1951,0,98177,47.7553,-122.37,2430,16400,1,12,2015,UNK,-990,11105
2582500110,10/7/2014,305000.0,4,2.5,2230,6487,2.0,0.0,0.0,3,7,2230,0,2003,0,98092,47.3287,-122.169,2230,6882,10,7,2014,UNK,0,-395
6749700031,6/9/2014,345000.0,3,2.5,1210,1420,3.0,0.0,0.0,3,8,1210,0,2008,0,98103,47.6977,-122.34899999999999,1190,1407,6,9,2014,N,20,13
4136800205,2/19/2015,258000.0,2,2.0,750,6553,1.5,0.0,2.0,3,7,750,0,1945,0,98178,47.4982,-122.221,1140,7500,2,19,2015,UNK,-390,-947
3438503120,3/30/2015,275000.0,4,1.0,1770,7345,1.5,0.0,0.0,3,7,1770,0,1966,0,98106,47.5393,-122.351,1580,7345,3,30,2015,UNK,190,0
1922069089,3/24/2015,310000.0,3,1.0,1020,55756,1.0,0.0,0.0,3,7,1020,0,1961,0,98042,47.3836,-122.08200000000001,1490,12745,3,24,2015,UNK,-470,43011
4099501215,6/3/2014,713250.0,3,2.0,2050,9000,1.0,0.0,0.0,4,7,2050,0,1951,0,98040,47.5885,-122.245,2910,8856,6,3,2014,UNK,-860,144
3325069025,5/8/2015,500000.0,3,1.0,2000,21780,1.0,0.0,0.0,3,8,1480,520,1978,0,98074,47.6064,-122.039,2000,45738,5,8,2015,UNK,0,-23958
4058200985,9/11/2014,472000.0,3,1.75,2180,7200,1.0,0.0,3.0,4,8,1090,1090,1954,0,98178,47.5044,-122.235,2180,7140,9,11,2014,UNK,0,60
3031200246,7/11/2014,250000.0,3,1.0,920,4429,1.0,0.0,0.0,3,7,920,0,1952,0,98118,47.5369,-122.291,1320,7860,7,11,2014,UNK,-400,-3431
624101110,10/2/2014,725000.0,4,2.25,3440,14237,2.0,0.0,0.0,3,9,3440,0,1982,0,98077,47.7241,-122.065,3250,18365,10,2,2014,UNK,190,-4128
4046700210,6/29/2014,345000.0,3,2.0,1610,15005,1.0,0.0,0.0,4,7,1610,0,1986,0,98014,47.6886,-121.911,1610,15479,6,29,2014,UNK,0,-474
2916200065,1/15/2015,460000.0,3,1.5,1870,15685,1.0,0.0,0.0,3,7,1470,400,1936,0,98133,47.723,-122.353,1340,7620,1,15,2015,UNK,530,8065
6141100038,6/2/2014,440150.0,2,1.0,1110,6800,1.0,0.0,0.0,5,7,1000,110,1947,0,98133,47.7184,-122.355,1410,6963,6,2,2014,UNK,-300,-163
2806800090,11/4/2014,390000.0,3,1.75,2200,8036,1.0,0.0,0.0,3,7,1270,930,1978,0,98011,47.7763,-122.209,1850,7563,11,4,2014,UNK,350,473
312000265,5/4/2015,375000.0,2,1.0,790,5120,1.0,0.0,0.0,3,6,790,0,1950,0,98136,47.556999999999995,-122.395,1250,5120,5,4,2015,UNK,-460,0
2938200040,12/11/2014,224950.0,3,1.5,1630,9282,1.0,0.0,0.0,4,7,1630,0,1963,0,98022,47.2021,-122.00200000000001,1420,9282,12,11,2014,UNK,210,0
114101161,8/29/2014,480000.0,3,1.5,2100,67269,1.0,0.0,0.0,4,7,1220,880,1949,0,98028,47.7592,-122.23,1610,15999,8,29,2014,UNK,490,51270
1862400353,3/26/2015,721000.0,4,2.75,2690,5400,2.0,0.0,0.0,3,7,2210,480,1940,2009,98117,47.6963,-122.367,1620,5400,3,26,2015,Y,1070,0
179000100,8/26/2014,174000.0,2,1.0,600,4854,1.0,0.0,0.0,5,6,600,0,1922,0,98168,47.4927,-122.28,1470,5000,8,26,2014,UNK,-870,-146
7812800865,11/19/2014,170000.0,2,1.0,810,9882,1.0,0.0,0.0,3,6,810,0,1944,0,98178,47.4925,-122.23899999999999,950,7200,11,19,2014,UNK,-140,2682
809002390,1/15/2015,658000.0,3,1.5,1660,3190,1.5,0.0,0.0,3,7,1660,0,1919,0,98109,47.6368,-122.351,2200,3240,1,15,2015,UNK,-540,-50
2925059294,3/27/2015,860000.0,3,2.0,1880,8494,1.0,0.0,0.0,4,7,1200,680,1968,0,98004,47.6217,-122.19200000000001,1290,9128,3,27,2015,UNK,590,-634
7574200210,6/18/2014,407450.0,4,1.5,2310,68824,2.0,0.0,0.0,4,7,2310,0,1968,0,98010,47.3354,-122.031,2020,39900,6,18,2014,UNK,290,28924
5634500775,1/30/2015,615000.0,4,1.5,2650,34000,2.0,0.0,0.0,4,7,2650,0,1930,0,98028,47.7516,-122.23700000000001,1960,34000,1,30,2015,UNK,690,0
8965460090,4/7/2015,920000.0,4,3.0,3130,12381,2.0,0.0,0.0,3,9,3130,0,1995,0,98006,47.5599,-122.118,3250,10049,4,7,2015,UNK,-120,2332
1796350300,7/10/2014,195000.0,2,1.0,860,10400,1.0,0.0,0.0,4,6,860,0,1983,0,98042,47.3682,-122.096,1390,9086,7,10,2014,UNK,-530,1314
428000150,7/18/2014,269950.0,3,1.0,990,9950,1.0,0.0,0.0,5,7,990,0,1961,0,98056,47.5104,-122.171,1370,9260,7,18,2014,UNK,-380,690
2323089009,1/19/2015,855000.0,4,3.5,4030,1024068,2.0,0.0,0.0,3,10,4030,0,2006,0,98045,47.4619,-121.744,1830,11700,1,19,2015,N,2200,1012368
3528900735,9/10/2014,620000.0,3,2.25,1780,1429,3.0,0.0,0.0,3,8,1570,210,2007,0,98109,47.6413,-122.346,1470,1799,9,10,2014,N,310,-370
3904100220,12/9/2014,276000.0,2,2.0,1480,6075,1.0,0.0,0.0,5,7,740,740,1919,0,98118,47.5317,-122.27600000000001,1230,6053,12,9,2014,UNK,250,22
254000735,8/6/2014,329000.0,3,1.0,1140,5258,1.5,0.0,0.0,3,6,1140,0,1911,0,98146,47.5122,-122.383,1140,5280,8,6,2014,UNK,0,-22
7893205080,10/7/2014,270000.0,3,1.5,1230,7500,1.0,0.0,0.0,3,7,1230,0,1962,0,98198,47.4202,-122.331,1260,7800,10,7,2014,UNK,-30,-300
4397010300,11/13/2014,440000.0,4,2.5,3080,10646,2.0,0.0,0.0,3,9,3080,0,1993,0,98042,47.3828,-122.148,2740,9994,11,13,2014,UNK,340,652
1150000740,10/3/2014,639000.0,4,2.5,1990,8034,2.0,0.0,0.0,4,10,1990,0,1989,0,98029,47.56100000000001,-122.01799999999999,2580,8034,10,3,2014,UNK,-590,0
1926049141,10/10/2014,403500.0,1,1.0,700,5621,1.0,0.0,0.0,4,6,700,0,1945,0,98133,47.733999999999995,-122.353,1020,5621,10,10,2014,UNK,-320,0
7011201016,10/1/2014,585000.0,3,2.5,1700,1156,2.0,0.0,2.0,3,9,1320,380,2002,0,98119,47.6373,-122.369,1710,1686,10,1,2014,UNK,-10,-530
3028200100,8/26/2014,216000.0,2,1.0,860,9000,1.0,0.0,0.0,4,6,860,0,1942,0,98168,47.4801,-122.315,990,9975,8,26,2014,UNK,-130,-975
8081010040,9/11/2014,1150000.0,3,2.5,3160,24437,1.0,0.0,3.0,3,11,2160,1000,1991,0,98006,47.5531,-122.131,3990,11977,9,11,2014,UNK,-830,12460
3023049186,4/16/2015,575000.0,3,2.0,2500,30056,1.0,0.0,0.0,5,8,1840,660,1954,0,98166,47.4468,-122.337,2500,30000,4,16,2015,UNK,0,56
8029900110,11/14/2014,430000.0,4,2.5,3000,9460,2.0,0.0,0.0,3,9,3000,0,2001,0,98031,47.3959,-122.211,3000,8450,11,14,2014,UNK,0,1010
9367200205,3/24/2015,660000.0,2,1.0,1670,8195,1.0,0.0,0.0,3,7,1670,0,1954,1975,98033,47.6627,-122.19200000000001,1980,7500,3,24,2015,Y,-310,695
5550300205,4/13/2015,338000.0,2,1.0,690,6400,1.0,0.0,0.0,3,6,690,0,1943,0,98126,47.5287,-122.367,1000,6400,4,13,2015,UNK,-310,0
8820901415,5/29/2014,400000.0,4,2.75,1240,3867,1.0,0.0,0.0,3,7,800,440,1987,0,98125,47.7157,-122.28399999999999,1150,7733,5,29,2014,UNK,90,-3866
6018500120,2/20/2015,210000.0,2,1.0,900,5000,1.0,0.0,0.0,5,6,900,0,1930,1990,98022,47.2008,-121.995,1150,5000,2,20,2015,Y,-250,0
3826000665,5/22/2014,305000.0,4,1.75,2200,8100,1.5,0.0,0.0,5,6,1400,800,1942,0,98168,47.4945,-122.303,1520,8100,5,22,2014,UNK,680,0
1025079086,8/20/2014,365000.0,2,1.0,960,223898,1.0,0.0,0.0,3,6,960,0,1985,0,98014,47.6668,-121.89200000000001,1830,230868,8,20,2014,UNK,-870,-6970
2621660040,6/29/2014,325000.0,5,2.75,2130,6222,1.0,0.0,0.0,3,7,1300,830,1991,0,98118,47.5272,-122.27600000000001,2130,6222,6,29,2014,UNK,0,0
8731982550,12/10/2014,245000.0,4,1.75,2020,8800,1.0,0.0,0.0,4,8,2020,0,1969,0,98023,47.3202,-122.384,2320,8000,12,10,2014,UNK,-300,800
4324500180,9/26/2014,182000.0,3,1.0,1060,7350,1.0,0.0,0.0,4,7,1060,0,1959,0,98032,47.3809,-122.287,1060,7350,9,26,2014,UNK,0,0
1702901485,6/3/2014,440000.0,2,1.0,1230,6600,1.0,0.0,0.0,3,7,1130,100,1906,0,98118,47.5573,-122.28200000000001,1260,5060,6,3,2014,UNK,-30,1540
251300110,7/31/2014,225000.0,3,2.25,2510,12013,2.0,0.0,0.0,3,8,2510,0,1988,0,98003,47.3473,-122.314,1870,8017,7,31,2014,UNK,640,3996
251300110,1/14/2015,358000.0,3,2.25,2510,12013,2.0,0.0,0.0,3,8,2510,0,1988,0,98003,47.3473,-122.314,1870,8017,1,14,2015,UNK,640,3996
461002615,12/2/2014,580000.0,5,2.5,2720,5000,1.5,0.0,0.0,4,7,1530,1190,1939,0,98117,47.6827,-122.376,1210,5000,12,2,2014,UNK,1510,0
8091401030,4/22/2015,240000.0,3,1.5,1070,8886,1.0,0.0,0.0,4,7,1070,0,1984,0,98030,47.3516,-122.166,1730,9461,4,22,2015,UNK,-660,-575
3924500040,4/13/2015,700000.0,4,3.25,3580,43093,1.0,0.0,0.0,4,8,3580,0,1990,0,98024,47.5595,-121.90100000000001,2070,43093,4,13,2015,UNK,1510,0
9432900040,7/29/2014,325000.0,4,2.5,2230,8500,2.0,0.0,0.0,3,8,2230,0,1994,0,98022,47.2082,-122.009,2270,8770,7,29,2014,UNK,-40,-270
2426049125,11/14/2014,488000.0,4,2.25,2500,10890,1.0,0.0,0.0,5,7,1800,700,1978,0,98034,47.7318,-122.23899999999999,2500,7467,11,14,2014,UNK,0,3423
2883201055,9/10/2014,875000.0,4,1.0,1670,4600,1.5,0.0,0.0,5,8,1670,0,1906,0,98103,47.6838,-122.33200000000001,1820,4600,9,10,2014,UNK,-150,0
1795900360,6/2/2014,615000.0,4,2.5,2150,9070,2.0,0.0,0.0,4,8,2150,0,1985,0,98052,47.7279,-122.10700000000001,2230,8995,6,2,2014,UNK,-80,75
9542830690,11/20/2014,321000.0,3,2.5,2020,4183,2.0,0.0,0.0,3,7,2020,0,2012,0,98038,47.3658,-122.01700000000001,2030,4140,11,20,2014,N,-10,43
1245500690,6/2/2014,1040000.0,3,2.5,2230,5750,2.0,0.0,0.0,3,9,2230,0,2003,0,98033,47.6938,-122.213,1900,8238,6,2,2014,UNK,330,-2488
7454000315,4/24/2015,299500.0,2,1.0,740,6300,1.0,0.0,0.0,3,6,740,0,1942,0,98126,47.5158,-122.376,740,6300,4,24,2015,UNK,0,0
2426049113,4/14/2015,459000.0,4,1.5,2020,9583,2.0,0.0,0.0,4,7,2020,0,1963,0,98034,47.7283,-122.238,1770,8625,4,14,2015,UNK,250,958
8665050450,9/12/2014,435000.0,3,2.5,1730,4065,2.0,0.0,0.0,3,8,1730,0,1996,0,98029,47.5668,-122.005,1730,4094,9,12,2014,UNK,0,-29
2787320620,10/10/2014,222000.0,3,1.75,1370,8280,1.0,0.0,0.0,4,7,1370,0,1980,0,98031,47.4096,-122.17200000000001,1850,7820,10,10,2014,UNK,-480,460
5100401411,10/27/2014,485000.0,4,1.0,1210,6380,1.5,0.0,0.0,3,7,1210,0,1936,0,98115,47.6924,-122.321,1340,6380,10,27,2014,UNK,-130,0
2767602855,4/29/2015,750000.0,5,3.5,2160,2323,3.0,0.0,0.0,3,9,2160,0,2007,0,98107,47.6726,-122.39,1750,4650,4,29,2015,N,410,-2327
7575620750,12/22/2014,266000.0,3,2.25,1550,6022,2.0,0.0,0.0,3,8,1550,0,1989,0,98003,47.3525,-122.304,1650,5627,12,22,2014,UNK,-100,395
1529300115,6/2/2014,455000.0,2,1.0,1170,6000,1.0,0.0,0.0,4,7,970,200,1941,0,98103,47.6994,-122.354,2130,6002,6,2,2014,UNK,-960,-2
122029066,5/8/2015,490000.0,3,1.75,2020,215622,2.0,0.0,0.0,4,7,2020,0,1975,0,98070,47.4189,-122.499,1810,215622,5,8,2015,UNK,210,0
8732130580,4/30/2015,280000.0,3,1.75,1740,8625,1.0,0.0,0.0,4,7,1240,500,1978,0,98023,47.3054,-122.38,1980,8625,4,30,2015,UNK,-240,0
1689400375,8/5/2014,1450000.0,4,3.25,3100,3900,2.0,0.0,2.0,5,9,2090,0,1923,0,98109,47.6385,-122.348,2110,3900,8,5,2014,UNK,990,0
985001321,12/17/2014,291000.0,4,1.0,1590,24330,1.5,0.0,0.0,3,6,1140,450,1942,0,98168,47.4906,-122.309,1000,16228,12,17,2014,UNK,590,8102
7987400475,4/17/2015,745000.0,5,3.0,2400,10126,2.0,0.0,3.0,3,8,2400,0,1981,0,98126,47.5726,-122.37299999999999,2250,3946,4,17,2015,UNK,150,6180
6383000820,8/7/2014,685900.0,3,2.5,2290,9142,1.0,0.0,0.0,3,8,2290,0,1972,0,98117,47.691,-122.387,1770,8035,8,7,2014,UNK,520,1107
1311400120,8/1/2014,160000.0,3,1.75,1610,7392,1.0,0.0,0.0,4,7,1610,0,1964,0,98001,47.3413,-122.28,1450,7392,8,1,2014,UNK,160,0
1153000040,4/29/2015,650000.0,4,2.5,2240,9934,1.0,0.0,0.0,4,8,1490,750,1968,0,98005,47.6147,-122.166,2640,11622,4,29,2015,UNK,-400,-1688
7452500530,2/19/2015,250000.0,2,1.0,850,6370,1.0,0.0,0.0,3,6,850,0,1951,0,98126,47.5198,-122.37299999999999,850,5170,2,19,2015,UNK,0,1200
6300000212,2/18/2015,265000.0,2,1.5,920,1458,2.0,0.0,0.0,3,7,920,0,1995,0,98133,47.7081,-122.34200000000001,1110,1598,2,18,2015,UNK,-190,-140
3332000530,11/5/2014,599000.0,5,3.25,2590,6180,1.0,0.0,0.0,3,7,1330,1260,1960,0,98118,47.551,-122.272,1560,6180,11,5,2014,UNK,1030,0
7657600195,11/5/2014,199950.0,3,1.0,1340,7260,1.5,0.0,0.0,3,6,1340,0,1944,0,98178,47.4934,-122.23700000000001,1210,7260,11,5,2014,UNK,130,0
1102000237,4/28/2015,712500.0,4,2.75,2420,11201,1.0,0.0,1.0,3,8,1420,1000,1948,1999,98118,47.5459,-122.265,3170,9385,4,28,2015,Y,-750,1816
2887702070,10/22/2014,490000.0,2,1.0,1420,4305,1.0,0.0,0.0,4,7,920,500,1941,0,98115,47.6864,-122.311,1420,4305,10,22,2014,UNK,0,0
6392001005,6/20/2014,511500.0,4,1.0,1360,6000,1.5,0.0,0.0,3,7,1360,0,1917,0,98115,47.6854,-122.288,1710,6000,6,20,2014,UNK,-350,0
1601600195,3/19/2015,299000.0,3,1.0,1510,6200,1.0,0.0,0.0,3,6,1010,500,1955,0,98118,47.5293,-122.274,1710,8623,3,19,2015,UNK,-200,-2423
3586500620,8/14/2014,685000.0,4,2.5,2650,25248,1.0,0.0,2.0,3,9,2330,320,1954,0,98177,47.7537,-122.37299999999999,3020,23135,8,14,2014,UNK,-370,2113
6021502250,8/25/2014,597000.0,4,2.0,2120,4000,1.5,0.0,0.0,4,7,1720,400,1927,0,98117,47.688,-122.383,1760,4000,8,25,2014,UNK,360,0
3830210220,9/8/2014,210000.0,3,1.0,1200,7200,1.0,0.0,0.0,3,6,1200,0,1977,0,98030,47.3746,-122.18299999999999,1200,7420,9,8,2014,UNK,0,-220
2568300266,5/30/2014,659000.0,4,2.5,3190,11375,1.0,0.0,0.0,5,8,2210,980,1946,0,98125,47.70399999999999,-122.3,1100,8500,5,30,2014,UNK,2090,2875
3423600065,6/4/2014,540000.0,3,1.0,1050,4160,1.0,0.0,0.0,4,7,1050,0,1925,0,98115,47.6756,-122.3,1580,3680,6,4,2014,UNK,-530,480
3343300180,3/30/2015,469000.0,3,2.0,1300,22605,1.0,0.0,0.0,3,7,1300,0,1998,0,98056,47.5337,-122.18700000000001,2250,10215,3,30,2015,UNK,-950,12390
3125079013,4/30/2015,1070000.0,3,2.5,3970,263538,1.5,0.0,0.0,3,9,3970,0,1991,0,98024,47.6067,-121.95200000000001,3970,194676,4,30,2015,UNK,0,68862
6453900040,7/14/2014,575000.0,5,2.5,2990,7500,1.0,0.0,2.0,3,9,1800,1190,1972,0,98177,47.7707,-122.369,2800,9860,7,14,2014,UNK,190,-2360
148000590,7/31/2014,725000.0,4,2.75,2440,7042,1.5,0.0,2.0,4,7,1640,0,1941,0,98116,47.5731,-122.40799999999999,2170,7900,7,31,2014,UNK,270,-858
419000015,9/17/2014,299950.0,4,1.0,1170,5400,1.0,0.0,0.0,5,6,1170,0,1953,0,98056,47.492,-122.17200000000001,1100,5400,9,17,2014,UNK,70,0
303000220,4/21/2015,375000.0,4,2.0,2270,18450,1.0,0.0,0.0,3,7,2270,0,1961,0,98001,47.3264,-122.262,2150,18450,4,21,2015,UNK,120,0
6450302175,11/18/2014,342450.0,3,1.5,1280,5525,1.0,0.0,0.0,3,7,1280,0,1962,0,98133,47.7339,-122.336,1330,5286,11,18,2014,UNK,-50,239
1180000625,10/29/2014,315000.0,4,2.5,1950,3225,2.0,0.0,0.0,3,7,1950,0,2002,0,98178,47.5014,-122.226,1980,3225,10,29,2014,UNK,-30,0
7972600450,12/22/2014,328000.0,4,2.75,1930,3840,1.0,0.0,0.0,3,7,1170,760,1997,0,98106,47.5303,-122.346,1610,3840,12,22,2014,UNK,320,0
1328300180,5/9/2014,323000.0,4,2.75,1970,7213,1.0,0.0,0.0,3,8,1170,800,1977,0,98058,47.4424,-122.126,1980,7045,5,9,2014,UNK,-10,168
7866000158,10/22/2014,320000.0,4,3.0,1820,3120,1.0,0.0,0.0,3,7,1000,820,1997,0,98118,47.5468,-122.274,1600,5001,10,22,2014,UNK,220,-1881
7518505345,12/29/2014,550000.0,2,1.0,950,4080,1.0,0.0,0.0,4,7,950,0,1924,0,98117,47.6765,-122.384,1120,4080,12,29,2014,UNK,-170,0
8084900195,11/21/2014,1650000.0,6,3.5,4010,16200,1.0,0.0,0.0,3,8,2090,1920,1955,1990,98004,47.6322,-122.21600000000001,3560,16200,11,21,2014,Y,450,0
4139420590,5/20/2014,1210000.0,4,3.5,4560,16643,1.0,0.0,3.0,3,12,2230,2330,1995,0,98006,47.5521,-122.115,4060,15177,5,20,2014,UNK,500,1466
4139420590,8/27/2014,1200000.0,4,3.5,4560,16643,1.0,0.0,3.0,3,12,2230,2330,1995,0,98006,47.5521,-122.115,4060,15177,8,27,2014,UNK,500,1466
2621600015,1/21/2015,120000.0,3,1.0,1150,8924,1.0,0.0,0.0,3,6,1150,0,1943,0,98030,47.3865,-122.21700000000001,1492,8924,1,21,2015,UNK,-342,0
2621600015,4/30/2015,175000.0,3,1.0,1150,8924,1.0,0.0,0.0,3,6,1150,0,1943,0,98030,47.3865,-122.21700000000001,1492,8924,4,30,2015,UNK,-342,0
8005100360,9/16/2014,169900.0,3,1.0,910,5800,1.5,0.0,0.0,4,5,910,0,1900,0,98022,47.2068,-121.992,1400,6766,9,16,2014,UNK,-490,-966
9527000330,8/11/2014,508000.0,6,2.75,2890,7500,1.0,0.0,0.0,4,8,1830,1060,1976,0,98034,47.7099,-122.23,1880,7500,8,11,2014,UNK,1010,0
748000145,12/11/2014,335000.0,2,1.0,1070,6678,1.0,0.0,0.0,4,7,1070,0,1951,0,98133,47.7315,-122.35700000000001,1680,7788,12,11,2014,UNK,-610,-1110
9191200015,9/10/2014,613200.0,3,2.75,2050,3320,1.5,0.0,0.0,4,7,1580,470,1927,0,98105,47.6719,-122.301,1760,4150,9,10,2014,UNK,290,-830
1822300040,5/7/2014,420000.0,2,1.5,1040,3500,1.5,0.0,0.0,4,6,1040,0,1904,0,98144,47.588,-122.304,1340,1213,5,7,2014,UNK,-300,2287
9129100040,8/25/2014,1000000.0,4,3.25,3320,8587,3.0,0.0,0.0,3,11,2950,370,2008,0,98103,47.691,-122.337,1860,5668,8,25,2014,N,1460,2919
3331500940,6/17/2014,342000.0,2,1.0,740,6180,1.0,0.0,0.0,3,6,740,0,1948,0,98118,47.5517,-122.272,1330,4635,6,17,2014,UNK,-590,1545
524069101,7/23/2014,850000.0,4,2.0,3380,90968,1.0,0.0,0.0,4,9,1690,1690,1979,0,98075,47.5936,-122.07700000000001,3380,42740,7,23,2014,UNK,0,48228
6021502310,12/18/2014,582000.0,2,1.75,1210,4141,1.0,0.0,0.0,4,7,910,300,1942,0,98117,47.68600000000001,-122.382,1310,4141,12,18,2014,UNK,-100,0
4022901316,10/31/2014,475000.0,3,2.5,2480,6031,2.0,0.0,0.0,3,8,2480,0,2001,0,98155,47.772,-122.29700000000001,1850,7704,10,31,2014,UNK,630,-1673
23500180,5/5/2014,570000.0,3,2.25,2010,6000,1.0,0.0,0.0,3,8,1330,680,1975,0,98052,47.6912,-122.115,2080,8260,5,5,2014,UNK,-70,-2260
9191200490,3/24/2015,826600.0,4,3.25,3230,5000,1.5,0.0,0.0,4,7,1750,1480,1916,0,98105,47.6702,-122.3,1730,4000,3,24,2015,UNK,1500,1000
1189000207,10/21/2014,387000.0,2,2.5,1170,1394,2.0,0.0,0.0,3,8,1170,0,2001,0,98122,47.6131,-122.29700000000001,1250,3136,10,21,2014,UNK,-80,-1742
1771110720,5/21/2014,330000.0,3,1.0,1250,9126,1.0,0.0,0.0,3,7,1250,0,1969,0,98077,47.7554,-122.07600000000001,1440,10620,5,21,2014,UNK,-190,-1494
224069010,7/25/2014,653450.0,3,2.5,2070,49658,1.0,0.0,0.0,4,8,1540,530,1980,0,98075,47.5936,-122.01299999999999,2620,35160,7,25,2014,UNK,-550,14498
3630060040,9/11/2014,285000.0,2,1.0,1050,3088,1.0,0.0,0.0,3,7,1050,0,2005,0,98029,47.5471,-121.99600000000001,1890,2772,9,11,2014,N,-840,316
3211100450,8/14/2014,217000.0,3,1.0,1400,7800,1.0,0.0,0.0,3,7,1400,0,1962,0,98059,47.4789,-122.15899999999999,1400,7800,8,14,2014,UNK,0,0
1245003255,2/23/2015,615000.0,3,1.0,1120,12500,1.0,0.0,0.0,4,7,1120,0,1977,0,98033,47.6842,-122.2,2380,10000,2,23,2015,UNK,-1260,2500
1438000110,6/3/2014,580135.0,4,2.5,3150,5886,2.0,0.0,0.0,3,8,3150,0,2014,0,98059,47.4787,-122.12200000000001,2650,5886,6,3,2014,N,500,0
8089500180,7/30/2014,1150000.0,4,3.5,4540,19767,2.0,0.0,0.0,3,11,4200,340,1998,0,98006,47.5445,-122.137,3990,12881,7,30,2014,UNK,550,6886
6802200110,10/29/2014,231200.0,3,2.0,1400,8821,1.0,0.0,0.0,3,7,1400,0,1991,0,98022,47.1949,-121.98899999999999,1450,8721,10,29,2014,UNK,-50,100
7203100120,6/16/2014,680000.0,4,2.75,2500,4950,2.0,0.0,0.0,3,8,2500,0,2010,0,98053,47.6964,-122.01700000000001,2500,4950,6,16,2014,N,0,0
3445400120,7/25/2014,267500.0,3,1.5,1390,2153,2.0,0.0,0.0,3,7,1390,0,2001,0,98118,47.5506,-122.29,1100,2617,7,25,2014,UNK,290,-464
1454100650,8/4/2014,942000.0,4,2.75,3160,37200,2.0,0.0,3.0,3,8,2310,850,1939,0,98125,47.7214,-122.285,3130,20000,8,4,2014,UNK,30,17200
106000015,6/19/2014,435000.0,3,1.75,1310,8065,1.0,0.0,0.0,4,6,1310,0,1948,0,98117,47.701,-122.368,1420,8100,6,19,2014,UNK,-110,-35
9459200110,6/10/2014,315000.0,2,1.0,1740,3622,1.0,0.0,0.0,4,7,950,790,1924,0,98118,47.5541,-122.29,1270,3800,6,10,2014,UNK,470,-178
3448000410,5/13/2014,354901.0,3,2.5,1490,1709,3.0,0.0,0.0,3,8,1490,0,2004,0,98125,47.7173,-122.29899999999999,1364,1709,5,13,2014,N,126,0
8682281220,10/14/2014,439888.0,2,2.0,1300,6515,1.0,0.0,0.0,3,8,1300,0,2005,0,98053,47.7078,-122.01299999999999,1640,6009,10,14,2014,N,-340,506
2114700530,1/22/2015,360000.0,4,1.0,1460,3840,1.5,0.0,0.0,3,8,1340,120,1928,0,98106,47.533,-122.34700000000001,990,4200,1,22,2015,UNK,470,-360
8093600065,12/31/2014,205000.0,4,1.0,1030,6621,1.0,0.0,0.0,4,6,1030,0,1955,0,98055,47.4857,-122.221,1420,6631,12,31,2014,UNK,-390,-10
4137030040,6/12/2014,299995.0,3,2.5,1970,7500,2.0,0.0,0.0,3,8,1970,0,1988,0,98092,47.2658,-122.21799999999999,1950,8220,6,12,2014,UNK,20,-720
5126900100,9/23/2014,150000.0,2,1.0,790,7275,1.0,0.0,0.0,4,6,790,0,1944,0,98058,47.4771,-122.17399999999999,850,7399,9,23,2014,UNK,-60,-124
5469501530,6/3/2014,575000.0,3,2.25,3800,33825,1.0,0.0,0.0,4,10,3330,470,1976,0,98042,47.3797,-122.152,3470,14484,6,3,2014,UNK,330,19341
7784000180,5/5/2015,625000.0,3,2.0,2168,12616,2.0,0.0,1.0,4,7,2168,0,1950,0,98146,47.4933,-122.367,2168,9750,5,5,2015,UNK,0,2866
7135520610,5/29/2014,950000.0,4,3.5,4140,13392,2.0,0.0,0.0,3,11,4140,0,2000,0,98059,47.5261,-122.14399999999999,4140,11529,5,29,2014,UNK,0,1863
8856500120,2/10/2015,278800.0,4,2.5,2440,7797,1.0,0.0,0.0,3,8,1560,880,1965,0,98031,47.3895,-122.22200000000001,2090,8100,2,10,2015,UNK,350,-303
5015000180,11/10/2014,713500.0,3,2.0,1720,4200,2.0,0.0,0.0,3,8,1720,0,1908,0,98112,47.6285,-122.301,1720,4200,11,10,2014,UNK,0,0
3024059014,3/25/2015,1900000.0,4,2.25,3020,11489,1.5,1.0,3.0,5,10,2110,910,1916,0,98040,47.5395,-122.21,3890,11489,3,25,2015,UNK,-870,0
9268200348,10/28/2014,439000.0,5,2.0,2610,5009,1.0,0.0,0.0,3,7,1710,900,1988,0,98117,47.6969,-122.366,1600,5040,10,28,2014,UNK,1010,-31
9195700040,9/26/2014,425000.0,3,2.0,1500,8086,1.0,0.0,0.0,3,7,1060,440,1981,0,98027,47.5584,-122.081,1550,8086,9,26,2014,UNK,-50,0
8798000100,8/25/2014,252500.0,4,2.5,2600,11280,1.5,0.0,0.0,3,7,1570,1030,1961,0,98003,47.33600000000001,-122.304,1660,11200,8,25,2014,UNK,940,80
304000530,5/12/2014,185000.0,3,1.5,1370,8470,1.0,0.0,0.0,4,7,1370,0,1961,0,98092,47.2874,-122.19200000000001,1710,8800,5,12,2014,UNK,-340,-330
3575304895,9/23/2014,406550.0,5,2.75,2400,15781,1.0,0.0,0.0,4,7,1200,1200,1974,0,98074,47.622,-122.059,2390,7500,9,23,2014,UNK,10,8281
9406500540,6/30/2014,243000.0,2,1.5,1068,1758,2.0,0.0,0.0,3,7,1068,0,1990,0,98028,47.7527,-122.244,1078,1315,6,30,2014,UNK,-10,443
6071800410,12/1/2014,500000.0,3,1.5,2220,8994,1.0,0.0,0.0,4,8,1110,1110,1962,0,98006,47.5473,-122.17200000000001,2220,8994,12,1,2014,UNK,0,0
2122049013,5/13/2015,204750.0,2,1.0,880,7575,1.0,0.0,0.0,4,7,880,0,1942,0,98198,47.3757,-122.304,1800,7575,5,13,2015,UNK,-920,0
5470100220,9/9/2014,222000.0,3,1.5,1310,9273,1.0,0.0,0.0,4,7,1310,0,1968,0,98042,47.3683,-122.147,1710,9600,9,9,2014,UNK,-400,-327
6623400246,5/23/2014,200000.0,4,1.0,1350,11507,1.0,0.0,0.0,3,7,1350,0,1966,0,98055,47.4269,-122.197,1320,25675,5,23,2014,UNK,30,-14168
3918400028,10/21/2014,367000.0,3,2.25,1400,1320,3.0,0.0,2.0,3,8,1400,0,2006,0,98133,47.7147,-122.35600000000001,1490,1449,10,21,2014,N,-90,-129
1422700040,5/14/2015,183000.0,3,1.0,1170,7320,1.0,0.0,0.0,3,7,1170,0,1962,0,98188,47.4685,-122.28200000000001,2040,7320,5,14,2015,UNK,-870,0
7660100336,12/10/2014,300000.0,3,2.5,1020,1570,2.0,0.0,0.0,3,7,720,300,2004,0,98144,47.5871,-122.31700000000001,1470,1249,12,10,2014,N,-450,321
6145602240,8/19/2014,369000.0,3,1.75,1300,3844,1.0,0.0,0.0,3,7,1300,0,1985,0,98133,47.7024,-122.355,1290,3844,8,19,2014,UNK,10,0
7287100035,7/31/2014,380000.0,3,2.0,2010,16736,2.0,0.0,0.0,4,6,2010,0,1929,0,98133,47.7643,-122.352,1890,11477,7,31,2014,UNK,120,5259
5101405465,2/3/2015,463000.0,3,2.0,1590,5009,2.0,0.0,0.0,4,6,1590,0,1985,0,98125,47.7012,-122.322,1730,6380,2,3,2015,UNK,-140,-1371
3756500180,12/8/2014,475000.0,3,1.0,1470,9750,1.0,0.0,0.0,3,7,1470,0,1963,0,98034,47.7155,-122.194,1300,9750,12,8,2014,UNK,170,0
3750605620,3/24/2015,225000.0,3,1.75,1580,14400,1.0,0.0,0.0,4,7,1580,0,1981,0,98001,47.2598,-122.281,1480,9600,3,24,2015,UNK,100,4800
2473350790,5/11/2015,371000.0,3,1.75,1970,9512,1.0,0.0,0.0,3,8,1970,0,1968,0,98058,47.4545,-122.146,2250,10573,5,11,2015,UNK,-280,-1061
3389900965,8/27/2014,625000.0,3,2.5,2330,3141,2.0,0.0,0.0,3,8,2330,0,2003,0,98116,47.5622,-122.39200000000001,1980,5265,8,27,2014,UNK,350,-2124
1068000375,9/23/2014,3200000.0,6,5.0,7100,18200,2.5,0.0,0.0,3,13,5240,1860,1933,2002,98199,47.6427,-122.40799999999999,3130,6477,9,23,2014,Y,3970,11723
9407100730,1/29/2015,329000.0,3,1.75,1230,10725,1.0,0.0,0.0,3,7,1230,0,1980,0,98045,47.4431,-121.772,1250,10170,1,29,2015,UNK,-20,555
7618700112,2/10/2015,634000.0,3,1.75,2570,13000,2.0,0.0,0.0,4,7,2570,0,1962,0,98177,47.7705,-122.37100000000001,2570,8521,2,10,2015,UNK,0,4479
5104540360,11/7/2014,616000.0,4,2.5,3440,6915,2.0,0.0,0.0,3,10,3440,0,2006,0,98038,47.3538,-122.00399999999999,3200,6915,11,7,2014,N,240,0
1051000040,4/24/2015,1820000.0,3,2.25,3330,20053,2.0,0.0,0.0,3,9,3330,0,1968,0,98004,47.6395,-122.214,2870,20053,4,24,2015,UNK,460,0
2896400300,3/19/2015,435000.0,4,2.25,1780,2684,2.0,0.0,0.0,3,7,1780,0,2002,0,98072,47.7642,-122.149,1670,2426,3,19,2015,UNK,110,258
5003600120,4/15/2015,320000.0,4,2.5,2110,6295,2.0,0.0,0.0,3,8,2110,0,2000,0,98030,47.3641,-122.193,2720,6311,4,15,2015,UNK,-610,-16
6352600490,1/14/2015,820000.0,4,3.5,2770,8049,2.0,0.0,0.0,3,9,2770,0,2002,0,98074,47.6469,-122.081,3410,7447,1,14,2015,UNK,-640,602
3820350120,8/22/2014,310000.0,3,2.5,1590,3359,2.0,0.0,0.0,3,7,1590,0,2000,0,98019,47.7349,-121.986,1820,3383,8,22,2014,UNK,-230,-24
4235400097,12/2/2014,443750.0,3,2.25,1460,968,2.0,0.0,0.0,3,7,1140,320,2003,0,98199,47.6601,-122.4,1460,1531,12,2,2014,UNK,0,-563
2757000040,6/5/2014,795000.0,4,2.25,2070,13084,1.0,0.0,0.0,4,8,1700,370,1967,0,98040,47.5606,-122.22200000000001,2520,10180,6,5,2014,UNK,-450,2904
537000325,11/4/2014,475000.0,3,2.5,2420,36862,1.0,0.0,0.0,4,8,1530,890,1957,0,98003,47.3264,-122.30799999999999,1670,9046,11,4,2014,UNK,750,27816
9522100485,5/15/2014,585000.0,5,1.75,2000,3750,2.0,0.0,0.0,4,7,2000,0,1921,0,98103,47.6618,-122.355,1520,3750,5,15,2014,UNK,480,0
345700040,7/29/2014,315000.0,2,1.0,1010,7338,2.0,0.0,0.0,4,7,1010,0,1981,0,98056,47.5123,-122.19,1220,7719,7,29,2014,UNK,-210,-381
3904960910,9/17/2014,635000.0,4,2.5,3050,7238,2.0,0.0,0.0,3,8,3050,0,1989,0,98029,47.5772,-122.01299999999999,2580,7228,9,17,2014,UNK,470,10
1771000690,5/28/2014,305000.0,3,1.0,1160,11776,1.0,0.0,0.0,3,7,1160,0,1968,0,98077,47.7427,-122.074,1160,10050,5,28,2014,UNK,0,1726
1931300035,5/16/2014,785000.0,3,2.0,2180,5440,1.0,0.0,0.0,5,7,1100,1080,1904,0,98103,47.657,-122.345,1470,4109,5,16,2014,UNK,710,1331
2770601800,10/24/2014,525000.0,3,1.75,1560,6000,1.0,0.0,0.0,3,6,780,780,1944,0,98199,47.6501,-122.384,1560,1734,10,24,2014,UNK,0,4266
5309100515,1/20/2015,537000.0,4,1.75,1580,3635,1.0,0.0,0.0,4,7,790,790,1910,0,98117,47.6795,-122.37100000000001,1190,3638,1,20,2015,UNK,390,-3
984210850,2/17/2015,279950.0,3,1.75,1660,8303,1.0,0.0,0.0,3,7,1380,280,1974,0,98058,47.4366,-122.171,1740,8320,2,17,2015,UNK,-80,-17
924059233,12/8/2014,659000.0,4,2.0,2350,9329,2.0,0.0,0.0,3,8,2350,0,1977,0,98005,47.583,-122.17,1640,9403,12,8,2014,UNK,710,-74
5029451080,8/21/2014,203000.0,2,1.0,1440,6650,1.0,0.0,0.0,3,7,970,0,1980,0,98023,47.2896,-122.369,1600,6847,8,21,2014,UNK,-160,-197
4379400220,9/9/2014,782500.0,4,2.5,2930,7806,2.0,0.0,0.0,3,9,2930,0,2005,0,98074,47.6219,-122.024,2600,6051,9,9,2014,N,330,1755
5419800220,6/10/2014,250000.0,3,1.75,1590,7560,1.0,0.0,0.0,3,7,1130,460,1984,0,98031,47.4016,-122.18,1500,7560,6,10,2014,UNK,90,0
1839500065,8/5/2014,279000.0,3,1.0,1400,9450,1.0,0.0,0.0,4,7,1060,340,1955,0,98056,47.5051,-122.194,1400,8108,8,5,2014,UNK,0,1342
2525059172,11/25/2014,664000.0,6,2.5,3190,12196,2.0,0.0,0.0,4,8,3190,0,1979,0,98052,47.6309,-122.103,2790,13068,11,25,2014,UNK,400,-872
7159200040,9/17/2014,2900000.0,4,3.25,4580,4838,2.0,0.0,3.0,4,11,3080,1500,1991,0,98109,47.6305,-122.354,3540,6483,9,17,2014,UNK,1040,-1645
3812400107,3/30/2015,378500.0,4,2.0,1830,6000,1.0,0.0,0.0,5,7,1070,760,1953,0,98118,47.5453,-122.279,1830,5500,3,30,2015,UNK,0,500
2726079061,5/7/2014,535000.0,3,1.75,2720,149410,1.5,0.0,0.0,3,9,2720,0,1988,0,98014,47.7092,-121.89200000000001,2560,149410,5,7,2014,UNK,160,0
1270000040,7/16/2014,520000.0,2,1.0,1360,22508,1.0,0.0,0.0,3,7,1360,0,1932,0,98034,47.7101,-122.226,2830,12600,7,16,2014,UNK,-1470,9908
2113700115,5/4/2015,369950.0,3,2.0,1520,4000,1.0,0.0,0.0,5,6,800,720,1943,0,98106,47.53100000000001,-122.351,1430,4000,5,4,2015,UNK,90,0
824069113,9/24/2014,545000.0,3,2.25,2290,14585,2.0,0.0,0.0,3,8,2290,0,1981,0,98075,47.5874,-122.074,1660,36961,9,24,2014,UNK,630,-22376
8856920110,5/4/2015,360000.0,3,2.5,2150,14092,2.0,0.0,0.0,3,8,2150,0,1991,0,98058,47.4621,-122.12899999999999,2400,10699,5,4,2015,UNK,-250,3393
8146100410,8/5/2014,760000.0,3,1.5,1170,7645,1.0,0.0,0.0,4,7,1170,0,1955,0,98004,47.6077,-122.194,1870,7678,8,5,2014,UNK,-700,-33
5101400838,9/16/2014,450000.0,3,1.75,1830,5488,1.0,0.0,2.0,4,7,1010,820,1939,0,98115,47.6914,-122.309,1200,5488,9,16,2014,UNK,630,0
1088800850,5/2/2014,612500.0,4,2.5,2730,12261,2.0,0.0,0.0,3,9,2730,0,1991,0,98011,47.7419,-122.205,2730,10872,5,2,2014,UNK,0,1389
1061400360,7/1/2014,280000.0,3,1.0,1090,10710,1.0,0.0,0.0,4,7,1090,0,1962,0,98056,47.5,-122.169,1090,10440,7,1,2014,UNK,0,270
9545250110,4/14/2015,750000.0,3,2.5,2560,9182,2.0,0.0,0.0,3,9,2560,0,1993,0,98027,47.5361,-122.051,2800,8784,4,14,2015,UNK,-240,398
425400115,7/15/2014,237000.0,3,1.0,1160,6132,1.0,0.0,0.0,4,7,1160,0,1958,0,98056,47.5015,-122.17299999999999,1280,6132,7,15,2014,UNK,-120,0
2436700315,10/14/2014,441500.0,2,1.75,1010,4000,1.5,0.0,0.0,5,7,1010,0,1919,0,98105,47.6665,-122.287,1470,4000,10,14,2014,UNK,-460,0
1545803520,1/26/2015,251000.0,3,2.0,1650,7930,1.0,0.0,0.0,4,7,1650,0,1989,0,98038,47.3617,-122.05,1510,7930,1,26,2015,UNK,140,0
257000037,12/29/2014,200000.0,3,1.0,2120,31564,1.0,0.0,0.0,3,7,1220,900,1942,0,98168,47.4938,-122.29799999999999,1790,11571,12,29,2014,UNK,330,19993
5016000315,6/16/2014,332000.0,1,1.0,960,2640,1.0,0.0,0.0,3,7,760,200,1908,0,98112,47.6223,-122.294,1620,3759,6,16,2014,UNK,-660,-1119
6300500477,8/26/2014,401500.0,3,2.5,1509,1114,3.0,0.0,0.0,3,8,1509,0,2014,0,98133,47.7048,-122.34,1509,2431,8,26,2014,N,0,-1317
4022905172,9/26/2014,585000.0,4,1.75,2270,27122,1.0,0.0,0.0,5,8,1300,970,1957,0,98155,47.7637,-122.281,2380,11822,9,26,2014,UNK,-110,15300
7300000650,7/2/2014,340000.0,4,2.5,1954,4805,2.0,0.0,0.0,3,8,1954,0,2005,0,98055,47.4297,-122.19,1714,3259,7,2,2014,N,240,1546
8682282070,1/12/2015,920000.0,3,3.5,2800,7694,1.0,0.0,0.0,3,9,2800,0,2005,0,98053,47.7095,-122.022,2420,7694,1,12,2015,N,380,0
7812801115,6/13/2014,153000.0,3,1.0,1270,6405,1.5,0.0,0.0,3,6,1270,0,1944,0,98178,47.4959,-122.241,1110,6405,6,13,2014,UNK,160,0
9269750690,1/5/2015,299950.0,4,2.25,1810,7601,1.0,0.0,0.0,3,7,1080,730,1986,0,98023,47.2857,-122.35799999999999,1570,7601,1,5,2015,UNK,240,0
1402620120,5/12/2015,440000.0,4,2.5,2410,7517,2.0,0.0,0.0,3,8,2410,0,1983,0,98058,47.4388,-122.14200000000001,2420,8095,5,12,2015,UNK,-10,-578
3793501390,9/15/2014,293000.0,3,2.5,1690,17383,2.0,0.0,0.0,3,7,1690,0,2003,0,98038,47.3691,-122.031,2610,7999,9,15,2014,UNK,-920,9384
9282800065,3/29/2015,203000.0,3,1.75,1190,6000,1.0,0.0,0.0,3,7,1190,0,1952,0,98178,47.5026,-122.236,1200,6000,3,29,2015,UNK,-10,0
1921059310,3/20/2015,193000.0,2,1.75,1280,6774,1.0,0.0,0.0,3,7,1280,0,1991,0,98002,47.2925,-122.219,1450,7810,3,20,2015,UNK,-170,-1036
109000040,3/16/2015,305000.0,3,1.75,1460,7862,1.0,0.0,0.0,3,7,1460,0,1965,0,98155,47.7755,-122.29899999999999,2200,9293,3,16,2015,UNK,-740,-1431
5101405331,5/2/2014,495000.0,4,1.75,1600,6380,1.0,0.0,0.0,3,8,1130,470,1959,0,98125,47.701,-122.306,1090,6380,5,2,2014,UNK,510,0
2044500142,9/2/2014,420000.0,3,1.75,1770,6000,1.0,0.0,0.0,3,7,1130,640,1952,0,98125,47.7135,-122.315,1900,7200,9,2,2014,UNK,-130,-1200
1837010040,9/5/2014,569500.0,4,2.5,2800,8190,1.0,0.0,0.0,3,8,1700,1100,1971,0,98177,47.7695,-122.368,2460,8165,9,5,2014,UNK,340,25
3905000540,5/15/2014,620000.0,4,2.5,2680,9185,2.0,0.0,0.0,3,9,2680,0,1989,0,98029,47.5738,-121.992,2810,8505,5,15,2014,UNK,-130,680
6071200375,12/11/2014,466000.0,3,1.75,1680,9460,1.0,0.0,0.0,4,7,1680,0,1959,0,98006,47.5525,-122.182,1690,9448,12,11,2014,UNK,-10,12
3756500610,3/24/2015,355500.0,3,1.0,1120,10032,1.0,0.0,0.0,3,7,1120,0,1962,0,98034,47.7182,-122.194,1210,9918,3,24,2015,UNK,-90,114
3885805035,5/8/2015,687500.0,2,1.0,1040,7200,1.0,0.0,0.0,4,6,1040,0,1955,0,98033,47.6823,-122.20299999999999,1640,7200,5,8,2015,UNK,-600,0
7525100530,4/11/2015,432100.0,3,2.25,1790,2240,2.0,0.0,0.0,4,8,1790,0,1975,0,98052,47.6343,-122.10600000000001,1780,2560,4,11,2015,UNK,10,-320
1324059048,7/21/2014,500000.0,3,2.5,2410,34848,1.5,0.0,0.0,3,8,2410,0,1976,0,98006,47.5694,-122.12,2420,16424,7,21,2014,UNK,-10,18424
3904921250,10/10/2014,690000.0,5,3.25,3370,7313,2.0,0.0,0.0,4,8,2140,1230,1988,0,98029,47.5632,-122.015,2990,7806,10,10,2014,UNK,380,-493
3331500485,1/2/2015,350000.0,2,1.0,800,5150,1.0,0.0,0.0,4,6,800,0,1949,0,98118,47.5525,-122.274,1280,5150,1,2,2015,UNK,-480,0
7338401759,6/10/2014,268000.0,2,1.0,1380,5000,1.0,0.0,0.0,3,7,870,510,1943,0,98108,47.5339,-122.29299999999999,1450,5000,6,10,2014,UNK,-70,0
3122069029,6/19/2014,120000.0,2,1.0,990,39964,1.0,0.0,0.0,2,4,990,0,1945,0,98042,47.3577,-122.085,1560,8990,6,19,2014,UNK,-570,30974
3797310150,2/18/2015,285000.0,4,2.5,1800,9229,2.0,0.0,0.0,3,7,1800,0,1994,0,98022,47.1927,-122.015,1970,9231,2,18,2015,UNK,-170,-2
2205500540,10/8/2014,365000.0,4,1.5,1820,12327,1.0,0.0,0.0,4,7,1380,440,1955,0,98006,47.5767,-122.14399999999999,1450,9256,10,8,2014,UNK,370,3071
7202310040,4/8/2015,635000.0,3,2.5,2620,6842,2.0,0.0,0.0,3,7,2620,0,2002,0,98053,47.6846,-122.037,2280,4800,4,8,2015,UNK,340,2042
3630120330,7/8/2014,630000.0,2,2.5,2290,3507,2.0,0.0,0.0,3,9,2290,0,2005,0,98029,47.5545,-122.00200000000001,2290,3640,7,8,2014,N,0,-133
4310700665,3/5/2015,450000.0,4,3.0,2200,4466,2.0,0.0,0.0,3,7,2200,0,1968,0,98103,47.7005,-122.339,1780,2250,3,5,2015,UNK,420,2216
7504001080,3/4/2015,590000.0,4,2.5,2940,12600,1.0,0.0,0.0,4,8,1850,1090,1974,0,98074,47.6294,-122.06200000000001,2030,11770,3,4,2015,UNK,910,830
2021200770,9/9/2014,895000.0,2,1.75,1700,3618,1.0,0.0,1.0,3,8,1260,440,1950,0,98199,47.6336,-122.397,2200,5000,9,9,2014,UNK,-500,-1382
2005600090,5/14/2014,160000.0,3,1.0,860,11900,1.0,0.0,0.0,4,6,860,0,1963,0,98030,47.3574,-122.186,1660,10248,5,14,2014,UNK,-800,1652
123000110,9/30/2014,520000.0,2,1.0,910,5000,1.0,0.0,0.0,3,7,910,0,1924,0,98107,47.6733,-122.37,1050,5000,9,30,2014,UNK,-140,0
2473372170,8/6/2014,432000.0,4,3.25,2820,13059,2.0,0.0,0.0,4,8,2820,0,1976,0,98058,47.4508,-122.132,2360,8600,8,6,2014,UNK,460,4459
7227500865,5/19/2014,141800.0,2,1.0,930,4743,1.0,0.0,0.0,4,5,930,0,1942,0,98056,47.4966,-122.18700000000001,930,4779,5,19,2014,UNK,0,-36
510001280,7/14/2014,980000.0,4,2.0,2190,4560,2.5,0.0,0.0,5,8,2190,0,1910,0,98103,47.662,-122.329,2190,4560,7,14,2014,UNK,0,0
3886903615,4/16/2015,1290000.0,4,2.5,3430,7200,2.0,0.0,0.0,3,9,3430,0,2014,0,98033,47.6842,-122.196,1530,7800,4,16,2015,N,1900,-600
439200035,11/17/2014,740000.0,4,2.75,2560,6900,1.0,0.0,0.0,3,8,1480,1080,1959,0,98115,47.68600000000001,-122.29700000000001,2600,7200,11,17,2014,UNK,-40,-300
4303200184,10/10/2014,230000.0,2,1.0,770,6450,1.0,0.0,0.0,4,6,770,0,1948,0,98106,47.53100000000001,-122.35799999999999,780,6063,10,10,2014,UNK,-10,387
9362000040,6/23/2014,3400000.0,3,4.5,5230,17826,2.0,1.0,4.0,3,10,3740,1490,2005,0,98040,47.5348,-122.243,3670,17826,6,23,2014,N,1560,0
4039701280,4/8/2015,954500.0,3,2.25,2440,9689,1.0,0.0,2.0,4,8,1830,610,1974,0,98008,47.6141,-122.111,2730,9689,4,8,2015,UNK,-290,0
9828201202,3/16/2015,622000.0,3,1.5,1650,3150,1.5,0.0,0.0,4,8,1650,0,1929,0,98122,47.6156,-122.29700000000001,1650,4500,3,16,2015,UNK,0,-1350
2734100835,3/3/2015,90000.0,1,1.0,780,4000,1.0,0.0,0.0,3,5,780,0,1905,0,98108,47.5424,-122.321,1150,4000,3,3,2015,UNK,-370,0
6749700110,10/29/2014,342000.0,3,3.0,1260,1634,3.0,0.0,0.0,3,8,1260,0,1998,0,98103,47.696999999999996,-122.34899999999999,1260,1135,10,29,2014,UNK,0,499
3832060940,7/29/2014,305000.0,4,2.5,2320,4683,2.0,0.0,0.0,3,7,2320,0,2007,0,98042,47.3349,-122.059,2230,5750,7,29,2014,N,90,-1067
2214800110,8/20/2014,259900.0,4,2.75,1560,8820,1.0,0.0,3.0,3,7,1060,500,1979,0,98001,47.3382,-122.257,2140,7800,8,20,2014,UNK,-580,1020
1909600115,8/27/2014,420000.0,3,2.0,2330,6346,1.5,0.0,0.0,3,6,1600,730,1934,2014,98146,47.5135,-122.38,1380,8400,8,27,2014,Y,950,-2054
40000553,3/4/2015,250000.0,2,1.0,1400,19570,1.5,0.0,0.0,3,6,1100,300,1929,0,98168,47.4724,-122.271,2250,6500,3,4,2015,UNK,-850,13070
7686203195,3/23/2015,249950.0,3,1.5,1450,6875,1.0,0.0,0.0,4,7,1450,0,1961,0,98198,47.4205,-122.316,1270,8000,3,23,2015,UNK,180,-1125
2923059064,2/17/2015,199000.0,2,1.0,1140,15120,1.0,0.0,0.0,4,6,990,150,1932,0,98055,47.4521,-122.196,2320,11250,2,17,2015,UNK,-1180,3870
2895600090,4/7/2015,355200.0,3,1.0,1120,7320,1.0,0.0,0.0,4,7,1120,0,1954,0,98146,47.5103,-122.382,1410,6328,4,7,2015,UNK,-290,992
4019301386,9/9/2014,425000.0,3,1.5,1970,13709,1.0,0.0,0.0,4,7,1680,290,1955,0,98155,47.7562,-122.277,2200,16536,9,9,2014,UNK,-230,-2827
7199360100,11/12/2014,379500.0,3,1.0,1110,7128,1.0,0.0,0.0,3,7,1110,0,1980,0,98052,47.6968,-122.124,1510,7107,11,12,2014,UNK,-400,21
1241500032,8/19/2014,860000.0,4,2.5,3070,6923,2.0,0.0,0.0,3,9,3070,0,2009,0,98033,47.669,-122.17200000000001,2190,9218,8,19,2014,N,880,-2295
9558020610,5/12/2014,335000.0,3,2.5,1940,4927,2.0,0.0,0.0,3,8,1940,0,2004,0,98058,47.4479,-122.12,2070,4892,5,12,2014,N,-130,35
2050100450,11/5/2014,865000.0,3,2.5,3050,12558,2.0,0.0,0.0,3,10,3050,0,1997,0,98074,47.6549,-122.089,3543,12558,11,5,2014,UNK,-493,0
1250200600,4/8/2015,390000.0,3,1.0,1240,3600,1.5,0.0,0.0,3,7,1240,0,1902,0,98144,47.5986,-122.29799999999999,1680,3600,4,8,2015,UNK,-440,0
9325200110,9/9/2014,569950.0,5,4.25,3380,7805,2.0,0.0,0.0,3,8,3380,0,2014,0,98148,47.4349,-122.32799999999999,2790,7805,9,9,2014,N,590,0
293850040,2/5/2015,495500.0,3,2.5,3190,7828,2.0,0.0,0.0,3,9,3190,0,2006,0,98059,47.5047,-122.14399999999999,2970,7828,2,5,2015,N,220,0
3723800097,12/11/2014,476500.0,4,1.75,1670,10200,1.0,0.0,0.0,3,7,1390,280,1953,0,98118,47.5524,-122.26700000000001,1720,6860,12,11,2014,UNK,-50,3340
7788400180,8/12/2014,261000.0,3,1.0,1660,11200,1.0,0.0,0.0,3,7,1660,0,1957,0,98056,47.5121,-122.16799999999999,1380,10875,8,12,2014,UNK,280,325
2206700215,8/22/2014,375000.0,4,2.0,2070,9822,1.0,0.0,0.0,5,7,2070,0,1955,0,98006,47.566,-122.14,1300,9572,8,22,2014,UNK,770,250
2206700215,4/22/2015,550000.0,4,2.0,2070,9822,1.0,0.0,0.0,5,7,2070,0,1955,0,98006,47.566,-122.14,1300,9572,4,22,2015,UNK,770,250
603001050,7/23/2014,230000.0,2,1.0,1430,4000,1.0,0.0,0.0,3,7,930,500,1949,0,98118,47.5233,-122.28399999999999,1110,4000,7,23,2014,UNK,320,0
3583400120,2/4/2015,526750.0,5,2.5,2270,10700,1.0,0.0,0.0,4,8,1570,0,1963,0,98028,47.74100000000001,-122.256,2020,10230,2,4,2015,UNK,250,470
3886903155,3/4/2015,606000.0,3,2.0,1980,7680,1.5,0.0,0.0,4,6,1070,910,1911,0,98033,47.6839,-122.195,1330,8704,3,4,2015,UNK,650,-1024
9485910100,4/24/2015,368500.0,4,2.75,2500,26400,1.0,0.0,0.0,3,8,1780,720,1977,0,98031,47.3444,-122.084,2180,31900,4,24,2015,UNK,320,-5500
3223039089,9/29/2014,275000.0,3,1.0,1230,171190,1.0,0.0,0.0,3,7,1230,0,1973,0,98070,47.4397,-122.46,1550,15450,9,29,2014,UNK,-320,155740
2596300035,4/22/2015,342000.0,4,1.0,1390,9023,1.5,0.0,0.0,3,7,1390,0,1955,0,98155,47.7754,-122.296,1760,9023,4,22,2015,UNK,-370,0
9542801120,3/27/2015,278100.0,4,1.75,2120,8520,1.0,0.0,0.0,3,7,1600,520,1978,0,98023,47.302,-122.37299999999999,2160,8400,3,27,2015,UNK,-40,120
8150600195,10/28/2014,450000.0,4,2.75,1540,4840,1.0,0.0,2.0,4,7,850,690,1929,0,98126,47.5491,-122.375,1180,4840,10,28,2014,UNK,360,0
6806100040,8/25/2014,349950.0,4,2.5,2000,5006,2.0,0.0,0.0,3,7,2000,0,2005,0,98058,47.466,-122.147,2410,4889,8,25,2014,N,-410,117
8857640040,4/10/2015,425000.0,4,2.5,2400,6053,2.0,0.0,0.0,3,8,2400,0,2001,0,98038,47.3869,-122.03299999999999,2460,6519,4,10,2015,UNK,-60,-466
2138000120,6/26/2014,435000.0,4,2.75,2110,8751,1.0,0.0,0.0,3,7,1510,600,1962,0,98011,47.7617,-122.215,1660,10295,6,26,2014,UNK,450,-1544
4022902260,6/26/2014,460000.0,4,2.5,2550,19017,1.0,0.0,0.0,4,7,1300,1250,1961,0,98155,47.7682,-122.28399999999999,2080,21100,6,26,2014,UNK,470,-2083
2225300149,12/22/2014,323000.0,4,1.75,1440,8114,1.0,0.0,0.0,4,7,1440,0,1963,0,98155,47.7639,-122.33200000000001,1940,7208,12,22,2014,UNK,-500,906
3438500880,4/30/2015,325000.0,2,1.0,810,6827,1.0,0.0,0.0,3,6,810,0,1944,0,98106,47.5495,-122.35700000000001,990,6827,4,30,2015,UNK,-180,0
1646502165,8/13/2014,480000.0,2,1.75,1170,4635,1.0,0.0,0.0,4,6,690,480,1924,0,98117,47.6842,-122.359,1240,4120,8,13,2014,UNK,-70,515
9541600110,4/30/2015,1330000.0,3,2.5,3590,8400,1.0,0.0,0.0,3,9,2950,640,1958,2007,98005,47.595,-122.17299999999999,1620,7875,4,30,2015,Y,1970,525
3348401095,4/27/2015,210000.0,4,1.75,2090,6485,1.0,0.0,0.0,3,7,1280,810,1956,0,98178,47.4958,-122.265,2190,9600,4,27,2015,UNK,-100,-3115
7579200915,4/1/2015,920000.0,5,4.5,3820,5750,2.0,0.0,3.0,3,9,2830,990,2000,0,98116,47.5581,-122.385,1750,5750,4,1,2015,UNK,2070,0
2126049096,12/2/2014,399000.0,3,1.0,1460,8290,1.0,0.0,0.0,3,8,1460,0,1959,0,98125,47.7246,-122.3,1470,8290,12,2,2014,UNK,-10,0
6021500025,8/18/2014,631750.0,3,1.75,2360,4063,1.0,0.0,0.0,5,7,1180,1180,1940,0,98117,47.6902,-122.382,1660,4063,8,18,2014,UNK,700,0
8945000910,3/26/2015,184000.0,3,1.0,1100,8680,1.0,0.0,0.0,3,6,1100,0,1962,0,98023,47.3072,-122.363,1100,9220,3,26,2015,UNK,0,-540
2473411130,4/16/2015,333000.0,4,2.5,2100,7208,2.0,0.0,0.0,3,8,2100,0,1974,0,98058,47.4478,-122.12799999999999,2060,7480,4,16,2015,UNK,40,-272
2781250900,6/20/2014,218000.0,2,2.0,1310,2841,2.0,0.0,0.0,3,6,1310,0,2004,0,98038,47.3502,-122.022,1360,2550,6,20,2014,N,-50,291
3330500925,2/24/2015,258305.0,2,1.5,750,2964,1.0,0.0,0.0,5,5,750,0,1919,0,98118,47.5518,-122.277,1350,3090,2,24,2015,UNK,-600,-126
9522100375,7/15/2014,775000.0,5,1.5,1720,5000,1.5,0.0,0.0,3,8,1720,0,1915,0,98103,47.6627,-122.355,1720,5000,7,15,2014,UNK,0,0
1826049362,6/11/2014,515000.0,3,2.5,3370,19585,2.0,0.0,0.0,3,7,3200,170,1951,0,98133,47.7388,-122.339,1730,9430,6,11,2014,UNK,1640,10155
1250200495,6/24/2014,455000.0,2,1.5,1200,1259,2.0,0.0,0.0,3,8,1000,200,2015,0,98144,47.6001,-122.29799999999999,1320,1852,6,24,2014,N,-120,-593
5662100110,2/18/2015,440000.0,3,2.5,1830,6807,2.5,0.0,0.0,5,7,1830,0,1954,0,98155,47.7613,-122.322,1340,6807,2,18,2015,UNK,490,0
2025049111,6/19/2014,1440000.0,3,3.5,3870,3819,2.0,0.0,0.0,3,11,2760,1110,2002,0,98102,47.6452,-122.31700000000001,2530,5500,6,19,2014,UNK,1340,-1681
7576700131,7/14/2014,850000.0,3,2.25,2220,3707,2.0,0.0,0.0,4,8,1620,600,1919,0,98122,47.617,-122.286,2030,4850,7,14,2014,UNK,190,-1143
4027701265,5/1/2015,480000.0,3,1.75,2920,21375,1.0,0.0,0.0,3,8,1850,1070,1961,0,98028,47.7666,-122.265,1540,8482,5,1,2015,UNK,1380,12893
3423059177,11/26/2014,420000.0,5,2.75,2540,27007,1.0,0.0,0.0,3,8,1520,1020,1980,0,98058,47.4326,-122.155,1800,26572,11,26,2014,UNK,740,435
3876312840,9/12/2014,408000.0,3,1.75,1970,7100,1.0,0.0,0.0,3,7,1590,0,1976,0,98072,47.7353,-122.17200000000001,1790,7455,9,12,2014,UNK,180,-355
6928600330,8/20/2014,278000.0,5,1.75,2170,9752,1.0,0.0,0.0,3,7,1100,0,1962,0,98003,47.3355,-122.331,1810,10609,8,20,2014,UNK,360,-857
5316100820,1/22/2015,1200000.0,3,3.0,2350,1620,2.0,0.0,0.0,3,9,1560,790,2001,0,98112,47.6308,-122.279,2000,4380,1,22,2015,UNK,350,-2760
1022059161,6/13/2014,454000.0,4,2.25,2630,39000,2.0,0.0,0.0,3,9,2630,0,1979,0,98042,47.4089,-122.149,2270,66647,6,13,2014,UNK,360,-27647
4134300175,4/17/2015,1850000.0,4,2.5,4120,14866,1.0,1.0,4.0,3,8,2070,2050,1965,0,98006,47.5571,-122.193,3620,19729,4,17,2015,UNK,500,-4863
7853301130,5/5/2015,499000.0,4,2.25,2440,5000,2.0,0.0,0.0,3,7,2440,0,2007,0,98065,47.5407,-121.89,2440,5212,5,5,2015,N,0,-212
6928000620,2/18/2015,590000.0,5,3.0,3480,6625,2.0,0.0,0.0,3,8,3480,0,2012,0,98059,47.4815,-122.15299999999999,2800,9400,2,18,2015,N,680,-2775
5680000750,7/30/2014,385000.0,3,3.5,1900,4805,2.0,0.0,0.0,3,8,1560,340,1999,0,98108,47.5686,-122.315,1360,4800,7,30,2014,UNK,540,5
333100265,9/24/2014,1250000.0,4,3.25,3160,10043,2.0,0.0,2.0,3,9,3160,0,2011,0,98034,47.7001,-122.238,3450,10043,9,24,2014,N,-290,0
3530490031,9/24/2014,202200.0,2,1.75,1330,2159,1.0,0.0,0.0,4,8,1330,0,1979,0,98198,47.3822,-122.32,1220,3679,9,24,2014,UNK,110,-1520
6400700230,3/11/2015,450000.0,3,2.25,1420,13468,1.0,0.0,0.0,3,7,960,460,1976,0,98033,47.6693,-122.176,1480,10980,3,11,2015,UNK,-60,2488
322069010,5/8/2015,435000.0,3,2.0,2570,233481,1.5,0.0,0.0,4,8,2570,0,1986,0,98038,47.4199,-122.03399999999999,2280,157687,5,8,2015,UNK,290,75794
2722059013,2/4/2015,550000.0,2,1.0,1270,43560,1.0,0.0,0.0,4,5,1270,0,1908,0,98042,47.3651,-122.165,1870,6960,2,4,2015,UNK,-600,36600
3878900815,5/4/2015,361000.0,3,2.25,2470,5650,1.0,0.0,2.0,3,7,1550,920,1973,0,98178,47.5072,-122.25200000000001,1660,5650,5,4,2015,UNK,810,0
2600010330,1/20/2015,760000.0,4,2.25,2590,12600,2.0,0.0,0.0,3,9,2590,0,1979,0,98006,47.5566,-122.162,2620,11050,1,20,2015,UNK,-30,1550
3889100027,6/16/2014,902000.0,4,2.5,3030,8507,2.0,0.0,0.0,3,9,3030,0,2003,0,98033,47.6675,-122.176,2570,8830,6,16,2014,UNK,460,-323
3505100297,4/11/2015,505000.0,3,1.75,1240,4550,1.5,0.0,0.0,4,7,1240,0,1951,0,98116,47.5803,-122.398,2110,5700,4,11,2015,UNK,-870,-1150
5560001130,2/25/2015,200000.0,3,1.0,1040,8925,1.0,0.0,0.0,4,6,1040,0,1961,0,98023,47.3265,-122.335,1040,8925,2,25,2015,UNK,0,0
1311910300,2/4/2015,260000.0,5,2.25,2320,6375,1.0,0.0,0.0,4,7,1270,1050,1967,0,98001,47.3351,-122.28200000000001,1760,7600,2,4,2015,UNK,560,-1225
7518505160,9/25/2014,417000.0,2,1.0,1190,5100,1.5,0.0,0.0,2,7,1190,0,1928,0,98117,47.6773,-122.382,1920,5100,9,25,2014,UNK,-730,0
2115510330,2/2/2015,287500.0,3,2.25,2030,8690,1.0,0.0,0.0,4,8,1360,670,1986,0,98023,47.3185,-122.391,1720,8800,2,2,2015,UNK,310,-110
3955500100,4/7/2015,450000.0,3,1.5,1390,10530,1.0,0.0,0.0,3,7,1390,0,1961,0,98033,47.7025,-122.196,1750,10530,4,7,2015,UNK,-360,0
2771104965,1/30/2015,825000.0,2,1.75,2050,4000,1.5,0.0,2.0,3,8,2050,0,1979,0,98119,47.6415,-122.37299999999999,1940,4000,1,30,2015,UNK,110,0
5317100530,8/27/2014,1480000.0,4,3.0,3050,6179,2.0,0.0,0.0,4,9,2330,720,1926,0,98112,47.6253,-122.28399999999999,3020,6505,8,27,2014,UNK,30,-326
3336002215,2/25/2015,319950.0,2,1.0,1240,5500,1.5,0.0,0.0,3,6,1240,0,1921,0,98118,47.5257,-122.26299999999999,1520,5500,2,25,2015,UNK,-280,0
9408300180,8/28/2014,682000.0,4,2.5,3030,30000,2.0,0.0,0.0,4,9,3030,0,1981,0,98072,47.7468,-122.11200000000001,2600,34932,8,28,2014,UNK,430,-4932
2770604575,5/6/2015,560000.0,3,1.75,1930,6000,1.0,0.0,0.0,3,8,1130,800,1956,0,98119,47.6516,-122.375,1870,6000,5,6,2015,UNK,60,0
7305900082,12/30/2014,350000.0,3,1.75,1490,10344,1.0,0.0,0.0,3,7,1490,0,1985,0,98155,47.7517,-122.32600000000001,1450,8632,12,30,2014,UNK,40,1712
8661000148,10/28/2014,270000.0,3,2.0,1510,10215,1.0,0.0,0.0,4,7,1510,0,1995,0,98022,47.2078,-122.00299999999999,1370,8902,10,28,2014,UNK,140,1313
7968460230,3/5/2015,284000.0,3,1.75,1320,35100,1.0,0.0,0.0,3,7,1320,0,1990,0,98092,47.312,-122.12899999999999,1660,35100,3,5,2015,UNK,-340,0
827000110,7/14/2014,308000.0,4,2.5,2330,4606,2.0,0.0,0.0,3,8,2330,0,2004,0,98031,47.3934,-122.184,2330,5783,7,14,2014,N,0,-1177
3390600025,5/29/2014,450000.0,4,2.0,2240,7725,1.0,0.0,0.0,5,7,1120,1120,1956,0,98106,47.5331,-122.365,1340,6300,5,29,2014,UNK,900,1425
1026069172,6/18/2014,540000.0,4,2.5,2050,34222,2.0,0.0,0.0,4,8,2050,0,1989,0,98077,47.7572,-122.022,2240,51400,6,18,2014,UNK,-190,-17178
1226039103,6/10/2014,380000.0,4,1.5,1680,11123,1.0,0.0,0.0,3,7,1130,550,1959,0,98177,47.7565,-122.361,1770,10103,6,10,2014,UNK,-90,1020
2125079054,2/24/2015,522500.0,4,2.75,2200,122403,1.5,0.0,0.0,3,7,2200,0,1971,0,98014,47.6301,-121.911,1710,74487,2,24,2015,UNK,490,47916
1545807810,10/21/2014,118000.0,1,1.0,670,7957,1.0,0.0,0.0,4,6,670,0,1978,0,98038,47.3594,-122.056,1600,7957,10,21,2014,UNK,-930,0
7205500120,4/23/2015,280400.0,4,1.75,1730,7210,1.0,0.0,0.0,4,7,1010,720,1968,0,98003,47.354,-122.315,1620,7210,4,23,2015,UNK,110,0
924069176,9/3/2014,710000.0,4,2.75,2710,41811,1.5,0.0,0.0,4,8,1690,0,1995,0,98075,47.5836,-122.046,2110,35656,9,3,2014,UNK,600,6155
4045500620,9/10/2014,720000.0,3,3.25,3410,25741,2.0,0.0,0.0,4,8,3410,0,1993,0,98014,47.6929,-121.868,1660,25865,9,10,2014,UNK,1750,-124
8146100325,5/5/2014,787000.0,3,1.75,1330,7500,1.0,0.0,0.0,3,8,1330,0,1961,0,98004,47.6074,-122.195,1690,7800,5,5,2014,UNK,-360,-300
8663240180,3/30/2015,537000.0,4,2.5,1990,2660,2.0,0.0,0.0,3,8,1990,0,2012,0,98034,47.732,-122.178,1990,2665,3,30,2015,N,0,-5
2087700115,11/3/2014,650000.0,2,1.5,1900,4450,1.0,0.0,0.0,5,7,1500,400,1916,0,98144,47.5834,-122.29299999999999,2130,5000,11,3,2014,UNK,-230,-550
7973202225,1/6/2015,154200.0,4,1.0,1310,8640,1.0,0.0,0.0,3,6,910,400,1948,0,98146,47.5104,-122.34200000000001,1310,8640,1,6,2015,UNK,0,0
2557000090,1/15/2015,238000.0,4,2.5,1690,7260,1.0,0.0,0.0,3,7,1080,610,1979,0,98023,47.3001,-122.368,1690,7700,1,15,2015,UNK,0,-440
3500100209,8/4/2014,285650.0,3,1.0,1040,8199,1.0,0.0,0.0,3,7,1040,0,1953,0,98155,47.7348,-122.302,1420,8200,8,4,2014,UNK,-380,-1
7234601166,8/7/2014,485500.0,2,1.5,1340,1286,2.0,0.0,0.0,3,8,1190,150,2006,0,98122,47.617,-122.309,1460,1245,8,7,2014,N,-120,41
3972900215,1/26/2015,315000.0,2,1.0,1120,7350,1.0,0.0,0.0,3,7,1120,0,1942,0,98155,47.7648,-122.31,1320,7545,1,26,2015,UNK,-200,-195
1924059029,6/17/2014,4670000.0,5,6.75,9640,13068,1.0,1.0,4.0,3,12,4820,4820,1983,2009,98040,47.556999999999995,-122.21,3270,10454,6,17,2014,Y,6370,2614
3900500110,11/17/2014,627000.0,3,2.0,2310,10525,2.0,0.0,0.0,5,7,2310,0,1965,0,98033,47.6727,-122.17399999999999,1430,10523,11,17,2014,UNK,880,2
5561000600,4/10/2015,525000.0,3,2.5,2190,34528,2.0,0.0,0.0,3,8,2190,0,1994,0,98027,47.4594,-121.986,2460,37901,4,10,2015,UNK,-270,-3373
3589500315,9/19/2014,526000.0,3,3.25,1220,1281,2.0,0.0,0.0,3,8,930,290,2014,0,98105,47.67,-122.31700000000001,1303,3810,9,19,2014,N,-83,-2529
3658700690,3/27/2015,480000.0,3,1.5,1200,3060,1.0,0.0,0.0,4,7,1060,140,1910,0,98115,47.678999999999995,-122.315,1410,3060,3,27,2015,UNK,-210,0
4054560120,10/8/2014,970000.0,3,3.5,3840,53696,2.0,0.0,0.0,3,9,3840,0,1996,0,98077,47.7322,-122.035,3810,35181,10,8,2014,UNK,30,18515
3918400123,8/11/2014,640000.0,4,2.5,2460,9973,1.0,0.0,0.0,4,8,1560,900,1965,0,98177,47.7133,-122.361,1830,7200,8,11,2014,UNK,630,2773
2592300450,6/27/2014,279000.0,3,2.5,1630,7950,1.0,0.0,0.0,3,8,1320,310,1985,0,98042,47.4224,-122.15899999999999,1650,7952,6,27,2014,UNK,-20,-2
123039424,7/10/2014,303000.0,2,2.0,970,9750,1.0,0.0,0.0,5,6,970,0,1940,0,98146,47.5073,-122.37200000000001,1850,9000,7,10,2014,UNK,-880,750
8068000730,6/25/2014,315000.0,4,2.0,1780,5336,1.5,0.0,0.0,5,6,930,0,1918,0,98178,47.5094,-122.26299999999999,1910,10304,6,25,2014,UNK,-130,-4968
7461420230,3/25/2015,336500.0,4,1.75,1760,7268,1.0,0.0,0.0,4,7,1080,680,1979,0,98058,47.4267,-122.148,1830,8786,3,25,2015,UNK,-70,-1518
1443501020,11/13/2014,163250.0,2,1.0,770,8150,1.0,0.0,0.0,3,6,770,0,1951,0,98118,47.5324,-122.275,1140,8550,11,13,2014,UNK,-370,-400
3798000165,2/18/2015,444950.0,3,1.0,1760,6927,1.0,0.0,0.0,3,7,1050,710,1962,0,98011,47.7623,-122.2,2060,9120,2,18,2015,UNK,-300,-2193
730000085,8/1/2014,285000.0,2,1.0,990,2446,2.0,0.0,0.0,3,7,990,0,1998,0,98144,47.5919,-122.29700000000001,1260,2805,8,1,2014,UNK,-270,-359
2061100265,3/17/2015,370000.0,2,1.0,1250,4960,1.0,0.0,0.0,3,7,940,310,1938,0,98115,47.6893,-122.325,2030,7440,3,17,2015,UNK,-780,-2480
1683900040,12/15/2014,330000.0,3,2.25,1440,5150,2.0,0.0,0.0,3,7,1440,0,1997,0,98106,47.5456,-122.35600000000001,1530,5238,12,15,2014,UNK,-90,-88
3959401880,8/20/2014,395000.0,2,2.0,1960,4018,1.0,0.0,0.0,5,7,980,980,1950,0,98108,47.5629,-122.32,1240,4641,8,20,2014,UNK,720,-623
2124049160,4/16/2015,440000.0,6,3.0,2510,5310,1.0,0.0,0.0,4,7,1460,1050,1944,0,98108,47.5533,-122.304,1390,5407,4,16,2015,UNK,1120,-97
7708180040,5/3/2014,625000.0,4,2.75,2920,6605,2.0,0.0,0.0,3,8,2920,0,2012,0,98059,47.4909,-122.14399999999999,3030,6605,5,3,2014,N,-110,0
1422300100,9/29/2014,435000.0,3,2.5,1730,46638,2.0,0.0,0.0,3,8,1730,0,1991,0,98045,47.4614,-121.709,1750,35508,9,29,2014,UNK,-20,11130
255550230,11/18/2014,299950.0,3,2.5,1570,2577,2.0,0.0,0.0,3,7,1570,0,2005,0,98019,47.7456,-121.984,1970,2952,11,18,2014,N,-400,-375
1370804480,9/29/2014,560000.0,2,1.75,970,4233,1.0,0.0,0.0,4,7,970,0,1944,0,98199,47.6384,-122.4,1340,4233,9,29,2014,UNK,-370,0
5104511590,5/20/2014,380000.0,4,3.0,2800,9764,2.0,0.0,0.0,3,8,2800,0,2002,0,98038,47.3543,-122.012,3610,8194,5,20,2014,UNK,-810,1570
1498302783,5/19/2014,333000.0,4,2.0,1580,7800,2.0,0.0,0.0,2,6,1580,0,1906,0,98144,47.5848,-122.302,1190,4440,5,19,2014,UNK,390,3360
1623800300,6/10/2014,499000.0,2,1.0,1220,3000,1.0,0.0,0.0,3,7,920,300,1926,0,98117,47.6823,-122.365,1270,3000,6,10,2014,UNK,-50,0
5649600266,2/24/2015,386000.0,3,1.5,1550,8000,1.0,0.0,0.0,3,6,1330,220,1980,0,98118,47.5536,-122.286,1150,5150,2,24,2015,UNK,400,2850
2968801075,9/22/2014,320600.0,3,2.0,1220,7620,1.0,0.0,0.0,3,6,720,500,1947,0,98166,47.4564,-122.352,1640,7620,9,22,2014,UNK,-420,0
1923039089,6/10/2014,285000.0,2,2.0,1651,18200,1.0,0.0,0.0,3,6,1651,0,1946,0,98070,47.4621,-122.461,1510,89595,6,10,2014,UNK,141,-71395
4006000183,9/9/2014,450000.0,7,4.0,3150,7800,2.0,0.0,0.0,3,8,3150,0,2013,0,98118,47.5259,-122.279,1880,6000,9,9,2014,N,1270,1800
9183700845,12/18/2014,175000.0,2,1.0,800,7150,1.0,0.0,0.0,3,5,800,0,1933,0,98030,47.3788,-122.22399999999999,1220,8019,12,18,2014,UNK,-420,-869
9558050360,4/21/2015,544800.0,5,2.75,3190,5857,2.0,0.0,0.0,3,9,3190,0,2004,0,98058,47.4575,-122.119,3100,5857,4,21,2015,N,90,0
1683600120,1/21/2015,220000.0,3,1.75,1720,7587,1.0,0.0,0.0,4,7,1140,580,1981,0,98092,47.3175,-122.182,1120,7287,1,21,2015,UNK,600,300
1604601570,9/5/2014,374000.0,2,2.25,1100,1695,2.0,0.0,0.0,3,9,1100,0,2009,0,98118,47.5663,-122.289,1100,3082,9,5,2014,N,0,-1387
2787460720,2/27/2015,200000.0,3,2.0,1010,7896,1.0,0.0,0.0,3,7,1010,0,1984,0,98031,47.4046,-122.181,1540,7896,2,27,2015,UNK,-530,0
2787460720,5/6/2015,259950.0,3,2.0,1010,7896,1.0,0.0,0.0,3,7,1010,0,1984,0,98031,47.4046,-122.181,1540,7896,5,6,2015,UNK,-530,0
6386700300,7/22/2014,255000.0,4,2.75,1760,9222,1.0,0.0,0.0,3,7,1140,620,1971,0,98023,47.3099,-122.36200000000001,1800,9222,7,22,2014,UNK,-40,0
2297400090,3/23/2015,447000.0,3,1.75,1400,6750,1.0,0.0,0.0,3,7,1040,360,1975,0,98034,47.717,-122.226,1860,7480,3,23,2015,UNK,-460,-730
2420069278,3/19/2015,287000.0,3,2.5,1820,8722,1.5,0.0,0.0,3,7,1820,0,1926,2008,98022,47.2137,-121.98899999999999,1480,12285,3,19,2015,Y,340,-3563
7276100145,9/30/2014,344950.0,3,2.0,1470,6950,1.0,0.0,0.0,5,6,1470,0,1932,0,98133,47.7619,-122.34299999999999,1660,5065,9,30,2014,UNK,-190,1885
2475900850,10/10/2014,212000.0,2,1.0,770,7000,1.0,0.0,0.0,3,6,770,0,1921,0,98024,47.5654,-121.89,1100,8777,10,10,2014,UNK,-330,-1777
3760100100,7/23/2014,425000.0,5,2.75,1340,11583,1.0,0.0,0.0,3,7,1190,150,1962,0,98034,47.708999999999996,-122.214,1950,10514,7,23,2014,UNK,-610,1069
7849202585,9/4/2014,170000.0,1,1.0,480,4560,1.0,0.0,0.0,3,5,480,0,1922,0,98065,47.5253,-121.82600000000001,890,4803,9,4,2014,UNK,-410,-243
6430500291,2/12/2015,565000.0,3,1.0,1260,4080,1.5,0.0,0.0,4,7,1260,0,1928,0,98103,47.6893,-122.354,1130,3876,2,12,2015,UNK,130,204
8151600701,6/23/2014,234000.0,2,1.0,870,11100,1.0,0.0,0.0,3,6,870,0,1940,0,98146,47.5038,-122.36399999999999,1370,10404,6,23,2014,UNK,-500,696
2597450620,10/9/2014,1510000.0,3,2.5,4010,12105,1.0,0.0,3.0,5,11,2600,1410,1983,0,98006,47.553999999999995,-122.15100000000001,4010,15081,10,9,2014,UNK,0,-2976
1099900120,1/26/2015,345000.0,3,2.5,2340,8414,1.0,0.0,0.0,3,7,1280,1060,1993,0,98188,47.4685,-122.265,2340,7268,1,26,2015,UNK,0,1146
7853340450,4/27/2015,415000.0,3,2.75,1770,3172,2.0,0.0,0.0,3,8,1770,0,2009,0,98065,47.5164,-121.87799999999999,1760,2891,4,27,2015,N,10,281
5652600065,10/10/2014,760000.0,5,1.75,2660,10637,1.5,0.0,0.0,5,7,1670,990,1922,0,98115,47.6945,-122.292,1570,6825,10,10,2014,UNK,1090,3812
6114400142,2/26/2015,484000.0,5,2.5,3600,20001,2.0,0.0,0.0,4,9,3600,0,1976,0,98166,47.4484,-122.339,2860,21780,2,26,2015,UNK,740,-1779
3630050180,9/26/2014,360000.0,2,1.75,1230,1107,2.0,0.0,0.0,3,8,1230,0,2006,0,98029,47.5475,-121.999,1380,1107,9,26,2014,N,-150,0
1853000300,2/24/2015,875000.0,3,2.75,3270,39586,1.5,0.0,0.0,3,11,3270,0,1988,0,98077,47.731,-122.07799999999999,3480,35998,2,24,2015,UNK,-210,3588
3585900785,5/14/2014,930000.0,3,2.5,3100,20553,1.0,0.0,0.0,3,10,3100,0,1954,0,98177,47.7635,-122.37700000000001,3000,22302,5,14,2014,UNK,100,-1749
1545801970,5/16/2014,250000.0,3,2.0,1900,6660,1.0,0.0,0.0,5,7,950,950,1966,0,98038,47.3594,-122.054,1690,8111,5,16,2014,UNK,210,-1451
7853340610,4/21/2015,394000.0,2,2.0,1750,2731,2.0,0.0,0.0,3,8,1750,0,2012,0,98065,47.5169,-121.87799999999999,1650,2731,4,21,2015,N,100,0
8562900590,1/22/2015,865000.0,4,3.5,3380,11270,2.0,0.0,1.0,3,9,2160,1220,2007,0,98074,47.6124,-122.06,2910,11214,1,22,2015,N,470,56
9422400035,9/12/2014,477500.0,2,2.0,2090,6000,2.0,0.0,1.0,3,7,2090,0,1918,1985,98116,47.5732,-122.413,1600,5400,9,12,2014,Y,490,600
9273200115,12/17/2014,1250000.0,4,2.75,4120,12500,1.0,0.0,4.0,4,8,2060,2060,1947,0,98116,47.5914,-122.385,3680,5000,12,17,2014,UNK,440,7500
3971700937,8/27/2014,270000.0,3,1.75,1260,7500,1.0,0.0,0.0,3,6,840,420,1947,0,98155,47.772,-122.323,1340,7500,8,27,2014,UNK,-80,0
1508210230,4/28/2015,567000.0,3,2.25,1800,6875,1.0,0.0,0.0,4,8,1230,570,1974,0,98052,47.6773,-122.11,1800,8749,4,28,2015,UNK,0,-1874
5249803550,6/2/2014,635000.0,3,2.5,1960,7200,1.0,0.0,0.0,4,8,980,980,1940,0,98118,47.5655,-122.27,1440,7200,6,2,2014,UNK,520,0
4218400100,9/11/2014,1870000.0,6,2.75,4460,6952,2.5,0.0,2.0,4,10,3460,1000,1930,0,98105,47.6626,-122.26899999999999,2750,4769,9,11,2014,UNK,1710,2183
1424100100,6/10/2014,183000.0,3,1.75,1330,9200,1.0,0.0,0.0,4,7,1330,0,1973,0,98092,47.2916,-122.185,1590,9200,6,10,2014,UNK,-260,0
7861000021,4/29/2015,309933.0,3,1.75,1820,78408,1.0,0.0,0.0,3,6,1220,600,1950,0,98042,47.3364,-122.12799999999999,1340,78408,4,29,2015,UNK,480,0
7856601110,3/25/2015,945800.0,4,2.75,3360,9100,1.0,0.0,0.0,4,8,1760,1600,1973,0,98006,47.5641,-122.149,2620,8925,3,25,2015,UNK,740,175
1121039059,5/22/2014,503000.0,2,1.75,2860,59612,1.0,1.0,4.0,3,8,1510,1350,1948,0,98023,47.3276,-122.389,2720,59612,5,22,2014,UNK,140,0
522059172,8/14/2014,220000.0,3,1.0,1460,10200,1.0,0.0,0.0,4,7,1460,0,1957,0,98055,47.4238,-122.197,1460,8500,8,14,2014,UNK,0,1700
8594400110,4/1/2015,335000.0,3,1.75,1900,36769,1.0,0.0,0.0,3,8,1900,0,1987,0,98092,47.3041,-122.066,1950,35847,4,1,2015,UNK,-50,922
9201000120,4/22/2015,650000.0,3,2.25,1790,9927,1.0,0.0,2.0,4,7,1240,550,1969,0,98075,47.5822,-122.07700000000001,2610,10700,4,22,2015,UNK,-820,-773
1822059440,2/3/2015,511000.0,4,3.5,3100,7600,2.0,0.0,0.0,3,10,3100,0,2005,0,98031,47.3892,-122.215,3350,7638,2,3,2015,N,-250,-38
1623089039,12/17/2014,275000.0,2,1.0,900,57063,1.0,0.0,0.0,4,6,900,0,1938,0,98045,47.4735,-121.786,1440,268765,12,17,2014,UNK,-540,-211702
452001570,4/3/2015,576250.0,2,1.75,1530,5000,2.0,0.0,0.0,4,7,1260,270,1989,0,98107,47.6755,-122.37,1470,5000,4,3,2015,UNK,60,0
1724069079,3/19/2015,1450000.0,2,3.25,2070,3128,2.0,1.0,3.0,3,9,1760,310,1988,0,98075,47.5686,-122.06,2740,3568,3,19,2015,UNK,-670,-440
3141600210,6/19/2014,186000.0,3,2.0,1340,4320,1.0,0.0,0.0,3,5,920,420,1912,1993,98002,47.299,-122.228,980,6480,6,19,2014,Y,360,-2160
1797500530,5/5/2015,655100.0,1,1.0,1220,4160,1.0,0.0,0.0,3,7,1220,0,1922,0,98115,47.6746,-122.315,1970,4200,5,5,2015,UNK,-750,-40
7300400580,5/5/2014,328000.0,4,2.5,2370,6500,2.0,0.0,0.0,3,9,2370,0,1998,0,98092,47.3328,-122.17299999999999,2590,6137,5,5,2014,UNK,-220,363
1826049442,3/10/2015,441000.0,3,2.5,1890,11036,1.0,0.0,0.0,3,8,1460,430,1973,0,98133,47.7426,-122.354,2040,7524,3,10,2015,UNK,-150,3512
2525000220,4/14/2015,370000.0,3,1.75,1480,7725,1.5,0.0,0.0,4,7,1480,0,1981,0,98059,47.483000000000004,-122.163,1720,8379,4,14,2015,UNK,-240,-654
191100665,4/13/2015,630000.0,2,1.0,1050,8382,1.0,0.0,0.0,3,7,1050,0,1959,0,98040,47.5627,-122.221,2400,9525,4,13,2015,UNK,-1350,-1143
5634500201,4/14/2015,470500.0,4,2.25,2070,14000,1.0,0.0,0.0,3,7,1720,350,1958,0,98028,47.7484,-122.23700000000001,1690,14444,4,14,2015,UNK,380,-444
795000405,4/13/2015,285950.0,2,1.0,1170,6000,1.0,0.0,0.0,3,6,1170,0,1948,0,98168,47.5033,-122.331,1130,7500,4,13,2015,UNK,40,-1500
1300300730,3/24/2015,698000.0,3,1.5,1090,7200,1.0,0.0,0.0,4,7,1090,0,1958,0,98040,47.5817,-122.241,2010,8982,3,24,2015,UNK,-920,-1782
1862900040,6/26/2014,268000.0,3,2.5,1650,6684,2.0,0.0,0.0,3,7,1650,0,1991,0,98031,47.4051,-122.184,1850,7048,6,26,2014,UNK,-200,-364
9279700150,2/12/2015,1630000.0,4,3.75,4410,8112,3.0,0.0,4.0,3,11,3570,840,2003,0,98116,47.5888,-122.39200000000001,2770,5750,2,12,2015,UNK,1640,2362
322059311,3/30/2015,355000.0,4,2.5,1780,15000,2.0,0.0,0.0,2,7,1780,0,1993,0,98058,47.4239,-122.15299999999999,2005,9680,3,30,2015,UNK,-225,5320
3333002710,9/17/2014,299000.0,3,1.0,1550,8778,1.0,0.0,0.0,3,7,1250,300,1952,0,98118,47.5413,-122.281,2120,7268,9,17,2014,UNK,-570,1510
1257200115,5/21/2014,1000000.0,4,2.75,2290,6120,2.0,0.0,0.0,4,7,2170,120,1926,0,98115,47.6746,-122.32700000000001,1910,4590,5,21,2014,UNK,380,1530
9183703045,4/20/2015,275000.0,4,2.0,2220,8229,1.5,0.0,0.0,4,7,2220,0,1958,0,98030,47.3722,-122.22,1660,8396,4,20,2015,UNK,560,-167
7899800905,5/3/2015,475000.0,3,1.75,1150,10240,1.0,0.0,0.0,3,6,1030,120,1918,0,98106,47.5222,-122.35700000000001,1270,2566,5,3,2015,UNK,-120,7674
7215400770,6/23/2014,260000.0,4,2.5,2000,37045,2.0,0.0,0.0,3,8,2000,0,1989,0,98042,47.3398,-122.071,2390,36868,6,23,2014,UNK,-390,177
1139000215,7/18/2014,416000.0,2,1.75,1270,7560,1.5,0.0,0.0,4,7,1270,0,1932,0,98133,47.7083,-122.35700000000001,1480,7560,7,18,2014,UNK,-210,0
9218400088,11/19/2014,495000.0,5,1.0,1810,11205,1.5,0.0,2.0,3,7,1810,0,1915,0,98178,47.5099,-122.262,1860,7965,11,19,2014,UNK,-50,3240
9455200596,1/14/2015,357500.0,3,1.0,1450,8100,1.0,0.0,0.0,3,6,1450,0,1952,0,98125,47.7027,-122.289,1450,7800,1,14,2015,UNK,0,300
510002506,8/25/2014,459500.0,2,1.5,1170,1079,3.0,0.0,0.0,3,7,1170,0,2003,0,98103,47.6607,-122.333,1170,1116,8,25,2014,UNK,0,-37
7212680850,9/3/2014,258000.0,3,2.5,1730,6930,2.0,0.0,0.0,3,8,1730,0,1994,0,98003,47.2621,-122.30799999999999,1780,6930,9,3,2014,UNK,-50,0
5229300085,4/11/2015,600000.0,3,2.25,2680,98445,1.0,0.0,0.0,5,8,2680,0,1962,0,98059,47.5015,-122.10799999999999,2340,98445,4,11,2015,UNK,340,0
7436000205,9/19/2014,665000.0,3,1.0,1260,24550,1.5,0.0,2.0,4,7,1260,0,1937,0,98136,47.5442,-122.396,2500,12320,9,19,2014,UNK,-1240,12230
425200205,10/3/2014,165000.0,3,1.5,1020,10152,1.0,0.0,0.0,5,6,1020,0,1959,0,98056,47.4971,-122.16799999999999,1320,8892,10,3,2014,UNK,-300,1260
7138200150,5/18/2014,297000.0,5,2.5,1970,8605,2.0,0.0,0.0,4,7,1970,0,1994,0,98022,47.1944,-122.01299999999999,1970,8460,5,18,2014,UNK,0,145
1782000180,10/23/2014,350000.0,2,1.0,830,5100,1.0,0.0,0.0,4,7,830,0,1942,0,98126,47.5259,-122.37899999999999,1220,5100,10,23,2014,UNK,-390,0
3623500205,5/13/2014,2450000.0,4,4.5,5030,11023,2.0,0.0,2.0,3,11,3250,1780,2008,0,98040,47.5722,-122.236,3640,11490,5,13,2014,N,1390,-467
1423200110,5/13/2015,180000.0,2,1.0,800,9450,1.0,0.0,0.0,3,6,800,0,1958,0,98058,47.4563,-122.184,1090,9450,5,13,2015,UNK,-290,0
797000256,4/7/2015,339950.0,3,1.75,1330,12092,1.0,0.0,0.0,4,6,720,610,1981,0,98168,47.5102,-122.324,1770,11770,4,7,2015,UNK,-440,322
9357000215,1/27/2015,365000.0,3,1.0,1030,4700,1.0,0.0,0.0,3,7,1030,0,1952,0,98146,47.5118,-122.37700000000001,1030,4700,1,27,2015,UNK,0,0
2526069095,6/5/2014,955000.0,4,4.25,5660,193593,2.0,0.0,0.0,3,10,4100,1560,2001,0,98019,47.7064,-121.98100000000001,3620,207141,6,5,2014,UNK,2040,-13548
6908200650,5/27/2014,732000.0,3,2.5,2330,1987,2.0,0.0,4.0,3,9,1410,920,2004,0,98107,47.6735,-122.405,2640,5250,5,27,2014,N,-310,-3263
5021900175,6/16/2014,500000.0,3,1.75,1540,10800,1.0,0.0,0.0,5,6,770,770,1947,0,98040,47.5763,-122.22200000000001,2020,10800,6,16,2014,UNK,-480,0
4038700220,2/13/2015,610000.0,6,2.75,2040,8560,1.0,0.0,2.0,4,7,1100,940,1961,0,98008,47.61600000000001,-122.115,2230,8560,2,13,2015,UNK,-190,0
9455200205,6/4/2014,525000.0,3,2.0,1540,7800,1.0,0.0,0.0,3,8,1540,0,2004,0,98125,47.7041,-122.288,1510,7800,6,4,2014,N,30,0
5379804470,6/17/2014,170000.0,4,1.0,1920,13787,1.0,0.0,0.0,4,7,1220,700,1966,0,98188,47.4502,-122.277,1490,11200,6,17,2014,UNK,430,2587
2517000150,7/13/2014,300000.0,3,2.5,1870,3439,2.0,0.0,0.0,3,7,1870,0,2005,0,98042,47.3992,-122.163,2190,4029,7,13,2014,N,-320,-590
9264930770,10/29/2014,389500.0,5,3.5,2960,12527,2.0,0.0,0.0,3,9,1940,1020,1986,0,98023,47.3134,-122.35,2210,10952,10,29,2014,UNK,750,1575
4197400043,2/19/2015,330000.0,3,1.5,1690,10250,1.0,0.0,0.0,4,7,1690,0,1955,0,98166,47.4531,-122.344,1990,11084,2,19,2015,UNK,-300,-834
2329800330,11/14/2014,269950.0,3,2.25,1610,7187,2.0,0.0,0.0,3,7,1610,0,1988,0,98042,47.3764,-122.117,1640,7194,11,14,2014,UNK,-30,-7
7899800450,8/28/2014,107000.0,2,1.0,670,4720,1.0,0.0,0.0,4,6,670,0,1948,0,98106,47.5243,-122.35799999999999,1480,4720,8,28,2014,UNK,-810,0
2895110062,12/2/2014,249000.0,3,1.0,1752,14626,2.0,0.0,2.0,3,8,1752,0,2005,0,98032,47.3755,-122.27799999999999,1800,9000,12,2,2014,N,-48,5626
3448001285,8/18/2014,442500.0,4,2.0,1540,5920,1.5,0.0,0.0,5,7,1540,0,1935,0,98125,47.7148,-122.301,1630,6216,8,18,2014,UNK,-90,-296
521079025,4/17/2015,579000.0,3,2.5,3160,286181,2.0,0.0,3.0,3,9,3160,0,2002,0,98010,47.3401,-121.946,2110,94663,4,17,2015,UNK,1050,191518
624069098,1/21/2015,621500.0,3,1.75,2570,39634,2.0,0.0,0.0,3,8,2570,0,1984,0,98075,47.596000000000004,-122.08,2990,39634,1,21,2015,UNK,-420,0
2946003580,11/19/2014,203000.0,3,1.5,1370,7500,1.0,0.0,0.0,3,7,1080,290,1958,0,98198,47.4167,-122.322,1400,7500,11,19,2014,UNK,-30,0
7227500450,9/9/2014,222900.0,2,1.0,860,5800,1.0,0.0,0.0,5,5,860,0,1942,0,98056,47.4979,-122.18299999999999,900,6000,9,9,2014,UNK,-40,-200
2322069100,4/9/2015,453000.0,2,1.5,1680,17400,1.5,0.0,0.0,3,7,1680,0,1991,0,98038,47.3836,-122.006,1610,27600,4,9,2015,UNK,70,-10200
2144800615,6/25/2014,190000.0,1,0.75,930,29258,1.0,0.0,0.0,3,6,930,0,1941,0,98178,47.4837,-122.236,2000,18321,6,25,2014,UNK,-1070,10937
1432900150,4/6/2015,320000.0,4,1.75,1820,7381,1.0,0.0,0.0,5,7,1150,670,1962,0,98058,47.4567,-122.171,1610,8462,4,6,2015,UNK,210,-1081
7942601810,12/10/2014,733500.0,3,1.5,2120,4370,1.5,0.0,0.0,3,8,2120,0,1904,0,98122,47.606,-122.307,1960,5120,12,10,2014,UNK,160,-750
7302900090,2/18/2015,555000.0,4,2.25,3330,21785,2.0,0.0,0.0,3,9,3330,0,1994,0,98059,47.4725,-122.13600000000001,3330,21796,2,18,2015,UNK,0,-11
2310050110,12/15/2014,364950.0,3,2.25,2520,6170,2.0,0.0,0.0,3,7,1850,670,2003,0,98038,47.3522,-122.042,2260,6967,12,15,2014,UNK,260,-797
6743700090,11/20/2014,490000.0,3,1.75,1560,9247,1.0,0.0,0.0,3,7,1160,400,1989,0,98033,47.6954,-122.17399999999999,1690,8772,11,20,2014,UNK,-130,475
3935900093,4/27/2015,688000.0,5,1.75,2250,13526,1.0,0.0,1.0,3,8,1350,0,1957,0,98125,47.7108,-122.279,2580,10078,4,27,2015,UNK,-330,3448
123039279,7/11/2014,165000.0,2,1.0,640,7768,1.0,0.0,0.0,3,6,640,0,1942,0,98106,47.515,-122.359,840,7424,7,11,2014,UNK,-200,344
4307350730,11/13/2014,506000.0,5,3.75,3880,8370,2.0,0.0,0.0,4,7,3880,0,2004,0,98056,47.4811,-122.179,2160,4651,11,13,2014,N,1720,3719
1954700610,12/9/2014,2190000.0,3,2.25,3360,7108,2.0,0.0,0.0,3,10,2770,590,1905,2004,98112,47.6187,-122.28399999999999,3450,8558,12,9,2014,Y,-90,-1450
8155500110,4/29/2015,754000.0,5,1.75,2350,7800,1.0,0.0,0.0,4,8,1510,840,1968,0,98008,47.6225,-122.10700000000001,2220,8400,4,29,2015,UNK,130,-600
7129303045,4/17/2015,949950.0,5,2.5,2340,1989,2.0,1.0,4.0,3,8,2340,0,1959,0,98118,47.5193,-122.257,2200,3230,4,17,2015,UNK,140,-1241
6021503451,8/22/2014,443600.0,3,2.5,1430,1056,3.0,0.0,0.0,3,8,1430,0,2003,0,98117,47.684,-122.38799999999999,1310,2135,8,22,2014,UNK,120,-1079
3793400360,8/14/2014,380600.0,3,2.5,1920,12244,2.0,0.0,0.0,3,7,1920,0,1998,0,98019,47.7256,-121.97,1920,11859,8,14,2014,UNK,0,385
7504101280,1/26/2015,722800.0,3,3.25,4330,14600,2.0,0.0,0.0,3,10,3630,700,1985,0,98074,47.6341,-122.044,3220,12672,1,26,2015,UNK,1110,1928
3331500121,2/10/2015,342888.0,2,1.0,790,5150,1.0,0.0,0.0,4,6,790,0,1948,0,98118,47.5528,-122.272,1460,5150,2,10,2015,UNK,-670,0
438000015,9/16/2014,555000.0,4,1.75,2350,5946,1.0,0.0,2.0,3,8,1350,1000,1957,0,98115,47.6879,-122.29799999999999,2060,6000,9,16,2014,UNK,290,-54
5366200205,6/3/2014,613000.0,3,2.5,1350,3068,2.0,0.0,0.0,3,7,1350,0,1991,0,98122,47.6099,-122.29299999999999,1900,4000,6,3,2014,UNK,-550,-932
2026049067,7/2/2014,480000.0,3,2.0,1470,10052,1.0,0.0,0.0,4,8,1470,0,1956,0,98125,47.726000000000006,-122.316,1480,9780,7,2,2014,UNK,-10,272
3885808035,3/16/2015,619500.0,6,1.5,1680,5202,1.5,0.0,0.0,2,7,1680,0,1911,0,98033,47.6798,-122.206,1890,5500,3,16,2015,UNK,-210,-298
1494300040,6/24/2014,437000.0,4,2.5,1890,8505,1.0,0.0,0.0,3,8,1290,600,1980,0,98052,47.6796,-122.115,1720,9600,6,24,2014,UNK,170,-1095
6071200195,4/8/2015,621000.0,4,2.5,2030,9905,1.0,0.0,0.0,4,8,2030,0,1959,0,98006,47.5518,-122.184,2130,10008,4,8,2015,UNK,-100,-103
1257202215,7/14/2014,810000.0,4,1.75,1760,4080,1.5,0.0,0.0,4,8,1760,0,1906,0,98103,47.675,-122.331,1760,6120,7,14,2014,UNK,0,-2040
5589300145,5/27/2014,415000.0,3,2.25,1950,8868,1.0,0.0,0.0,3,7,1350,600,1964,0,98155,47.7538,-122.31200000000001,1300,8880,5,27,2014,UNK,650,-12
293000145,11/13/2014,250000.0,4,1.0,1440,7404,1.0,0.0,0.0,3,6,1080,360,1918,0,98126,47.5328,-122.37899999999999,1620,7436,11,13,2014,UNK,-180,-32
4315701163,4/13/2015,585000.0,3,1.5,2230,6000,1.0,0.0,1.0,3,8,1260,970,1968,0,98136,47.5373,-122.395,2120,7200,4,13,2015,UNK,110,-1200
6163900981,5/28/2014,220000.0,3,1.0,1180,5002,1.5,0.0,0.0,3,7,1180,0,1946,0,98155,47.7529,-122.324,1470,8410,5,28,2014,UNK,-290,-3408
4157600120,4/22/2015,580000.0,5,2.5,2500,11900,1.0,0.0,0.0,3,7,1400,1100,1963,0,98007,47.5915,-122.132,2820,11900,4,22,2015,UNK,-320,0
3262301355,7/25/2014,1320000.0,3,2.75,2680,20104,1.0,0.0,0.0,5,9,1820,860,1964,0,98039,47.6304,-122.234,3060,19837,7,25,2014,UNK,-380,267
4376700330,8/1/2014,675000.0,4,2.5,2040,9225,1.0,0.0,0.0,5,8,1610,430,1968,0,98052,47.636,-122.09700000000001,1730,9225,8,1,2014,UNK,310,0
8691370330,10/29/2014,695000.0,4,2.75,2660,7389,2.0,0.0,0.0,3,9,2660,0,2002,0,98075,47.5993,-121.977,2820,7388,10,29,2014,UNK,-160,1
5078400090,12/9/2014,915000.0,5,2.75,2580,7630,1.0,0.0,0.0,4,7,1730,850,1954,0,98004,47.6226,-122.205,2040,7717,12,9,2014,UNK,540,-87
5272200040,11/21/2014,375000.0,3,1.0,1000,6947,1.0,0.0,0.0,4,7,1000,0,1947,0,98125,47.7142,-122.319,1000,6947,11,21,2014,UNK,0,0
2997800015,4/7/2015,500000.0,3,1.5,1330,1265,2.0,0.0,0.0,3,8,1140,190,2008,0,98116,47.5773,-122.40899999999999,1330,1264,4,7,2015,N,0,1
2780900220,12/26/2014,335000.0,2,2.0,1420,5185,1.0,0.0,0.0,3,7,1420,0,2004,0,98038,47.3543,-122.022,2140,4890,12,26,2014,N,-720,295
4463400195,7/18/2014,170000.0,2,1.0,1280,21750,1.5,0.0,0.0,5,6,1280,0,1912,0,98001,47.3096,-122.241,1520,21750,7,18,2014,UNK,-240,0
844001485,4/29/2015,320900.0,5,2.5,2200,8500,1.0,0.0,0.0,4,7,1400,800,1971,0,98010,47.3073,-122.006,1360,8855,4,29,2015,UNK,840,-355
8123450300,3/6/2015,508000.0,3,1.75,1800,8462,1.0,0.0,0.0,3,8,1440,360,1978,0,98052,47.6623,-122.141,2210,8436,3,6,2015,UNK,-410,26
7137800300,7/8/2014,228950.0,3,1.75,1200,9085,1.0,0.0,0.0,4,7,1200,0,1968,0,98023,47.2795,-122.353,1200,9085,7,8,2014,UNK,0,0
7972600910,5/7/2015,433000.0,4,2.0,1840,4760,1.5,0.0,0.0,4,6,1080,760,1929,0,98106,47.5297,-122.34899999999999,1170,5950,5,7,2015,UNK,670,-1190
7452500770,9/8/2014,267500.0,2,1.0,960,5150,1.0,0.0,0.0,5,6,960,0,1951,0,98126,47.5201,-122.37200000000001,1010,5000,9,8,2014,UNK,-50,150
5250300035,10/8/2014,910000.0,4,1.5,2890,9000,2.0,0.0,4.0,3,8,2090,800,1939,0,98118,47.5682,-122.274,2550,8400,10,8,2014,UNK,340,600
9517200610,3/3/2015,370000.0,3,1.75,1290,10117,1.0,0.0,0.0,3,7,1290,0,1984,0,98072,47.7598,-122.146,1770,11839,3,3,2015,UNK,-480,-1722
952004570,12/6/2014,320000.0,2,1.0,1140,3834,1.5,0.0,0.0,3,6,1140,0,1911,0,98126,47.5642,-122.37799999999999,1190,5750,12,6,2014,UNK,-50,-1916
579002600,10/1/2014,660000.0,3,1.75,1750,5200,1.0,0.0,1.0,4,8,1750,0,1956,0,98117,47.6995,-122.383,2060,5200,10,1,2014,UNK,-310,0
4351300978,8/26/2014,787888.0,4,2.25,2580,21115,2.0,0.0,0.0,4,9,2580,0,1977,0,98040,47.5566,-122.219,2690,10165,8,26,2014,UNK,-110,10950
1152700090,12/18/2014,329000.0,4,2.5,2650,5880,2.0,0.0,0.0,3,9,2650,0,2005,0,98042,47.3509,-122.165,2610,6490,12,18,2014,N,40,-610
3179100720,12/3/2014,602000.0,2,1.0,1470,6398,1.0,0.0,0.0,4,7,970,500,1941,0,98105,47.6716,-122.279,1950,6398,12,3,2014,UNK,-480,0
5628300015,11/6/2014,375000.0,3,2.0,1640,9750,1.0,0.0,0.0,3,7,1640,0,1959,0,98028,47.7425,-122.241,1340,9750,11,6,2014,UNK,300,0
1900000035,5/5/2015,212000.0,1,1.0,620,7620,1.0,0.0,0.0,3,6,620,0,1926,0,98166,47.4697,-122.34899999999999,1160,7620,5,5,2015,UNK,-540,0
1105000432,8/22/2014,224000.0,3,1.5,1440,8370,1.0,0.0,0.0,3,7,1440,0,1977,0,98118,47.5418,-122.275,1440,8370,8,22,2014,UNK,0,0
1402810150,3/10/2015,315500.0,3,2.0,1160,10079,1.0,0.0,0.0,3,7,1160,0,1986,0,98019,47.7341,-121.976,1130,10087,3,10,2015,UNK,30,-8
2163900028,1/28/2015,350000.0,2,1.0,1070,2880,1.0,0.0,0.0,3,7,1070,0,1902,0,98102,47.6261,-122.324,2030,2880,1,28,2015,UNK,-960,0
5409000110,5/6/2015,389000.0,6,4.5,3560,14010,2.0,0.0,0.0,3,7,3560,0,1989,0,98002,47.3244,-122.21700000000001,1710,11116,5,6,2015,UNK,1850,2894
8687800100,7/13/2014,285000.0,3,1.75,1720,13104,1.0,0.0,0.0,4,7,1720,0,1962,0,98168,47.4709,-122.26,1840,13104,7,13,2014,UNK,-120,0
8563300085,12/1/2014,425000.0,3,1.75,1530,9800,1.0,0.0,0.0,5,8,1530,0,1958,0,98133,47.7655,-122.336,1660,9800,12,1,2014,UNK,-130,0
7140200330,3/9/2015,190000.0,3,1.75,1270,7875,1.0,0.0,0.0,4,7,1270,0,1980,0,98030,47.3696,-122.17,1830,7210,3,9,2015,UNK,-560,665
2124069103,5/5/2015,374000.0,3,1.75,1510,18439,1.0,0.0,0.0,3,7,1510,0,1971,0,98027,47.5491,-122.046,1600,34326,5,5,2015,UNK,-90,-15887
1703401110,8/7/2014,292000.0,2,1.0,880,5500,1.0,0.0,0.0,3,6,880,0,1904,0,98118,47.5573,-122.289,1080,5500,8,7,2014,UNK,-200,0
6046400755,5/11/2015,475000.0,5,1.75,2020,5100,1.5,0.0,0.0,5,7,1320,700,1911,0,98103,47.6915,-122.345,1130,5100,5,11,2015,UNK,890,0
5309100450,3/30/2015,546500.0,3,2.5,1410,2675,1.0,0.0,0.0,3,7,820,590,1985,0,98117,47.6786,-122.37100000000001,1410,4013,3,30,2015,UNK,0,-1338
3883800011,11/5/2014,82000.0,3,1.0,860,10426,1.0,0.0,0.0,3,6,860,0,1954,0,98146,47.4987,-122.34100000000001,1140,11250,11,5,2014,UNK,-280,-824
3883800011,4/8/2015,219900.0,3,1.0,860,10426,1.0,0.0,0.0,3,6,860,0,1954,0,98146,47.4987,-122.34100000000001,1140,11250,4,8,2015,UNK,-280,-824
4315700175,6/12/2014,440000.0,3,1.0,1210,5750,1.5,0.0,0.0,4,7,1210,0,1910,0,98136,47.5403,-122.391,1160,5000,6,12,2014,UNK,50,750
221029019,4/28/2015,400000.0,3,2.5,2090,32718,2.0,1.0,4.0,3,7,1550,540,1919,0,98070,47.3338,-122.51100000000001,1200,192268,4,28,2015,UNK,890,-159550
4035900085,11/17/2014,453000.0,3,1.75,1430,20193,1.0,0.0,0.0,3,7,1430,0,1955,0,98006,47.5619,-122.18299999999999,2140,18364,11,17,2014,UNK,-710,1829
3438500781,8/12/2014,330000.0,6,3.25,2120,6893,1.0,0.0,0.0,4,7,1060,1060,1983,0,98106,47.5508,-122.355,1380,6986,8,12,2014,UNK,740,-93
8097000330,7/21/2014,359950.0,3,2.75,2540,8604,2.0,0.0,0.0,3,8,2540,0,1991,0,98092,47.3209,-122.185,2260,7438,7,21,2014,UNK,280,1166
8677300720,6/17/2014,616000.0,4,2.5,2490,12929,2.0,0.0,0.0,3,9,2490,0,1983,0,98074,47.6161,-122.021,2440,12929,6,17,2014,UNK,50,0
3644100072,11/7/2014,245000.0,2,1.0,670,2356,1.0,0.0,0.0,5,6,670,0,1960,0,98144,47.5918,-122.295,1220,1740,11,7,2014,UNK,-550,616
1453602284,11/3/2014,296000.0,2,2.0,1320,2040,3.0,0.0,0.0,3,7,1320,0,1997,0,98125,47.7224,-122.291,1430,2040,11,3,2014,UNK,-110,0
4365700450,11/6/2014,193000.0,2,1.0,950,9000,1.0,0.0,0.0,3,6,950,0,1924,0,98106,47.5219,-122.361,1000,8280,11,6,2014,UNK,-50,720
9268200315,8/28/2014,456000.0,3,2.0,1870,8442,1.5,0.0,0.0,5,7,1060,810,1927,0,98117,47.6964,-122.365,1640,6174,8,28,2014,UNK,230,2268
4358700141,4/27/2015,480000.0,4,1.75,1840,9250,1.0,0.0,0.0,4,7,980,860,1956,0,98133,47.708,-122.337,1520,9250,4,27,2015,UNK,320,0
4310701577,5/9/2014,382000.0,3,3.25,1410,1253,3.0,0.0,0.0,3,8,1410,0,2005,0,98103,47.6981,-122.34,1410,1253,5,9,2014,N,0,0
9828200762,6/28/2014,650000.0,2,1.0,1050,2542,1.0,0.0,0.0,3,7,880,170,1904,0,98122,47.6172,-122.29799999999999,1620,1809,6,28,2014,UNK,-570,733
2026049097,11/25/2014,431750.0,2,2.0,1400,10052,1.0,0.0,0.0,3,8,1400,0,1957,0,98125,47.7262,-122.316,1400,8785,11,25,2014,UNK,0,1267
6639900219,5/11/2015,419900.0,3,2.5,1630,1755,2.0,0.0,0.0,3,8,1320,310,1997,0,98033,47.691,-122.176,1920,14550,5,11,2015,UNK,-290,-12795
2521039066,12/29/2014,315000.0,3,2.0,1900,9513,1.0,0.0,0.0,3,8,1900,0,1995,0,98023,47.2843,-122.35700000000001,1790,8028,12,29,2014,UNK,110,1485
5649300120,4/20/2015,597500.0,4,3.0,1890,35280,1.0,0.0,0.0,3,9,1510,380,1979,0,98052,47.7112,-122.09899999999999,2730,34525,4,20,2015,UNK,-840,755
1774230300,3/6/2015,615000.0,3,2.5,2980,43301,1.0,0.0,0.0,4,8,1930,1050,1978,0,98077,47.7631,-122.09299999999999,2890,35915,3,6,2015,UNK,90,7386
7313200120,10/31/2014,605000.0,4,3.25,2885,33671,2.0,0.0,0.0,4,8,2885,0,1984,0,98027,47.5174,-122.046,1910,16000,10,31,2014,UNK,975,17671
4137010540,4/1/2015,220000.0,3,2.5,1980,11900,2.0,0.0,0.0,3,8,1980,0,1990,0,98092,47.2656,-122.21700000000001,2130,9933,4,1,2015,UNK,-150,1967
7844200120,4/13/2015,340000.0,4,2.5,3020,8750,1.0,0.0,0.0,3,8,1710,1310,1960,0,98188,47.4298,-122.29,1900,8750,4,13,2015,UNK,1120,0
1923099058,10/15/2014,620000.0,4,2.5,2980,210395,2.0,0.0,0.0,3,9,2980,0,2001,0,98045,47.4575,-121.70700000000001,2530,45596,10,15,2014,UNK,450,164799
7922710690,5/19/2014,602000.0,5,1.75,3290,11900,1.5,0.0,0.0,3,8,3290,0,1973,0,98052,47.6626,-122.141,2210,8549,5,19,2014,UNK,1080,3351
2624049165,5/13/2014,575000.0,3,1.75,1580,11750,1.0,0.0,0.0,4,7,1180,400,1951,0,98118,47.5368,-122.265,2150,11750,5,13,2014,UNK,-570,0
7575600100,5/2/2014,285000.0,3,2.5,2090,10834,1.0,0.0,0.0,4,8,1360,730,1987,0,98003,47.3537,-122.303,1750,8595,5,2,2014,UNK,340,2239
3450400330,2/20/2015,306500.0,3,1.5,1100,8140,1.0,0.0,0.0,4,7,1100,0,1965,0,98059,47.5004,-122.162,1430,7700,2,20,2015,UNK,-330,440
4307300930,1/2/2015,325000.0,3,2.5,1870,3480,2.0,0.0,0.0,3,7,1870,0,2002,0,98056,47.4831,-122.18299999999999,2160,3480,1,2,2015,UNK,-290,0
3288301030,3/19/2015,623000.0,3,2.75,2390,21804,1.0,0.0,0.0,3,8,1450,940,1973,0,98034,47.7339,-122.18299999999999,2390,10136,3,19,2015,UNK,0,11668
5466350120,3/11/2015,256500.0,3,2.0,1320,8568,1.0,0.0,0.0,3,7,1320,0,1993,0,98042,47.3904,-122.164,1600,8463,3,11,2015,UNK,-280,105
3791410210,11/17/2014,473000.0,5,3.5,3430,6872,2.0,0.0,0.0,3,10,2830,600,2002,0,98031,47.4065,-122.20700000000001,3650,6600,11,17,2014,UNK,-220,272
1795900120,10/29/2014,549000.0,3,2.5,2250,9235,2.0,0.0,0.0,3,8,2250,0,1985,0,98052,47.7268,-122.105,2290,8187,10,29,2014,UNK,-40,1048
8656300385,3/17/2015,305000.0,3,1.0,1710,19115,1.0,0.0,0.0,3,6,1710,0,1986,0,98014,47.65600000000001,-121.913,1650,15144,3,17,2015,UNK,60,3971
6649250410,2/4/2015,317000.0,4,2.5,2160,8049,2.0,0.0,0.0,3,9,2160,0,1988,0,98001,47.3337,-122.26,2490,8995,2,4,2015,UNK,-330,-946
1426049054,7/1/2014,450000.0,3,1.75,1400,13775,1.0,0.0,0.0,3,8,1400,0,1963,0,98028,47.7413,-122.259,2200,10450,7,1,2014,UNK,-800,3325
7841300535,4/9/2015,225000.0,2,2.5,1560,5333,1.0,0.0,0.0,3,5,780,780,1947,0,98055,47.4749,-122.213,1010,4800,4,9,2015,UNK,550,533
2867700035,2/12/2015,500000.0,5,2.0,2300,7897,2.5,0.0,0.0,4,8,2300,0,1956,0,98133,47.7556,-122.35600000000001,2030,7902,2,12,2015,UNK,270,-5
2658000215,8/12/2014,207000.0,2,1.0,820,4860,1.0,0.0,0.0,5,6,820,0,1955,0,98118,47.5298,-122.271,1240,6000,8,12,2014,UNK,-420,-1140
7100000120,8/18/2014,474900.0,3,1.0,1630,8308,1.5,0.0,0.0,3,7,1630,0,1948,0,98146,47.5075,-122.37799999999999,1170,8308,8,18,2014,UNK,460,0
200300210,7/1/2014,515000.0,3,2.5,2010,7200,2.0,0.0,0.0,3,8,2010,0,1994,0,98028,47.7372,-122.223,1970,7202,7,1,2014,UNK,40,-2
1868903130,2/12/2015,542000.0,4,1.0,1540,5000,1.5,0.0,0.0,4,7,1090,450,1922,0,98115,47.6754,-122.294,1590,5000,2,12,2015,UNK,-50,0
7385310040,6/5/2014,725000.0,4,2.75,2420,10962,1.0,0.0,0.0,3,8,1530,890,1977,0,98007,47.6218,-122.152,2620,13200,6,5,2014,UNK,-200,-2238
5104510210,3/9/2015,314950.0,3,2.5,1690,4533,2.0,0.0,0.0,3,7,1690,0,2003,0,98038,47.3575,-122.016,1830,5175,3,9,2015,UNK,-140,-642
9517200180,11/6/2014,375000.0,3,2.0,1410,10078,1.0,0.0,0.0,4,6,1410,0,1983,0,98072,47.7587,-122.14399999999999,2090,9202,11,6,2014,UNK,-680,876
1725079061,7/10/2014,500000.0,3,1.75,1640,47044,1.0,0.0,0.0,3,7,1640,0,1989,0,98014,47.653999999999996,-121.94,2280,200811,7,10,2014,UNK,-640,-153767
2141310820,6/24/2014,689000.0,3,1.75,2200,9840,1.0,0.0,0.0,5,8,1500,700,1978,0,98006,47.559,-122.13600000000001,2410,9623,6,24,2014,UNK,-210,217
2902200234,12/9/2014,525000.0,3,2.25,1290,1182,2.0,0.0,0.0,3,8,1000,290,2006,0,98102,47.637,-122.32700000000001,1300,1169,12,9,2014,N,-10,13
1443500395,5/4/2015,360000.0,3,1.5,1060,6232,1.0,0.0,0.0,4,7,1060,0,1968,0,98118,47.5329,-122.271,1120,5379,5,4,2015,UNK,-60,853
2391601010,8/20/2014,425000.0,3,1.0,1240,5750,1.0,0.0,0.0,4,6,1240,0,1948,0,98116,47.56399999999999,-122.398,1240,5750,8,20,2014,UNK,0,0
7129303970,3/4/2015,239950.0,2,1.0,1280,5500,1.0,0.0,0.0,3,7,1280,0,1949,0,98118,47.5179,-122.264,1270,5500,3,4,2015,UNK,10,0
567000025,4/2/2015,577500.0,2,2.5,2330,3000,2.0,0.0,3.0,3,8,2330,0,1915,1994,98144,47.5953,-122.294,1760,4000,4,2,2015,Y,570,-1000
2493200195,5/2/2014,615000.0,3,1.75,2360,7291,1.0,0.0,0.0,4,8,1360,1000,1948,0,98136,47.5274,-122.384,1860,5499,5,2,2014,UNK,500,1792
8562901250,8/27/2014,516000.0,4,2.75,2210,10800,1.0,0.0,0.0,4,8,1170,1040,1997,0,98074,47.6086,-122.059,2210,10800,8,27,2014,UNK,0,0
2600020330,8/13/2014,1220000.0,4,2.75,3670,15400,2.0,0.0,3.0,4,10,3670,0,1986,0,98006,47.5581,-122.156,3370,13300,8,13,2014,UNK,300,2100
1370801520,5/27/2014,1660000.0,4,3.5,3080,4815,2.0,0.0,3.0,3,10,2300,780,1937,2009,98199,47.6417,-122.411,2910,5350,5,27,2014,Y,170,-535
5589900761,5/1/2015,315000.0,2,1.0,770,6731,1.0,0.0,0.0,4,6,770,0,1943,0,98155,47.7505,-122.31200000000001,1120,9212,5,1,2015,UNK,-350,-2481
3601800580,10/21/2014,250000.0,4,2.0,2600,9000,1.0,0.0,0.0,3,8,1410,1190,1959,0,98032,47.381,-122.29899999999999,2600,7200,10,21,2014,UNK,0,1800
3336000296,11/13/2014,250000.0,4,1.5,1220,4900,1.0,0.0,0.0,3,6,1220,0,1942,0,98118,47.5292,-122.26899999999999,1410,3000,11,13,2014,UNK,-190,1900
1525059020,4/10/2015,925000.0,4,2.5,2910,48351,1.0,0.0,0.0,4,8,1910,1000,1967,0,98005,47.6495,-122.164,2760,43560,4,10,2015,UNK,150,4791
6150200330,8/25/2014,358000.0,3,1.0,1150,4681,1.0,0.0,0.0,3,7,1150,0,1955,0,98133,47.7284,-122.336,1150,6800,8,25,2014,UNK,0,-2119
4136950180,9/26/2014,262000.0,3,2.5,1700,6200,2.0,0.0,0.0,3,8,1700,0,1997,0,98092,47.2621,-122.221,1720,6205,9,26,2014,UNK,-20,-5
259600790,10/15/2014,500000.0,3,1.75,1220,7370,1.0,0.0,0.0,4,7,1220,0,1964,0,98008,47.6334,-122.12,1580,8213,10,15,2014,UNK,-360,-843
2770604925,7/15/2014,1300000.0,5,1.0,1670,6400,1.5,0.0,0.0,3,8,1670,0,1919,0,98119,47.6542,-122.37299999999999,1910,2983,7,15,2014,UNK,-240,3417
6902000100,9/15/2014,500000.0,3,1.75,2420,65501,2.0,0.0,1.0,3,8,2420,0,1984,0,98074,47.6525,-122.087,2970,19036,9,15,2014,UNK,-550,46465
3275850180,6/2/2014,675000.0,3,2.25,2610,9002,2.0,0.0,0.0,3,9,2610,0,1988,0,98052,47.6909,-122.104,2320,8306,6,2,2014,UNK,290,696
4154300296,9/26/2014,235000.0,3,1.0,960,5030,1.0,0.0,0.0,3,7,960,0,1955,0,98118,47.5611,-122.28,1460,5400,9,26,2014,UNK,-500,-370
4154300296,3/18/2015,545000.0,3,1.0,960,5030,1.0,0.0,0.0,3,7,960,0,1955,0,98118,47.5611,-122.28,1460,5400,3,18,2015,UNK,-500,-370
3888100043,5/7/2014,350000.0,3,1.0,1010,9360,1.0,0.0,0.0,3,6,1010,0,1981,0,98033,47.6874,-122.16799999999999,1470,9360,5,7,2014,UNK,-460,0
8165501510,11/25/2014,320000.0,2,2.25,1550,1827,2.0,0.0,0.0,3,8,1550,0,2008,0,98106,47.5394,-122.368,1420,1826,11,25,2014,N,130,1
5152700120,3/18/2015,452000.0,5,2.5,5067,13315,1.0,0.0,2.0,3,9,3154,1913,1968,0,98003,47.3391,-122.325,2860,13957,3,18,2015,UNK,2207,-642
1962200475,7/25/2014,875000.0,3,2.0,2350,6000,1.5,0.0,0.0,4,8,1990,360,1922,0,98102,47.6476,-122.32,2010,5040,7,25,2014,UNK,340,960
272000355,11/8/2014,325000.0,3,1.5,1310,2998,2.0,0.0,0.0,3,7,1310,0,1998,0,98144,47.5873,-122.29899999999999,1310,2997,11,8,2014,UNK,0,1
5113400113,6/19/2014,756000.0,4,2.25,2160,5600,1.0,0.0,0.0,5,7,1080,0,1947,0,98119,47.6442,-122.37200000000001,1850,5150,6,19,2014,UNK,310,450
6669010120,6/24/2014,319000.0,4,2.5,2510,7992,1.0,0.0,0.0,3,8,1610,900,1978,0,98032,47.3715,-122.285,2030,7992,6,24,2014,UNK,480,0
7170200110,1/21/2015,455000.0,3,1.75,890,3800,1.5,0.0,0.0,3,7,750,140,1926,0,98115,47.6803,-122.291,1280,3800,1,21,2015,UNK,-390,0
2113700025,4/9/2015,330000.0,2,1.0,1129,3840,1.0,0.0,0.0,3,7,1129,0,1953,0,98106,47.5313,-122.351,1300,3880,4,9,2015,UNK,-171,-40
7197000100,1/8/2015,510000.0,4,3.25,1980,9988,1.0,0.0,0.0,3,8,1340,640,1980,0,98052,47.6883,-122.111,1980,8972,1,8,2015,UNK,0,1016
7577700061,4/16/2015,532000.0,3,1.0,2360,5012,1.0,0.0,0.0,3,7,1560,800,1964,0,98116,47.5705,-122.384,1690,4800,4,16,2015,UNK,670,212
1862400215,1/20/2015,775000.0,3,2.5,2480,5007,2.0,0.0,0.0,3,8,1960,520,2014,0,98117,47.6974,-122.369,1650,7806,1,20,2015,N,830,-2799
3726800201,4/17/2015,410000.0,3,1.75,2160,4000,1.0,0.0,0.0,3,7,1080,1080,1953,0,98144,47.5721,-122.309,1260,3200,4,17,2015,UNK,900,800
13002460,3/18/2015,205000.0,2,1.75,1740,5100,1.0,0.0,0.0,3,6,580,1160,1915,0,98108,47.5211,-122.33,1440,5100,3,18,2015,UNK,300,0
5151200215,12/12/2014,585000.0,4,2.5,2430,6766,2.0,0.0,0.0,3,8,2430,0,1999,0,98177,47.7294,-122.35799999999999,1820,6772,12,12,2014,UNK,610,-6
8731983200,3/10/2015,255000.0,2,1.75,1950,8200,1.0,0.0,0.0,3,8,1950,0,1975,0,98023,47.3161,-122.382,2370,8000,3,10,2015,UNK,-420,200
5309101395,9/11/2014,415000.0,2,1.0,910,3750,1.0,0.0,0.0,3,7,910,0,1904,0,98117,47.6772,-122.369,1160,4000,9,11,2014,UNK,-250,-250
4364700945,4/2/2015,459000.0,4,2.0,2360,7080,1.0,0.0,0.0,5,6,1180,1180,1925,0,98126,47.5261,-122.376,1340,7200,4,2,2015,UNK,1020,-120
395300330,12/11/2014,354000.0,3,1.0,1130,11250,1.0,0.0,0.0,3,7,1130,0,1965,0,98034,47.7254,-122.227,1410,11250,12,11,2014,UNK,-280,0
3295730040,7/15/2014,587000.0,3,2.5,2150,5193,2.0,0.0,0.0,3,8,2150,0,1995,0,98033,47.6952,-122.18700000000001,2150,7172,7,15,2014,UNK,0,-1979
7937600395,7/8/2014,782000.0,4,3.5,5270,53428,2.0,0.0,0.0,3,10,3440,1830,2004,0,98058,47.4358,-122.085,2340,30904,7,8,2014,N,2930,22524
1236300146,5/4/2015,570000.0,3,1.5,1300,7287,1.0,0.0,0.0,4,7,1300,0,1965,0,98033,47.6889,-122.18700000000001,1300,9129,5,4,2015,UNK,0,-1842
8024200625,2/5/2015,414500.0,3,1.0,1050,6002,1.0,0.0,0.0,3,7,840,210,1941,0,98115,47.6988,-122.316,1180,6003,2,5,2015,UNK,-130,-1
7340600845,8/6/2014,185000.0,4,1.0,1380,6700,1.0,0.0,0.0,3,7,1190,190,1928,0,98168,47.4871,-122.281,1380,8292,8,6,2014,UNK,0,-1592
898000220,10/1/2014,262500.0,3,1.5,1610,10291,1.0,0.0,0.0,4,7,1610,0,1961,0,98022,47.2025,-121.999,1410,7729,10,1,2014,UNK,200,2562
2212600100,5/22/2014,370000.0,4,2.75,3150,67518,1.0,0.0,0.0,4,9,2250,900,1965,0,98092,47.3382,-122.196,2210,32391,5,22,2014,UNK,940,35127
6412100092,1/5/2015,362500.0,3,1.0,1520,9507,1.0,0.0,0.0,3,7,1520,0,1954,0,98125,47.7162,-122.324,1360,7219,1,5,2015,UNK,160,2288
8835350300,3/4/2015,536000.0,3,2.5,1990,7397,2.0,0.0,0.0,3,9,1990,0,1993,0,98072,47.7703,-122.165,2210,7397,3,4,2015,UNK,-220,0
2586800210,4/21/2015,425000.0,5,2.0,2500,7804,1.5,0.0,0.0,3,7,1570,930,1921,0,98146,47.5031,-122.348,1170,7676,4,21,2015,UNK,1330,128
2044500201,6/9/2014,435000.0,3,2.25,1890,7200,1.0,0.0,0.0,4,7,1230,660,1973,0,98125,47.7156,-122.31700000000001,1970,8101,6,9,2014,UNK,-80,-901
6450303950,5/5/2014,435000.0,5,2.0,1840,9240,1.0,0.0,0.0,4,7,1540,300,1942,0,98133,47.7308,-122.34,1200,5250,5,5,2014,UNK,640,3990
3013300409,3/12/2015,400000.0,2,1.0,1220,6300,1.0,0.0,0.0,3,7,760,460,1942,0,98136,47.5299,-122.387,1850,4886,3,12,2015,UNK,-630,1414
1934800087,6/26/2014,446000.0,2,1.5,1370,1221,2.0,0.0,0.0,3,8,1080,290,2008,0,98122,47.6039,-122.307,1560,2081,6,26,2014,N,-190,-860
1125049140,1/26/2015,1250000.0,3,2.5,2710,13120,1.0,0.0,0.0,3,10,2710,0,1959,0,98105,47.6718,-122.256,3130,13566,1,26,2015,UNK,-420,-446
2025700180,11/20/2014,300000.0,3,2.25,1760,5421,2.0,0.0,0.0,3,7,1760,0,1991,0,98038,47.3484,-122.037,1570,6000,11,20,2014,UNK,190,-579
8024201055,8/6/2014,404500.0,2,1.0,800,5080,1.0,0.0,0.0,3,7,800,0,1938,0,98115,47.6978,-122.314,1560,5110,8,6,2014,UNK,-760,-30
2426059097,3/5/2015,910000.0,4,2.5,3530,49222,2.0,0.0,0.0,4,9,3530,0,1986,0,98072,47.7285,-122.11200000000001,3750,49222,3,5,2015,UNK,-220,0
9829200855,5/13/2014,771000.0,3,2.25,1780,6120,1.5,0.0,0.0,4,9,1390,390,1927,0,98122,47.6025,-122.286,1960,5568,5,13,2014,UNK,-180,552
1864940180,6/5/2014,335000.0,4,2.5,2610,4781,2.0,0.0,0.0,3,8,2610,0,2009,0,98001,47.2649,-122.292,2583,4796,6,5,2014,N,27,-15
1023089085,8/4/2014,390000.0,3,1.75,1850,15170,1.0,0.0,0.0,3,7,1850,0,1965,0,98045,47.4991,-121.774,1160,14175,8,4,2014,UNK,690,995
4399200100,4/28/2015,288000.0,3,2.25,1560,9706,1.0,0.0,0.0,4,7,1560,0,1963,0,98002,47.3191,-122.213,1510,9706,4,28,2015,UNK,50,0
1087500040,10/14/2014,403000.0,3,1.75,1270,10790,1.0,0.0,0.0,3,7,1270,0,1956,0,98033,47.6647,-122.177,1270,10790,10,14,2014,UNK,0,0
1972201965,6/24/2014,510000.0,3,2.25,1420,1309,3.0,0.0,0.0,3,8,1420,0,2006,0,98103,47.6534,-122.346,1500,1282,6,24,2014,N,-80,27
272000085,2/19/2015,751000.0,6,3.0,2880,6800,2.0,0.0,0.0,3,7,2880,0,1980,0,98144,47.5873,-122.29899999999999,1640,4000,2,19,2015,UNK,1240,2800
7129302806,2/3/2015,408000.0,3,1.0,1420,8000,1.0,0.0,4.0,3,7,1420,0,1950,0,98118,47.5169,-122.255,1780,8295,2,3,2015,UNK,-360,-295
4389201021,7/1/2014,1010000.0,3,1.0,1640,12855,1.5,0.0,0.0,5,6,1500,140,1920,0,98004,47.6169,-122.212,2190,11262,7,1,2014,UNK,-550,1593
6751300385,4/24/2015,575000.0,3,2.0,1730,9030,1.0,0.0,0.0,4,7,1730,0,1956,0,98007,47.5875,-122.134,1470,9030,4,24,2015,UNK,260,0
723049274,4/17/2015,330000.0,3,1.75,1250,8100,1.0,0.0,0.0,3,7,1250,0,1951,0,98146,47.5016,-122.348,1300,8175,4,17,2015,UNK,-50,-75
2767602094,5/16/2014,565000.0,3,2.25,1520,1221,3.0,0.0,0.0,3,8,1520,0,2013,0,98107,47.674,-122.37700000000001,1550,4750,5,16,2014,N,-30,-3529
8635760330,4/13/2015,456000.0,3,2.5,1820,2935,2.0,0.0,0.0,3,8,1820,0,1999,0,98074,47.6018,-122.021,1820,2936,4,13,2015,UNK,0,-1
3905010100,6/15/2014,652500.0,4,2.5,2700,9122,2.0,0.0,0.0,3,9,2700,0,1990,0,98029,47.5771,-121.994,2500,9122,6,15,2014,UNK,200,0
2493200215,12/31/2014,582000.0,3,1.75,1820,3140,2.0,0.0,0.0,5,8,1820,0,1949,1990,98136,47.5271,-122.384,2030,5499,12,31,2014,Y,-210,-2359
8691390530,6/25/2014,700000.0,4,2.5,2770,5686,2.0,0.0,0.0,3,9,2770,0,2004,0,98075,47.5997,-121.973,2910,5000,6,25,2014,N,-140,686
4319200620,10/15/2014,235000.0,2,1.0,1270,9182,1.5,0.0,0.0,3,6,1270,0,1917,0,98126,47.5365,-122.37799999999999,1760,9100,10,15,2014,UNK,-490,82
424069096,7/31/2014,460000.0,3,1.75,1400,12155,1.0,0.0,0.0,4,7,1400,0,1977,0,98075,47.5926,-122.04700000000001,2540,23522,7,31,2014,UNK,-1140,-11367
8121200820,5/22/2014,475000.0,3,2.25,1820,8008,1.0,0.0,0.0,3,8,1240,580,1981,0,98052,47.7206,-122.11,2030,8750,5,22,2014,UNK,-210,-742
8682231110,6/9/2014,579000.0,2,2.0,1870,6275,1.0,0.0,0.0,3,8,1870,0,2003,0,98053,47.7108,-122.031,1670,5200,6,9,2014,UNK,200,1075
2767602645,11/10/2014,507000.0,4,2.0,1360,2746,1.5,0.0,0.0,3,7,1360,0,1945,2011,98107,47.6736,-122.39,1960,2746,11,10,2014,Y,-600,0
7131300035,5/12/2014,210000.0,3,2.5,1040,2643,2.0,0.0,0.0,3,7,720,320,2004,0,98118,47.5165,-122.26799999999999,1540,5110,5,12,2014,N,-500,-2467
2595650100,6/30/2014,359500.0,4,2.75,2140,10316,2.0,0.0,0.0,3,8,2140,0,1993,0,98001,47.3537,-122.274,1920,11337,6,30,2014,UNK,220,-1021
2616700450,11/7/2014,248000.0,3,1.75,1330,9831,1.0,0.0,0.0,3,7,1330,0,1987,0,98001,47.3304,-122.277,1330,7500,11,7,2014,UNK,0,2331
2520900301,10/22/2014,239300.0,3,1.0,1070,5750,1.0,0.0,0.0,3,7,1070,0,1952,0,98178,47.5071,-122.255,1420,6500,10,22,2014,UNK,-350,-750
1473200150,12/16/2014,315000.0,3,2.25,1370,1533,3.0,0.0,0.0,3,8,1370,0,2009,0,98133,47.7326,-122.34299999999999,1370,1125,12,16,2014,N,0,408
1726600150,2/26/2015,970000.0,4,3.0,3510,12410,2.0,0.0,0.0,4,9,3510,0,1976,0,98005,47.6381,-122.166,3000,13209,2,26,2015,UNK,510,-799
9169600110,3/17/2015,510000.0,3,1.5,1730,6240,1.0,0.0,1.0,3,8,1000,730,1954,0,98136,47.5282,-122.391,1620,6240,3,17,2015,UNK,110,0
4036800580,6/21/2014,418000.0,4,1.5,1550,9176,1.0,0.0,0.0,3,7,1000,550,1956,0,98008,47.6005,-122.12899999999999,1730,8539,6,21,2014,UNK,-180,637
2324800110,6/12/2014,699000.0,4,2.5,3280,27441,2.0,0.0,0.0,3,9,3280,0,1996,0,98053,47.6711,-122.012,3200,26960,6,12,2014,UNK,80,481
7855800910,3/21/2015,871000.0,4,2.5,2150,8536,1.0,0.0,3.0,4,8,1400,750,1967,0,98006,47.5663,-122.163,2800,9500,3,21,2015,UNK,-650,-964
3625059140,5/7/2014,515000.0,3,1.75,1580,9147,1.0,0.0,1.0,4,7,1210,370,1967,0,98008,47.6069,-122.11200000000001,2600,23564,5,7,2014,UNK,-1020,-14417
1200021,8/11/2014,400000.0,3,1.0,1460,43000,1.0,0.0,0.0,3,7,1460,0,1952,0,98166,47.4434,-122.34700000000001,2250,20023,8,11,2014,UNK,-790,22977
9455200790,12/9/2014,445000.0,3,1.75,1410,5100,1.0,0.0,0.0,4,7,1110,300,1954,0,98125,47.7026,-122.29,1600,7800,12,9,2014,UNK,-190,-2700
2021200530,2/25/2015,1110000.0,4,2.75,3090,6600,1.0,0.0,2.0,3,9,1800,1290,1956,0,98199,47.6339,-122.396,2380,5000,2,25,2015,UNK,710,1600
7760600110,10/27/2014,212000.0,3,1.5,1690,9600,1.0,0.0,0.0,3,7,1210,480,1976,0,98038,47.3857,-122.079,1450,9647,10,27,2014,UNK,240,-47
9323610110,1/12/2015,710000.0,4,2.5,2870,11304,2.0,0.0,0.0,3,9,2870,0,1980,0,98006,47.5547,-122.154,2690,9940,1,12,2015,UNK,180,1364
1612500090,3/31/2015,225800.0,4,1.0,1100,7110,1.0,0.0,0.0,4,7,880,220,1907,0,98030,47.3858,-122.227,1150,7110,3,31,2015,UNK,-50,0
4027700594,12/22/2014,520000.0,3,1.75,2310,36665,1.0,0.0,2.0,3,8,1580,730,1983,0,98155,47.7697,-122.274,2000,14000,12,22,2014,UNK,310,22665
1924059254,5/8/2015,1300000.0,5,3.75,3490,15246,1.0,0.0,1.0,4,10,1940,1550,1968,0,98040,47.5479,-122.212,3410,15682,5,8,2015,UNK,80,-436
2172000846,6/19/2014,248000.0,4,2.0,2080,13510,1.0,0.0,0.0,3,7,1040,1040,1950,0,98178,47.4918,-122.258,2010,11625,6,19,2014,UNK,70,1885
514500195,10/16/2014,556000.0,4,2.5,2230,7200,1.0,0.0,0.0,4,7,1220,1010,1957,0,98005,47.589,-122.156,1920,7200,10,16,2014,UNK,310,0
8151600142,5/12/2015,319950.0,5,1.75,1710,11900,1.0,0.0,0.0,3,7,1070,640,1958,0,98146,47.506,-122.365,1030,10360,5,12,2015,UNK,680,1540
7950304045,3/31/2015,320000.0,4,2.75,1640,3000,1.0,0.0,0.0,3,7,1000,640,1984,0,98118,47.5625,-122.28299999999999,1150,4545,3,31,2015,UNK,490,-1545
6700390210,7/8/2014,245000.0,3,2.5,1600,2788,2.0,0.0,0.0,4,7,1600,0,1992,0,98031,47.4034,-122.18700000000001,1720,3605,7,8,2014,UNK,-120,-817
2195700230,2/3/2015,700000.0,3,2.5,2850,36585,2.0,0.0,0.0,3,10,2850,0,1987,0,98072,47.7376,-122.102,3340,35671,2,3,2015,UNK,-490,914
558100090,3/12/2015,628000.0,5,2.75,2600,8160,2.0,0.0,0.0,3,8,2600,0,2015,0,98133,47.7348,-122.34,1600,8160,3,12,2015,N,1000,0
2749600245,6/17/2014,640000.0,3,2.0,1380,4800,1.0,0.0,0.0,3,7,1380,0,1948,0,98199,47.651,-122.369,1740,5640,6,17,2014,UNK,-360,-840
1782500065,4/28/2015,420000.0,4,1.75,1320,4978,1.0,0.0,0.0,4,7,940,380,1942,0,98126,47.5266,-122.37899999999999,1260,4693,4,28,2015,UNK,60,285
263000329,10/8/2014,349950.0,3,2.5,1420,1162,3.0,0.0,0.0,3,8,1420,0,2002,0,98103,47.6982,-122.34899999999999,1430,1560,10,8,2014,UNK,-10,-398
9432900180,7/14/2014,307999.0,4,2.75,2420,8438,2.0,0.0,0.0,3,8,2420,0,1996,0,98022,47.2091,-122.009,2420,8580,7,14,2014,UNK,0,-142
142000165,5/7/2014,749950.0,4,2.75,2600,6050,2.0,0.0,0.0,5,8,1960,640,1949,0,98116,47.5656,-122.4,1990,6050,5,7,2014,UNK,610,0
6145600410,7/11/2014,290000.0,2,1.0,840,3844,1.0,0.0,0.0,4,6,840,0,1919,0,98133,47.7048,-122.34700000000001,1040,3844,7,11,2014,UNK,-200,0
2599001500,7/12/2014,235000.0,3,1.75,1420,7920,1.0,0.0,0.0,4,7,1420,0,1962,0,98092,47.2931,-122.18799999999999,1420,7920,7,12,2014,UNK,0,0
1721801010,9/3/2014,225000.0,3,1.0,1790,6120,1.0,0.0,0.0,3,6,1790,0,1937,1964,98146,47.508,-122.337,830,6120,9,3,2014,Y,960,0
1721801010,4/24/2015,302100.0,3,1.0,1790,6120,1.0,0.0,0.0,3,6,1790,0,1937,1964,98146,47.508,-122.337,830,6120,4,24,2015,Y,960,0
5101404491,2/12/2015,520000.0,2,1.0,1340,6380,1.0,0.0,0.0,3,7,890,450,1939,0,98115,47.696999999999996,-122.31299999999999,1380,6380,2,12,2015,UNK,-40,0
326049111,6/26/2014,285000.0,2,1.0,1010,7200,1.0,0.0,0.0,3,7,1010,0,1975,0,98155,47.7651,-122.291,1890,9248,6,26,2014,UNK,-880,-2048
1785400300,8/21/2014,525000.0,3,2.0,1640,15258,1.0,0.0,0.0,3,8,1640,0,1981,0,98074,47.6301,-122.037,1640,16345,8,21,2014,UNK,0,-1087
1310980580,3/19/2015,374900.0,5,2.75,2980,8500,1.0,0.0,0.0,3,8,1540,1440,1982,0,98032,47.3641,-122.27799999999999,2310,8500,3,19,2015,UNK,670,0
6632300230,10/6/2014,377500.0,3,2.0,1370,7200,1.0,0.0,0.0,3,7,1130,240,1926,1955,98125,47.7329,-122.30799999999999,1300,7208,10,6,2014,Y,70,-8
9324800650,4/27/2015,587450.0,3,2.25,2190,8775,1.5,0.0,1.0,4,8,2190,0,1927,0,98125,47.7303,-122.287,1910,8145,4,27,2015,UNK,280,630
2188201010,1/21/2015,245000.0,3,2.25,1530,12000,1.0,0.0,0.0,3,7,1070,460,1979,0,98023,47.2715,-122.338,2140,13636,1,21,2015,UNK,-610,-1636
7137910360,7/29/2014,200000.0,3,2.0,1290,5757,1.0,0.0,0.0,3,7,1290,0,1994,0,98092,47.3175,-122.17,1580,6798,7,29,2014,UNK,-290,-1041
125069038,11/25/2014,2140000.0,4,3.75,5150,453895,2.0,0.0,3.0,3,11,4360,790,1997,0,98053,47.6795,-121.991,2500,215186,11,25,2014,UNK,2650,238709
9465910150,11/9/2014,607000.0,3,2.5,2470,9226,2.0,0.0,0.0,3,9,2470,0,1991,0,98072,47.7439,-122.17,2820,11013,11,9,2014,UNK,-350,-1787
724069023,4/14/2015,1250000.0,1,1.25,1810,5070,1.5,1.0,4.0,4,8,1230,580,1967,0,98075,47.5814,-122.081,2280,5070,4,14,2015,UNK,-470,0
6600220150,3/10/2015,549950.0,4,2.5,2230,14694,1.0,0.0,0.0,4,7,1180,1050,1981,0,98074,47.6305,-122.03399999999999,1470,13458,3,10,2015,UNK,760,1236
7227800025,11/18/2014,250000.0,3,3.0,2300,7701,1.0,0.0,0.0,3,7,2300,0,1960,0,98056,47.5102,-122.18,1570,8116,11,18,2014,UNK,730,-415
3905040220,5/9/2014,525000.0,3,2.5,2030,6970,2.0,0.0,0.0,4,8,2030,0,1991,0,98029,47.5718,-121.999,2000,6140,5,9,2014,UNK,30,830
5072300210,6/24/2014,440000.0,3,1.75,2000,9900,1.0,0.0,2.0,4,8,1480,520,1957,0,98166,47.4436,-122.339,2310,10200,6,24,2014,UNK,-310,-300
121039042,3/13/2015,425000.0,3,2.75,3610,107386,1.5,0.0,3.0,3,8,3130,480,1918,1962,98023,47.3351,-122.36200000000001,2630,42126,3,13,2015,Y,980,65260
6705870120,7/1/2014,739900.0,5,2.5,3290,5029,2.0,0.0,0.0,3,8,3290,0,2004,0,98075,47.5773,-122.056,2990,6441,7,1,2014,N,300,-1412
1109000040,5/28/2014,315000.0,3,2.0,1300,3731,1.0,0.0,0.0,3,7,900,400,1993,0,98118,47.5374,-122.27,1300,3731,5,28,2014,UNK,0,0
9358001590,3/3/2015,340000.0,5,1.0,1880,3774,1.5,0.0,0.0,3,6,1360,520,1917,0,98126,47.566,-122.37,1420,2550,3,3,2015,UNK,460,1224
705700580,5/1/2015,366000.0,4,2.75,2170,9743,2.0,0.0,0.0,3,7,2170,0,1995,0,98038,47.3814,-122.024,1670,7734,5,1,2015,UNK,500,2009
4343800100,10/21/2014,315000.0,3,1.75,1680,7250,1.0,0.0,0.0,3,7,930,750,1952,0,98133,47.7201,-122.35,1340,7250,10,21,2014,UNK,340,0
3343900781,10/27/2014,299000.0,3,1.5,1190,9135,1.0,0.0,0.0,4,7,1190,0,1959,0,98056,47.5164,-122.189,1520,9146,10,27,2014,UNK,-330,-11
1062100085,11/13/2014,350000.0,2,1.0,940,5000,1.0,0.0,0.0,3,7,940,0,1950,0,98155,47.7518,-122.279,1800,7400,11,13,2014,UNK,-860,-2400
6821101827,11/5/2014,340000.0,2,1.75,1010,1461,1.0,0.0,0.0,3,7,670,340,2003,0,98199,47.6515,-122.4,1500,2499,11,5,2014,UNK,-490,-1038
3901100015,12/30/2014,460000.0,3,1.75,1290,8580,1.0,0.0,0.0,4,7,1290,0,1962,0,98033,47.6707,-122.17399999999999,1840,8580,12,30,2014,UNK,-550,0
9500900110,7/31/2014,224000.0,3,1.5,1480,10588,1.0,0.0,0.0,3,7,1480,0,1957,0,98002,47.2872,-122.212,1370,10588,7,31,2014,UNK,110,0
4006000401,8/11/2014,140000.0,2,1.0,900,6400,1.0,0.0,0.0,2,6,900,0,1940,0,98118,47.5287,-122.281,1350,6405,8,11,2014,UNK,-450,-5
1218000025,10/13/2014,246000.0,4,2.0,1400,7632,1.5,0.0,0.0,5,6,1400,0,1930,0,98166,47.4625,-122.345,1400,7632,10,13,2014,UNK,0,0
1875500040,1/27/2015,330000.0,3,2.5,2040,14071,2.0,0.0,0.0,3,7,2040,0,1995,0,98019,47.7278,-121.963,1890,14040,1,27,2015,UNK,150,31
7955000210,7/9/2014,306000.0,3,1.0,1450,7200,1.0,0.0,0.0,3,7,1010,440,1969,0,98034,47.7311,-122.199,1500,6767,7,9,2014,UNK,-50,433
7568700175,6/4/2014,324950.0,3,1.0,1210,7440,1.0,0.0,0.0,3,7,1210,0,1949,0,98155,47.7402,-122.323,1120,7440,6,4,2014,UNK,90,0
3410600100,6/13/2014,345000.0,2,1.5,1800,26615,1.0,0.0,0.0,5,7,1240,560,1987,0,98092,47.302,-122.12299999999999,2010,26337,6,13,2014,UNK,-210,278
923049378,5/8/2014,207000.0,3,1.0,1490,8995,1.0,0.0,0.0,4,7,1490,0,1954,0,98168,47.4901,-122.303,1490,9000,5,8,2014,UNK,0,-5
420000085,8/27/2014,238000.0,3,1.0,1240,5700,1.5,0.0,0.0,5,6,1240,0,1953,0,98056,47.4927,-122.169,1140,5700,8,27,2014,UNK,100,0
2817210210,4/1/2015,695000.0,3,2.0,2632,18743,2.0,0.0,3.0,3,10,2632,0,2000,0,98070,47.3743,-122.421,1970,14171,4,1,2015,UNK,662,4572
2141340040,9/11/2014,649950.0,3,2.5,2150,15304,2.0,0.0,0.0,4,9,2150,0,1979,0,98006,47.5573,-122.13600000000001,2540,10507,9,11,2014,UNK,-390,4797
714000315,4/14/2015,515000.0,3,2.75,1710,9448,1.0,0.0,0.0,3,7,1010,700,1947,0,98105,47.6693,-122.26700000000001,1960,8951,4,14,2015,UNK,-250,497
263000040,10/1/2014,452000.0,3,2.5,1530,5032,2.0,0.0,0.0,3,7,1530,0,1998,0,98103,47.6985,-122.34899999999999,1450,2136,10,1,2014,UNK,80,2896
1721801161,10/30/2014,236000.0,4,2.5,1630,3060,2.0,0.0,0.0,3,7,1630,0,2003,0,98146,47.5072,-122.336,1270,4590,10,30,2014,UNK,360,-1530
4139490210,7/30/2014,1290000.0,4,3.5,4080,14450,2.0,0.0,2.0,3,12,3210,870,1998,0,98006,47.5519,-122.10600000000001,4080,12114,7,30,2014,UNK,0,2336
6790900110,6/10/2014,563000.0,3,2.75,2340,16500,1.0,0.0,0.0,4,8,1500,840,1972,0,98075,47.5952,-122.051,2210,15251,6,10,2014,UNK,130,1249
1775800220,4/2/2015,410988.0,3,1.75,1000,14061,1.0,0.0,0.0,4,7,1000,0,1967,0,98072,47.7417,-122.09299999999999,1260,12635,4,2,2015,UNK,-260,1426
4141000490,10/21/2014,1200000.0,4,2.5,3180,13118,2.0,0.0,0.0,4,11,3180,0,1986,0,98040,47.5382,-122.23,3070,12861,10,21,2014,UNK,110,257
8078100120,3/19/2015,340000.0,4,2.5,2170,19785,2.0,0.0,0.0,3,8,2170,0,1992,0,98031,47.4034,-122.167,2280,8616,3,19,2015,UNK,-110,11169
3034200666,11/7/2014,808100.0,4,3.25,3020,13457,1.0,0.0,0.0,5,9,3020,0,1956,0,98133,47.7174,-122.336,2120,7553,11,7,2014,UNK,900,5904
8892900210,6/9/2014,236000.0,3,1.75,1330,6301,1.0,0.0,0.0,3,7,1330,0,1998,0,98002,47.3411,-122.219,1330,6144,6,9,2014,UNK,0,157
7399000360,5/13/2015,330000.0,4,1.75,1720,8300,1.0,0.0,0.0,4,8,1720,0,1965,0,98055,47.4654,-122.194,1840,8300,5,13,2015,UNK,-120,0
3491300082,1/27/2015,799990.0,4,3.5,2540,5808,2.0,0.0,0.0,5,8,1820,720,1910,1986,98117,47.6857,-122.376,1520,5461,1,27,2015,Y,1020,347
323059146,4/17/2015,343000.0,3,1.0,1410,18600,1.0,0.0,0.0,5,7,1410,0,1960,0,98059,47.5031,-122.152,1610,24941,4,17,2015,UNK,-200,-6341
1079350090,6/17/2014,332000.0,3,2.5,1530,9406,1.0,0.0,0.0,3,7,1270,260,1993,0,98059,47.4852,-122.162,1700,7682,6,17,2014,UNK,-170,1724
98000740,4/1/2015,945000.0,5,3.5,4380,14925,2.0,0.0,0.0,3,11,4380,0,2003,0,98075,47.5848,-121.969,4310,14633,4,1,2015,UNK,70,292
5126400150,6/17/2014,239950.0,3,1.0,1140,8366,1.0,0.0,0.0,5,6,1140,0,1943,0,98058,47.4768,-122.177,960,7200,6,17,2014,UNK,180,1166
8815400165,3/3/2015,674000.0,5,1.75,2110,5000,1.5,0.0,0.0,4,7,1250,860,1946,0,98115,47.6745,-122.287,1720,5000,3,3,2015,UNK,390,0
421000555,5/20/2014,200000.0,3,1.0,1050,5000,1.0,0.0,0.0,4,6,1050,0,1967,0,98056,47.4923,-122.165,1050,5200,5,20,2014,UNK,0,-200
686300930,3/5/2015,453000.0,3,1.75,1600,7232,1.0,0.0,0.0,3,8,1600,0,1966,0,98008,47.6293,-122.12100000000001,1970,8120,3,5,2015,UNK,-370,-888
2744600040,6/14/2014,330000.0,3,1.75,1430,8865,1.0,0.0,0.0,3,7,1430,0,1950,0,98125,47.7331,-122.29899999999999,1250,8154,6,14,2014,UNK,180,711
3832070040,4/16/2015,285000.0,4,2.5,1996,4547,2.0,0.0,0.0,3,7,1996,0,2009,0,98042,47.3365,-122.051,2180,5127,4,16,2015,N,-184,-580
7305300090,11/6/2014,338000.0,4,1.75,1530,8152,1.0,0.0,0.0,5,6,910,620,1948,0,98155,47.7557,-122.32799999999999,1310,8152,11,6,2014,UNK,220,0
7452500730,4/24/2015,264950.0,2,1.0,1000,6000,1.0,0.0,0.0,3,6,1000,0,1951,0,98126,47.5208,-122.37200000000001,1250,6000,4,24,2015,UNK,-250,0
1824059079,3/11/2015,880000.0,4,2.0,2530,10800,1.0,0.0,0.0,5,8,1350,1180,1954,0,98040,47.5705,-122.225,2960,12150,3,11,2015,UNK,-430,-1350
3438503426,4/6/2015,209500.0,3,1.5,970,5488,1.0,0.0,0.0,3,7,970,0,1976,0,98106,47.5366,-122.359,1040,5488,4,6,2015,UNK,-70,0
8948500025,4/25/2015,380000.0,4,2.5,2400,9398,1.0,0.0,0.0,4,7,1310,1090,1958,0,98056,47.4952,-122.178,1330,8249,4,25,2015,UNK,1070,1149
1722059021,12/17/2014,336500.0,3,2.0,1830,12891,1.0,0.0,0.0,3,7,1830,0,1994,0,98031,47.3924,-122.19200000000001,2320,8709,12,17,2014,UNK,-490,4182
8899210090,7/14/2014,360000.0,3,2.25,2130,8466,1.0,0.0,0.0,3,7,1290,840,1983,0,98055,47.4537,-122.211,2250,9682,7,14,2014,UNK,-120,-1216
4019300155,8/21/2014,911100.0,4,3.25,3330,33826,2.0,0.0,0.0,5,8,3330,0,1924,0,98155,47.7596,-122.275,2580,28707,8,21,2014,UNK,750,5119
4364700165,11/24/2014,249900.0,2,1.0,560,7560,1.0,0.0,0.0,3,6,560,0,1944,0,98126,47.5271,-122.375,990,7560,11,24,2014,UNK,-430,0
796000085,9/23/2014,175000.0,4,1.0,1210,6250,1.0,0.0,0.0,3,7,1210,0,1962,0,98168,47.5008,-122.333,1210,8291,9,23,2014,UNK,0,-2041
7987401095,11/13/2014,549950.0,3,2.5,2380,2500,3.0,0.0,3.0,3,9,2380,0,1988,0,98126,47.5734,-122.375,2270,5000,11,13,2014,UNK,110,-2500
1237500540,10/21/2014,225000.0,3,1.75,1370,10866,1.0,0.0,0.0,4,6,1370,0,1945,0,98052,47.6774,-122.164,1580,14250,10,21,2014,UNK,-210,-3384
1237500540,12/22/2014,270000.0,3,1.75,1370,10866,1.0,0.0,0.0,4,6,1370,0,1945,0,98052,47.6774,-122.164,1580,14250,12,22,2014,UNK,-210,-3384
3649100304,8/19/2014,400000.0,3,2.25,1740,11040,2.0,0.0,0.0,3,8,1740,0,1980,0,98028,47.7376,-122.242,1720,11778,8,19,2014,UNK,20,-738
7400062,5/21/2014,299800.0,2,1.0,790,5240,1.0,0.0,0.0,4,6,790,0,1925,0,98118,47.5303,-122.288,1430,5320,5,21,2014,UNK,-640,-80
6388910730,8/6/2014,555000.0,3,2.5,2480,8676,2.0,0.0,0.0,4,8,2480,0,1989,0,98056,47.53,-122.17200000000001,2540,9496,8,6,2014,UNK,-60,-820
7882900120,5/7/2014,230000.0,3,2.5,1920,9180,2.0,0.0,0.0,3,8,1920,0,1988,0,98055,47.4818,-122.23100000000001,1930,7252,5,7,2014,UNK,-10,1928
1865000040,12/10/2014,360000.0,4,2.5,2750,6259,2.0,0.0,0.0,3,9,2750,0,2002,0,98092,47.3304,-122.179,2810,6824,12,10,2014,UNK,-60,-565
6821100246,9/3/2014,415000.0,2,1.0,880,3200,1.0,0.0,0.0,3,7,880,0,1910,1970,98199,47.6575,-122.402,1880,6000,9,3,2014,Y,-1000,-2800
8731981500,8/18/2014,355000.0,4,1.75,2160,8000,1.0,0.0,0.0,4,9,1660,500,1976,0,98023,47.3165,-122.382,2350,8200,8,18,2014,UNK,-190,-200
6979910120,3/23/2015,635000.0,4,2.5,2570,27972,2.0,0.0,0.0,3,8,2570,0,1997,0,98053,47.6343,-121.969,2500,29761,3,23,2015,UNK,70,-1789
2123700100,12/2/2014,353000.0,5,2.75,2130,5000,1.0,0.0,0.0,5,7,1100,1030,1978,0,98118,47.5271,-122.274,1340,6837,12,2,2014,UNK,790,-1837
3425059141,5/28/2014,999000.0,7,4.0,3150,34830,1.0,0.0,0.0,3,9,3150,0,1957,2005,98007,47.6029,-122.147,2390,12054,5,28,2014,Y,760,22776
3876600120,4/22/2015,265000.0,3,1.5,1780,10196,1.0,0.0,0.0,4,7,1270,510,1967,0,98001,47.3375,-122.291,1320,7875,4,22,2015,UNK,460,2321
4038000040,3/26/2015,250000.0,4,1.75,1910,8250,1.0,0.0,0.0,4,7,1910,0,1959,0,98008,47.6131,-122.12299999999999,1500,8250,3,26,2015,UNK,410,0
6668900155,8/20/2014,225000.0,2,1.0,1170,7142,1.0,0.0,0.0,3,7,1170,0,1951,0,98155,47.7497,-122.31299999999999,1170,7615,8,20,2014,UNK,0,-473
8132700150,5/3/2014,553000.0,2,1.0,900,5000,1.0,0.0,0.0,3,7,900,0,1944,0,98117,47.6883,-122.395,1280,5000,5,3,2014,UNK,-380,0
4038800580,6/4/2014,565000.0,5,2.5,2650,11455,1.0,0.0,0.0,3,7,1400,1250,1961,0,98008,47.6141,-122.116,1960,9880,6,4,2014,UNK,690,1575
3331001910,8/18/2014,312000.0,2,1.0,1170,5150,1.0,0.0,0.0,3,6,980,190,1907,0,98118,47.5503,-122.28299999999999,1660,5150,8,18,2014,UNK,-490,0
2726079103,7/22/2014,475000.0,3,2.5,2630,185130,2.0,0.0,0.0,3,9,2630,0,1991,0,98014,47.7035,-121.89399999999999,2630,210394,7,22,2014,UNK,0,-25264
7212651210,11/6/2014,320000.0,4,2.75,2150,9163,1.0,0.0,0.0,3,8,1340,810,1992,0,98003,47.26600000000001,-122.307,2260,7750,11,6,2014,UNK,-110,1413
2026059119,8/25/2014,453000.0,3,2.0,1430,9583,1.0,0.0,0.0,4,7,1430,0,1964,0,98034,47.7206,-122.197,1890,11100,8,25,2014,UNK,-460,-1517
3330501120,3/25/2015,320000.0,3,1.0,960,6180,1.0,0.0,0.0,4,6,960,0,1910,0,98118,47.5518,-122.279,1250,4120,3,25,2015,UNK,-290,2060
1250202324,1/22/2015,610000.0,4,2.75,2640,8400,1.0,0.0,2.0,3,8,1440,1200,1947,0,98144,47.5882,-122.29,2610,6000,1,22,2015,UNK,30,2400
3815500035,5/20/2014,385000.0,3,1.5,1490,9630,1.0,0.0,0.0,4,8,1490,0,1959,0,98028,47.7623,-122.256,1960,10469,5,20,2014,UNK,-470,-839
5706600150,5/28/2014,215000.0,3,1.75,1210,8075,1.0,0.0,0.0,4,6,1210,0,1983,0,98001,47.2666,-122.25399999999999,1310,8025,5,28,2014,UNK,-100,50
8005100540,7/9/2014,215000.0,4,1.5,1860,5040,1.5,0.0,0.0,5,8,1860,0,1920,0,98022,47.2077,-121.993,1680,5800,7,9,2014,UNK,180,-760
293720180,12/30/2014,415000.0,3,2.5,1980,4274,2.0,0.0,0.0,3,7,1980,0,2003,0,98028,47.7767,-122.23899999999999,2000,4394,12,30,2014,UNK,-20,-120
5101405604,8/14/2014,350000.0,1,1.0,900,6380,1.0,0.0,0.0,3,6,900,0,1947,0,98125,47.7019,-122.311,1830,6380,8,14,2014,UNK,-930,0
5101405604,4/28/2015,395000.0,1,1.0,900,6380,1.0,0.0,0.0,3,6,900,0,1947,0,98125,47.7019,-122.311,1830,6380,4,28,2015,UNK,-930,0
2387000110,11/10/2014,898000.0,2,1.75,1490,9874,1.0,0.0,0.0,4,7,1490,0,1963,0,98004,47.6246,-122.199,2280,9869,11,10,2014,UNK,-790,5
7238000330,12/18/2014,480000.0,3,2.5,2980,7338,2.0,0.0,0.0,3,8,2980,0,2006,0,98055,47.437,-122.20700000000001,3010,5267,12,18,2014,N,-30,2071
3879901295,11/10/2014,1240000.0,3,2.5,2660,1973,3.0,0.0,3.0,3,9,1870,790,2007,0,98119,47.6264,-122.36399999999999,1640,1369,11,10,2014,N,1020,604
326069131,6/11/2014,599000.0,4,2.5,2790,230868,2.0,0.0,0.0,3,8,2790,0,1989,0,98077,47.7647,-122.01899999999999,1590,217800,6,11,2014,UNK,1200,13068
629811340,5/8/2015,770000.0,4,3.0,2800,9127,2.0,0.0,0.0,3,9,2800,0,1999,0,98074,47.6123,-122.007,2780,8165,5,8,2015,UNK,20,962
9808700650,3/13/2015,1210000.0,3,2.25,1590,8520,2.0,0.0,0.0,4,8,1590,0,1980,0,98004,47.6477,-122.21600000000001,2470,12005,3,13,2015,UNK,-880,-3485
8964800755,1/16/2015,1590000.0,4,2.25,3240,11131,1.0,0.0,0.0,4,9,2080,1160,1953,0,98004,47.6182,-122.215,2300,12150,1,16,2015,UNK,940,-1019
1126059095,5/26/2014,880000.0,3,2.0,2130,35169,1.0,0.0,0.0,4,8,2130,0,1989,0,98072,47.7489,-122.12299999999999,2860,43560,5,26,2014,UNK,-730,-8391
1899400365,6/20/2014,332000.0,3,2.0,1510,7884,1.0,0.0,0.0,3,6,1510,0,1942,2014,98166,47.4683,-122.348,1050,7620,6,20,2014,Y,460,264
259800410,11/6/2014,445000.0,3,1.75,1750,7200,1.0,0.0,0.0,3,7,1750,0,1966,0,98008,47.6289,-122.119,1810,7590,11,6,2014,UNK,-60,-390
3523069047,8/25/2014,849000.0,4,2.75,4010,87555,2.0,0.0,0.0,3,10,4010,0,2004,0,98038,47.4299,-121.99799999999999,2451,209523,8,25,2014,N,1559,-121968
6852700476,12/11/2014,752000.0,4,1.5,1650,2970,1.5,0.0,0.0,3,7,1650,0,1903,0,98102,47.6233,-122.319,1670,2970,12,11,2014,UNK,-20,0
424049043,8/11/2014,450000.0,9,7.5,4050,6504,2.0,0.0,0.0,3,7,4050,0,1996,0,98144,47.5923,-122.301,1448,3866,8,11,2014,UNK,2602,2638
7646900360,9/18/2014,420000.0,3,1.0,1320,5500,1.0,0.0,0.0,3,7,1320,0,1955,0,98116,47.5705,-122.398,1480,5250,9,18,2014,UNK,-160,250
2991000220,3/17/2015,330000.0,4,2.5,2310,6320,2.0,0.0,0.0,3,8,2310,0,1997,0,98092,47.3287,-122.167,1850,6181,3,17,2015,UNK,460,139
3034200366,12/3/2014,409000.0,3,1.75,1440,9065,1.0,0.0,0.0,4,8,1440,0,1972,0,98133,47.7163,-122.333,1990,8812,12,3,2014,UNK,-550,253
5127000410,6/27/2014,350000.0,5,1.75,2330,14322,1.0,0.0,0.0,4,7,1180,1150,1968,0,98059,47.4768,-122.155,1690,10010,6,27,2014,UNK,640,4312
2826079101,4/15/2015,570000.0,4,2.5,2430,44001,1.0,0.0,0.0,3,8,2430,0,1994,0,98019,47.7125,-121.916,2200,46924,4,15,2015,UNK,230,-2923
3972900195,9/16/2014,315000.0,3,1.0,1390,8333,1.0,0.0,0.0,3,7,1390,0,1982,0,98155,47.7652,-122.31,1320,7090,9,16,2014,UNK,70,1243
8018600870,10/6/2014,224000.0,2,1.0,1150,15000,1.0,0.0,0.0,3,6,1060,90,1930,2013,98168,47.4935,-122.316,1350,15000,10,6,2014,Y,-200,0
257000038,10/6/2014,293550.0,4,1.75,2120,9706,1.0,0.0,0.0,3,7,1370,750,1965,0,98168,47.4939,-122.29700000000001,1730,11337,10,6,2014,UNK,390,-1631
7981900110,10/3/2014,350000.0,4,2.75,2300,3175,1.5,0.0,0.0,3,6,1340,960,1966,0,98144,47.5732,-122.305,1260,3175,10,3,2014,UNK,1040,0
8965500880,9/16/2014,1110000.0,4,2.5,3320,9380,2.0,0.0,3.0,3,10,3320,0,1988,0,98006,47.5655,-122.11399999999999,2870,11779,9,16,2014,UNK,450,-2399
5253300437,3/19/2015,442500.0,4,2.5,2400,7092,2.0,0.0,0.0,3,7,2400,0,1997,0,98133,47.7522,-122.338,2350,8310,3,19,2015,UNK,50,-1218
2523069172,8/4/2014,616500.0,3,2.5,3580,118047,1.0,0.0,0.0,3,9,3240,340,1992,0,98027,47.4453,-121.98,3240,123275,8,4,2014,UNK,340,-5228
6388910360,11/19/2014,506400.0,3,2.5,2100,9040,1.0,0.0,0.0,3,8,1700,400,1989,0,98056,47.5329,-122.17299999999999,2430,8809,11,19,2014,UNK,-330,231
7326200110,12/22/2014,324000.0,3,2.25,1550,4411,2.0,0.0,0.0,3,7,1550,0,2001,0,98019,47.7373,-121.96600000000001,1620,4621,12,22,2014,UNK,-70,-210
3701900085,8/5/2014,169000.0,3,1.5,1570,6450,1.5,0.0,0.0,4,6,1570,0,1931,0,98022,47.2021,-121.99600000000001,1400,6450,8,5,2014,UNK,170,0
9376301520,5/29/2014,595000.0,3,2.0,1480,5000,1.0,0.0,0.0,4,7,750,730,1928,0,98117,47.6859,-122.37,1250,4000,5,29,2014,UNK,230,1000
2111000580,5/21/2014,299900.0,3,2.5,2720,6014,2.0,0.0,0.0,3,7,2720,0,2002,0,98092,47.3344,-122.17399999999999,2760,6537,5,21,2014,UNK,-40,-523
8645510230,5/29/2014,332000.0,3,2.25,2270,8876,1.0,0.0,0.0,3,7,1380,890,1977,0,98058,47.4653,-122.176,2150,7455,5,29,2014,UNK,120,1421
6204410330,10/20/2014,432000.0,4,1.75,2410,8400,1.0,0.0,0.0,3,7,1600,810,1978,0,98011,47.7341,-122.2,1850,8400,10,20,2014,UNK,560,0
8159300040,10/2/2014,510000.0,4,2.75,2730,9112,1.0,0.0,2.0,3,9,1740,990,1996,0,98198,47.4005,-122.31200000000001,3050,10454,10,2,2014,UNK,-320,-1342
8091410530,5/1/2015,270000.0,3,2.5,1540,7739,2.0,0.0,0.0,4,7,1540,0,1986,0,98030,47.3511,-122.169,1720,7200,5,1,2015,UNK,-180,539
8653600100,3/30/2015,750000.0,5,2.5,3120,15593,2.0,0.0,4.0,3,11,3120,0,1986,0,98074,47.6142,-122.065,3390,17003,3,30,2015,UNK,-270,-1410
9550202730,10/14/2014,509250.0,2,1.5,1480,3120,1.0,0.0,0.0,3,7,930,550,1914,2007,98105,47.6684,-122.323,1000,3780,10,14,2014,Y,480,-660
8651410740,2/19/2015,189000.0,3,1.0,860,5200,1.0,0.0,0.0,5,6,860,0,1969,0,98042,47.3677,-122.07799999999999,1010,5200,2,19,2015,UNK,-150,0
225039177,12/8/2014,726500.0,4,2.5,2180,3893,2.0,0.0,0.0,3,8,2180,0,1999,0,98117,47.6886,-122.38799999999999,1710,4550,12,8,2014,UNK,470,-657
6082400191,6/19/2014,287000.0,3,2.0,1300,11374,1.5,0.0,0.0,5,7,1300,0,1933,0,98168,47.4839,-122.302,1480,9670,6,19,2014,UNK,-180,1704
3622069095,9/17/2014,679000.0,4,3.5,3420,49223,2.0,0.0,0.0,3,9,3420,0,2004,0,98010,47.3534,-121.992,3580,49223,9,17,2014,N,-160,0
6666860210,6/2/2014,316000.0,3,2.25,2130,8721,1.0,0.0,0.0,3,8,1570,0,1987,0,98031,47.4202,-122.204,2130,9477,6,2,2014,UNK,0,-756
8161000230,4/27/2015,498000.0,4,2.5,2300,22445,2.0,0.0,0.0,4,8,2300,0,1992,0,98014,47.6454,-121.902,2640,21886,4,27,2015,UNK,-340,559
7214820610,10/7/2014,448000.0,4,1.75,2560,8270,1.0,0.0,0.0,3,7,1480,1080,1979,0,98072,47.7572,-122.147,2320,8450,10,7,2014,UNK,240,-180
434000040,5/27/2014,535000.0,2,1.0,1040,5527,1.0,0.0,0.0,3,7,1040,0,1951,0,98115,47.6774,-122.28399999999999,2080,7020,5,27,2014,UNK,-1040,-1493
8914200220,1/16/2015,560000.0,4,3.0,3080,9601,2.0,0.0,1.0,3,10,3080,0,1990,0,98003,47.333999999999996,-122.33200000000001,3200,9375,1,16,2015,UNK,-120,226
6072760210,10/2/2014,437850.0,4,2.25,2670,14255,1.0,0.0,0.0,4,8,1610,1060,1975,0,98006,47.5623,-122.175,2470,10290,10,2,2014,UNK,200,3965
9485950040,6/6/2014,435000.0,4,2.75,3270,50994,2.0,0.0,0.0,4,8,2720,550,1983,0,98042,47.347,-122.087,2780,36036,6,6,2014,UNK,490,14958
4027700456,6/19/2014,510000.0,4,2.5,2610,8031,2.0,0.0,0.0,3,8,2610,0,1998,0,98155,47.7717,-122.27,2320,8031,6,19,2014,UNK,290,0
1023059365,5/6/2014,520000.0,3,2.5,2460,54885,2.0,0.0,0.0,4,8,2460,0,1980,0,98059,47.4996,-122.146,2770,21407,5,6,2014,UNK,-310,33478
8944600620,7/3/2014,509000.0,2,1.5,1930,3521,2.0,0.0,0.0,3,8,1930,0,1989,0,98007,47.6092,-122.146,1840,3576,7,3,2014,UNK,90,-55
2997800090,4/6/2015,575000.0,3,1.0,1220,5652,1.0,0.0,0.0,3,6,1220,0,1905,0,98116,47.5767,-122.40799999999999,1490,2467,4,6,2015,UNK,-270,3185
2787700150,4/22/2015,365000.0,4,2.5,2030,7210,1.0,0.0,0.0,5,7,1330,0,1969,0,98059,47.5067,-122.16,1980,7560,4,22,2015,UNK,50,-350
4055701110,6/12/2014,795000.0,3,2.0,2420,17859,1.0,0.0,1.0,5,9,1500,920,1979,0,98034,47.7074,-122.24600000000001,2955,17859,6,12,2014,UNK,-535,0
2517000790,6/11/2014,285000.0,3,2.5,1870,4060,2.0,0.0,0.0,3,7,1870,0,2005,0,98042,47.3986,-122.163,2190,4060,6,11,2014,N,-320,0
2125059124,6/2/2014,955000.0,3,2.25,3020,43560,2.0,0.0,0.0,3,10,2720,300,1969,0,98005,47.6456,-122.17299999999999,3910,43560,6,2,2014,UNK,-890,0
7284900405,7/14/2014,775000.0,4,2.5,2880,8400,2.0,0.0,4.0,3,8,2050,830,1955,1987,98177,47.7704,-122.38600000000001,2880,7440,7,14,2014,Y,0,960
3937900120,10/6/2014,400000.0,4,3.0,1810,5012,2.0,0.0,0.0,4,7,1810,0,1997,0,98108,47.5691,-122.292,1670,5161,10,6,2014,UNK,140,-149
200520120,7/1/2014,570000.0,4,2.5,2590,8483,2.0,0.0,0.0,3,9,2590,0,1991,0,98011,47.738,-122.221,2660,8717,7,1,2014,UNK,-70,-234
7203220360,10/20/2014,955990.0,5,3.25,3830,6507,2.0,0.0,0.0,3,9,3830,0,2014,0,98053,47.6843,-122.016,3950,6723,10,20,2014,N,-120,-216
3425059219,9/29/2014,1150000.0,3,2.25,3250,34848,1.0,0.0,0.0,3,10,2260,990,2006,0,98005,47.6077,-122.15799999999999,2770,21512,9,29,2014,N,480,13336
5469502170,4/14/2015,459950.0,4,2.0,2760,21465,1.0,0.0,0.0,4,9,2120,640,1979,0,98042,47.3818,-122.165,2550,13144,4,14,2015,UNK,210,8321
6303401395,2/19/2015,245000.0,2,1.75,1220,8382,1.0,0.0,0.0,3,6,1220,0,1942,0,98146,47.5033,-122.359,1100,8382,2,19,2015,UNK,120,0
8822901301,9/8/2014,281000.0,3,1.5,1280,974,3.0,0.0,0.0,3,7,1280,0,2003,0,98125,47.7162,-122.29299999999999,1420,1422,9,8,2014,UNK,-140,-448
6730700385,10/22/2014,205000.0,3,0.75,770,7000,1.0,0.0,0.0,3,4,770,0,1942,0,98024,47.5661,-121.887,950,10500,10,22,2014,UNK,-180,-3500
4396000530,6/11/2014,290000.0,3,1.75,1520,15090,1.0,0.0,0.0,4,7,1520,0,1968,0,98038,47.398,-121.964,1580,18618,6,11,2014,UNK,-60,-3528
4077800590,2/26/2015,635000.0,4,2.5,2080,11176,1.0,0.0,0.0,5,8,2080,0,1954,0,98125,47.7107,-122.289,1390,7928,2,26,2015,UNK,690,3248
2461900845,9/3/2014,310000.0,1,1.0,570,6000,1.0,0.0,0.0,2,5,570,0,1918,0,98136,47.5517,-122.385,1530,6000,9,3,2014,UNK,-960,0
5366200330,1/14/2015,470000.0,4,2.0,1500,3659,1.0,0.0,0.0,3,7,830,670,1906,0,98122,47.6088,-122.29299999999999,1560,3706,1,14,2015,UNK,-60,-47
6899990230,7/1/2014,600000.0,2,2.5,2510,14878,2.0,0.0,0.0,3,10,2510,0,1990,0,98011,47.7525,-122.205,3080,13594,7,1,2014,UNK,-570,1284
7950700120,12/17/2014,279000.0,4,2.0,1980,10051,1.0,0.0,0.0,3,7,1980,0,1969,2003,98092,47.3231,-122.103,1520,10125,12,17,2014,Y,460,-74
7852090180,8/4/2014,538500.0,3,3.5,2500,4270,2.0,0.0,0.0,3,8,2500,0,2000,0,98065,47.536,-121.87700000000001,2420,4205,8,4,2014,UNK,80,65
3066410850,7/9/2014,594950.0,4,2.5,2720,10006,2.0,0.0,0.0,3,9,2720,0,1989,0,98074,47.6295,-122.042,2720,10759,7,9,2014,UNK,0,-753
2422059015,8/8/2014,533050.0,2,1.0,910,295772,1.0,0.0,0.0,3,5,910,0,1953,0,98042,47.3752,-122.11,2050,48351,8,8,2014,UNK,-1140,247421
7436500360,6/6/2014,510000.0,3,1.75,1480,7040,1.0,0.0,0.0,3,7,1480,0,1974,0,98033,47.6723,-122.169,2040,7810,6,6,2014,UNK,-560,-770
984210590,9/29/2014,360000.0,4,2.25,2470,8686,1.0,0.0,0.0,4,7,1270,1200,1974,0,98058,47.4371,-122.166,1900,7350,9,29,2014,UNK,570,1336
8024202350,7/21/2014,435000.0,2,1.0,1650,5106,1.0,0.0,0.0,3,7,1090,560,1960,0,98115,47.6992,-122.309,1300,6947,7,21,2014,UNK,350,-1841
6392002020,3/24/2015,559000.0,3,1.75,1700,6500,1.0,0.0,0.0,3,8,1700,0,1967,0,98115,47.6837,-122.28399999999999,1880,6000,3,24,2015,UNK,-180,500
6398000191,8/27/2014,645000.0,2,1.5,1995,115670,1.5,0.0,1.0,4,8,1995,0,1991,0,98070,47.4022,-122.464,2142,29375,8,27,2014,UNK,-147,86295
3904100065,10/28/2014,340000.0,2,1.0,1280,9690,1.0,0.0,0.0,4,6,640,640,1919,0,98118,47.5341,-122.279,1630,15884,10,28,2014,UNK,-350,-6194
5535600150,3/12/2015,565000.0,4,2.5,2980,10459,2.0,0.0,0.0,3,9,2980,0,2001,0,98019,47.7354,-121.97399999999999,2920,7700,3,12,2015,UNK,60,2759
8024200820,2/13/2015,575700.0,3,1.75,1730,6130,1.0,0.0,0.0,3,7,1480,250,1941,0,98115,47.6978,-122.316,1730,6131,2,13,2015,UNK,0,-1
9301300215,6/17/2014,1010000.0,3,3.25,2420,1923,2.0,0.0,2.0,3,10,1840,580,2006,0,98109,47.637,-122.34100000000001,1840,2890,6,17,2014,N,580,-967
1122069006,7/10/2014,540500.0,3,2.0,2800,185130,1.0,0.0,0.0,3,8,2320,480,1996,0,98038,47.4133,-122.006,2200,72055,7,10,2014,UNK,600,113075
5379801972,8/18/2014,265000.0,5,4.0,1400,8580,1.0,0.0,0.0,5,7,900,500,1954,0,98188,47.456,-122.292,1220,8832,8,18,2014,UNK,180,-252
4077800088,8/11/2014,699950.0,4,2.0,2070,7830,1.0,0.0,1.0,5,7,1180,890,1941,0,98125,47.7058,-122.27799999999999,2390,7830,8,11,2014,UNK,-320,0
1823069059,6/11/2014,355000.0,1,1.75,750,20339,1.0,0.0,0.0,4,4,550,200,1946,0,98059,47.4756,-122.09,2020,23958,6,11,2014,UNK,-1270,-3619
7979900215,6/11/2014,381000.0,3,1.5,1460,11407,1.0,0.0,0.0,3,7,1460,0,1954,0,98155,47.746,-122.294,1470,11407,6,11,2014,UNK,-10,0
5101404444,4/14/2015,564000.0,5,2.25,2140,8700,1.0,0.0,2.0,3,8,1220,920,1962,0,98115,47.6969,-122.31,1720,6670,4,14,2015,UNK,420,2030
892000025,7/10/2014,114975.0,2,1.0,740,6250,1.0,0.0,0.0,3,6,740,0,1942,0,98146,47.506,-122.335,980,6957,7,10,2014,UNK,-240,-707
6303400395,1/30/2015,325000.0,1,0.75,410,8636,1.0,0.0,0.0,2,4,410,0,1953,0,98146,47.5077,-122.35700000000001,1190,8636,1,30,2015,UNK,-780,0
2320069189,10/27/2014,299990.0,2,1.0,1570,125452,1.0,0.0,3.0,4,7,1570,0,1953,0,98022,47.2077,-122.016,1660,46119,10,27,2014,UNK,-90,79333
2568200610,5/13/2015,751000.0,5,2.75,2860,5280,2.0,0.0,0.0,3,9,2860,0,2006,0,98052,47.707,-122.102,3150,6442,5,13,2015,N,-290,-1162
6073230230,12/31/2014,425000.0,3,2.25,1400,6970,2.0,0.0,0.0,3,8,1400,0,1984,0,98006,47.542,-122.184,1800,8140,12,31,2014,UNK,-400,-1170
1024049006,1/14/2015,665000.0,3,1.75,2700,5040,1.0,0.0,2.0,3,8,1560,1140,1947,0,98144,47.5834,-122.29,3010,5000,1,14,2015,UNK,-310,40
823069044,3/25/2015,833450.0,5,4.0,4460,269345,2.0,0.0,4.0,3,9,3330,1130,1996,0,98027,47.4992,-122.06,2670,115434,3,25,2015,UNK,1790,153911
2926049086,10/28/2014,575000.0,7,1.5,2670,11250,1.5,0.0,0.0,4,8,2320,350,1948,0,98133,47.7121,-122.33200000000001,2030,9000,10,28,2014,UNK,640,2250
5127001320,11/25/2014,190000.0,3,1.75,1520,9600,1.0,0.0,0.0,4,7,1520,0,1967,0,98059,47.473,-122.149,1590,10183,11,25,2014,UNK,-70,-583
5127001320,2/23/2015,314950.0,3,1.75,1520,9600,1.0,0.0,0.0,4,7,1520,0,1967,0,98059,47.473,-122.149,1590,10183,2,23,2015,UNK,-70,-583
1994200375,12/3/2014,601150.0,2,2.0,1660,5200,1.0,0.0,0.0,5,7,1120,540,1906,0,98103,47.6871,-122.334,1260,5160,12,3,2014,UNK,400,40
7100000035,12/12/2014,315000.0,2,1.0,860,8308,1.0,0.0,0.0,3,7,860,0,1948,0,98146,47.508,-122.37799999999999,1200,8308,12,12,2014,UNK,-340,0
6329000705,4/2/2015,545000.0,2,1.5,2340,13380,1.0,0.0,0.0,4,7,1280,1060,1954,0,98146,47.5017,-122.37700000000001,1490,8100,4,2,2015,UNK,850,5280
7524950870,5/19/2014,565000.0,4,2.25,2110,10698,2.0,0.0,0.0,4,8,2110,0,1979,0,98027,47.5614,-122.08200000000001,2220,8252,5,19,2014,UNK,-110,2446
9564800145,5/6/2014,175000.0,3,1.0,1010,7034,1.0,0.0,0.0,3,7,1010,0,1954,0,98055,47.49,-122.22,1440,10994,5,6,2014,UNK,-430,-3960
2077700042,6/26/2014,530000.0,3,2.0,2330,26571,2.5,0.0,0.0,3,8,2330,0,1987,0,98005,47.6009,-122.15799999999999,2030,20037,6,26,2014,UNK,300,6534
3835500195,6/18/2014,4490000.0,4,3.0,6430,27517,2.0,0.0,0.0,3,12,6430,0,2001,0,98004,47.6208,-122.219,3720,14592,6,18,2014,UNK,2710,12925
259000100,10/7/2014,430000.0,3,1.75,1610,7900,1.0,0.0,0.0,4,8,1310,300,1960,0,98177,47.7588,-122.36,2210,7700,10,7,2014,UNK,-600,200
1796360870,10/30/2014,225000.0,3,1.75,1460,8372,1.0,0.0,0.0,4,7,1460,0,1981,0,98042,47.3683,-122.087,1220,7803,10,30,2014,UNK,240,569
923049440,7/17/2014,312000.0,5,4.0,2900,9779,2.0,0.0,0.0,4,7,1950,950,1937,0,98168,47.5003,-122.306,1360,8000,7,17,2014,UNK,1540,1779
9144100298,3/2/2015,380000.0,3,1.0,1260,7980,1.0,0.0,0.0,3,7,1260,0,1951,0,98177,47.7013,-122.37299999999999,1760,7606,3,2,2015,UNK,-500,374
3223049158,4/17/2015,222200.0,2,1.0,1210,10000,1.0,0.0,0.0,3,7,1210,0,1953,0,98148,47.4402,-122.333,1620,10959,4,17,2015,UNK,-410,-959
5456000025,12/1/2014,1440000.0,5,3.5,3420,8000,2.0,0.0,0.0,3,10,3420,0,2006,0,98040,47.5736,-122.212,1900,8000,12,1,2014,N,1520,0
3558000120,7/2/2014,329950.0,4,2.5,2120,4558,2.0,0.0,0.0,3,7,2120,0,2002,0,98038,47.3795,-122.022,2370,5506,7,2,2014,UNK,-250,-948
6133100120,9/23/2014,995000.0,3,2.5,2460,10300,1.0,0.0,0.0,3,10,2460,0,1992,0,98117,47.6999,-122.391,2410,5250,9,23,2014,UNK,50,5050
5608000590,7/14/2014,929950.0,3,3.5,3790,10829,2.0,0.0,0.0,3,11,3790,0,1993,0,98027,47.5525,-122.098,3620,10989,7,14,2014,UNK,170,-160
8651480090,3/27/2015,692000.0,4,2.5,2350,9779,1.0,0.0,0.0,3,10,2350,0,1987,0,98074,47.6411,-122.065,2700,10441,3,27,2015,UNK,-350,-662
2768301490,6/26/2014,402000.0,2,1.0,620,2475,1.0,0.0,0.0,5,6,620,0,1911,0,98107,47.6655,-122.37100000000001,1290,2475,6,26,2014,UNK,-670,0
3325069060,9/12/2014,510000.0,3,1.75,1920,43560,1.0,0.0,0.0,4,7,1340,580,1962,0,98074,47.6052,-122.044,2540,58806,9,12,2014,UNK,-620,-15246
8802400411,6/19/2014,249000.0,3,1.0,1050,8498,1.0,0.0,0.0,4,7,1050,0,1959,0,98031,47.4043,-122.20200000000001,1050,8498,6,19,2014,UNK,0,0
2953000090,12/2/2014,244900.0,3,1.5,1360,9980,1.0,0.0,0.0,4,7,1360,0,1966,0,98031,47.4143,-122.206,1360,9750,12,2,2014,UNK,0,230
7657600025,2/19/2015,289900.0,3,1.0,1180,7068,1.0,0.0,0.0,3,6,1180,0,1944,0,98178,47.4947,-122.238,1180,7068,2,19,2015,UNK,0,0
8118600025,3/31/2015,552500.0,4,1.0,1560,7980,1.0,0.0,0.0,4,7,1170,390,1939,0,98146,47.5093,-122.387,1570,7980,3,31,2015,UNK,-10,0
326069118,6/30/2014,760000.0,4,2.5,3300,165528,2.0,0.0,0.0,3,8,3300,0,1984,0,98077,47.7657,-122.02799999999999,3030,144696,6,30,2014,UNK,270,20832
2902200838,10/27/2014,440000.0,2,2.75,1100,1088,2.0,0.0,0.0,3,7,750,350,2006,0,98102,47.6405,-122.324,2090,4125,10,27,2014,N,-990,-3037
798000062,8/1/2014,286000.0,3,1.75,1770,9000,1.0,0.0,0.0,3,7,1090,680,1954,0,98168,47.4997,-122.32600000000001,1520,21141,8,1,2014,UNK,250,-12141
3298700941,9/5/2014,260000.0,3,1.0,1200,4592,1.0,0.0,0.0,3,6,800,400,1950,0,98106,47.519,-122.352,940,4440,9,5,2014,UNK,260,152
114100155,6/27/2014,355000.0,2,2.25,1330,10838,2.0,0.0,0.0,3,8,1330,0,1985,0,98028,47.7689,-122.241,1390,10310,6,27,2014,UNK,-60,528
5151600360,1/30/2015,318000.0,3,1.75,1570,12506,1.0,0.0,0.0,4,8,1570,0,1959,0,98003,47.3365,-122.319,2120,13243,1,30,2015,UNK,-550,-737
523049106,8/26/2014,255000.0,2,1.0,1610,19965,1.0,0.0,0.0,3,7,1610,0,1952,0,98168,47.5095,-122.31299999999999,2100,28400,8,26,2014,UNK,-490,-8435
3751600025,5/14/2014,139000.0,3,1.0,1100,17334,1.0,0.0,0.0,3,7,1100,0,1978,0,98001,47.3003,-122.27,1530,18694,5,14,2014,UNK,-430,-1360
6918730230,4/1/2015,485000.0,4,2.25,1810,7068,2.0,0.0,0.0,5,7,1810,0,1976,0,98034,47.7319,-122.204,1460,7274,4,1,2015,UNK,350,-206
3226079059,10/19/2014,549950.0,3,1.75,2930,266587,2.0,0.0,0.0,3,8,2440,0,1995,0,98014,47.6991,-121.947,2700,438213,10,19,2014,UNK,230,-171626
9521100880,9/16/2014,588000.0,3,1.5,1780,4200,1.5,0.0,0.0,4,8,1780,0,1916,0,98103,47.662,-122.34899999999999,1380,3333,9,16,2014,UNK,400,867
425049146,7/15/2014,975000.0,3,2.5,3050,7410,1.5,0.0,0.0,5,8,1950,1100,1950,0,98115,47.6772,-122.296,1890,5814,7,15,2014,UNK,1160,1596
3630010040,5/23/2014,402000.0,3,2.0,1540,1827,2.0,0.0,0.0,3,8,1540,0,2005,0,98029,47.5479,-121.99799999999999,1540,1827,5,23,2014,N,0,0
6620400025,5/1/2015,245000.0,3,1.0,1380,9875,1.0,0.0,0.0,3,7,1380,0,1959,0,98168,47.5131,-122.334,1200,6250,5,1,2015,UNK,180,3625
8886000021,6/16/2014,445000.0,3,1.75,1890,32340,1.5,0.0,3.0,3,8,1890,0,1976,0,98070,47.4137,-122.439,1890,40180,6,16,2014,UNK,0,-7840
766800090,5/25/2014,195000.0,3,1.75,1570,8459,1.0,0.0,0.0,3,7,1570,0,1991,0,98022,47.2016,-122.006,1650,8844,5,25,2014,UNK,-80,-385
4022900571,1/12/2015,385000.0,5,2.0,2540,11750,1.0,0.0,0.0,3,7,1480,1060,1962,0,98155,47.7754,-122.291,2000,12000,1,12,2015,UNK,540,-250
2206700165,7/16/2014,450000.0,3,1.5,1520,7903,1.0,0.0,0.0,4,7,1000,520,1955,0,98006,47.5659,-122.141,1520,9830,7,16,2014,UNK,0,-1927
4151800530,10/28/2014,1090000.0,4,2.5,2780,6837,2.0,0.0,0.0,3,9,2780,0,2004,0,98033,47.666000000000004,-122.20100000000001,1160,6837,10,28,2014,N,1620,0
8122600195,5/20/2014,396675.0,2,1.0,1730,6375,2.0,0.0,0.0,4,6,1730,0,1945,0,98126,47.5357,-122.368,1180,6250,5,20,2014,UNK,550,125
5379805160,10/2/2014,242000.0,5,2.25,2340,7494,1.0,0.0,0.0,3,7,1170,1170,1951,0,98188,47.448,-122.28,1650,10125,10,2,2014,UNK,690,-2631
323089095,10/31/2014,380000.0,3,1.75,1300,12378,1.0,0.0,0.0,4,6,1300,0,1943,0,98045,47.4996,-121.77799999999999,1300,11596,10,31,2014,UNK,0,782
9000025,12/3/2014,496000.0,2,1.0,1420,4635,2.0,0.0,0.0,4,7,1420,0,1941,1973,98115,47.68,-122.304,1810,4635,12,3,2014,Y,-390,0
8835200330,12/8/2014,399950.0,3,2.5,1470,4488,2.0,0.0,0.0,5,7,1470,0,1980,0,98034,47.723,-122.162,1400,4441,12,8,2014,UNK,70,47
1239400064,3/4/2015,895000.0,4,2.5,2850,8526,2.0,0.0,0.0,3,9,2850,0,1998,0,98033,47.6747,-122.191,2440,7072,3,4,2015,UNK,410,1454
2719100115,11/4/2014,690000.0,3,2.0,2360,6149,2.0,0.0,3.0,3,8,1560,0,1926,1989,98136,47.5433,-122.384,2000,6149,11,4,2014,Y,360,0
5589300361,9/2/2014,270000.0,3,1.5,1610,8375,2.0,0.0,0.0,3,7,1610,0,1927,0,98155,47.7527,-122.306,1610,9107,9,2,2014,UNK,0,-732
2523069146,6/23/2014,349900.0,3,2.0,2420,38781,1.0,0.0,0.0,5,7,1210,1210,1949,0,98027,47.4511,-121.976,2650,88426,6,23,2014,UNK,-230,-49645
3630020090,5/4/2015,454280.0,3,2.5,1470,1741,2.0,0.0,0.0,3,8,1170,300,2004,0,98029,47.5464,-121.999,1470,1583,5,4,2015,N,0,158
1775700011,5/12/2015,390000.0,3,2.5,1410,26375,1.0,0.0,0.0,3,6,1410,0,1992,0,98077,47.7432,-122.07600000000001,1410,12474,5,12,2015,UNK,0,13901
9264921110,1/15/2015,275000.0,3,1.75,1840,14005,1.0,0.0,0.0,3,8,1840,0,1983,0,98023,47.3124,-122.345,2170,7992,1,15,2015,UNK,-330,6013
6837820330,4/29/2015,300000.0,4,2.5,2450,8932,2.0,0.0,0.0,3,8,2450,0,1990,0,98023,47.3093,-122.345,2410,8775,4,29,2015,UNK,40,157
6822100750,5/8/2015,700000.0,3,1.75,1500,6000,1.0,0.0,0.0,5,7,850,650,1940,0,98199,47.6474,-122.402,1700,6000,5,8,2015,UNK,-200,0
6769200040,12/18/2014,520000.0,3,1.75,2080,6609,1.0,0.0,0.0,3,7,1280,800,1950,0,98115,47.6883,-122.3,1680,6270,12,18,2014,UNK,400,339
1668500090,4/2/2015,715000.0,3,2.5,2770,39529,2.0,0.0,0.0,3,9,2770,0,1987,0,98053,47.6495,-122.042,3010,35435,4,2,2015,UNK,-240,4094
5104530220,4/20/2015,404000.0,3,2.5,2370,4324,2.0,0.0,0.0,3,8,2370,0,2006,0,98038,47.3515,-121.999,2370,4348,4,20,2015,N,0,-24
726059048,9/26/2014,490500.0,3,2.0,3000,21883,2.0,0.0,0.0,3,7,1970,1030,1998,0,98011,47.7599,-122.214,2280,14025,9,26,2014,UNK,720,7858
8835401250,5/6/2015,1490000.0,6,2.75,4430,6440,2.0,0.0,3.0,3,10,2680,1750,1964,2015,98118,47.5462,-122.265,3530,7314,5,6,2015,Y,900,-874
6821100090,4/9/2015,557800.0,4,1.75,1550,6000,1.0,0.0,0.0,5,7,1550,0,1944,0,98199,47.6567,-122.399,1550,6000,4,9,2015,UNK,0,0
5072400100,4/13/2015,571000.0,4,2.25,2290,9900,1.0,0.0,2.0,4,8,1550,740,1959,0,98166,47.4434,-122.34299999999999,2320,9900,4,13,2015,UNK,-30,0
2781200090,7/8/2014,410000.0,4,2.5,2560,4020,2.0,0.0,0.0,3,9,2560,0,2006,0,98038,47.3533,-122.027,3010,4916,7,8,2014,N,-450,-896
4006000580,3/13/2015,225000.0,3,1.5,1240,5506,1.0,0.0,0.0,4,7,1240,0,1971,0,98118,47.5294,-122.285,1670,5589,3,13,2015,UNK,-430,-83
3825310530,7/16/2014,700000.0,4,2.5,2590,4498,2.0,0.0,0.0,3,9,2590,0,2004,0,98052,47.7047,-122.12799999999999,2660,5238,7,16,2014,N,-70,-740
3797000745,2/9/2015,500000.0,3,1.0,1370,3500,1.5,0.0,0.0,3,7,1370,0,1905,1985,98103,47.6857,-122.348,1590,4500,2,9,2015,Y,-220,-1000
7550801207,4/28/2015,536500.0,2,2.0,1360,1860,1.0,0.0,0.0,4,7,680,680,1925,0,98107,47.6727,-122.396,1440,5000,4,28,2015,UNK,-80,-3140
2468800040,4/10/2015,330000.0,3,2.5,2060,25046,1.0,0.0,0.0,4,8,1600,460,1980,0,98022,47.184,-121.959,2050,21255,4,10,2015,UNK,10,3791
8092700230,2/11/2015,249950.0,3,1.75,1120,15210,1.0,0.0,0.0,5,7,1120,0,1976,0,98042,47.3659,-122.113,1710,8470,2,11,2015,UNK,-590,6740
4435000490,10/15/2014,249000.0,4,1.75,1630,8410,1.5,0.0,0.0,5,7,1630,0,1943,0,98188,47.4538,-122.288,1390,8410,10,15,2014,UNK,240,0
3686900025,4/8/2015,249000.0,3,1.75,1590,7535,1.5,0.0,0.0,5,6,1590,0,1909,0,98032,47.3769,-122.234,1110,6000,4,8,2015,UNK,480,1535
2450500110,5/8/2014,780000.0,4,1.75,2480,9195,1.0,0.0,0.0,3,7,1390,1090,1950,0,98004,47.583999999999996,-122.195,2440,9195,5,8,2014,UNK,40,0
1257200315,7/5/2014,1200000.0,4,2.5,2700,4275,2.0,0.0,0.0,3,9,2700,0,2004,0,98115,47.6725,-122.32700000000001,1810,4500,7,5,2014,N,890,-225
3876312370,9/15/2014,434500.0,3,1.75,1930,7210,1.0,0.0,0.0,3,7,1110,820,1975,0,98072,47.735,-122.17399999999999,1870,7877,9,15,2014,UNK,60,-667
2821079081,10/10/2014,590000.0,4,2.0,2490,339332,1.0,0.0,0.0,3,8,2490,0,2002,0,98022,47.2725,-121.929,1910,129373,10,10,2014,UNK,580,209959
7550800915,2/19/2015,417200.0,2,1.0,1000,4000,1.0,0.0,0.0,3,6,1000,0,1910,0,98107,47.6742,-122.396,1490,5000,2,19,2015,UNK,-490,-1000
7504010750,9/24/2014,649990.0,4,2.25,2130,11900,2.0,0.0,0.0,3,9,2130,0,1976,0,98074,47.6408,-122.05799999999999,2590,11900,9,24,2014,UNK,-460,0
1175000110,12/2/2014,506000.0,2,1.0,1060,3588,1.0,0.0,0.0,4,7,960,100,1926,0,98107,47.6721,-122.395,1570,3741,12,2,2014,UNK,-510,-153
9320990090,4/21/2015,348000.0,3,2.5,1730,4004,2.0,0.0,0.0,3,7,1730,0,1999,0,98148,47.4317,-122.32799999999999,1730,5523,4,21,2015,UNK,0,-1519
3791400100,7/28/2014,301000.0,4,2.5,2810,6146,2.0,0.0,0.0,3,9,2810,0,1998,0,98031,47.4045,-122.208,2810,6180,7,28,2014,UNK,0,-34
6021503885,7/8/2014,427550.0,2,1.0,880,4000,1.0,0.0,0.0,3,7,880,0,1940,0,98117,47.6848,-122.38600000000001,1150,4000,7,8,2014,UNK,-270,0
7979900552,5/1/2015,361000.0,3,1.0,1040,6720,1.5,0.0,0.0,3,7,1040,0,1951,0,98155,47.7444,-122.294,1880,11407,5,1,2015,UNK,-840,-4687
5101405340,8/21/2014,460000.0,2,2.5,1830,8107,1.0,0.0,0.0,5,7,930,900,1946,0,98125,47.701,-122.305,1260,6960,8,21,2014,UNK,570,1147
5016003146,7/10/2014,958000.0,4,3.5,1800,6400,2.0,0.0,2.0,3,8,1800,0,1984,0,98112,47.625,-122.3,1700,4736,7,10,2014,UNK,100,1664
2734100065,6/12/2014,445000.0,5,1.75,2460,6846,1.5,0.0,0.0,5,7,1340,1120,1911,0,98108,47.5445,-122.321,1410,4800,6,12,2014,UNK,1050,2046
8029650040,5/19/2014,373000.0,3,2.5,1670,3565,2.0,0.0,0.0,3,7,1670,0,1999,0,98072,47.7623,-122.161,1510,3770,5,19,2014,UNK,160,-205
6204410150,4/14/2015,525000.0,4,2.25,2660,7957,1.0,0.0,0.0,4,8,1750,910,1977,0,98011,47.7351,-122.199,1890,8250,4,14,2015,UNK,770,-293
662310620,8/26/2014,364988.0,3,2.5,2850,12593,2.0,0.0,0.0,3,9,2850,0,1997,0,98023,47.2848,-122.345,2850,9435,8,26,2014,UNK,0,3158
924000040,8/14/2014,324000.0,2,1.0,820,8370,1.0,0.0,0.0,4,7,820,0,1941,0,98177,47.7256,-122.361,1410,8370,8,14,2014,UNK,-590,0
3333500096,3/5/2015,625000.0,4,3.0,2350,5627,1.0,0.0,0.0,5,8,1490,860,1960,0,98118,47.5514,-122.26799999999999,2020,5627,3,5,2015,UNK,330,0
349400100,9/8/2014,237500.0,3,1.75,1480,7830,1.0,0.0,0.0,3,7,1480,0,1980,0,98022,47.1967,-121.99799999999999,1130,7553,9,8,2014,UNK,350,277
3876000970,8/6/2014,429300.0,6,2.25,2930,15949,1.0,0.0,0.0,4,8,1730,1200,1965,0,98034,47.7188,-122.185,1730,8550,8,6,2014,UNK,1200,7399
7883603425,5/29/2014,155000.0,3,1.0,1250,6250,1.0,0.0,0.0,2,7,1030,220,1949,0,98108,47.5292,-122.323,1130,6250,5,29,2014,UNK,120,0
923000580,2/23/2015,614000.0,4,2.75,2760,8160,1.5,0.0,2.0,4,8,1780,980,1940,0,98177,47.7248,-122.365,2720,8160,2,23,2015,UNK,40,0
6635000110,3/31/2015,650000.0,3,2.5,2380,3332,2.0,0.0,0.0,3,9,2380,0,2014,0,98034,47.7194,-122.199,2590,4382,3,31,2015,N,-210,-1050
7000100775,7/21/2014,625000.0,3,2.0,1730,12219,1.0,0.0,0.0,4,7,1730,0,1986,0,98004,47.5825,-122.189,2470,13594,7,21,2014,UNK,-740,-1375
6383000690,3/25/2015,587100.0,3,2.25,1670,6414,1.0,0.0,0.0,4,8,1670,0,1961,0,98117,47.6921,-122.38600000000001,2130,7035,3,25,2015,UNK,-460,-621
9113600210,6/17/2014,380000.0,4,2.5,2150,37647,2.0,0.0,0.0,3,8,2150,0,1991,0,98042,47.3117,-122.083,2410,42193,6,17,2014,UNK,-260,-4546
5249804760,5/5/2015,479500.0,2,1.0,930,5760,1.0,0.0,0.0,3,6,730,200,1917,0,98118,47.5598,-122.266,1970,5760,5,5,2015,UNK,-1040,0
3364900156,3/17/2015,382888.0,1,1.0,620,2380,1.0,0.0,0.0,3,6,620,0,1900,0,98115,47.6746,-122.32600000000001,980,3570,3,17,2015,UNK,-360,-1190
117000001,5/27/2014,540000.0,4,4.25,1960,3565,2.0,0.0,0.0,3,7,1960,0,1940,2003,98116,47.5849,-122.384,1920,5750,5,27,2014,Y,40,-2185
7555200230,5/21/2014,691000.0,4,2.75,2550,8632,1.0,0.0,0.0,3,8,1700,850,1972,0,98033,47.6477,-122.197,2550,9534,5,21,2014,UNK,0,-902
9178600360,6/4/2014,760500.0,3,2.0,1990,3990,1.0,0.0,0.0,5,7,1130,860,1912,0,98103,47.6572,-122.333,1710,4000,6,4,2014,UNK,280,-10
7853301570,4/30/2015,685000.0,4,2.5,3550,10968,2.0,0.0,0.0,3,9,3550,0,2006,0,98065,47.5431,-121.88600000000001,3550,8583,4,30,2015,N,0,2385
5066400564,9/29/2014,199129.0,3,1.0,860,33664,1.0,0.0,0.0,4,6,860,0,1955,0,98001,47.295,-122.275,1290,18287,9,29,2014,UNK,-430,15377
9264950600,7/24/2014,335000.0,3,3.0,2031,7702,2.0,0.0,0.0,3,9,2031,0,1988,0,98023,47.3058,-122.348,2390,7700,7,24,2014,UNK,-359,2
4010800110,6/9/2014,305100.0,3,2.0,1590,35988,1.0,0.0,0.0,4,8,1590,0,1974,0,98058,47.4365,-122.10600000000001,2780,23789,6,9,2014,UNK,-1190,12199
1546600120,3/25/2015,830000.0,4,2.25,3010,12202,1.0,0.0,0.0,4,9,3010,0,1959,0,98005,47.6387,-122.17399999999999,2480,10143,3,25,2015,UNK,530,2059
4139440100,1/28/2015,810000.0,3,2.5,2610,8481,2.0,0.0,0.0,3,10,2610,0,1993,0,98006,47.5535,-122.115,3140,10008,1,28,2015,UNK,-530,-1527
1939050110,1/13/2015,500000.0,3,2.25,1440,15661,1.0,0.0,0.0,3,8,1180,260,1988,0,98074,47.6225,-122.038,1440,13963,1,13,2015,UNK,0,1698
6126601445,5/30/2014,490000.0,3,1.75,1920,5405,1.0,0.0,2.0,4,7,960,960,1947,0,98126,47.5583,-122.38,1190,5405,5,30,2014,UNK,730,0
9274200620,10/28/2014,490000.0,2,1.75,1670,4200,2.0,0.0,0.0,3,7,1670,0,1912,0,98116,47.5862,-122.387,1340,2875,10,28,2014,UNK,330,1325
2868300061,9/18/2014,272000.0,4,1.75,1390,10660,1.0,0.0,0.0,4,7,1030,360,1960,0,98198,47.4128,-122.323,1800,11960,9,18,2014,UNK,-410,-1300
3831200210,9/10/2014,280000.0,3,2.25,2140,7200,2.0,0.0,0.0,4,7,2140,0,1979,0,98031,47.3913,-122.191,1890,7455,9,10,2014,UNK,250,-255
7301300150,6/25/2014,233000.0,3,1.0,1250,6180,1.5,0.0,0.0,3,7,1250,0,1955,0,98155,47.7474,-122.32700000000001,1490,6180,6,25,2014,UNK,-240,0
3368900084,6/23/2014,275000.0,3,1.0,1080,6000,1.0,0.0,0.0,4,7,1080,0,1952,0,98133,47.7579,-122.33,1200,7210,6,23,2014,UNK,-120,-1210
8856500220,7/28/2014,375000.0,3,3.25,2760,6420,2.0,0.0,2.0,3,9,2110,650,1991,0,98031,47.3895,-122.221,2030,7725,7,28,2014,UNK,730,-1305
9527310110,8/26/2014,445000.0,3,2.75,2180,3703,2.0,0.0,0.0,3,8,2180,0,2004,0,98011,47.776,-122.169,2190,3963,8,26,2014,N,-10,-260
2767604712,9/19/2014,437500.0,3,2.5,1260,1125,3.0,0.0,0.0,3,8,1260,0,2002,0,98107,47.6706,-122.381,1360,1250,9,19,2014,UNK,-100,-125
3336001515,5/11/2015,426250.0,4,1.0,1610,6000,1.5,0.0,0.0,4,7,1510,100,1905,0,98118,47.5261,-122.266,1430,6000,5,11,2015,UNK,180,0
5103900015,6/26/2014,358000.0,3,1.5,2450,12497,1.0,0.0,0.0,4,7,2450,0,1967,0,98065,47.5317,-121.834,1560,11700,6,26,2014,UNK,890,797
1025069255,10/23/2014,1180000.0,4,3.5,4150,49503,2.0,0.0,0.0,3,11,4150,0,2003,0,98053,47.6746,-122.01799999999999,3330,60137,10,23,2014,UNK,820,-10634
2724069010,4/30/2015,305000.0,2,1.0,960,8276,1.0,0.0,0.0,3,5,960,0,1939,0,98027,47.5322,-122.03299999999999,1620,6000,4,30,2015,UNK,-660,2276
8682262170,5/30/2014,415000.0,2,1.75,1340,4664,1.0,0.0,0.0,3,8,1340,0,2004,0,98053,47.7182,-122.03399999999999,1350,4236,5,30,2014,N,-10,428
1773100755,8/21/2014,520000.0,11,3.0,3000,4960,2.0,0.0,0.0,3,7,2400,600,1918,1999,98106,47.556000000000004,-122.363,1420,4960,8,21,2014,Y,1580,0
8691390770,10/13/2014,733000.0,4,3.5,3080,5974,2.0,0.0,0.0,3,9,3080,0,2003,0,98075,47.6007,-121.97399999999999,2950,5425,10,13,2014,UNK,130,549
7771300085,3/9/2015,411500.0,3,1.0,1130,8159,1.0,0.0,0.0,4,7,1130,0,1954,0,98133,47.7362,-122.333,1570,8162,3,9,2015,UNK,-440,-3
9194101388,9/19/2014,540000.0,3,1.75,2280,16671,1.5,0.0,0.0,4,6,1760,520,1909,0,98034,47.7096,-122.219,1850,9351,9,19,2014,UNK,430,7320
7633400110,2/24/2015,270500.0,3,1.5,1952,8613,1.0,0.0,0.0,4,7,1652,300,1960,0,98032,47.3715,-122.29,1400,8712,2,24,2015,UNK,552,-99
2767704302,4/10/2015,422250.0,2,1.5,1280,1256,2.0,0.0,0.0,3,8,1200,80,1998,0,98107,47.6741,-122.375,1390,1256,4,10,2015,UNK,-110,0
8562970040,5/16/2014,655000.0,5,3.25,3690,12353,2.0,0.0,0.0,5,9,3690,0,1977,0,98155,47.7672,-122.292,2290,9082,5,16,2014,UNK,1400,3271
8562720410,8/7/2014,1200000.0,5,3.25,4610,10576,2.0,0.0,3.0,3,11,3310,1300,2006,0,98027,47.5373,-122.07,4042,8321,8,7,2014,N,568,2255
120069059,8/4/2014,550000.0,3,2.5,2920,169448,2.5,0.0,0.0,3,9,2920,0,1990,0,98022,47.2492,-121.975,2360,326097,8,4,2014,UNK,560,-156649
9828702513,5/6/2014,460000.0,2,2.25,1230,929,2.0,0.0,0.0,3,8,1020,210,2004,0,98122,47.6191,-122.301,1270,1370,5,6,2014,N,-40,-441
7812800515,10/25/2014,159075.0,4,1.5,1580,6200,1.0,0.0,0.0,3,6,790,790,1944,0,98178,47.4971,-122.24,1320,6499,10,25,2014,UNK,260,-299
3363900155,12/9/2014,470000.0,2,1.0,1220,4000,1.5,0.0,0.0,4,6,1220,0,1908,0,98103,47.6801,-122.354,1580,4000,12,9,2014,UNK,-360,0
9448300061,7/8/2014,235000.0,2,1.0,1020,7920,1.0,0.0,0.0,3,6,1020,0,1939,0,98108,47.5558,-122.31,1530,6900,7,8,2014,UNK,-510,1020
1840300100,9/18/2014,309950.0,2,1.5,1510,9843,1.0,0.0,0.0,4,7,1510,0,1961,0,98188,47.4419,-122.27,1590,9368,9,18,2014,UNK,-80,475
4246000180,5/23/2014,433000.0,4,1.75,1830,9600,1.0,0.0,0.0,4,7,1010,820,1966,0,98006,47.5728,-122.125,1910,11100,5,23,2014,UNK,-80,-1500
7856000110,2/3/2015,895000.0,3,2.5,2750,10000,1.0,0.0,3.0,3,8,1650,1100,1967,0,98006,47.5644,-122.15299999999999,2490,10000,2,3,2015,UNK,260,0
2422059111,6/20/2014,291000.0,3,1.5,1860,60960,1.0,0.0,0.0,4,7,1140,720,1967,0,98042,47.3796,-122.102,2170,82764,6,20,2014,UNK,-310,-21804
1925069199,2/9/2015,835000.0,3,2.5,2720,13124,2.0,0.0,0.0,3,9,2720,0,1988,0,98052,47.6371,-122.094,2760,16200,2,9,2015,UNK,-40,-3076
2771603940,1/9/2015,640000.0,2,1.0,1360,5000,1.0,0.0,0.0,3,7,1200,160,1936,0,98199,47.6372,-122.39200000000001,1540,4000,1,9,2015,UNK,-180,1000
6028000090,1/26/2015,438000.0,3,2.25,2340,14279,1.0,0.0,0.0,3,8,1340,1000,1965,0,98006,47.5715,-122.124,2340,13600,1,26,2015,UNK,0,679
5126310110,7/22/2014,540000.0,4,2.5,2600,9935,2.0,0.0,0.0,3,8,2600,0,2005,0,98059,47.4865,-122.14200000000001,2830,7620,7,22,2014,N,-230,2315
7520000616,3/9/2015,325000.0,4,2.5,2090,7434,1.0,0.0,0.0,3,7,1090,1000,1993,0,98146,47.4962,-122.34899999999999,1260,8404,3,9,2015,UNK,830,-970
3343900120,1/26/2015,380000.0,4,1.75,2260,7200,1.5,0.0,0.0,5,7,1360,900,1924,0,98056,47.5122,-122.186,1410,7465,1,26,2015,UNK,850,-265
714000195,11/13/2014,510000.0,2,1.0,1390,5544,1.0,0.0,0.0,3,7,930,460,1947,0,98105,47.6696,-122.26700000000001,1710,6200,11,13,2014,UNK,-320,-656
2310100230,8/12/2014,380000.0,4,2.5,2300,7707,2.0,0.0,0.0,3,8,2300,0,2004,0,98038,47.3497,-122.044,2320,6035,8,12,2014,N,-20,1672
7856600900,6/16/2014,825000.0,4,2.5,2810,9800,1.0,0.0,0.0,4,8,1710,1100,1973,0,98006,47.5657,-122.149,2800,9800,6,16,2014,UNK,10,0
926069192,9/26/2014,880000.0,4,3.25,4060,52707,2.0,0.0,0.0,4,9,4060,0,1996,0,98077,47.7615,-122.041,3100,50755,9,26,2014,UNK,960,1952
3343302110,3/6/2015,1800000.0,3,3.0,2790,13295,2.0,1.0,4.0,4,10,2370,420,1933,1989,98006,47.5466,-122.197,3140,11949,3,6,2015,Y,-350,1346
5100403405,1/7/2015,790000.0,3,1.0,1290,6380,1.5,0.0,0.0,3,7,1290,0,1930,0,98115,47.6951,-122.319,1630,6380,1,7,2015,UNK,-340,0
3298700302,12/12/2014,287000.0,2,1.5,720,4346,1.0,0.0,0.0,4,6,720,0,1942,0,98106,47.5225,-122.351,790,4346,12,12,2014,UNK,-70,0
3333001430,9/12/2014,509000.0,3,3.0,2130,5000,1.5,0.0,0.0,3,7,1570,560,1913,0,98118,47.5451,-122.28399999999999,1638,4500,9,12,2014,UNK,492,500
8849700040,9/8/2014,270000.0,3,2.25,1750,8400,1.0,0.0,0.0,3,7,1350,400,1965,0,98188,47.4571,-122.272,2020,9110,9,8,2014,UNK,-270,-710
3256400051,7/8/2014,210000.0,3,2.0,960,9380,1.0,0.0,0.0,3,6,960,0,1949,0,98146,47.4852,-122.34299999999999,1460,9240,7,8,2014,UNK,-500,140
7283900551,11/24/2014,415000.0,3,1.0,1570,11752,1.5,0.0,0.0,5,8,1570,0,1930,0,98133,47.7686,-122.348,2010,8291,11,24,2014,UNK,-440,3461
5067400032,12/5/2014,550000.0,3,2.5,3070,14400,1.0,0.0,3.0,5,9,1720,1350,1985,0,98198,47.3716,-122.321,2020,18211,12,5,2014,UNK,1050,-3811
1370801020,7/9/2014,1250000.0,4,2.5,2920,5500,1.0,0.0,3.0,3,10,2030,890,1957,0,98199,47.6406,-122.412,3790,5500,7,9,2014,UNK,-870,0
3852900026,8/1/2014,499950.0,3,1.0,1870,4984,1.0,0.0,0.0,3,7,1120,750,1955,0,98116,47.5771,-122.391,1650,5750,8,1,2014,UNK,220,-766
1189000025,9/5/2014,659000.0,3,1.5,1540,5040,2.0,0.0,0.0,3,8,1540,0,1907,0,98122,47.6138,-122.29899999999999,1590,3600,9,5,2014,UNK,-50,1440
4047200580,3/2/2015,265000.0,2,1.5,1440,22081,2.0,0.0,0.0,3,7,1440,0,1990,0,98019,47.7698,-121.896,1440,19544,3,2,2015,UNK,0,2537
2607720150,6/5/2014,492000.0,4,3.75,2810,10840,2.0,0.0,2.0,4,8,2070,740,1994,0,98045,47.4861,-121.804,2370,11248,6,5,2014,UNK,440,-408
5459300040,8/13/2014,715000.0,4,2.5,2450,7700,1.0,0.0,0.0,3,8,1250,1200,1958,0,98040,47.5731,-122.212,2450,8000,8,13,2014,UNK,0,-300
2613200025,3/13/2015,175000.0,2,1.0,1330,28270,1.5,0.0,0.0,3,6,1330,0,1925,0,98168,47.4824,-122.274,1210,6926,3,13,2015,UNK,120,21344
686050100,11/28/2014,975000.0,4,3.5,3130,52322,2.0,0.0,0.0,3,9,2430,700,2011,0,98005,47.5932,-122.15899999999999,3200,5820,11,28,2014,N,-70,46502
2117700065,10/9/2014,306950.0,1,1.0,730,5005,1.0,0.0,0.0,4,5,730,0,1945,0,98117,47.6992,-122.36399999999999,1630,5667,10,9,2014,UNK,-900,-662
5742600115,4/7/2015,630000.0,4,2.0,2480,3680,1.5,0.0,0.0,4,7,1470,0,1916,0,98116,47.5686,-122.39200000000001,1500,5750,4,7,2015,UNK,980,-2070
2064800600,1/9/2015,367500.0,3,1.0,1270,8792,1.0,0.0,0.0,5,7,1270,0,1969,0,98056,47.5351,-122.17399999999999,1780,8792,1,9,2015,UNK,-510,0
34001765,3/25/2015,699950.0,3,3.25,2230,5460,1.0,0.0,1.0,4,8,1430,800,1977,0,98136,47.53,-122.38799999999999,2070,5600,3,25,2015,UNK,160,-140
1186000065,4/16/2015,1000000.0,3,3.0,2880,3750,2.0,0.0,0.0,3,9,2220,660,1909,1991,98122,47.6155,-122.29,1910,4000,4,16,2015,Y,970,-250
1687000220,10/16/2014,285000.0,4,2.5,2434,4400,2.0,0.0,0.0,3,8,2434,0,2007,0,98001,47.2874,-122.28299999999999,2434,4400,10,16,2014,N,0,0
7985400133,1/14/2015,215000.0,2,1.5,1120,1312,2.0,0.0,0.0,3,7,1000,120,2004,0,98106,47.534,-122.36399999999999,1560,1314,1,14,2015,N,-440,-2
3303980090,3/6/2015,1050000.0,4,2.5,4080,11054,2.0,0.0,0.0,3,11,4080,0,2001,0,98059,47.5188,-122.15100000000001,3520,11914,3,6,2015,UNK,560,-860
7855200120,5/9/2014,1370000.0,4,2.75,3720,9450,1.0,0.0,4.0,5,10,1960,1760,1962,0,98006,47.5627,-122.156,2900,8605,5,9,2014,UNK,820,845
2800031,4/1/2015,235000.0,3,1.0,1430,7599,1.5,0.0,0.0,4,6,1010,420,1930,0,98168,47.4783,-122.265,1290,10320,4,1,2015,UNK,140,-2721
2306400040,4/16/2015,604000.0,3,2.0,1560,2589,1.0,0.0,0.0,3,7,790,770,1923,0,98103,47.6587,-122.344,1450,3893,4,16,2015,UNK,110,-1304
5035300834,5/30/2014,750000.0,3,1.75,1700,8400,1.0,0.0,0.0,3,8,1460,240,1947,0,98199,47.6534,-122.415,2010,7000,5,30,2014,UNK,-310,1400
9542300530,11/24/2014,800000.0,4,2.25,2510,9963,1.0,0.0,0.0,4,9,2200,310,1967,0,98005,47.5973,-122.177,3110,9963,11,24,2014,UNK,-600,0
9191201250,1/7/2015,580000.0,5,2.0,2600,3750,1.5,0.0,0.0,4,6,1400,1200,1914,0,98105,47.6691,-122.29899999999999,1700,3750,1,7,2015,UNK,900,0
7950300775,12/4/2014,350000.0,1,1.0,790,4590,1.0,0.0,0.0,3,6,790,0,1911,0,98118,47.5677,-122.285,1070,4590,12,4,2014,UNK,-280,0
2934800025,12/16/2014,353750.0,4,2.0,1710,7490,2.0,0.0,0.0,3,7,1320,390,1956,0,98166,47.4544,-122.35700000000001,1880,7704,12,16,2014,UNK,-170,-214
7855400330,6/4/2014,1100000.0,5,2.75,2660,8737,1.0,0.0,4.0,5,8,1470,1190,1969,0,98006,47.5667,-122.155,3280,8783,6,4,2014,UNK,-620,-46
259600330,2/9/2015,465000.0,4,2.0,1470,10291,1.0,0.0,0.0,4,7,1470,0,1963,0,98008,47.6316,-122.12100000000001,1460,9601,2,9,2015,UNK,10,690
3723800409,5/7/2014,568000.0,3,2.0,2350,5080,1.5,0.0,0.0,3,8,1780,570,1929,0,98118,47.5516,-122.26299999999999,1700,5080,5,7,2014,UNK,650,0
5191100180,11/6/2014,1010000.0,5,2.0,2440,3080,2.0,0.0,0.0,4,8,2440,0,1910,0,98112,47.6242,-122.306,1640,3077,11,6,2014,UNK,800,3
257000057,9/16/2014,213500.0,3,1.5,1150,11571,1.0,0.0,0.0,3,7,1150,0,1961,0,98168,47.4931,-122.29799999999999,1630,11571,9,16,2014,UNK,-480,0
1771100330,6/5/2014,250000.0,3,2.5,1510,10384,1.0,0.0,0.0,2,7,1030,480,1976,0,98077,47.758,-122.071,1490,10000,6,5,2014,UNK,20,384
1782500035,7/3/2014,357000.0,2,1.0,870,4600,1.0,0.0,0.0,4,7,870,0,1942,0,98126,47.5274,-122.37899999999999,930,4600,7,3,2014,UNK,-60,0
7104100065,9/26/2014,425000.0,2,2.0,1280,4095,2.0,0.0,0.0,4,8,1280,0,1918,0,98136,47.5501,-122.39299999999999,1470,5500,9,26,2014,UNK,-190,-1405
200500610,6/11/2014,571000.0,3,2.5,2600,7465,2.0,0.0,0.0,3,9,2600,0,1988,0,98011,47.7387,-122.21700000000001,2660,7683,6,11,2014,UNK,-60,-218
7199320600,5/19/2014,588000.0,3,2.25,2030,7350,1.0,0.0,0.0,4,7,1190,840,1977,0,98052,47.6939,-122.126,1950,7350,5,19,2014,UNK,80,0
3322049201,5/23/2014,275000.0,4,1.5,1930,15531,2.0,0.0,0.0,3,7,1930,0,1979,0,98003,47.345,-122.296,1580,7800,5,23,2014,UNK,350,7731
5153200100,2/25/2015,565000.0,3,2.75,3210,15939,2.0,0.0,1.0,3,10,3210,0,1998,0,98023,47.3357,-122.351,2870,15939,2,25,2015,UNK,340,0
726059349,3/19/2015,460000.0,3,1.75,1970,9135,1.0,0.0,0.0,4,7,1370,600,1961,0,98011,47.7603,-122.215,1880,9650,3,19,2015,UNK,90,-515
8833510230,6/4/2014,603500.0,4,2.5,4060,9734,1.0,0.0,4.0,3,9,2150,1910,1977,0,98028,47.7678,-122.25399999999999,2750,10370,6,4,2014,UNK,1310,-636
7298000090,7/3/2014,490600.0,3,2.5,3316,11447,2.0,0.0,0.0,3,9,3316,0,1986,0,98023,47.3036,-122.34,3000,11447,7,3,2014,UNK,316,0
3885804225,6/24/2014,1010000.0,2,2.0,1460,9052,1.0,0.0,2.0,5,6,1460,0,1900,0,98033,47.6857,-122.208,2554,7834,6,24,2014,UNK,-1094,1218
2558600100,8/27/2014,500000.0,4,2.0,2100,12620,1.0,0.0,0.0,4,7,2100,0,1972,0,98034,47.7239,-122.17299999999999,1720,7840,8,27,2014,UNK,380,4780
7697920450,6/25/2014,249000.0,4,2.25,1830,6136,2.0,0.0,0.0,3,7,1830,0,1990,0,98030,47.367,-122.181,1830,7664,6,25,2014,UNK,0,-1528
8899200110,6/3/2014,235000.0,3,2.0,1530,8700,1.0,0.0,0.0,4,7,1530,0,1970,0,98055,47.4529,-122.20700000000001,1960,7600,6,3,2014,UNK,-430,1100
3992700775,1/21/2015,410000.0,4,2.0,1490,13736,1.0,0.0,0.0,4,6,1490,0,1942,0,98125,47.711999999999996,-122.281,2040,7200,1,21,2015,UNK,-550,6536
6384500035,7/1/2014,370000.0,2,1.0,860,6050,1.0,0.0,0.0,3,7,860,0,1952,0,98116,47.5697,-122.4,1130,6050,7,1,2014,UNK,-270,0
2787700210,9/16/2014,360000.0,5,2.5,2130,7111,1.0,0.0,0.0,3,7,1330,800,1968,0,98059,47.5071,-122.16,1840,7592,9,16,2014,UNK,290,-481
2524049018,12/5/2014,1410000.0,5,2.25,3580,16789,2.0,0.0,0.0,5,9,3580,0,1966,0,98040,47.5364,-122.23899999999999,3390,17000,12,5,2014,UNK,190,-211
7569450090,11/21/2014,298000.0,4,2.5,2420,3825,2.0,0.0,0.0,3,8,2420,0,2003,0,98042,47.3687,-122.126,1880,4250,11,21,2014,UNK,540,-425
123039570,7/8/2014,485000.0,4,2.25,1900,7200,1.0,0.0,0.0,3,8,1370,530,1977,0,98146,47.5033,-122.37200000000001,2030,8008,7,8,2014,UNK,-130,-808
6071300090,8/26/2014,400000.0,3,1.75,1330,9143,1.0,0.0,0.0,3,7,1330,0,1960,0,98006,47.5538,-122.176,1950,10384,8,26,2014,UNK,-620,-1241
4221250100,8/5/2014,580000.0,3,2.5,2150,4604,2.0,0.0,0.0,3,8,2150,0,2003,0,98075,47.5893,-122.01899999999999,2280,4253,8,5,2014,UNK,-130,351
8730000210,8/7/2014,355000.0,2,2.5,1370,1140,2.0,0.0,0.0,3,8,1080,290,2009,0,98133,47.7055,-122.34200000000001,1340,1050,8,7,2014,N,30,90
4178600100,7/21/2014,650000.0,3,2.5,2430,12997,2.0,0.0,0.0,3,9,2430,0,1992,0,98011,47.744,-122.194,2720,12500,7,21,2014,UNK,-290,497
9476200485,9/29/2014,261490.0,4,1.0,1640,8467,1.0,0.0,2.0,4,6,1220,420,1943,0,98056,47.4894,-122.18799999999999,1060,7396,9,29,2014,UNK,580,1071
3205400230,7/16/2014,347000.0,3,1.0,1010,7200,1.0,0.0,0.0,3,7,1010,0,1968,0,98034,47.7225,-122.179,1120,7200,7,16,2014,UNK,-110,0
9307300100,5/19/2014,485000.0,3,1.0,1500,4100,1.5,0.0,0.0,3,7,1370,130,1926,0,98107,47.6689,-122.367,1500,4100,5,19,2014,UNK,0,0
2770600930,10/22/2014,601000.0,3,2.5,1740,1251,2.0,0.0,0.0,3,9,1180,560,2012,0,98199,47.644,-122.385,1740,1625,10,22,2014,N,0,-374
2817900180,4/11/2015,380000.0,3,3.25,2090,51212,1.0,0.0,0.0,3,8,1510,580,1989,0,98092,47.3097,-122.09899999999999,2690,40820,4,11,2015,UNK,-600,10392
7504001340,8/29/2014,565000.0,3,3.0,1850,12556,2.0,0.0,0.0,3,9,1850,0,1976,0,98074,47.6286,-122.053,2390,12474,8,29,2014,UNK,-540,82
3121500330,3/23/2015,750000.0,3,2.5,2790,21043,2.0,0.0,0.0,3,9,2790,0,1993,0,98053,47.673,-122.03,2900,34589,3,23,2015,UNK,-110,-13546
1099760230,1/7/2015,291000.0,3,2.25,1480,7200,1.0,0.0,0.0,3,7,1190,290,1975,0,98023,47.3037,-122.375,1830,7200,1,7,2015,UNK,-350,0
3904920600,11/5/2014,560000.0,3,2.5,2280,12498,2.0,0.0,0.0,4,9,2280,0,1987,0,98029,47.5688,-122.014,2330,8844,11,5,2014,UNK,-50,3654
7504100590,3/25/2015,725000.0,4,2.25,3180,9600,2.0,0.0,0.0,3,10,3180,0,1984,0,98074,47.6313,-122.045,2840,10739,3,25,2015,UNK,340,-1139
1725079025,9/3/2014,539000.0,3,2.0,2350,209088,1.0,0.0,0.0,3,7,2350,0,1993,0,98014,47.6527,-121.949,2300,209088,9,3,2014,UNK,50,0
9406540150,7/22/2014,470000.0,5,3.25,3910,7077,2.0,0.0,0.0,3,9,2710,1200,2000,0,98038,47.3766,-122.027,2650,7077,7,22,2014,UNK,1260,0
6163900032,1/9/2015,264950.0,2,1.0,770,7434,1.0,0.0,0.0,3,6,770,0,1947,0,98155,47.7606,-122.32,1060,7453,1,9,2015,UNK,-290,-19
844000180,2/25/2015,200000.0,4,1.5,1780,8000,2.0,0.0,0.0,4,6,1080,700,1900,1996,98010,47.3124,-122.00299999999999,1750,9147,2,25,2015,Y,30,-1147
7229800175,6/4/2014,453500.0,5,2.5,2300,23345,1.0,0.0,0.0,5,7,1170,1130,1967,0,98059,47.4739,-122.11399999999999,2280,23345,6,4,2014,UNK,20,0
325059086,8/25/2014,811000.0,2,2.5,2510,17986,2.0,0.0,0.0,3,9,2510,0,1943,2014,98052,47.6832,-122.164,2440,8039,8,25,2014,Y,70,9947
4310701565,9/16/2014,425000.0,3,3.25,1410,1350,3.0,0.0,0.0,3,8,1410,0,2005,0,98103,47.698,-122.34,1410,1253,9,16,2014,N,0,97
2524049257,9/18/2014,1530000.0,4,2.25,4250,16940,1.0,0.0,2.0,4,9,2380,1870,1974,0,98040,47.5453,-122.234,3460,17693,9,18,2014,UNK,790,-753
1226059161,12/29/2014,562000.0,4,2.75,2560,83200,1.0,0.0,0.0,3,8,1860,700,1980,0,98072,47.7511,-122.111,1990,38332,12,29,2014,UNK,570,44868
7212660900,7/23/2014,281000.0,3,2.5,1760,7601,2.0,0.0,0.0,3,8,1760,0,1992,0,98003,47.2672,-122.31299999999999,1920,6851,7,23,2014,UNK,-160,750
6147650300,10/16/2014,270000.0,3,2.25,2100,14027,2.0,0.0,0.0,3,8,2100,0,1979,0,98042,47.3833,-122.1,2730,5999,10,16,2014,UNK,-630,8028
8945300090,8/11/2014,205950.0,3,1.0,1490,8239,1.0,0.0,0.0,4,6,1490,0,1963,0,98023,47.306000000000004,-122.37,1200,8470,8,11,2014,UNK,290,-231
7452500365,6/25/2014,310000.0,2,1.0,870,5400,1.0,0.0,0.0,3,6,870,0,1950,2007,98126,47.52,-122.374,990,5200,6,25,2014,Y,-120,200
3629960600,3/12/2015,350000.0,3,1.75,1260,1111,2.0,0.0,0.0,3,8,1260,0,2003,0,98029,47.5476,-122.005,1410,1630,3,12,2015,UNK,-150,-519
540100056,6/1/2014,843500.0,4,2.0,2630,16475,2.0,0.0,0.0,4,8,2630,0,1953,0,98004,47.638999999999996,-122.219,2670,15001,6,1,2014,UNK,-40,1474
1109000175,5/8/2015,370000.0,4,2.0,1950,3757,1.0,0.0,0.0,4,6,1160,790,1908,0,98118,47.5372,-122.26899999999999,1720,3757,5,8,2015,UNK,230,0
8645500900,6/20/2014,279000.0,4,2.0,2200,7700,1.0,0.0,0.0,3,7,1100,1100,1979,0,98058,47.464,-122.18,1790,7700,6,20,2014,UNK,410,0
722069057,1/2/2015,408000.0,3,1.75,1600,313672,1.0,0.0,0.0,4,7,1600,0,1960,0,98058,47.4129,-122.08,1780,90860,1,2,2015,UNK,-180,222812
2660500365,1/6/2015,392000.0,3,1.0,1230,9600,1.0,0.0,0.0,3,7,1230,0,1952,0,98118,47.5553,-122.288,1510,6600,1,6,2015,UNK,-280,3000
2516000475,9/29/2014,455000.0,2,1.0,1030,5000,1.0,0.0,0.0,5,6,1030,0,1917,0,98107,47.6585,-122.363,1550,5000,9,29,2014,UNK,-520,0
522039103,11/13/2014,310000.0,2,1.5,1040,83199,1.0,0.0,0.0,4,7,870,170,1965,0,98070,47.4222,-122.443,1760,75794,11,13,2014,UNK,-720,7405
7689600650,9/17/2014,323500.0,3,3.0,2240,11536,2.0,0.0,0.0,3,7,2240,0,1943,0,98178,47.4886,-122.245,1650,8760,9,17,2014,UNK,590,2776
9285800801,9/26/2014,364500.0,3,1.0,1600,4489,1.0,0.0,2.0,3,6,800,800,1944,0,98126,47.5686,-122.37799999999999,1640,6013,9,26,2014,UNK,-40,-1524
3750607974,5/9/2014,280000.0,4,2.0,2190,14439,1.0,0.0,0.0,4,7,1180,1010,1977,0,98001,47.2702,-122.29,2160,14439,5,9,2014,UNK,30,0
1622049154,12/15/2014,289900.0,3,1.75,1899,11325,2.0,0.0,0.0,3,7,1899,0,1943,0,98198,47.3987,-122.3,2000,10454,12,15,2014,UNK,-101,871
9530100555,6/13/2014,585000.0,3,1.0,1870,2807,1.5,0.0,0.0,4,7,1580,290,1927,0,98107,47.6674,-122.35799999999999,1640,4500,6,13,2014,UNK,230,-1693
4178500300,9/16/2014,269000.0,3,2.5,1730,6653,1.0,0.0,0.0,4,7,1360,370,1990,0,98042,47.3588,-122.088,1730,7061,9,16,2014,UNK,0,-408
8856960720,8/8/2014,280000.0,3,2.25,1860,9210,2.0,0.0,0.0,3,7,1860,0,1994,0,98038,47.3864,-122.03,1530,8091,8,8,2014,UNK,330,1119
9117000230,4/9/2015,287000.0,3,1.75,1940,9000,1.0,0.0,0.0,3,7,1290,650,1965,0,98055,47.4361,-122.189,1900,9120,4,9,2015,UNK,40,-120
8122100835,8/12/2014,183000.0,2,1.0,670,5140,1.0,0.0,0.0,3,6,670,0,1926,0,98126,47.5387,-122.37100000000001,850,5140,8,12,2014,UNK,-180,0
2788500090,12/19/2014,309000.0,3,1.0,1820,8142,1.0,0.0,0.0,3,7,1040,780,1961,0,98168,47.505,-122.316,1820,8142,12,19,2014,UNK,0,0
324059161,10/13/2014,920000.0,4,2.5,3810,13579,2.0,0.0,0.0,3,10,3810,0,2003,0,98007,47.6006,-122.15299999999999,3310,9270,10,13,2014,UNK,500,4309
4217400540,9/29/2014,815241.0,5,2.25,2060,4800,2.5,0.0,0.0,3,8,2060,0,1907,0,98105,47.66,-122.28200000000001,1740,4800,9,29,2014,UNK,320,0
3876312290,11/21/2014,405000.0,3,1.75,1520,7252,1.0,0.0,0.0,3,7,1140,380,1975,0,98072,47.7358,-122.175,1910,7820,11,21,2014,UNK,-390,-568
8556800090,4/30/2015,525000.0,5,3.5,3450,19080,2.0,0.0,3.0,3,9,3450,0,2001,0,98022,47.2123,-122.005,2570,17007,4,30,2015,UNK,880,2073
2113701095,7/17/2014,150000.0,2,1.0,830,4045,1.0,0.0,0.0,3,6,830,0,1943,0,98106,47.5293,-122.351,1100,4116,7,17,2014,UNK,-270,-71
3750603940,9/25/2014,240000.0,4,1.75,1880,9600,1.0,0.0,0.0,5,7,1020,860,1946,0,98001,47.2633,-122.281,1560,14400,9,25,2014,UNK,320,-4800
1245003160,5/2/2014,698000.0,4,2.25,2200,11250,1.5,0.0,0.0,5,7,1300,900,1920,0,98033,47.6845,-122.20100000000001,2320,10814,5,2,2014,UNK,-120,436
2600010360,3/9/2015,440000.0,3,2.0,1800,10950,1.0,0.0,0.0,4,8,1800,0,1982,0,98006,47.556999999999995,-122.163,2400,11300,3,9,2015,UNK,-600,-350
7893200900,4/14/2015,204000.0,3,1.0,1200,12500,1.5,0.0,0.0,3,6,1200,0,1936,0,98198,47.4162,-122.329,1200,7500,4,14,2015,UNK,0,5000
269000615,5/16/2014,875000.0,3,2.0,2220,6641,1.0,0.0,2.0,4,7,1220,1000,1947,0,98199,47.6426,-122.38799999999999,1800,5900,5,16,2014,UNK,420,741
2174503441,7/3/2014,650000.0,3,1.5,1380,4500,1.0,0.0,0.0,5,7,1380,0,1960,0,98040,47.5866,-122.25,1590,9000,7,3,2014,UNK,-210,-4500
4025300371,4/8/2015,392500.0,3,1.0,1660,8839,1.0,0.0,0.0,4,7,1660,0,1947,0,98155,47.7485,-122.3,1230,9236,4,8,2015,UNK,430,-397
3101500090,10/17/2014,400000.0,4,1.0,2320,4000,1.5,0.0,0.0,3,6,1310,1010,1921,0,98144,47.573,-122.31200000000001,1750,4000,10,17,2014,UNK,570,0
3447000090,4/28/2015,653000.0,3,2.25,2800,17300,1.0,0.0,0.0,4,8,1420,1380,1971,0,98006,47.5716,-122.12799999999999,2140,12650,4,28,2015,UNK,660,4650
917000300,5/20/2014,452000.0,4,1.0,1210,3760,1.5,0.0,0.0,3,6,1210,0,1900,0,98103,47.6872,-122.344,1540,3800,5,20,2014,UNK,-330,-40
9510400100,5/6/2014,345000.0,4,2.5,2331,3826,2.0,0.0,0.0,3,8,2331,0,2007,0,98058,47.4444,-122.182,2441,3826,5,6,2014,N,-110,0
4058801225,12/2/2014,350000.0,4,1.75,1820,6930,1.0,0.0,2.0,4,7,1320,500,1952,0,98178,47.5053,-122.242,1820,6825,12,2,2014,UNK,0,105
3578600201,7/31/2014,650000.0,4,2.5,2860,5576,2.0,0.0,0.0,3,8,2860,0,2004,0,98028,47.745,-122.22399999999999,2290,10667,7,31,2014,N,570,-5091
5282200015,5/27/2014,525000.0,5,3.0,2750,3800,1.5,0.0,0.0,5,7,1750,1000,1926,0,98115,47.6845,-122.31299999999999,1900,3800,5,27,2014,UNK,850,0
5282200015,1/26/2015,840000.0,5,3.0,2750,3800,1.5,0.0,0.0,5,7,1750,1000,1926,0,98115,47.6845,-122.31299999999999,1900,3800,1,26,2015,UNK,850,0
4219400555,11/24/2014,1330000.0,3,2.5,2280,5000,2.0,0.0,3.0,4,9,2280,0,1926,0,98105,47.6574,-122.27799999999999,2200,5000,11,24,2014,UNK,80,0
104550540,1/20/2015,259950.0,4,2.0,1610,6650,1.0,0.0,0.0,3,7,1610,0,1989,0,98023,47.3085,-122.35799999999999,1960,6650,1,20,2015,UNK,-350,0
3317500100,2/20/2015,998000.0,5,3.5,3760,10207,2.0,0.0,0.0,3,10,3150,610,1969,0,98040,47.5605,-122.225,3550,12118,2,20,2015,UNK,210,-1911
2436200395,6/10/2014,1070000.0,3,3.0,2940,4622,2.0,0.0,0.0,4,9,2230,710,1988,0,98105,47.6641,-122.29299999999999,1580,4000,6,10,2014,UNK,1360,622
1118001560,7/10/2014,1910000.0,4,3.0,4460,6833,2.0,0.0,0.0,3,10,3140,1320,1955,2007,98112,47.6342,-122.289,3130,7450,7,10,2014,Y,1330,-617
8728100775,3/9/2015,190500.0,3,1.5,1110,1150,2.0,0.0,0.0,3,8,940,170,2007,0,98144,47.5929,-122.306,1380,1751,3,9,2015,N,-270,-601
2223069112,11/12/2014,465000.0,3,2.25,2560,117176,1.0,0.0,0.0,4,9,1280,1280,1977,0,98027,47.4655,-122.03299999999999,2760,57063,11,12,2014,UNK,-200,60113
7278100665,2/4/2015,370000.0,3,1.0,1060,7419,1.0,0.0,2.0,4,6,1060,0,1906,0,98177,47.7712,-122.39200000000001,2190,5953,2,4,2015,UNK,-1130,1466
822059038,7/31/2014,290000.0,6,4.5,2810,11214,1.0,0.0,0.0,3,8,2010,0,1958,0,98031,47.4045,-122.197,1940,8349,7,31,2014,UNK,870,2865
7977201065,11/4/2014,350000.0,3,1.75,1380,4590,1.0,0.0,0.0,2,7,930,450,1950,0,98115,47.6841,-122.29299999999999,1320,4692,11,4,2014,UNK,60,-102
7977201065,3/5/2015,740000.0,3,1.75,1380,4590,1.0,0.0,0.0,2,7,930,450,1950,0,98115,47.6841,-122.29299999999999,1320,4692,3,5,2015,UNK,60,-102
5255000110,10/7/2014,460000.0,3,1.75,2560,8400,1.0,0.0,0.0,3,7,1970,590,1959,0,98011,47.7668,-122.197,1970,8400,10,7,2014,UNK,590,0
9407001790,8/26/2014,290000.0,3,1.0,1010,10800,1.0,0.0,0.0,4,7,1010,0,1972,0,98045,47.4483,-121.773,1370,9500,8,26,2014,UNK,-360,1300
1120069059,9/18/2014,475000.0,3,1.5,1790,229125,2.0,0.0,3.0,3,7,1790,0,1987,0,98022,47.2309,-122.009,1970,216928,9,18,2014,UNK,-180,12197
2048000330,9/26/2014,214000.0,3,2.5,1600,2231,2.0,0.0,0.0,3,7,1600,0,2003,0,98001,47.3314,-122.29,1600,2962,9,26,2014,UNK,0,-731
8820903080,5/8/2015,455000.0,2,1.0,910,5759,1.0,0.0,0.0,3,6,910,0,1951,0,98125,47.7153,-122.28399999999999,1520,7518,5,8,2015,UNK,-610,-1759
1687000210,7/25/2014,275000.0,3,2.5,2497,4400,2.0,0.0,0.0,3,8,2497,0,2007,0,98001,47.2873,-122.28299999999999,2434,4400,7,25,2014,N,63,0
621049103,7/9/2014,305000.0,3,1.5,1800,12196,1.0,0.0,0.0,4,7,1800,0,1966,0,98023,47.333,-122.345,1490,11730,7,9,2014,UNK,310,466
1321059052,4/9/2015,449000.0,5,2.5,2570,61855,1.0,0.0,0.0,4,7,1470,1100,1981,0,98092,47.3013,-122.109,1990,49658,4,9,2015,UNK,580,12197
2114700540,10/21/2014,366000.0,3,2.5,1320,4320,1.0,0.0,0.0,3,6,660,660,1918,0,98106,47.5327,-122.34700000000001,1190,4200,10,21,2014,UNK,130,120
4307330180,3/28/2015,348000.0,3,2.5,1670,5090,2.0,0.0,0.0,3,7,1670,0,2003,0,98056,47.4799,-122.18,2560,4851,3,28,2015,UNK,-890,239
114100304,12/3/2014,515000.0,4,2.5,2800,21370,2.0,0.0,0.0,3,8,2800,0,2003,0,98028,47.776,-122.24600000000001,1880,9336,12,3,2014,UNK,920,12034
7501000220,6/20/2014,950000.0,4,2.5,3360,11548,2.0,0.0,0.0,3,9,3360,0,1988,0,98033,47.6534,-122.182,3400,14091,6,20,2014,UNK,-40,-2543
8562901910,7/30/2014,815000.0,3,2.5,2590,21494,2.0,0.0,0.0,4,8,2590,0,1991,0,98074,47.6139,-122.061,2590,10720,7,30,2014,UNK,0,10774
1442800150,1/20/2015,199950.0,3,3.0,1530,2132,2.0,0.0,0.0,3,8,1530,0,1993,0,98038,47.3746,-122.056,1530,3384,1,20,2015,UNK,0,-1252
3715500220,6/5/2014,386000.0,3,2.0,1330,8100,1.0,0.0,0.0,4,7,1330,0,1969,0,98034,47.7251,-122.175,1590,8100,6,5,2014,UNK,-260,0
8647800150,1/2/2015,273000.0,3,2.25,2160,7964,2.0,0.0,0.0,3,8,2160,0,1991,0,98042,47.3622,-122.074,2000,7964,1,2,2015,UNK,160,0
2508800220,3/25/2015,284000.0,4,2.5,1830,6360,2.0,0.0,0.0,3,8,1830,0,1994,0,98031,47.4184,-122.18,1830,6596,3,25,2015,UNK,0,-236
106000044,8/26/2014,399950.0,3,1.0,1470,7930,1.0,0.0,0.0,3,7,1070,400,1950,0,98177,47.7013,-122.368,1440,8100,8,26,2014,UNK,30,-170
5652601035,1/15/2015,285000.0,3,1.75,1150,6423,1.0,0.0,0.0,3,5,590,560,1927,0,98115,47.6973,-122.29700000000001,1150,8367,1,15,2015,UNK,0,-1944
4142450490,4/3/2015,315000.0,3,2.5,1790,6452,2.0,0.0,0.0,3,7,1790,0,2004,0,98038,47.3841,-122.042,1610,3600,4,3,2015,N,180,2852
2788400090,8/7/2014,250000.0,3,1.0,1700,7700,1.0,0.0,0.0,3,7,1120,580,1960,0,98168,47.5114,-122.318,1700,8800,8,7,2014,UNK,0,-1100
7524200330,3/16/2015,290000.0,4,2.0,1630,7618,1.5,0.0,0.0,3,7,1630,0,1967,0,98198,47.3658,-122.31700000000001,1320,8774,3,16,2015,UNK,310,-1156
9359300220,6/23/2014,725000.0,4,2.5,3420,30410,2.0,0.0,0.0,3,9,3420,0,1988,0,98077,47.7745,-122.088,2940,45916,6,23,2014,UNK,480,-15506
3840700455,5/23/2014,410000.0,3,2.0,1650,9641,1.5,0.0,0.0,3,7,1650,0,1983,0,98034,47.7145,-122.23100000000001,1940,6701,5,23,2014,UNK,-290,2940
6790950150,8/17/2014,855000.0,4,2.5,2810,52062,1.5,0.0,0.0,4,9,2810,0,1988,0,98075,47.5941,-122.029,3330,49783,8,17,2014,UNK,-520,2279
3303950760,7/28/2014,399900.0,4,2.5,2710,8127,2.0,0.0,0.0,3,8,2710,0,1994,0,98038,47.379,-122.03200000000001,2520,8436,7,28,2014,UNK,190,-309
2600000210,6/11/2014,852600.0,4,2.5,3320,11901,2.0,0.0,0.0,5,9,2650,670,1977,0,98006,47.553999999999995,-122.16,2700,11114,6,11,2014,UNK,620,787
2341300115,8/8/2014,235000.0,2,1.0,720,6321,1.0,0.0,0.0,3,6,720,0,1940,0,98118,47.551,-122.289,920,5684,8,8,2014,UNK,-200,637
8655900100,8/7/2014,230950.0,2,1.0,930,12724,1.0,0.0,0.0,4,6,930,0,1912,0,98014,47.6567,-121.90899999999999,1240,21828,8,7,2014,UNK,-310,-9104
4345000210,3/30/2015,230000.0,3,2.25,1490,8722,2.0,0.0,0.0,3,7,1490,0,1997,0,98030,47.3648,-122.185,1510,8061,3,30,2015,UNK,-20,661
8929000330,7/29/2014,404763.0,3,2.5,1690,1609,2.0,0.0,0.0,3,8,1150,540,2014,0,98029,47.5521,-121.99799999999999,1690,1860,7,29,2014,N,0,-251
6700390150,9/23/2014,245000.0,3,2.5,1720,3407,2.0,0.0,0.0,3,7,1720,0,1992,0,98031,47.4034,-122.18799999999999,1720,3407,9,23,2014,UNK,0,0
1645000100,1/29/2015,188000.0,3,1.5,1140,8500,1.0,0.0,0.0,4,7,1140,0,1964,0,98022,47.2093,-122.005,1600,8500,1,29,2015,UNK,-460,0
8078350100,12/4/2014,626100.0,4,2.5,2280,7219,2.0,0.0,0.0,4,8,2280,0,1987,0,98029,47.5719,-122.021,2240,7471,12,4,2014,UNK,40,-252
6430500008,3/2/2015,428750.0,3,1.0,1100,4080,1.0,0.0,0.0,4,7,900,200,1929,0,98103,47.6872,-122.351,1170,4080,3,2,2015,UNK,-70,0
3902300100,5/12/2014,522000.0,4,2.25,1800,8623,1.0,0.0,0.0,4,8,1360,440,1980,0,98033,47.692,-122.184,2370,8623,5,12,2014,UNK,-570,0
2193330090,3/11/2015,684000.0,4,2.5,2500,8434,2.0,0.0,0.0,4,8,2500,0,1988,0,98052,47.6915,-122.101,1900,8131,3,11,2015,UNK,600,303
3524039202,4/20/2015,1070000.0,3,2.25,2950,7232,1.0,0.0,2.0,3,8,1520,1430,1983,0,98136,47.5257,-122.382,2130,7140,4,20,2015,UNK,820,92
59000201,5/5/2015,611206.0,1,1.0,1940,6300,1.0,0.0,3.0,3,8,1940,0,1963,0,98116,47.5782,-122.4,2560,6300,5,5,2015,UNK,-620,0
1782000085,9/15/2014,350000.0,2,1.0,1280,5250,1.0,0.0,0.0,4,7,1140,140,1942,0,98126,47.5258,-122.37700000000001,1050,5250,9,15,2014,UNK,230,0
3121500150,4/23/2015,894000.0,4,2.5,3800,22029,2.0,0.0,0.0,3,9,3800,0,1993,0,98053,47.6734,-122.02600000000001,3170,24979,4,23,2015,UNK,630,-2950
5207200360,9/3/2014,420000.0,2,1.0,930,5368,1.0,0.0,0.0,4,7,930,0,1953,0,98115,47.6952,-122.275,1770,6000,9,3,2014,UNK,-840,-632
2570500230,5/29/2014,400000.0,5,2.0,1930,9747,1.0,0.0,0.0,4,7,1020,910,1962,0,98028,47.7743,-122.235,2040,9370,5,29,2014,UNK,-110,377
2481600110,5/25/2014,675000.0,3,3.0,2980,28000,1.0,0.0,0.0,3,10,1820,1160,1981,0,98052,47.7318,-122.139,2570,28500,5,25,2014,UNK,410,-500
5104520150,5/20/2014,426000.0,4,2.5,2800,8494,2.0,0.0,0.0,3,8,2800,0,2004,0,98038,47.3521,-122.009,3740,8494,5,20,2014,N,-940,0
7504110760,6/27/2014,750000.0,4,2.25,3190,11597,2.0,0.0,0.0,3,10,2300,890,1984,0,98074,47.6323,-122.039,2990,10679,6,27,2014,UNK,200,918
3649100276,6/9/2014,368000.0,3,1.75,1710,10800,1.0,0.0,0.0,4,7,1710,0,1958,0,98028,47.7391,-122.241,1890,10800,6,9,2014,UNK,-180,0
4302700559,3/27/2015,342000.0,3,1.0,1980,6450,1.0,0.0,0.0,4,6,1120,860,1950,0,98106,47.5291,-122.35600000000001,1180,5160,3,27,2015,UNK,800,1290
2883200961,6/5/2014,700000.0,3,1.75,1910,4800,1.0,0.0,0.0,3,7,1080,830,1959,0,98103,47.6844,-122.33200000000001,1750,4800,6,5,2014,UNK,160,0
2767601280,7/22/2014,848750.0,6,3.75,3160,5000,2.0,0.0,0.0,3,8,3160,0,1989,0,98107,47.6748,-122.384,1740,5000,7,22,2014,UNK,1420,0
625049274,3/3/2015,720000.0,3,2.0,1590,5200,1.0,0.0,0.0,3,7,1320,270,1939,0,98103,47.6864,-122.34100000000001,1620,5150,3,3,2015,UNK,-30,50
686400210,9/22/2014,525000.0,4,2.25,1890,8549,1.0,0.0,0.0,3,8,1890,0,1967,0,98008,47.6328,-122.117,1940,7210,9,22,2014,UNK,-50,1339
121059038,3/24/2015,397900.0,3,2.75,2500,35245,1.0,0.0,0.0,3,7,1580,920,2000,0,98042,47.3414,-122.117,2060,153766,3,24,2015,UNK,440,-118521
3649100264,8/15/2014,405000.0,3,2.0,1740,18000,1.0,0.0,0.0,3,7,1230,510,1989,0,98028,47.7397,-122.242,1740,11250,8,15,2014,UNK,0,6750
6743700015,1/28/2015,392800.0,3,2.0,1080,11856,1.0,0.0,0.0,5,7,1080,0,1986,0,98033,47.6955,-122.175,1220,9247,1,28,2015,UNK,-140,2609
217500015,2/24/2015,394999.0,3,1.5,1730,7800,1.0,0.0,0.0,3,7,1330,400,1958,0,98133,47.7365,-122.337,1780,8309,2,24,2015,UNK,-50,-509
8691500410,6/19/2014,340000.0,3,2.5,2480,6112,2.0,0.0,0.0,3,7,2480,0,2004,0,98058,47.4387,-122.11399999999999,3220,6727,6,19,2014,N,-740,-615
9828702667,5/19/2014,482500.0,3,2.25,1450,1445,2.0,0.0,0.0,3,7,980,470,2005,0,98122,47.6184,-122.301,1510,1370,5,19,2014,N,-60,75
2597531110,9/9/2014,812500.0,4,2.5,2750,10159,2.0,0.0,0.0,3,10,2750,0,1991,0,98006,47.5426,-122.135,3160,10159,9,9,2014,UNK,-410,0
1126049095,9/26/2014,450000.0,3,2.5,2820,10208,1.0,0.0,1.0,4,8,1410,1410,1954,0,98028,47.7609,-122.26,1540,10684,9,26,2014,UNK,1280,-476
126049100,11/4/2014,398000.0,3,1.75,1830,27468,1.0,0.0,0.0,3,7,1830,0,1954,0,98028,47.7754,-122.23299999999999,1860,10180,11,4,2014,UNK,-30,17288
1724069060,5/7/2015,1080000.0,2,3.25,1550,1767,3.0,0.0,3.0,3,8,1550,0,2006,0,98075,47.5684,-122.06,2710,3444,5,7,2015,N,-1160,-1677
9530101385,10/14/2014,540000.0,2,2.0,1640,3021,1.0,0.0,2.0,3,7,840,800,1959,0,98107,47.666000000000004,-122.35799999999999,1780,4500,10,14,2014,UNK,-140,-1479
7243500015,10/3/2014,275000.0,4,2.0,1720,5472,1.0,0.0,0.0,3,6,860,860,1923,0,98118,47.5299,-122.288,1720,5670,10,3,2014,UNK,0,-198
1498303700,8/22/2014,780000.0,5,2.0,2880,12000,2.0,0.0,0.0,3,8,2880,0,1921,0,98144,47.5861,-122.295,1720,5000,8,22,2014,UNK,1160,7000
3352400325,7/24/2014,225000.0,3,1.5,1220,8345,1.5,0.0,0.0,3,7,1220,0,1931,0,98178,47.5038,-122.266,1880,10169,7,24,2014,UNK,-660,-1824
8021700495,7/22/2014,503045.0,3,3.0,1560,2250,2.0,0.0,0.0,3,9,1560,0,2009,0,98103,47.6929,-122.333,1610,4500,7,22,2014,N,-50,-2250
9406500530,9/12/2014,249000.0,2,2.0,1090,1357,2.0,0.0,0.0,3,7,1090,0,1990,0,98028,47.7526,-122.244,1078,1318,9,12,2014,UNK,12,39
9468200100,7/10/2014,569950.0,4,1.0,1140,5940,1.0,0.0,2.0,3,7,1140,0,1916,0,98103,47.6795,-122.354,1630,4000,7,10,2014,UNK,-490,1940
3179100482,1/26/2015,450000.0,2,2.25,1040,1377,2.0,0.0,0.0,3,8,1040,0,2003,0,98105,47.6692,-122.279,1264,1892,1,26,2015,UNK,-224,-515
5035300650,6/3/2014,1100000.0,4,2.0,2580,6000,1.0,0.0,0.0,5,9,1300,1280,1950,0,98199,47.6514,-122.413,2300,6200,6,3,2014,UNK,280,-200
6431000015,5/30/2014,700000.0,4,2.5,2310,3570,1.5,0.0,0.0,3,7,1490,820,1927,0,98103,47.6889,-122.34700000000001,1580,3060,5,30,2014,UNK,730,510
5366200210,8/19/2014,454000.0,3,2.5,1590,4094,2.0,0.0,0.0,3,7,1590,0,1991,0,98122,47.61,-122.29299999999999,1940,3924,8,19,2014,UNK,-350,170
9512501450,4/29/2015,555000.0,3,1.75,1270,9170,1.0,0.0,0.0,3,7,1270,0,1969,0,98052,47.6706,-122.15100000000001,1700,8500,4,29,2015,UNK,-430,670
8651411460,1/6/2015,214000.0,3,1.5,1240,5200,1.0,0.0,0.0,5,6,1240,0,1970,0,98042,47.3683,-122.079,1060,5200,1,6,2015,UNK,180,0
8078380230,8/8/2014,590000.0,3,2.5,2210,8622,2.0,0.0,0.0,3,8,2210,0,1988,0,98029,47.5715,-122.02,2340,7192,8,8,2014,UNK,-130,1430
1523069096,8/11/2014,459900.0,3,1.75,2340,51836,1.5,0.0,0.0,3,8,1510,830,1978,0,98027,47.4846,-122.035,2060,77536,8,11,2014,UNK,280,-25700
7893203480,5/12/2015,205000.0,3,1.5,1420,5000,1.0,0.0,0.0,3,7,920,0,1987,0,98198,47.4192,-122.33,1400,7500,5,12,2015,UNK,20,-2500
7795810110,5/12/2015,390000.0,3,1.75,1430,9857,1.0,0.0,2.0,4,7,1140,290,1980,0,98045,47.4964,-121.771,1310,9880,5,12,2015,UNK,120,-23
191100410,6/20/2014,970500.0,3,2.75,2470,10125,2.0,0.0,0.0,3,8,2470,0,1960,2012,98040,47.5651,-122.223,2290,10125,6,20,2014,Y,180,0
6151800330,4/21/2015,790000.0,3,2.5,2390,15084,2.0,0.0,0.0,3,8,2390,0,2000,0,98010,47.3389,-122.04799999999999,1850,17494,4,21,2015,UNK,540,-2410
1771100360,7/7/2014,320000.0,3,1.0,1120,10576,1.0,0.0,0.0,4,7,1120,0,1969,0,98077,47.7575,-122.072,1300,10000,7,7,2014,UNK,-180,576
1556200265,7/23/2014,552500.0,3,2.25,2700,4025,2.0,0.0,0.0,4,8,1760,940,1907,0,98122,47.6074,-122.294,1580,4025,7,23,2014,UNK,1120,0
6742700210,11/19/2014,1050000.0,3,3.0,3490,4500,2.5,0.0,0.0,3,9,3170,320,1924,0,98102,47.6394,-122.321,2840,4050,11,19,2014,UNK,650,450
1423800210,9/23/2014,230000.0,3,1.0,1640,7187,1.0,0.0,0.0,3,7,1640,0,1966,0,98058,47.455,-122.182,1340,8346,9,23,2014,UNK,300,-1159
2125049131,7/29/2014,680000.0,3,1.75,1620,5500,1.0,0.0,0.0,3,7,1110,510,1950,0,98112,47.6393,-122.30799999999999,2100,6500,7,29,2014,UNK,-480,-1000
5318101765,6/2/2014,985000.0,3,1.75,1670,5400,2.0,0.0,0.0,5,8,1670,0,1912,0,98112,47.635,-122.28399999999999,2100,5400,6,2,2014,UNK,-430,0
6624300110,6/23/2014,375000.0,4,2.5,1870,7471,2.0,0.0,0.0,3,8,1870,0,1990,0,98055,47.4314,-122.204,2020,8912,6,23,2014,UNK,-150,-1441
5160700035,4/22/2015,431000.0,2,1.5,1300,4000,1.5,0.0,0.0,4,6,1300,0,1900,0,98144,47.5937,-122.301,1480,4000,4,22,2015,UNK,-180,0
1472800220,9/9/2014,463000.0,3,2.5,2190,17108,2.0,0.0,0.0,3,8,2190,0,1991,0,98019,47.7321,-121.964,2400,14040,9,9,2014,UNK,-210,3068
3755000090,10/6/2014,350000.0,3,1.75,1320,10500,1.0,0.0,0.0,3,7,1320,0,1966,0,98034,47.7267,-122.226,1310,10500,10,6,2014,UNK,10,0
259601010,4/14/2015,485000.0,3,1.0,1250,7200,1.0,0.0,0.0,3,7,1250,0,1964,0,98008,47.6342,-122.12,1430,7400,4,14,2015,UNK,-180,-200
7939000090,9/29/2014,355000.0,4,1.75,2040,15000,1.0,0.0,0.0,4,7,1360,0,1967,0,98092,47.3107,-122.189,2310,15000,9,29,2014,UNK,-270,0
2675600025,3/27/2015,603500.0,3,1.75,2140,7280,1.0,0.0,0.0,3,7,1070,1070,1910,0,98117,47.6993,-122.37700000000001,2280,8400,3,27,2015,UNK,-140,-1120
5700000975,8/19/2014,860000.0,5,1.75,2510,6000,1.5,0.0,0.0,5,8,2010,500,1920,0,98144,47.5798,-122.292,2240,5000,8,19,2014,UNK,270,1000
9407150360,3/6/2015,259875.0,5,2.5,2200,6250,2.0,0.0,0.0,3,7,2200,0,1996,0,98038,47.3675,-122.021,1850,6091,3,6,2015,UNK,350,159
8146300015,7/16/2014,685000.0,4,2.5,2170,8680,1.0,0.0,0.0,3,7,1220,950,1959,0,98004,47.6078,-122.19200000000001,2010,8680,7,16,2014,UNK,160,0
9406570300,9/30/2014,382500.0,4,2.5,2980,8786,2.0,0.0,0.0,3,8,2980,0,2003,0,98038,47.378,-122.03,2980,6718,9,30,2014,UNK,0,2068
7518500301,3/1/2015,490000.0,3,1.0,1180,2250,1.5,0.0,0.0,3,7,1180,0,1902,0,98117,47.6779,-122.37700000000001,1320,5100,3,1,2015,UNK,-140,-2850
3739500096,1/26/2015,229000.0,3,2.0,1540,6000,1.0,0.0,0.0,4,6,1540,0,1953,0,98155,47.7372,-122.307,1490,8213,1,26,2015,UNK,50,-2213
3739500096,5/5/2015,430000.0,3,2.0,1540,6000,1.0,0.0,0.0,4,6,1540,0,1953,0,98155,47.7372,-122.307,1490,8213,5,5,2015,UNK,50,-2213
267020090,8/18/2014,580000.0,5,2.5,3110,15783,1.0,0.0,0.0,3,8,1720,1390,1974,0,98052,47.6301,-122.103,2550,12220,8,18,2014,UNK,560,3563
534000195,11/13/2014,510000.0,3,1.75,1370,6700,1.0,0.0,0.0,3,8,1370,0,1940,2012,98117,47.6982,-122.36200000000001,1180,6694,11,13,2014,Y,190,6
5469502700,5/8/2014,489990.0,5,2.25,2440,20828,1.5,0.0,0.0,4,8,2440,0,1975,0,98042,47.3762,-122.15799999999999,2670,14472,5,8,2014,UNK,-230,6356
7010700110,9/16/2014,440000.0,3,2.25,1760,1800,2.0,0.0,0.0,3,7,1330,430,1983,0,98199,47.6579,-122.39399999999999,1150,4575,9,16,2014,UNK,610,-2775
8106300090,4/28/2015,479950.0,3,2.5,2810,4984,1.0,0.0,0.0,3,9,1750,1060,2006,0,98055,47.4461,-122.209,2810,5711,4,28,2015,N,0,-727
225069013,6/23/2014,806000.0,4,2.5,2500,206474,1.0,0.0,0.0,3,10,2500,0,1997,0,98053,47.6778,-121.994,3680,208652,6,23,2014,UNK,-1180,-2178
1685800100,6/24/2014,875000.0,4,2.5,3220,22588,2.0,0.0,0.0,3,10,3220,0,1996,0,98077,47.7311,-122.055,3220,22922,6,24,2014,UNK,0,-334
293800870,9/11/2014,710800.0,3,2.5,2880,36820,2.0,0.0,0.0,3,10,2880,0,1992,0,98077,47.76600000000001,-122.044,3190,36820,9,11,2014,UNK,-310,0
7852190580,2/10/2015,565000.0,3,2.5,2700,6037,2.0,0.0,0.0,3,8,2700,0,2004,0,98065,47.5376,-121.87899999999999,2740,6054,2,10,2015,N,-40,-17
5636000210,2/23/2015,359999.0,5,3.0,2680,9624,2.0,0.0,0.0,3,7,1870,810,1995,0,98010,47.3279,-122.006,1860,9921,2,23,2015,UNK,820,-297
1623301185,1/23/2015,625000.0,3,1.75,1780,4500,1.0,0.0,0.0,4,7,920,860,1922,0,98117,47.6827,-122.36200000000001,1360,4000,1,23,2015,UNK,420,500
3260810590,9/12/2014,349950.0,3,2.5,2240,7565,2.0,0.0,0.0,3,8,2240,0,1999,0,98003,47.3485,-122.301,2190,8254,9,12,2014,UNK,50,-689
8589100090,6/17/2014,415000.0,4,2.0,1610,9600,1.0,0.0,0.0,5,7,1610,0,1967,0,98056,47.5327,-122.186,1450,9600,6,17,2014,UNK,160,0
7579200767,11/5/2014,435000.0,2,2.0,1440,1170,2.0,0.0,0.0,3,9,960,480,2004,0,98116,47.5592,-122.385,1440,1350,11,5,2014,N,0,-180
623049273,11/21/2014,225000.0,3,1.75,1550,9060,2.0,0.0,0.0,3,7,1550,0,1948,0,98146,47.5093,-122.345,1080,7620,11,21,2014,UNK,470,1440
1186000035,5/12/2014,770000.0,3,1.75,1720,5000,1.0,0.0,0.0,3,9,1720,0,1954,2014,98122,47.6157,-122.29,2120,4188,5,12,2014,Y,-400,812
2228900191,1/6/2015,340000.0,3,1.75,1740,10800,1.0,0.0,0.0,3,7,1740,0,1959,0,98133,47.7717,-122.351,1810,7735,1,6,2015,UNK,-70,3065
2597450120,3/12/2015,965000.0,5,2.75,3280,12673,1.0,0.0,0.0,4,9,2050,1230,1981,0,98006,47.5504,-122.146,3060,12847,3,12,2015,UNK,220,-174
3339400515,1/13/2015,667000.0,3,2.75,2216,31215,1.0,0.0,0.0,3,9,2216,0,1968,2005,98092,47.3164,-122.199,2216,30048,1,13,2015,Y,0,1167
1221000395,5/7/2014,250000.0,1,1.0,1100,4373,1.0,0.0,0.0,2,6,820,280,1947,0,98166,47.4653,-122.338,1100,7500,5,7,2014,UNK,0,-3127
1526300015,6/12/2014,397990.0,3,1.0,1180,11862,1.0,0.0,0.0,4,7,1180,0,1948,0,98177,47.7153,-122.363,1540,8100,6,12,2014,UNK,-360,3762
6163901772,9/18/2014,535000.0,3,1.75,2020,10031,1.0,0.0,0.0,5,7,1370,650,1952,0,98155,47.7487,-122.319,1500,8456,9,18,2014,UNK,520,1575
1180007005,6/25/2014,265950.0,3,1.5,1150,8450,1.0,0.0,0.0,4,6,1150,0,1951,0,98178,47.4927,-122.22399999999999,1160,6800,6,25,2014,UNK,-10,1650
5420300210,10/7/2014,258000.0,3,1.75,2090,7461,1.0,0.0,0.0,3,6,1200,890,1986,0,98030,47.3764,-122.184,1420,7462,10,7,2014,UNK,670,-1
476000331,12/2/2014,505500.0,3,2.5,1300,1187,3.0,0.0,0.0,3,8,1300,0,2005,0,98107,47.6704,-122.391,1320,1194,12,2,2014,N,-20,-7
2558700090,5/6/2014,455000.0,5,2.5,2240,7770,1.0,0.0,0.0,3,7,1340,900,1978,0,98034,47.7198,-122.171,1820,7770,5,6,2014,UNK,420,0
4151800410,10/31/2014,1350000.0,5,3.25,3540,5971,1.0,0.0,2.0,3,10,2000,1540,2005,0,98033,47.6643,-122.20200000000001,2820,6029,10,31,2014,N,720,-58
3586501075,1/9/2015,600000.0,4,2.25,2840,31720,1.0,0.0,0.0,3,8,1780,1060,1958,0,98177,47.7505,-122.375,2290,29577,1,9,2015,UNK,550,2143
4136870110,2/5/2015,329800.0,4,2.5,2080,7047,2.0,0.0,0.0,3,8,2080,0,1996,0,98092,47.2627,-122.215,2580,7227,2,5,2015,UNK,-500,-180
6623400090,4/21/2015,222000.0,2,1.0,1550,38449,1.0,0.0,0.0,3,6,1550,0,1947,0,98055,47.4315,-122.199,1188,25875,4,21,2015,UNK,362,12574
1560800150,4/5/2015,450000.0,4,2.5,1900,9240,1.0,0.0,0.0,3,7,1900,0,1962,0,98007,47.6167,-122.137,2040,8052,4,5,2015,UNK,-140,1188
2770605548,12/18/2014,952000.0,3,3.5,2760,4500,2.0,0.0,0.0,3,9,2120,640,2004,0,98119,47.6529,-122.37200000000001,1950,6000,12,18,2014,N,810,-1500
2023700040,7/23/2014,625000.0,4,2.0,1410,4480,1.5,0.0,0.0,3,8,1410,0,1927,0,98109,47.6385,-122.344,1240,3400,7,23,2014,UNK,170,1080
1164000040,3/12/2015,226800.0,2,1.0,1240,11393,1.0,0.0,0.0,4,7,1240,0,1960,0,98030,47.3714,-122.20700000000001,1660,11393,3,12,2015,UNK,-420,0
7135520650,12/12/2014,1210000.0,5,4.25,4420,13497,2.0,0.0,0.0,3,11,3510,910,2000,0,98059,47.5262,-122.14299999999999,4220,12015,12,12,2014,UNK,200,1482
3528400180,10/3/2014,350000.0,4,2.75,3390,16153,1.0,0.0,0.0,4,7,1970,1420,1961,0,98031,47.3954,-122.184,2530,8495,10,3,2014,UNK,860,7658
7820000015,3/12/2015,395000.0,3,1.75,1400,8640,1.0,0.0,0.0,3,7,1400,0,1962,0,98011,47.7659,-122.204,1630,8640,3,12,2015,UNK,-230,0
1105000229,9/19/2014,285000.0,5,3.0,2110,5260,2.0,0.0,0.0,3,7,1670,440,2002,0,98118,47.5449,-122.272,2110,5260,9,19,2014,UNK,0,0
3625059166,1/7/2015,553000.0,3,1.0,1310,18135,1.0,0.0,0.0,3,7,1310,0,1948,0,98008,47.6065,-122.113,2150,18135,1,7,2015,UNK,-840,0
8108600442,5/5/2015,254000.0,3,1.0,1270,16800,1.0,0.0,0.0,4,7,1270,0,1957,0,98188,47.4599,-122.27600000000001,1700,10200,5,5,2015,UNK,-430,6600
8143600015,8/26/2014,348140.0,2,1.5,2060,10880,1.0,0.0,0.0,3,6,1190,870,1924,0,98106,47.515,-122.36200000000001,1430,8781,8,26,2014,UNK,630,2099
8731900790,6/26/2014,354950.0,4,2.75,2530,7350,1.0,0.0,0.0,5,8,1280,1250,1977,0,98023,47.313,-122.374,2280,7350,6,26,2014,UNK,250,0
6079500230,6/12/2014,706000.0,3,2.75,1900,6400,1.0,0.0,0.0,5,7,1410,490,1942,0,98105,47.6697,-122.281,1350,6400,6,12,2014,UNK,550,0
7853302370,5/5/2014,499000.0,4,2.5,2910,6479,2.0,0.0,0.0,3,7,2910,0,2006,0,98065,47.5402,-121.887,2320,5178,5,5,2014,N,590,1301
122069107,12/4/2014,427500.0,3,1.5,1900,43186,1.5,0.0,0.0,4,7,1300,600,1971,0,98038,47.4199,-121.99,2080,108028,12,4,2014,UNK,-180,-64842
4204400175,2/17/2015,439000.0,5,3.5,2880,10000,2.0,0.0,3.0,3,8,1980,900,1991,0,98055,47.4874,-122.223,2120,9535,2,17,2015,UNK,760,465
2896310120,11/17/2014,545000.0,4,2.5,2820,25995,2.0,0.0,0.0,3,9,2820,0,1998,0,98010,47.3415,-122.029,3330,27653,11,17,2014,UNK,-510,-1658
4083301380,10/17/2014,842000.0,3,1.0,1620,4774,1.5,0.0,0.0,3,7,1620,0,1920,0,98103,47.659,-122.339,1880,4560,10,17,2014,UNK,-260,214
1332000100,12/10/2014,685000.0,4,2.5,3320,38043,2.0,0.0,0.0,3,9,3320,0,1997,0,98053,47.6504,-122.00399999999999,3170,42621,12,10,2014,UNK,150,-4578
3622069122,9/3/2014,665000.0,4,3.5,3770,47480,2.0,0.0,0.0,3,9,3770,0,2003,0,98010,47.3552,-121.99,3380,42689,9,3,2014,UNK,390,4791
6052401215,6/9/2014,255000.0,2,1.0,1200,9000,1.0,0.0,2.0,5,6,1200,0,1917,0,98198,47.4039,-122.323,1660,9000,6,9,2014,UNK,-460,0
7010700245,12/31/2014,565000.0,5,2.25,2130,4360,1.0,0.0,2.0,3,8,1240,890,1959,0,98199,47.6586,-122.395,1830,5000,12,31,2014,UNK,300,-640
1311100490,2/25/2015,274000.0,5,1.75,1950,8720,1.0,0.0,0.0,3,7,1050,900,1962,0,98001,47.3381,-122.289,1660,8030,2,25,2015,UNK,290,690
9510900360,5/9/2014,260000.0,3,2.0,1920,8075,1.0,0.0,0.0,4,7,1510,410,1969,0,98023,47.3092,-122.375,1920,7826,5,9,2014,UNK,0,249
8679600150,5/7/2014,581000.0,4,2.0,2510,13695,1.0,0.0,0.0,4,7,1280,1230,1961,2001,98033,47.7005,-122.17399999999999,1220,12500,5,7,2014,Y,1290,1195
7203600040,7/25/2014,625000.0,3,1.5,1990,5978,1.5,0.0,4.0,4,7,1990,0,1926,0,98198,47.3449,-122.329,2100,6221,7,25,2014,UNK,-110,-243
2212900180,12/29/2014,220000.0,3,1.0,1230,9720,1.0,0.0,0.0,5,7,1230,0,1969,0,98042,47.3266,-122.13799999999999,1230,9720,12,29,2014,UNK,0,0
2124079010,10/28/2014,765000.0,3,2.25,3190,324086,2.0,0.0,2.0,3,9,3190,0,1982,0,98024,47.5477,-121.93,3190,217800,10,28,2014,UNK,0,106286
2424059052,7/10/2014,1330000.0,6,4.25,5720,10213,2.0,0.0,0.0,3,10,4170,1550,2004,0,98006,47.5464,-122.116,4300,10224,7,10,2014,N,1420,-11
6746700615,3/18/2015,700000.0,8,2.5,2280,3000,1.5,0.0,0.0,3,7,1210,1070,1911,0,98105,47.6675,-122.316,1610,3000,3,18,2015,UNK,670,0
3298300530,9/24/2014,351000.0,4,1.0,1550,7260,1.0,0.0,0.0,4,6,1550,0,1959,0,98008,47.6229,-122.12100000000001,1210,7260,9,24,2014,UNK,340,0
8929000360,8/5/2014,413565.0,3,2.5,1690,1613,2.0,0.0,0.0,3,8,1150,540,2014,0,98029,47.5524,-121.99799999999999,1690,1619,8,5,2014,N,0,-6
2291400236,6/12/2014,363000.0,3,3.25,1651,1779,2.0,0.0,0.0,3,8,1341,310,2008,0,98133,47.7076,-122.346,1650,2908,6,12,2014,N,1,-1129
6445800120,4/4/2015,679000.0,4,1.75,2260,41236,1.0,0.0,0.0,4,8,1690,570,1962,0,98029,47.5528,-122.03399999999999,3080,30240,4,4,2015,UNK,-820,10996
8682261010,9/10/2014,473000.0,2,1.75,1510,4555,1.0,0.0,0.0,3,8,1510,0,2005,0,98053,47.7136,-122.031,1640,4500,9,10,2014,N,-130,55
8045000180,4/21/2015,585888.0,3,2.0,1490,7431,1.0,0.0,0.0,4,7,1490,0,1966,0,98052,47.6697,-122.162,1700,7725,4,21,2015,UNK,-210,-294
9475700220,6/26/2014,405000.0,4,2.5,2220,4652,2.0,0.0,0.0,3,7,2220,0,2001,0,98059,47.4902,-122.154,1840,4500,6,26,2014,UNK,380,152
3222049055,1/16/2015,650000.0,3,1.75,2800,19386,1.0,1.0,4.0,3,8,1400,1400,1965,0,98198,47.3554,-122.324,3270,31450,1,16,2015,UNK,-470,-12064
1222069133,2/24/2015,415000.0,4,2.5,2210,213008,1.0,0.0,0.0,4,7,1210,1000,1975,0,98038,47.4039,-121.98,2270,52707,2,24,2015,UNK,-60,160301
9165100230,12/22/2014,575000.0,3,2.0,2150,3880,1.0,0.0,0.0,3,8,1080,1070,1951,0,98117,47.6814,-122.39200000000001,2130,4000,12,22,2014,UNK,20,-120
8091411120,7/17/2014,220000.0,3,2.25,1400,7205,1.0,0.0,0.0,3,7,1140,260,1985,0,98030,47.349,-122.166,1970,7252,7,17,2014,UNK,-570,-47
1777600230,5/6/2014,610000.0,4,3.0,2450,10117,1.0,0.0,0.0,5,8,1580,870,1967,0,98006,47.5694,-122.132,2530,10125,5,6,2014,UNK,-80,-8
5101400862,5/12/2014,499950.0,3,1.0,980,6380,1.0,0.0,0.0,3,7,760,220,1941,0,98115,47.692,-122.30799999999999,1390,6380,5,12,2014,UNK,-410,0
5317100325,3/3/2015,883000.0,4,2.5,2800,6874,2.0,0.0,0.0,3,9,2170,630,1990,0,98112,47.6215,-122.29,1430,6240,3,3,2015,UNK,1370,634
9324800455,10/23/2014,436000.0,2,1.0,1240,8100,1.5,0.0,2.0,3,7,1240,0,1925,0,98125,47.7326,-122.288,2790,8100,10,23,2014,UNK,-1550,0
880000208,12/13/2014,320000.0,3,2.5,1610,1356,2.0,0.0,0.0,3,8,1240,370,2007,0,98106,47.5257,-122.361,1270,1314,12,13,2014,N,340,42
1223089081,5/30/2014,425000.0,3,1.75,1510,44000,1.0,0.0,0.0,3,7,1240,270,1989,0,98045,47.4851,-121.71600000000001,2290,36242,5,30,2014,UNK,-780,7758
5556800150,5/15/2014,204700.0,4,2.0,1670,9987,1.0,0.0,0.0,3,7,1670,0,1967,0,98001,47.3406,-122.28399999999999,1640,7280,5,15,2014,UNK,30,2707
4174600331,7/17/2014,384000.0,6,3.0,2320,4502,1.0,0.0,0.0,4,7,1200,1120,1987,0,98108,47.5552,-122.3,1160,5628,7,17,2014,UNK,1160,-1126
5419801120,1/13/2015,314000.0,3,2.75,1900,8200,2.0,0.0,0.0,4,7,1900,0,1984,0,98031,47.402,-122.18299999999999,1620,8200,1,13,2015,UNK,280,0
3649100674,4/30/2015,535000.0,3,2.5,2390,6263,2.0,0.0,0.0,3,9,2390,0,2003,0,98028,47.7379,-122.24799999999999,2390,11761,4,30,2015,UNK,0,-5498
1525069058,6/26/2014,568000.0,4,1.75,2110,265716,1.0,0.0,0.0,4,8,2110,0,1979,0,98053,47.657,-122.02600000000001,2110,110597,6,26,2014,UNK,0,155119
7202000220,5/1/2015,426000.0,4,1.5,1470,5850,1.0,0.0,0.0,4,7,810,660,1973,0,98052,47.7,-122.12899999999999,1290,7300,5,1,2015,UNK,180,-1450
7129301001,12/9/2014,675000.0,4,2.75,2670,6780,2.0,0.0,3.0,5,8,1630,1040,1908,0,98118,47.5131,-122.256,2400,5989,12,9,2014,UNK,270,791
8860500150,6/13/2014,380000.0,4,2.5,2540,6365,2.0,0.0,0.0,3,8,1870,670,2000,0,98055,47.4608,-122.215,2290,5942,6,13,2014,UNK,250,423
7384500110,7/23/2014,685000.0,3,2.5,3450,8000,3.0,0.0,0.0,4,8,2970,480,1927,1975,98116,47.5605,-122.402,1880,6135,7,23,2014,Y,1570,1865
622069123,8/19/2014,429000.0,3,2.0,1700,52826,1.0,0.0,0.0,3,7,1700,0,1991,0,98058,47.4164,-122.09200000000001,2480,114728,8,19,2014,UNK,-780,-61902
164000361,4/21/2015,799000.0,4,1.5,1810,6583,1.0,0.0,0.0,3,7,1500,310,1968,0,98133,47.7273,-122.351,860,8670,4,21,2015,UNK,950,-2087
3438500790,9/20/2014,318500.0,5,1.75,1550,6986,1.0,0.0,0.0,3,7,1030,520,1978,0,98106,47.5503,-122.35600000000001,1550,6986,9,20,2014,UNK,0,0
2024059110,4/20/2015,925000.0,3,3.25,4110,20900,2.0,0.0,0.0,3,9,2630,0,2002,0,98006,47.5506,-122.18700000000001,2640,14700,4,20,2015,UNK,1470,6200
7338400945,2/24/2015,420000.0,3,1.5,2080,5000,1.0,0.0,0.0,3,7,1300,780,1963,0,98118,47.5322,-122.29,1860,5000,2,24,2015,UNK,220,0
809003160,12/18/2014,570000.0,2,1.0,1100,4000,1.0,0.0,0.0,3,7,1100,0,1906,0,98109,47.6388,-122.35,1590,4000,12,18,2014,UNK,-490,0
8650700090,8/13/2014,1050000.0,4,2.75,3950,12840,2.0,0.0,0.0,5,8,3950,0,1960,0,98040,47.5489,-122.219,2350,12507,8,13,2014,UNK,1600,333
8151600663,9/17/2014,333000.0,3,1.0,1250,8450,1.0,0.0,0.0,4,7,1250,0,1954,0,98146,47.503,-122.36399999999999,1350,9300,9,17,2014,UNK,-100,-850
7352200100,2/24/2015,1360000.0,2,1.75,2620,14138,2.0,1.0,4.0,3,8,2120,0,1931,1991,98125,47.7142,-122.277,1830,8279,2,24,2015,Y,790,5859
1952200220,6/3/2014,660000.0,3,2.5,2290,2798,3.0,0.0,0.0,4,9,2290,0,1953,1983,98102,47.64100000000001,-122.315,2260,5000,6,3,2014,Y,30,-2202
1568100300,9/17/2014,350000.0,6,4.5,3500,8504,2.0,0.0,0.0,3,7,3500,0,1980,0,98155,47.7351,-122.295,1550,8460,9,17,2014,UNK,1950,44
1568100300,1/21/2015,682500.0,6,4.5,3500,8504,2.0,0.0,0.0,3,7,3500,0,1980,0,98155,47.7351,-122.295,1550,8460,1,21,2015,UNK,1950,44
2113700485,12/10/2014,399990.0,5,2.75,1690,4000,1.0,0.0,0.0,5,7,970,720,1943,0,98106,47.5312,-122.354,1240,4000,12,10,2014,UNK,450,0
1454600156,6/25/2014,860000.0,5,3.25,4500,9648,2.0,0.0,4.0,4,8,3000,1500,1968,0,98125,47.7262,-122.28200000000001,2780,21132,6,25,2014,UNK,1720,-11484
4204400201,10/21/2014,216180.0,2,1.0,1120,7797,1.0,0.0,0.0,3,6,1120,0,1948,0,98055,47.4871,-122.22,2180,7200,10,21,2014,UNK,-1060,597
8856890330,9/15/2014,300000.0,4,2.25,1740,9613,2.0,0.0,0.0,5,8,1740,0,1989,0,98058,47.463,-122.125,1680,9769,9,15,2014,UNK,60,-156
1922059278,10/14/2014,145000.0,3,1.0,1010,11880,1.0,0.0,0.0,3,7,1010,0,1960,0,98030,47.3762,-122.219,1150,9435,10,14,2014,UNK,-140,2445
1922059278,3/5/2015,255000.0,3,1.0,1010,11880,1.0,0.0,0.0,3,7,1010,0,1960,0,98030,47.3762,-122.219,1150,9435,3,5,2015,UNK,-140,2445
6623400356,7/2/2014,250000.0,3,1.75,1200,24805,1.0,0.0,0.0,3,6,1200,0,1984,0,98031,47.4236,-122.195,2150,4339,7,2,2014,UNK,-950,20466
9407111250,10/29/2014,245000.0,3,1.0,1020,8625,1.0,0.0,0.0,3,7,1020,0,1978,0,98045,47.4465,-121.77,1290,9440,10,29,2014,UNK,-270,-815
5422570760,10/14/2014,445000.0,3,1.75,1850,7056,2.5,0.0,0.0,4,8,1850,0,1979,0,98052,47.6602,-122.13,1970,7056,10,14,2014,UNK,-120,0
4036800910,5/14/2014,562000.0,3,1.5,1830,8000,1.0,0.0,0.0,4,7,1830,0,1957,0,98008,47.6017,-122.12200000000001,1310,7500,5,14,2014,UNK,520,500
259600530,5/5/2014,501000.0,4,1.0,2070,7519,1.0,0.0,0.0,3,7,1160,910,1963,0,98008,47.632,-122.119,1730,7519,5,5,2014,UNK,340,0
6303400981,1/13/2015,190000.0,3,1.75,1160,5850,1.0,0.0,0.0,4,6,1160,0,1918,0,98146,47.5064,-122.35600000000001,1110,8382,1,13,2015,UNK,50,-2532
7701990300,5/16/2014,862500.0,4,2.75,3280,24440,2.0,0.0,0.0,3,10,3280,0,1996,0,98077,47.7073,-122.07,3490,25138,5,16,2014,UNK,-210,-698
5700002510,6/11/2014,1090000.0,5,2.5,2340,6000,2.0,0.0,0.0,4,10,2340,0,1922,0,98144,47.5764,-122.287,2350,6000,6,11,2014,UNK,-10,0
2011400230,6/26/2014,575000.0,5,3.0,3690,49709,1.0,0.0,2.0,3,9,2690,1000,1960,0,98198,47.3908,-122.32,2590,8691,6,26,2014,UNK,1100,41018
1921069059,12/30/2014,250000.0,1,1.0,720,123710,1.0,0.0,0.0,4,6,720,0,1935,0,98092,47.2893,-122.084,1860,297514,12,30,2014,UNK,-1140,-173804
1471700410,5/6/2015,310000.0,7,1.5,2660,15111,1.5,0.0,0.0,4,7,2660,0,1962,0,98059,47.4644,-122.066,1710,15429,5,6,2015,UNK,950,-318
2102700025,10/9/2014,1400000.0,5,3.25,4300,9270,2.0,0.0,3.0,3,10,2910,1390,1957,2009,98116,47.5717,-122.40899999999999,2780,6610,10,9,2014,Y,1520,2660
4222300040,12/16/2014,284850.0,3,1.5,1590,8256,1.0,0.0,1.0,3,7,1090,500,1969,0,98003,47.3488,-122.304,1950,7840,12,16,2014,UNK,-360,416
3649100676,2/19/2015,570000.0,4,2.5,2590,7910,2.0,0.0,0.0,3,9,2590,0,2003,0,98028,47.7378,-122.24799999999999,2110,11761,2,19,2015,UNK,480,-3851
372000040,10/3/2014,304000.0,3,1.75,1720,6000,1.0,0.0,2.0,3,7,1000,720,1954,0,98178,47.4999,-122.223,1690,6000,10,3,2014,UNK,30,0
7312200040,12/16/2014,560000.0,4,2.5,1790,9787,1.0,0.0,2.0,4,8,1240,550,1983,0,98056,47.5344,-122.189,1790,9787,12,16,2014,UNK,0,0
6052400975,8/26/2014,325000.0,3,1.0,1590,8160,1.0,0.0,1.0,3,7,1090,500,1954,0,98198,47.4013,-122.321,1540,10500,8,26,2014,UNK,50,-2340
826000495,2/6/2015,557510.0,4,2.0,1580,4800,1.5,0.0,2.0,3,7,1580,0,1912,0,98136,47.5454,-122.383,1580,4800,2,6,2015,UNK,0,0
8731900880,4/20/2015,305000.0,4,2.25,2580,8820,1.0,0.0,0.0,4,9,1620,960,1967,0,98023,47.3122,-122.376,2140,8400,4,20,2015,UNK,440,420
1523059100,9/2/2014,320000.0,5,1.0,1740,27350,1.0,0.0,0.0,4,5,1740,0,1958,0,98059,47.4809,-122.15299999999999,2760,10749,9,2,2014,UNK,-1020,16601
2597550090,9/5/2014,455000.0,5,2.25,3470,28212,1.5,0.0,0.0,4,8,2790,680,1978,0,98042,47.3342,-122.10799999999999,2020,28177,9,5,2014,UNK,1450,35
3581000210,9/4/2014,383001.0,3,1.0,1180,7210,1.0,0.0,0.0,4,7,1180,0,1963,0,98034,47.7267,-122.241,1700,7210,9,4,2014,UNK,-520,0
4048400191,6/5/2014,545000.0,3,1.75,1700,51649,1.5,0.0,0.0,5,6,1700,0,1931,0,98059,47.4704,-122.07600000000001,1100,39504,6,5,2014,UNK,600,12145
7578200025,4/8/2015,487500.0,2,1.0,1190,5000,1.0,0.0,0.0,3,7,1190,0,1925,0,98116,47.5717,-122.382,1600,5000,4,8,2015,UNK,-410,0
2379300330,7/2/2014,345000.0,5,2.5,2450,6994,2.0,0.0,0.0,3,8,2450,0,2002,0,98030,47.3572,-122.19200000000001,1940,6035,7,2,2014,UNK,510,959
8917100180,6/4/2014,583000.0,6,2.75,2630,16411,1.0,0.0,0.0,4,8,1650,980,1974,0,98052,47.6309,-122.09299999999999,2250,12255,6,4,2014,UNK,380,4156
3395300180,8/12/2014,534950.0,3,2.25,2130,12286,2.0,0.0,0.0,3,8,2130,0,1977,0,98052,47.6471,-122.11399999999999,2130,10158,8,12,2014,UNK,0,2128
369000690,8/12/2014,403504.0,4,1.0,1060,5750,1.0,0.0,0.0,3,6,950,110,1904,0,98199,47.6562,-122.389,1790,5857,8,12,2014,UNK,-730,-107
7977200720,4/27/2015,500000.0,3,1.75,1480,6120,1.5,0.0,0.0,3,7,1480,0,1946,0,98115,47.6858,-122.295,1480,6120,4,27,2015,UNK,0,0
2322069175,2/24/2015,319502.0,3,1.75,1610,38707,1.0,0.0,0.0,3,7,1610,0,1990,0,98010,47.3778,-122.001,1930,45151,2,24,2015,UNK,-320,-6444
2324039100,11/12/2014,525000.0,4,2.75,2440,5080,2.0,0.0,0.0,3,8,1750,690,1960,0,98126,47.5547,-122.37899999999999,1920,6375,11,12,2014,UNK,520,-1295
5631500866,5/6/2014,563000.0,4,3.0,3100,15480,2.0,0.0,0.0,3,8,2400,700,1996,0,98028,47.7466,-122.241,2000,42500,5,6,2014,UNK,1100,-27020
2877101745,8/4/2014,898500.0,4,2.75,2890,5000,1.5,0.0,0.0,3,8,1990,900,1911,2014,98117,47.6768,-122.363,1080,3750,8,4,2014,Y,1810,1250
721069087,5/7/2014,651000.0,3,2.5,3240,108366,2.0,0.0,0.0,4,10,3240,0,1991,0,98042,47.327,-122.094,2090,108366,5,7,2014,UNK,1150,0
7934000145,12/1/2014,450000.0,4,2.75,2900,6400,2.0,0.0,0.0,3,7,2040,860,1911,1970,98136,47.5563,-122.39299999999999,1340,6144,12,1,2014,Y,1560,256
6072760360,3/21/2015,665000.0,4,2.25,2650,8149,1.0,0.0,0.0,4,8,1610,1040,1975,0,98006,47.5624,-122.176,2290,8019,3,21,2015,UNK,360,130
6021501635,11/2/2014,825000.0,4,2.5,2560,4000,2.0,0.0,0.0,5,8,1610,950,1929,0,98117,47.6885,-122.38600000000001,1760,4000,11,2,2014,UNK,800,0
1821059067,6/25/2014,200000.0,3,1.0,1150,4800,1.5,0.0,0.0,4,6,1150,0,1938,0,98002,47.3101,-122.212,1310,9510,6,25,2014,UNK,-160,-4710
3295750610,9/4/2014,295000.0,3,2.0,1760,6092,1.0,0.0,0.0,3,7,1760,0,1998,0,98030,47.3838,-122.184,2590,6255,9,4,2014,UNK,-830,-163
2926059146,12/15/2014,748000.0,4,2.5,3220,8379,2.0,0.0,0.0,3,10,3220,0,2004,0,98034,47.7043,-122.19200000000001,2720,7635,12,15,2014,N,500,744
9429500146,7/14/2014,580000.0,3,2.5,3200,18750,1.0,0.0,0.0,2,9,2660,540,1967,1996,98027,47.5717,-122.12,3200,22475,7,14,2014,Y,0,-3725
7893207490,2/12/2015,275000.0,3,1.0,1250,10744,1.0,0.0,0.0,3,6,1250,0,1942,0,98198,47.4226,-122.32700000000001,1500,10710,2,12,2015,UNK,-250,34
8945300110,3/26/2015,196000.0,3,1.0,1000,8470,1.0,0.0,0.0,4,6,1000,0,1963,0,98023,47.3056,-122.37,1020,8470,3,26,2015,UNK,-20,0
8151600610,5/22/2014,235750.0,2,1.0,740,11250,1.0,0.0,0.0,2,6,740,0,1938,0,98146,47.5036,-122.36200000000001,1390,11250,5,22,2014,UNK,-650,0
2923049399,3/23/2015,315000.0,3,2.25,2170,8480,1.0,0.0,0.0,3,8,2170,0,1965,0,98148,47.4562,-122.33,2080,8452,3,23,2015,UNK,90,28
3260810110,8/25/2014,338000.0,4,2.5,2370,10631,2.0,0.0,0.0,3,8,2370,0,1999,0,98003,47.3473,-122.302,2200,8297,8,25,2014,UNK,170,2334
5104530770,1/21/2015,353000.0,4,2.5,2300,4249,2.0,0.0,0.0,3,8,2300,0,2006,0,98038,47.3516,-122.0,2390,4385,1,21,2015,N,-90,-136
8661000033,6/27/2014,235000.0,3,1.75,1400,6300,1.0,0.0,0.0,3,7,1400,0,1998,0,98022,47.2074,-122.001,1400,8490,6,27,2014,UNK,0,-2190
4017050820,3/20/2015,569999.0,3,2.5,3080,13880,2.0,0.0,0.0,3,9,3080,0,1990,0,98038,47.3726,-122.025,2780,15318,3,20,2015,UNK,300,-1438
226039279,9/18/2014,505000.0,4,2.25,2350,12540,2.0,0.0,0.0,3,8,2350,0,1968,0,98177,47.7732,-122.382,2090,7964,9,18,2014,UNK,260,4576
1338800785,3/6/2015,1230000.0,4,3.0,2660,4600,1.5,0.0,0.0,3,8,1820,840,1906,0,98112,47.6258,-122.305,2350,4600,3,6,2015,UNK,310,0
2921049079,5/14/2014,299000.0,2,1.75,1250,34395,1.0,0.0,0.0,4,7,1250,0,1950,0,98003,47.2802,-122.316,1910,26042,5,14,2014,UNK,-660,8353
5113260040,10/16/2014,240000.0,3,2.0,1100,6360,1.0,0.0,0.0,3,7,1100,0,1991,0,98038,47.3878,-122.052,1620,6360,10,16,2014,UNK,-520,0
3124059023,2/13/2015,1960000.0,3,1.75,3330,12566,1.0,1.0,4.0,4,8,1940,1390,1960,0,98040,47.5287,-122.22,3730,16560,2,13,2015,UNK,-400,-3994
5351200265,9/11/2014,1270000.0,4,3.25,3640,3604,2.0,0.0,2.0,5,9,1960,1680,1913,0,98122,47.6145,-122.28399999999999,1940,4600,9,11,2014,UNK,1700,-996
2591010150,4/14/2015,405000.0,2,1.75,1350,2653,2.0,0.0,0.0,3,7,1350,0,1986,0,98033,47.6934,-122.184,1370,4115,4,14,2015,UNK,-20,-1462
6163900821,6/24/2014,304000.0,4,2.0,1310,8454,1.0,0.0,0.0,4,7,1310,0,1953,0,98155,47.7572,-122.318,1320,8274,6,24,2014,UNK,-10,180
2310060230,10/10/2014,272000.0,4,2.25,1800,5555,2.0,0.0,0.0,3,7,1800,0,2003,0,98038,47.3498,-122.052,1810,5669,10,10,2014,UNK,-10,-114
4449800315,6/20/2014,412000.0,2,1.0,1260,3960,1.0,0.0,0.0,3,6,690,570,1925,0,98117,47.6899,-122.391,1250,3960,6,20,2014,UNK,10,0
3299600120,7/18/2014,698000.0,4,2.5,2990,7231,2.0,0.0,0.0,3,9,2990,0,2001,0,98075,47.5623,-122.03200000000001,3160,8339,7,18,2014,UNK,-170,-1108
2490200615,6/9/2014,400000.0,2,1.0,1140,5100,1.0,0.0,0.0,3,7,1140,0,1942,0,98136,47.5323,-122.383,1230,5100,6,9,2014,UNK,-90,0
1565950230,11/20/2014,305000.0,3,2.5,2100,6825,2.0,0.0,0.0,3,8,2100,0,1994,0,98055,47.4314,-122.189,2180,7614,11,20,2014,UNK,-80,-789
6402700110,9/10/2014,585000.0,4,2.0,2400,12753,1.0,0.0,0.0,4,7,2400,0,1962,0,98033,47.6947,-122.177,1830,12060,9,10,2014,UNK,570,693
5029450100,8/12/2014,190000.0,2,1.5,1400,9031,1.0,0.0,0.0,3,7,960,440,1982,0,98023,47.2915,-122.368,1450,7658,8,12,2014,UNK,-50,1373
7525530590,7/20/2014,760000.0,4,2.5,2990,12788,2.0,0.0,0.0,3,10,2990,0,1988,0,98075,47.5601,-122.037,3250,12212,7,20,2014,UNK,-260,576
226059103,5/27/2014,570000.0,3,1.75,1930,36210,1.0,0.0,0.0,3,8,1930,0,1977,0,98072,47.7692,-122.12799999999999,1930,35060,5,27,2014,UNK,0,1150
6197200021,11/6/2014,144000.0,3,1.0,980,6800,1.0,0.0,0.0,3,6,980,0,1946,0,98058,47.4411,-122.186,1140,9975,11,6,2014,UNK,-160,-3175
7227500910,6/24/2014,139000.0,2,1.0,690,5280,1.0,0.0,0.0,4,5,690,0,1942,0,98056,47.4953,-122.18700000000001,1140,4860,6,24,2014,UNK,-450,420
5100402644,11/19/2014,525000.0,4,1.5,1430,6380,1.5,0.0,0.0,4,7,1130,300,1945,0,98115,47.6942,-122.319,1570,6380,11,19,2014,UNK,-140,0
748000205,7/16/2014,293000.0,1,1.0,1110,5421,1.0,0.0,0.0,3,6,1110,0,1935,0,98177,47.7322,-122.359,1230,8100,7,16,2014,UNK,-120,-2679
7899800476,4/27/2015,267100.0,2,2.5,1250,1580,2.0,0.0,0.0,3,7,1030,220,2005,0,98106,47.5243,-122.36,1250,1361,4,27,2015,N,0,219
3885804390,4/21/2015,1500000.0,4,3.25,3470,5222,2.0,0.0,0.0,3,10,2830,640,2005,0,98033,47.6845,-122.209,3090,6758,4,21,2015,N,380,-1536
1796370150,10/28/2014,240000.0,3,2.25,1500,15334,2.0,0.0,0.0,4,7,1500,0,1992,0,98042,47.3719,-122.09100000000001,1530,8102,10,28,2014,UNK,-30,7232
7935000625,4/9/2015,975000.0,3,2.5,2530,7000,2.5,0.0,4.0,3,9,2530,0,1915,1999,98136,47.5465,-122.398,2380,7000,4,9,2015,Y,150,0
1761300100,6/18/2014,279950.0,5,1.75,2150,7171,1.0,0.0,0.0,4,7,1460,690,1970,0,98031,47.3952,-122.176,1710,7300,6,18,2014,UNK,440,-129
1112700150,1/27/2015,405000.0,3,1.75,1260,7373,1.0,0.0,0.0,4,7,1260,0,1979,0,98034,47.7296,-122.23299999999999,1360,7373,1,27,2015,UNK,-100,0
2622049052,5/16/2014,400000.0,3,2.5,2740,83199,2.0,0.0,4.0,3,9,2740,0,1973,0,98032,47.3581,-122.266,2500,29269,5,16,2014,UNK,240,53930
423000035,11/24/2014,225000.0,3,1.0,960,6500,1.0,0.0,0.0,4,5,960,0,1954,0,98056,47.497,-122.171,1150,6500,11,24,2014,UNK,-190,0
1555300490,12/29/2014,250000.0,3,1.0,1520,7800,1.0,0.0,0.0,4,7,1120,400,1967,0,98032,47.3784,-122.29,1740,8000,12,29,2014,UNK,-220,-200
6802210450,3/31/2015,272950.0,3,2.25,1570,9096,1.0,0.0,0.0,4,7,1180,390,1991,0,98022,47.1937,-121.99,1570,8418,3,31,2015,UNK,0,678
7853310150,7/22/2014,625000.0,5,1.0,3240,5324,2.0,0.0,0.0,3,9,3240,0,2007,0,98065,47.523,-121.875,3240,6036,7,22,2014,N,0,-712
4086300065,7/18/2014,670000.0,3,1.75,1280,2147,1.5,0.0,0.0,4,7,1280,0,1910,0,98102,47.6362,-122.324,2010,2640,7,18,2014,UNK,-730,-493
809003085,4/1/2015,1070000.0,3,2.5,2130,3545,3.0,0.0,0.0,5,9,2130,0,1990,0,98109,47.6389,-122.34899999999999,1970,3464,4,1,2015,UNK,160,81
259100110,6/18/2014,540000.0,3,1.75,1970,8200,1.0,0.0,0.0,5,8,1420,550,1963,0,98177,47.7602,-122.363,2140,8000,6,18,2014,UNK,-170,200
2316800100,11/5/2014,525000.0,3,2.5,2990,6725,2.0,0.0,0.0,3,9,2990,0,2003,0,98059,47.4928,-122.14200000000001,2790,6725,11,5,2014,UNK,200,0
6414600051,3/3/2015,425000.0,2,1.0,1160,17700,1.0,0.0,0.0,3,7,1160,0,1947,0,98133,47.7244,-122.331,1440,9000,3,3,2015,UNK,-280,8700
1704900206,6/2/2014,465500.0,3,1.75,1890,7004,1.0,0.0,0.0,3,7,1290,600,1965,0,98118,47.5557,-122.28,1440,5378,6,2,2014,UNK,450,1626
7853301240,7/17/2014,443500.0,3,2.5,2170,5866,2.0,0.0,0.0,3,7,2170,0,2006,0,98065,47.5403,-121.889,2440,5798,7,17,2014,N,-270,68
3420069055,12/3/2014,350000.0,4,2.25,1570,499571,1.0,0.0,3.0,4,7,1570,0,1972,0,98022,47.1808,-122.023,1700,181708,12,3,2014,UNK,-130,317863
1726069198,9/18/2014,850000.0,3,2.5,3260,91911,2.0,0.0,0.0,4,9,3260,0,1984,0,98077,47.736999999999995,-122.074,2520,65775,9,18,2014,UNK,740,26136
4468400211,2/20/2015,205000.0,3,2.25,1250,952,3.0,0.0,0.0,3,8,1250,0,2008,0,98133,47.7098,-122.333,1250,1030,2,20,2015,N,0,-78
1864900230,6/26/2014,315000.0,4,2.5,1940,10200,1.0,0.0,0.0,4,8,1140,800,1977,0,98042,47.4157,-122.161,1920,12600,6,26,2014,UNK,20,-2400
8079040490,6/23/2014,470000.0,3,2.5,2150,8221,2.0,0.0,0.0,3,8,2150,0,1992,0,98059,47.5085,-122.15,2490,7951,6,23,2014,UNK,-340,270
7856400410,7/29/2014,1100000.0,4,2.25,3310,8540,1.0,0.0,4.0,4,9,1660,1650,1973,0,98006,47.5603,-122.15799999999999,3450,9566,7,29,2014,UNK,-140,-1026
1825079018,11/20/2014,340000.0,3,1.75,3400,46382,1.0,0.0,0.0,3,7,2050,1350,1979,0,98053,47.6458,-121.955,2320,20624,11,20,2014,UNK,1080,25758
5151600120,6/18/2014,310000.0,4,2.5,2660,12672,1.0,0.0,0.0,4,8,1740,920,1960,0,98003,47.3334,-122.323,2280,12477,6,18,2014,UNK,380,195
4024101050,6/2/2014,305000.0,3,1.0,950,13475,1.0,0.0,0.0,3,7,950,0,1950,0,98155,47.7543,-122.306,1240,8910,6,2,2014,UNK,-290,4565
2854800090,7/10/2014,307150.0,3,1.5,1480,6752,1.0,0.0,0.0,4,7,1480,0,1959,0,98056,47.4993,-122.176,1450,8023,7,10,2014,UNK,30,-1271
1726600120,7/1/2014,729032.0,4,2.5,2840,12866,1.0,0.0,0.0,4,9,1780,1060,1977,0,98005,47.6388,-122.167,2840,13209,7,1,2014,UNK,0,-343
627300195,3/3/2015,750000.0,5,2.5,3240,9960,1.0,0.0,1.0,3,8,2020,1220,1958,0,98008,47.5858,-122.11200000000001,2730,10400,3,3,2015,UNK,510,-440
2140900100,2/3/2015,289000.0,4,2.5,1961,3207,2.0,0.0,0.0,3,7,1961,0,2006,0,98042,47.3507,-122.16,1961,3401,2,3,2015,N,0,-194
446000150,4/15/2015,480000.0,3,1.0,1100,5700,1.0,0.0,0.0,3,7,1100,0,1950,0,98115,47.6883,-122.28200000000001,1560,6588,4,15,2015,UNK,-460,-888
7436500120,2/19/2015,529000.0,3,1.75,1500,7367,1.0,0.0,0.0,3,8,1500,0,1974,0,98033,47.6722,-122.167,1920,7579,2,19,2015,UNK,-420,-212
6917700195,7/28/2014,585000.0,3,1.75,1480,4800,2.0,0.0,0.0,4,7,1140,340,1944,0,98199,47.6567,-122.397,1810,4800,7,28,2014,UNK,-330,0
4377000100,9/25/2014,704000.0,4,2.75,2510,12500,1.0,0.0,0.0,5,8,2050,460,1976,0,98052,47.6278,-122.11,2200,12088,9,25,2014,UNK,310,412
925049278,3/4/2015,607000.0,4,2.0,1490,4054,1.5,0.0,0.0,5,7,1490,0,1926,0,98115,47.6744,-122.301,1510,3889,3,4,2015,UNK,-20,165
7558750120,3/10/2015,580000.0,3,2.25,2190,8188,2.0,0.0,0.0,3,8,1810,380,1978,0,98052,47.6883,-122.113,2190,8374,3,10,2015,UNK,0,-186
7856610490,8/5/2014,875000.0,5,2.5,2530,8564,2.0,0.0,0.0,4,8,2530,0,1976,0,98006,47.5622,-122.15299999999999,2480,8714,8,5,2014,UNK,50,-150
9346930100,10/15/2014,610000.0,4,2.5,2440,9350,1.0,0.0,0.0,4,8,1560,880,1976,0,98006,47.5614,-122.13,2260,8500,10,15,2014,UNK,180,850
114100763,7/28/2014,230000.0,3,0.75,1040,15000,1.0,0.0,0.0,3,6,1040,0,1941,0,98028,47.7639,-122.234,1410,19000,7,28,2014,UNK,-370,-4000
7214700580,6/8/2014,510000.0,4,2.25,2450,62290,2.0,0.0,0.0,3,8,2450,0,1976,0,98077,47.7603,-122.074,2450,41181,6,8,2014,UNK,0,21109
4237901075,3/5/2015,733000.0,4,2.5,2210,5002,1.0,0.0,0.0,3,7,1370,840,1977,0,98199,47.6637,-122.40100000000001,1970,4920,3,5,2015,UNK,240,82
302000375,8/14/2014,169100.0,3,2.0,1050,18304,1.0,0.0,0.0,4,7,1050,0,1953,0,98001,47.3206,-122.26899999999999,1690,15675,8,14,2014,UNK,-640,2629
302000375,5/6/2015,250000.0,3,2.0,1050,18304,1.0,0.0,0.0,4,7,1050,0,1953,0,98001,47.3206,-122.26899999999999,1690,15675,5,6,2015,UNK,-640,2629
6843300090,11/3/2014,500000.0,4,2.25,2730,35100,2.0,0.0,0.0,3,8,2730,0,1977,0,98075,47.5913,-122.012,2730,36677,11,3,2014,UNK,0,-1577
3524039144,10/7/2014,700000.0,2,1.0,1620,9855,1.0,0.0,4.0,3,8,1320,300,1948,0,98136,47.5264,-122.384,1820,7700,10,7,2014,UNK,-200,2155
1787250210,12/22/2014,379000.0,4,2.75,2410,5225,2.0,0.0,0.0,3,8,2410,0,2001,0,98058,47.4244,-122.15100000000001,2300,5378,12,22,2014,UNK,110,-153
3022079080,7/15/2014,650000.0,4,2.5,3420,222156,2.0,0.0,0.0,3,9,3420,0,2002,0,98010,47.3608,-121.97,3340,222156,7,15,2014,UNK,80,0
2402100205,11/19/2014,412133.0,2,1.0,920,4400,1.0,0.0,0.0,3,7,920,0,1948,0,98103,47.6903,-122.33200000000001,1560,4600,11,19,2014,UNK,-640,-200
1973800150,4/2/2015,480000.0,4,2.25,2330,14190,1.0,0.0,0.0,3,8,1740,590,1962,0,98034,47.718,-122.242,2330,14190,4,2,2015,UNK,0,0
5315100805,12/18/2014,650000.0,3,1.75,1940,10245,1.0,0.0,0.0,3,7,1940,0,1957,0,98040,47.5833,-122.241,2720,11448,12,18,2014,UNK,-780,-1203
8682262240,3/30/2015,505000.0,2,2.5,1900,5065,2.0,0.0,0.0,3,8,1900,0,2005,0,98053,47.7175,-122.03399999999999,1350,4664,3,30,2015,N,550,401
9541600490,5/5/2015,931088.0,4,2.5,3510,17400,1.0,0.0,0.0,4,9,1930,1580,1957,0,98005,47.5963,-122.171,2730,12120,5,5,2015,UNK,780,5280
686200490,9/26/2014,570000.0,4,1.75,1860,7700,1.0,0.0,0.0,4,8,1860,0,1964,0,98008,47.62600000000001,-122.11200000000001,1860,7700,9,26,2014,UNK,0,0
8121101380,8/13/2014,475000.0,3,1.0,1380,4635,1.0,0.0,0.0,4,6,1380,0,1919,0,98144,47.57,-122.285,1790,4635,8,13,2014,UNK,-410,0
9198600035,8/5/2014,240000.0,6,1.75,2210,8594,1.0,0.0,0.0,3,7,1310,900,1959,0,98188,47.4594,-122.273,1850,8594,8,5,2014,UNK,360,0
322069141,1/14/2015,462000.0,4,2.5,2640,47480,1.0,0.0,0.0,4,8,1590,1050,1979,0,98038,47.4258,-122.021,2390,67415,1,14,2015,UNK,250,-19935
2523039054,2/10/2015,1120000.0,3,2.5,4530,22873,2.0,0.0,2.0,5,8,3220,1310,1912,0,98166,47.4567,-122.369,3100,18210,2,10,2015,UNK,1430,4663
1446401540,9/16/2014,243000.0,3,1.0,1500,6600,1.0,0.0,0.0,2,6,1500,0,1970,0,98168,47.4845,-122.33,1730,6600,9,16,2014,UNK,-230,0
9541600015,2/11/2015,660000.0,4,2.25,2010,15375,1.0,0.0,0.0,4,8,2010,0,1957,0,98005,47.5956,-122.17399999999999,1930,15375,2,11,2015,UNK,80,0
7352200025,10/13/2014,1190000.0,2,1.75,2080,8112,1.0,1.0,4.0,4,8,1040,1040,1939,1984,98125,47.7134,-122.277,2030,8408,10,13,2014,Y,50,-296
853600150,5/24/2014,1680000.0,4,4.25,5584,68257,2.0,0.0,0.0,3,11,5584,0,1998,0,98014,47.6113,-121.95200000000001,5030,101901,5,24,2014,UNK,554,-33644
9208900037,9/19/2014,6890000.0,6,7.75,9890,31374,2.0,0.0,4.0,3,13,8860,1030,2001,0,98039,47.6305,-122.24,4540,42730,9,19,2014,UNK,5350,-11356
7853230720,9/10/2014,368000.0,3,2.5,2080,4307,2.0,0.0,0.0,3,7,2080,0,2004,0,98065,47.53,-121.848,2080,4947,9,10,2014,N,0,-640
8562750220,11/20/2014,811500.0,5,4.25,3970,4500,2.0,0.0,0.0,3,9,2860,1110,2004,0,98027,47.5402,-122.069,3480,4500,11,20,2014,N,490,0
3995700325,6/4/2014,275000.0,2,1.0,770,8149,1.0,0.0,0.0,5,6,770,0,1948,0,98155,47.7406,-122.302,770,8150,6,4,2014,UNK,0,-1
2387400120,9/29/2014,650000.0,4,2.5,2500,6005,2.0,0.0,0.0,3,9,2500,0,2001,0,98033,47.6922,-122.17399999999999,2680,7200,9,29,2014,UNK,-180,-1195
822039146,2/19/2015,485000.0,3,2.0,2410,50654,1.5,0.0,0.0,3,7,2410,0,1995,0,98070,47.4154,-122.458,1900,36300,2,19,2015,UNK,510,14354
1925069183,8/15/2014,425000.0,3,2.5,1340,10018,1.0,0.0,0.0,4,7,1340,0,1976,0,98052,47.6366,-122.094,2520,13068,8,15,2014,UNK,-1180,-3050
6205500580,12/10/2014,530000.0,3,2.5,2640,13775,1.0,0.0,0.0,3,8,1550,1090,1978,0,98005,47.5875,-122.177,2120,12432,12,10,2014,UNK,520,1343
8835400805,5/22/2014,657000.0,4,1.75,2740,8520,1.0,0.0,2.0,3,8,1370,1370,1954,0,98118,47.5445,-122.26299999999999,2740,9286,5,22,2014,UNK,0,-766
1518000230,12/31/2014,315000.0,4,2.75,1580,3770,1.0,0.0,0.0,3,7,1080,500,2002,0,98019,47.7368,-121.96799999999999,1740,3800,12,31,2014,UNK,-160,-30
4053200410,5/13/2014,273000.0,4,1.5,2180,22870,1.0,0.0,0.0,4,6,1280,900,1954,1975,98042,47.3187,-122.081,2420,22614,5,13,2014,Y,-240,256
2141300620,9/15/2014,550000.0,3,2.75,1960,13252,1.0,0.0,0.0,5,8,1240,720,1975,0,98006,47.5582,-122.139,2040,9866,9,15,2014,UNK,-80,3386
3278602170,12/15/2014,347000.0,2,2.25,1560,1705,2.0,0.0,0.0,3,8,1270,290,2006,0,98126,47.5482,-122.374,1560,1758,12,15,2014,N,0,-53
3876310300,6/6/2014,525000.0,5,2.75,2440,8000,1.0,0.0,0.0,4,7,1240,1200,1972,0,98034,47.7283,-122.17,1780,8391,6,6,2014,UNK,660,-391
8141200027,9/25/2014,490000.0,3,1.5,990,1343,2.0,0.0,0.0,3,8,840,150,2007,0,98112,47.6236,-122.306,1350,2521,9,25,2014,N,-360,-1178
3034200543,12/29/2014,500000.0,3,2.25,2210,7916,2.0,0.0,0.0,3,8,2210,0,1978,0,98133,47.7175,-122.339,1450,7955,12,29,2014,UNK,760,-39
7787050180,1/28/2015,585000.0,3,2.75,3080,7282,2.0,0.0,0.0,3,9,3080,0,2008,0,98059,47.4826,-122.149,3080,7274,1,28,2015,N,0,8
3760500475,11/6/2014,926500.0,4,2.75,2900,17802,1.0,0.0,2.0,3,9,1750,1150,1981,0,98034,47.7004,-122.229,2900,15720,11,6,2014,UNK,0,2082
9301301145,10/24/2014,465000.0,1,1.0,1020,3200,1.0,0.0,0.0,3,7,1020,0,1927,0,98109,47.6361,-122.34299999999999,1670,3480,10,24,2014,UNK,-650,-280
5615100330,3/27/2015,200000.0,4,2.0,1900,8160,1.0,0.0,0.0,3,7,1900,0,1975,0,98022,47.2114,-121.986,1280,6532,3,27,2015,UNK,620,1628
4139500410,1/26/2015,1680000.0,6,4.75,5770,16747,2.0,0.0,3.0,3,12,4500,1270,1998,0,98006,47.5512,-122.11,4470,14571,1,26,2015,UNK,1300,2176
722039087,9/23/2014,220500.0,2,1.0,990,57499,1.0,0.0,0.0,2,6,990,0,1949,0,98070,47.4145,-122.463,2090,27442,9,23,2014,UNK,-1100,30057
722039087,5/4/2015,329000.0,2,1.0,990,57499,1.0,0.0,0.0,2,6,990,0,1949,0,98070,47.4145,-122.463,2090,27442,5,4,2015,UNK,-1100,30057
8129700644,7/3/2014,715000.0,3,4.0,2080,2250,3.0,0.0,4.0,3,8,2080,0,1997,0,98103,47.6598,-122.355,2080,2250,7,3,2014,UNK,0,0
8129700644,4/24/2015,780000.0,3,4.0,2080,2250,3.0,0.0,4.0,3,8,2080,0,1997,0,98103,47.6598,-122.355,2080,2250,4,24,2015,UNK,0,0
4443800385,8/18/2014,410000.0,2,1.0,1480,4080,1.0,0.0,0.0,3,7,1050,430,1949,0,98117,47.6842,-122.39299999999999,1310,4080,8,18,2014,UNK,170,0
4443800385,5/6/2015,778100.0,2,1.0,1480,4080,1.0,0.0,0.0,3,7,1050,430,1949,0,98117,47.6842,-122.39299999999999,1310,4080,5,6,2015,UNK,170,0
7405700015,3/30/2015,406000.0,3,1.0,1090,11292,1.0,0.0,0.0,4,7,1090,0,1952,0,98133,47.7429,-122.35799999999999,1570,8198,3,30,2015,UNK,-480,3094
2780400035,5/5/2014,665000.0,4,2.5,2800,5900,1.0,0.0,0.0,3,8,1660,1140,1963,0,98115,47.6809,-122.286,2580,5900,5,5,2014,UNK,220,0
5562100325,11/25/2014,305000.0,2,1.0,1000,8212,1.0,0.0,0.0,4,7,1000,0,1947,0,98133,47.7444,-122.34100000000001,1620,8214,11,25,2014,UNK,-620,-2
7437101030,8/22/2014,265000.0,3,2.5,1640,7668,2.0,0.0,0.0,3,7,1640,0,1991,0,98038,47.3505,-122.027,1850,7200,8,22,2014,UNK,-210,468
3856904610,10/2/2014,485000.0,4,1.0,1620,4080,1.5,0.0,0.0,3,7,1620,0,1923,0,98105,47.6696,-122.324,1760,4080,10,2,2014,UNK,-140,0
1423069095,5/7/2014,600000.0,3,2.5,2460,108900,1.0,0.0,0.0,4,9,1860,0,1977,0,98027,47.4824,-122.0,2870,102366,5,7,2014,UNK,-410,6534
2523400205,4/21/2015,510000.0,2,1.5,1860,5100,1.0,0.0,0.0,3,7,1060,800,1940,0,98136,47.5573,-122.39200000000001,1710,5100,4,21,2015,UNK,150,0
3530420110,5/21/2014,195000.0,2,1.0,1080,3899,1.0,0.0,0.0,4,8,1080,0,1972,0,98198,47.3792,-122.321,1090,3899,5,21,2014,UNK,-10,0
6046401030,5/28/2014,432500.0,3,1.75,1980,5100,1.0,0.0,0.0,3,7,1270,710,1965,0,98103,47.6911,-122.34700000000001,1400,5100,5,28,2014,UNK,580,0
8563000770,12/10/2014,490000.0,3,1.75,1510,8433,1.0,0.0,0.0,4,7,1220,290,1967,0,98008,47.6226,-122.103,1950,8199,12,10,2014,UNK,-440,234
2215900180,7/11/2014,270000.0,3,2.5,1690,7165,2.0,0.0,0.0,4,7,1690,0,1992,0,98038,47.3498,-122.05799999999999,1410,8590,7,11,2014,UNK,280,-1425
2771602450,8/26/2014,370000.0,2,1.5,1010,2102,2.0,0.0,0.0,3,7,1010,0,1984,0,98119,47.6374,-122.375,1480,2632,8,26,2014,UNK,-470,-530
722059233,12/15/2014,327500.0,3,2.5,2090,12027,2.0,0.0,0.0,3,8,2090,0,1991,0,98031,47.4084,-122.213,2090,12666,12,15,2014,UNK,0,-639
1257201095,3/23/2015,826000.0,2,1.0,1060,6120,1.0,0.0,0.0,3,7,1060,0,1908,0,98103,47.6739,-122.329,1730,4080,3,23,2015,UNK,-670,2040
4391600035,7/1/2014,510000.0,3,1.75,1750,7020,2.0,0.0,0.0,3,7,1750,0,1934,1978,98010,47.3264,-122.038,1170,9546,7,1,2014,Y,580,-2526
625049310,3/11/2015,587750.0,2,1.0,890,4730,1.0,0.0,0.0,3,7,890,0,1941,0,98103,47.6876,-122.34100000000001,1330,5904,3,11,2015,UNK,-440,-1174
424059100,3/27/2015,449228.0,5,2.5,3020,24750,1.0,0.0,0.0,3,8,1650,1370,1965,0,98005,47.5897,-122.179,2930,16062,3,27,2015,UNK,90,8688
1422029138,9/2/2014,565000.0,3,2.5,2030,217805,1.0,0.0,0.0,3,9,2030,0,1999,0,98070,47.3942,-122.515,1870,109468,9,2,2014,UNK,160,108337
2723069146,4/24/2015,660000.0,4,2.5,3170,186436,2.0,0.0,0.0,3,9,3170,0,2000,0,98038,47.4475,-122.03399999999999,3250,215186,4,24,2015,UNK,-80,-28750
5112800042,12/3/2014,400000.0,5,2.75,2470,19200,1.0,0.0,0.0,5,8,1250,1220,1977,0,98058,47.4496,-122.083,2140,35140,12,3,2014,UNK,330,-15940
579002870,5/6/2014,612500.0,4,2.0,2060,5000,1.0,0.0,0.0,3,7,1030,1030,1949,2013,98117,47.6992,-122.37899999999999,1280,5000,5,6,2014,Y,780,0
2461900790,3/13/2015,560000.0,4,1.75,2120,6250,1.0,0.0,0.0,5,7,1060,1060,1917,0,98136,47.5506,-122.385,1410,6250,3,13,2015,UNK,710,0
6788200360,9/3/2014,727000.0,3,2.25,2180,4200,1.5,0.0,0.0,5,8,1520,660,1939,0,98112,47.6412,-122.302,1850,4200,9,3,2014,UNK,330,0
1018000110,4/23/2015,224000.0,4,3.0,2300,7609,2.0,0.0,0.0,4,7,2300,0,1976,0,98002,47.2943,-122.227,940,5937,4,23,2015,UNK,1360,1672
7701960720,10/17/2014,1080000.0,4,2.5,4200,35267,2.0,0.0,0.0,3,11,4200,0,1990,0,98077,47.7108,-122.071,3540,22234,10,17,2014,UNK,660,13033
9477201530,4/23/2015,439000.0,3,2.25,1480,7565,1.0,0.0,0.0,3,7,1220,260,1977,0,98034,47.7288,-122.191,1660,7565,4,23,2015,UNK,-180,0
1821069072,5/8/2014,335000.0,3,1.5,2240,87625,1.5,0.0,0.0,2,7,1480,760,1980,0,98092,47.3043,-122.094,1920,110206,5,8,2014,UNK,320,-22581
5035300572,10/16/2014,779000.0,4,1.5,2740,4912,1.0,0.0,0.0,4,8,1370,1370,1937,0,98199,47.6523,-122.412,2160,5006,10,16,2014,UNK,580,-94
1023089019,7/30/2014,452000.0,5,1.75,1830,47916,1.5,0.0,0.0,3,6,1830,0,1948,0,98045,47.4881,-121.777,2010,13135,7,30,2014,UNK,-180,34781
2710600015,3/27/2015,775000.0,4,3.0,2000,5304,1.5,0.0,0.0,4,7,2000,0,1947,0,98115,47.6762,-122.285,1670,5304,3,27,2015,UNK,330,0
1502400300,9/16/2014,235000.0,3,1.75,1380,8362,1.0,0.0,0.0,3,7,1380,0,1967,0,98003,47.3121,-122.323,1380,8800,9,16,2014,UNK,0,-438
4045700115,10/28/2014,370000.0,3,1.75,1620,37913,2.0,0.0,0.0,4,7,1620,0,1953,0,98001,47.2875,-122.289,2190,21518,10,28,2014,UNK,-570,16395
7504010590,11/14/2014,790000.0,4,3.0,3180,12070,2.0,0.0,0.0,4,9,3180,0,1976,0,98074,47.6371,-122.05799999999999,3110,12600,11,14,2014,UNK,70,-530
4389200610,12/1/2014,903000.0,2,1.5,1140,7800,1.0,0.0,0.0,4,6,1140,0,1947,0,98004,47.6142,-122.209,2020,7800,12,1,2014,UNK,-880,0
1321039076,6/27/2014,209950.0,3,1.0,970,9583,1.0,0.0,0.0,4,6,970,0,1967,0,98023,47.3044,-122.366,970,7875,6,27,2014,UNK,0,1708
4123800180,8/27/2014,309000.0,3,2.5,1780,7859,2.0,0.0,0.0,3,7,1780,0,1988,0,98038,47.3772,-122.045,1670,6618,8,27,2014,UNK,110,1241
6415100410,6/9/2014,440000.0,3,1.75,2240,8153,1.0,0.0,0.0,3,7,1120,1120,1948,0,98125,47.7303,-122.329,1710,8100,6,9,2014,UNK,530,53
4420600015,10/6/2014,571500.0,4,2.25,2810,25990,2.0,0.0,0.0,3,8,1860,950,1959,0,98001,47.2993,-122.29299999999999,2020,16140,10,6,2014,UNK,790,9850
3856901880,8/15/2014,514000.0,2,1.0,920,4000,1.0,0.0,0.0,4,7,920,0,1906,0,98105,47.6711,-122.32799999999999,1300,4000,8,15,2014,UNK,-380,0
3878900395,7/28/2014,323000.0,3,1.75,1830,12500,1.0,0.0,1.0,3,7,1200,630,1947,0,98178,47.5087,-122.25,1830,7300,7,28,2014,UNK,0,5200
9183701345,11/3/2014,290000.0,2,1.75,1560,7575,1.0,0.0,0.0,3,8,1560,0,2002,0,98030,47.3776,-122.228,2050,9000,11,3,2014,UNK,-490,-1425
7768700300,12/5/2014,2580000.0,4,4.25,5540,15408,2.0,0.0,1.0,3,11,4280,1260,2006,0,98004,47.6071,-122.212,3570,14750,12,5,2014,N,1970,658
3536900110,10/9/2014,1360000.0,3,2.0,2310,21318,1.0,0.0,0.0,3,10,2310,0,1979,0,98004,47.6381,-122.22399999999999,2950,21814,10,9,2014,UNK,-640,-496
7518503830,7/23/2014,551000.0,4,1.5,1470,5100,1.5,0.0,0.0,3,7,1470,0,1946,0,98117,47.6769,-122.381,1470,5100,7,23,2014,UNK,0,0
2125059161,10/23/2014,960000.0,4,2.5,3430,43560,1.5,0.0,2.0,5,10,3430,0,1979,0,98005,47.6426,-122.18,3700,44431,10,23,2014,UNK,-270,-871
2597520720,11/3/2014,720000.0,5,2.5,2900,9525,2.0,0.0,0.0,3,9,2900,0,1989,0,98006,47.5442,-122.13799999999999,2910,11854,11,3,2014,UNK,-10,-2329
109200730,5/6/2014,218000.0,3,1.75,1850,7684,1.0,0.0,0.0,3,8,1320,530,1979,0,98023,47.2975,-122.37,1940,7630,5,6,2014,UNK,-90,54
2621750110,12/23/2014,334950.0,4,2.5,2190,7000,2.0,0.0,0.0,3,8,2190,0,1997,0,98042,47.3718,-122.109,2040,7700,12,23,2014,UNK,150,-700
8644400040,7/29/2014,605000.0,4,2.25,2510,31584,2.0,0.0,0.0,4,9,2510,0,1979,0,98074,47.6153,-122.054,2510,39221,7,29,2014,UNK,0,-7637
4237901345,12/17/2014,825000.0,4,3.25,3200,4477,2.0,0.0,0.0,3,9,2390,810,2006,0,98199,47.663999999999994,-122.402,1830,4920,12,17,2014,N,1370,-443
8731982250,8/12/2014,268500.0,4,1.75,1670,8000,1.0,0.0,0.0,4,8,1670,0,1974,0,98023,47.3193,-122.383,1720,8000,8,12,2014,UNK,-50,0
7942100180,6/27/2014,230000.0,3,1.75,1010,9600,1.0,0.0,0.0,5,7,1010,0,1969,0,98042,47.3828,-122.09,1320,9600,6,27,2014,UNK,-310,0
3324079089,11/21/2014,1340000.0,4,4.0,5050,202554,2.0,0.0,0.0,3,10,3260,1790,2000,0,98027,47.5269,-121.92200000000001,3370,213444,11,21,2014,UNK,1680,-10890
7147800015,4/1/2015,245500.0,2,1.5,1430,9782,1.0,0.0,0.0,3,7,1430,0,1955,0,98188,47.441,-122.28200000000001,1430,9828,4,1,2015,UNK,0,-46
2826049023,7/29/2014,440000.0,3,2.25,1880,7989,1.0,0.0,0.0,3,7,1280,600,1982,0,98125,47.7077,-122.29899999999999,1820,7414,7,29,2014,UNK,60,575
3905081530,10/7/2014,571500.0,4,2.75,2180,5799,2.0,0.0,0.0,4,8,2180,0,1993,0,98029,47.5702,-121.995,2060,6061,10,7,2014,UNK,120,-262
9543000945,4/27/2015,182500.0,3,2.25,1830,4744,2.0,0.0,0.0,3,7,1830,0,1997,0,98001,47.2734,-122.24799999999999,1670,8001,4,27,2015,UNK,160,-3257
402000145,10/28/2014,217000.0,2,1.0,970,5600,1.0,0.0,0.0,3,6,970,0,1951,0,98118,47.5297,-122.277,1020,5600,10,28,2014,UNK,-50,0
4364200015,1/9/2015,335000.0,2,1.5,1170,5248,1.0,0.0,0.0,5,6,1170,0,1941,0,98126,47.5318,-122.374,1170,5120,1,9,2015,UNK,0,128
2979800845,5/24/2014,501000.0,2,1.0,1010,4320,1.0,0.0,0.0,5,7,1010,0,1924,0,98115,47.6846,-122.31700000000001,1680,4320,5,24,2014,UNK,-670,0
7230900120,10/27/2014,339950.0,3,2.5,2140,7641,1.0,0.0,0.0,3,8,1290,850,1979,0,98056,47.5053,-122.186,2090,8000,10,27,2014,UNK,50,-359
5018200155,1/21/2015,340000.0,3,1.75,2230,10403,1.0,0.0,0.0,3,8,1630,600,1968,0,98198,47.4092,-122.295,1730,9450,1,21,2015,UNK,500,953
6743700317,2/4/2015,582500.0,2,1.0,1140,23779,1.5,0.0,0.0,3,6,1140,0,1966,0,98033,47.6948,-122.17200000000001,2940,8417,2,4,2015,UNK,-1800,15362
3738900035,8/25/2014,298800.0,2,1.0,860,8189,1.0,0.0,0.0,3,6,860,0,1948,0,98155,47.735,-122.306,1180,8189,8,25,2014,UNK,-320,0
1328300040,3/12/2015,317500.0,6,1.75,2540,8400,1.0,0.0,0.0,3,8,1340,1200,1977,0,98058,47.4414,-122.12899999999999,1900,7695,3,12,2015,UNK,640,705
952000495,4/2/2015,598000.0,4,2.5,2420,5118,1.5,0.0,2.0,5,7,1550,870,1926,0,98126,47.5671,-122.37799999999999,1740,5750,4,2,2015,UNK,680,-632
7996700220,4/30/2015,375000.0,2,2.25,1640,2240,2.0,0.0,0.0,3,8,1640,0,1980,0,98133,47.7154,-122.34100000000001,1640,2240,4,30,2015,UNK,0,0
7972601445,1/16/2015,465000.0,4,2.25,2550,7650,2.0,0.0,2.0,4,9,2550,0,1996,0,98106,47.5296,-122.34200000000001,2550,7650,1,16,2015,UNK,0,0
3751601785,2/25/2015,551870.0,3,2.5,2507,18400,2.0,0.0,0.0,3,8,2507,0,2006,0,98001,47.2867,-122.27,1520,14709,2,25,2015,N,987,3691
7212650650,5/8/2014,295000.0,3,2.5,1920,7229,2.0,0.0,0.0,3,8,1920,0,1993,0,98003,47.2659,-122.31,2310,8009,5,8,2014,UNK,-390,-780
2413300730,9/24/2014,263500.0,4,1.75,2210,6375,1.0,0.0,0.0,3,8,1640,570,1977,0,98003,47.3268,-122.32799999999999,2070,7210,9,24,2014,UNK,140,-835
8127700735,6/16/2014,1100000.0,4,4.0,3530,8400,2.0,0.0,0.0,5,8,2630,900,1958,0,98199,47.6402,-122.395,2340,8216,6,16,2014,UNK,1190,184
2113701080,11/12/2014,300000.0,2,1.0,1100,4010,1.5,0.0,0.0,5,6,1100,0,1920,0,98106,47.5296,-122.351,980,4501,11,12,2014,UNK,120,-491
5700000120,7/22/2014,780000.0,4,1.0,3390,4500,1.5,0.0,0.0,3,8,2190,1200,1924,2014,98144,47.5824,-122.29299999999999,2030,4872,7,22,2014,Y,1360,-372
3172600031,3/27/2015,325000.0,3,1.5,1590,7936,1.0,0.0,0.0,3,7,1590,0,1956,0,98106,47.5201,-122.366,1590,7936,3,27,2015,UNK,0,0
66000265,8/7/2014,370000.0,2,1.0,820,6550,1.0,0.0,0.0,3,7,820,0,1949,2012,98126,47.5478,-122.381,1640,6550,8,7,2014,Y,-820,0
4045800040,7/25/2014,715000.0,4,2.5,2370,10000,1.0,0.0,0.0,5,8,1660,710,1974,0,98052,47.6383,-122.09899999999999,2480,9875,7,25,2014,UNK,-110,125
1430800100,1/16/2015,356000.0,4,2.0,1600,12500,1.0,0.0,0.0,5,7,1600,0,1938,0,98166,47.4713,-122.355,1260,8306,1,16,2015,UNK,340,4194
2473411240,3/24/2015,329950.0,4,1.75,1740,7208,1.5,0.0,0.0,3,8,1740,0,1976,0,98058,47.4483,-122.13,1680,7350,3,24,2015,UNK,60,-142
2877100985,6/23/2014,490000.0,3,2.25,1470,2500,2.0,0.0,0.0,3,8,1080,390,1984,0,98117,47.6762,-122.36,1640,4300,6,23,2014,UNK,-170,-1800
4310701575,6/10/2014,429000.0,3,3.25,1410,1246,3.0,0.0,0.0,3,8,1410,0,2005,0,98103,47.6981,-122.34,1410,1253,6,10,2014,N,0,-7
7715801030,3/31/2015,510000.0,4,2.5,1620,8125,2.0,0.0,0.0,4,7,1620,0,1983,0,98074,47.6255,-122.059,1480,8120,3,31,2015,UNK,140,5
7202331050,9/24/2014,550000.0,3,2.5,2360,4080,2.0,0.0,0.0,3,7,2360,0,2003,0,98053,47.6825,-122.038,2290,4080,9,24,2014,UNK,70,0
8820903555,1/5/2015,467500.0,3,1.0,1830,6453,1.0,0.0,0.0,4,7,1830,0,1956,0,98125,47.7139,-122.288,1670,8012,1,5,2015,UNK,160,-1559
5708500315,6/23/2014,615000.0,5,2.0,2130,4180,1.5,0.0,0.0,5,7,1270,860,1926,0,98116,47.575,-122.38799999999999,1710,4180,6,23,2014,UNK,420,0
526059103,10/13/2014,325000.0,2,1.0,990,15120,1.0,0.0,0.0,4,6,990,0,1953,0,98011,47.7669,-122.206,1300,11500,10,13,2014,UNK,-310,3620
1352300315,8/8/2014,219950.0,2,1.0,1010,4120,2.0,0.0,0.0,3,6,1010,0,1907,0,98055,47.488,-122.2,1200,4120,8,8,2014,UNK,-190,0
3307700150,4/13/2015,950000.0,3,1.0,1720,9830,1.0,0.0,0.0,4,7,1720,0,1946,0,98040,47.5905,-122.245,3200,8923,4,13,2015,UNK,-1480,907
809001400,9/22/2014,925000.0,3,1.0,1630,3200,1.5,0.0,0.0,4,8,1630,0,1912,0,98109,47.6351,-122.352,1710,3600,9,22,2014,UNK,-80,-400
6123600090,5/19/2014,251200.0,4,1.5,1310,8250,1.0,0.0,0.0,3,7,1060,250,1953,0,98148,47.425,-122.33200000000001,1260,8255,5,19,2014,UNK,50,-5
8651401720,9/18/2014,215000.0,3,1.5,1610,5304,1.0,0.0,0.0,4,6,1610,0,1968,0,98042,47.3632,-122.087,1060,5304,9,18,2014,UNK,550,0
6386700110,8/5/2014,245000.0,3,2.0,1850,8208,1.0,0.0,0.0,4,7,1180,670,1970,0,98023,47.3109,-122.36200000000001,1790,8174,8,5,2014,UNK,60,34
8100900115,2/6/2015,259000.0,3,1.75,1270,4815,1.5,0.0,0.0,3,6,980,0,1922,0,98108,47.5495,-122.31,1270,6431,2,6,2015,UNK,0,-1616
7549801395,11/13/2014,349950.0,4,1.5,1420,6720,1.5,0.0,0.0,3,7,1420,0,1925,0,98108,47.5518,-122.311,1560,5600,11,13,2014,UNK,-140,1120
226059096,11/18/2014,1570000.0,5,4.5,5220,67319,2.0,0.0,0.0,3,11,5220,0,2001,0,98072,47.7666,-122.12799999999999,4190,40609,11,18,2014,UNK,1030,26710
6021502070,5/8/2015,600000.0,2,1.0,1410,4500,1.0,0.0,0.0,3,7,1020,390,1939,0,98117,47.6883,-122.384,1300,4500,5,8,2015,UNK,110,0
2767603608,10/2/2014,405000.0,2,1.5,1170,1274,3.0,0.0,0.0,3,8,1170,0,2001,0,98107,47.6719,-122.381,1290,1308,10,2,2014,UNK,-120,-34
425059103,12/2/2014,625000.0,3,2.5,1860,10027,2.0,0.0,0.0,3,8,1860,0,1993,0,98033,47.6775,-122.165,1530,9204,12,2,2014,UNK,330,823
1624079057,7/17/2014,430000.0,4,1.0,1620,37075,1.5,0.0,0.0,3,7,1620,0,1943,0,98024,47.5654,-121.929,2190,87117,7,17,2014,UNK,-570,-50042
1931300688,4/29/2015,533000.0,3,3.0,1280,1085,3.0,0.0,0.0,3,8,1280,0,2004,0,98103,47.6569,-122.346,1300,1310,4,29,2015,N,-20,-225
7732650120,7/28/2014,1050000.0,4,2.5,2750,9949,2.0,0.0,0.0,3,10,2750,0,1999,0,98007,47.6595,-122.147,2750,9860,7,28,2014,UNK,0,89
179001425,10/24/2014,230000.0,3,1.75,1420,3000,1.0,0.0,0.0,3,5,710,710,1931,2014,98178,47.4928,-122.274,1960,5000,10,24,2014,Y,-540,-2000
5469300330,9/5/2014,275000.0,4,1.75,2000,8700,1.0,0.0,0.0,5,7,1010,990,1975,0,98042,47.373999999999995,-122.141,1490,7350,9,5,2014,UNK,510,1350
3678900110,6/10/2014,403000.0,2,1.0,1100,3598,1.0,0.0,0.0,4,7,1100,0,1926,0,98144,47.5738,-122.31299999999999,1240,3598,6,10,2014,UNK,-140,0
3388300730,9/10/2014,550388.0,3,3.0,1720,70567,1.0,0.0,2.0,5,7,1720,0,1966,0,98027,47.4936,-122.069,2740,70567,9,10,2014,UNK,-1020,0
4037600115,9/22/2014,415500.0,3,1.5,1240,12400,1.0,0.0,0.0,3,7,1240,0,1958,0,98007,47.607,-122.132,1640,9600,9,22,2014,UNK,-400,2800
4083302485,4/20/2015,913000.0,3,1.75,2170,4000,1.0,0.0,0.0,4,7,1110,1060,1925,0,98103,47.6546,-122.337,1890,4000,4,20,2015,UNK,280,0
7857000716,3/13/2015,334998.0,2,1.0,1800,5182,1.0,0.0,0.0,3,6,900,900,1942,0,98108,47.5508,-122.3,1570,5876,3,13,2015,UNK,230,-694
8857600490,5/9/2014,201500.0,3,1.0,1160,8320,1.0,0.0,0.0,4,7,1160,0,1959,0,98032,47.3831,-122.288,1480,7800,5,9,2014,UNK,-320,520
925069100,3/27/2015,820000.0,3,2.5,3030,46538,2.0,0.0,0.0,3,10,3030,0,1997,0,98053,47.663999999999994,-122.041,3370,51450,3,27,2015,UNK,-340,-4912
4077800518,6/11/2014,371000.0,3,1.0,890,7200,1.0,0.0,0.0,3,7,890,0,1951,0,98125,47.71,-122.286,1630,7455,6,11,2014,UNK,-740,-255
2212200100,10/22/2014,229950.0,4,2.5,2150,7670,1.0,0.0,0.0,5,7,1240,910,1976,0,98031,47.3942,-122.189,1610,7350,10,22,2014,UNK,540,320
2212200100,4/22/2015,344900.0,4,2.5,2150,7670,1.0,0.0,0.0,5,7,1240,910,1976,0,98031,47.3942,-122.189,1610,7350,4,22,2015,UNK,540,320
5100403876,8/20/2014,840000.0,3,2.5,2060,9715,2.0,0.0,0.0,3,8,2060,0,1924,2006,98115,47.6961,-122.316,1240,7072,8,20,2014,Y,820,2643
821049191,9/16/2014,285000.0,3,1.5,1380,12196,1.0,0.0,0.0,4,7,1380,0,1967,0,98003,47.3204,-122.322,1600,10720,9,16,2014,UNK,-220,1476
126039599,3/26/2015,475000.0,4,2.25,1800,7200,1.0,0.0,0.0,3,7,1230,570,1979,0,98177,47.7717,-122.376,2260,7498,3,26,2015,UNK,-460,-298
1218000195,3/3/2015,420000.0,2,1.0,1460,7832,1.0,0.0,0.0,3,6,1460,0,1924,0,98166,47.4617,-122.346,1460,7632,3,3,2015,UNK,0,200
9287800375,10/30/2014,685000.0,3,2.0,2210,5000,1.5,0.0,2.0,3,7,1710,500,1909,0,98103,47.6754,-122.35700000000001,1920,5000,10,30,2014,UNK,290,0
926069140,7/21/2014,879000.0,4,3.0,3590,89640,2.0,0.0,0.0,3,10,3590,0,2005,0,98077,47.7557,-122.036,2790,54014,7,21,2014,N,800,35626
2407000145,1/20/2015,197200.0,3,1.0,1140,8775,1.0,0.0,0.0,3,6,990,150,1942,0,98146,47.4824,-122.336,1300,8775,1,20,2015,UNK,-160,0
452001280,7/3/2014,529950.0,3,1.0,1240,5000,1.5,0.0,0.0,5,7,1240,0,1909,0,98107,47.6755,-122.367,1240,4900,7,3,2014,UNK,0,100
425069020,5/5/2014,1090000.0,4,2.5,4340,141570,2.5,0.0,0.0,3,11,4340,0,1992,0,98053,47.6805,-122.04799999999999,2720,97138,5,5,2014,UNK,1620,44432
4232901120,5/20/2014,792000.0,3,1.5,1570,1050,2.0,0.0,0.0,3,8,1570,0,1915,0,98109,47.6358,-122.35600000000001,2070,3600,5,20,2014,UNK,-500,-2550
4233400490,8/20/2014,262000.0,3,2.5,1680,10300,2.0,0.0,0.0,4,7,1680,0,1994,0,98010,47.31399999999999,-122.001,1680,9849,8,20,2014,UNK,0,451
4302201005,10/7/2014,353900.0,3,1.75,1560,5760,1.0,0.0,0.0,5,6,780,780,1927,0,98106,47.5272,-122.359,1320,7680,10,7,2014,UNK,240,-1920
2026079055,8/18/2014,380000.0,1,1.5,1200,44866,1.5,0.0,0.0,3,7,1200,0,1983,0,98019,47.7205,-121.93,1480,67082,8,18,2014,UNK,-280,-22216
5104510120,3/27/2015,305000.0,3,2.5,1690,5175,2.0,0.0,0.0,3,7,1690,0,2002,0,98038,47.3564,-122.016,1830,5175,3,27,2015,UNK,-140,0
7857003851,4/20/2015,440000.0,4,2.0,2310,5004,1.0,0.0,0.0,3,7,1430,880,1994,0,98108,47.5471,-122.29799999999999,1630,5060,4,20,2015,UNK,680,-56
1257202430,6/17/2014,1010000.0,4,3.5,2650,3060,2.0,0.0,0.0,3,9,2060,590,2001,0,98103,47.6735,-122.33200000000001,1470,3060,6,17,2014,UNK,1180,0
5104511530,9/19/2014,549900.0,5,3.0,3610,7555,2.0,0.0,0.0,3,8,3610,0,2003,0,98038,47.3534,-122.012,3610,7979,9,19,2014,UNK,0,-424
522069111,1/27/2015,678500.0,4,3.0,2620,214750,2.0,0.0,0.0,3,8,2620,0,1992,0,98058,47.4239,-122.068,2060,212137,1,27,2015,UNK,560,2613
5379804537,8/26/2014,270000.0,3,2.25,1760,8287,1.0,0.0,0.0,3,7,1160,600,1986,0,98188,47.4501,-122.274,1290,9587,8,26,2014,UNK,470,-1300
3034200410,3/30/2015,430000.0,3,1.0,940,12521,1.5,0.0,0.0,4,7,940,0,1949,0,98133,47.7169,-122.331,1920,9046,3,30,2015,UNK,-980,3475
5700003630,6/30/2014,1930000.0,5,4.25,4830,8050,2.5,0.0,0.0,4,11,3710,1120,1914,0,98144,47.5789,-122.286,4470,9194,6,30,2014,UNK,360,-1144
7203220410,8/13/2014,790500.0,4,2.75,3350,5416,2.0,0.0,0.0,3,9,3350,0,2014,0,98053,47.6849,-122.016,3625,5637,8,13,2014,N,-275,-221
2426049168,10/17/2014,447450.0,3,2.25,1570,7200,2.0,0.0,0.0,3,8,1570,0,1991,0,98034,47.7332,-122.23200000000001,1620,7318,10,17,2014,UNK,-50,-118
9828701565,2/9/2015,375000.0,3,2.0,2240,5200,1.0,0.0,0.0,3,7,1630,610,1954,0,98112,47.6191,-122.296,1470,3775,2,9,2015,UNK,770,1425
259600620,2/6/2015,565000.0,4,2.0,1950,9940,1.0,0.0,0.0,4,7,1950,0,1963,0,98008,47.6332,-122.118,1920,9270,2,6,2015,UNK,30,670
5312100040,4/23/2015,400000.0,2,1.0,1010,3916,1.0,0.0,2.0,4,6,810,200,1918,0,98144,47.5728,-122.306,1580,3888,4,23,2015,UNK,-570,28
1938400040,2/20/2015,246000.0,3,1.5,1630,10200,1.0,0.0,0.0,4,8,1300,330,1976,0,98023,47.3155,-122.36399999999999,1960,6700,2,20,2015,UNK,-330,3500
6632900405,10/29/2014,329922.0,3,1.75,1420,6289,1.0,0.0,0.0,3,7,1100,320,1967,0,98155,47.7398,-122.314,1460,7402,10,29,2014,UNK,-40,-1113
2125059123,4/14/2015,1250000.0,5,3.25,3950,44431,1.0,0.0,0.0,3,10,2100,1850,1969,0,98005,47.6451,-122.17299999999999,3860,45870,4,14,2015,UNK,90,-1439
6411600113,4/20/2015,375000.0,3,1.0,1210,7425,1.0,0.0,0.0,4,6,1210,0,1910,0,98133,47.7125,-122.33,1260,7425,4,20,2015,UNK,-50,0
6381500035,5/8/2014,385000.0,3,1.75,1890,9920,1.0,0.0,0.0,3,7,1230,660,1944,0,98125,47.7327,-122.306,1380,9086,5,8,2014,UNK,510,834
7518500985,9/3/2014,591500.0,4,2.5,1690,4080,1.5,0.0,0.0,4,7,1140,550,1912,0,98117,47.6825,-122.37899999999999,1600,4590,9,3,2014,UNK,90,-510
5149800040,9/18/2014,255000.0,4,2.0,2560,12155,1.0,0.0,0.0,4,7,1350,1210,1960,0,98003,47.3326,-122.323,1790,11906,9,18,2014,UNK,770,249
3211000930,3/16/2015,275000.0,3,1.5,1350,7800,1.0,0.0,0.0,3,7,1350,0,1959,0,98059,47.4805,-122.15799999999999,1510,8040,3,16,2015,UNK,-160,-240
1853081250,12/29/2014,800000.0,4,2.75,3120,5000,2.0,0.0,0.0,3,9,3120,0,2010,0,98074,47.593999999999994,-122.06200000000001,3200,5000,12,29,2014,N,-80,0
6632300040,4/25/2015,327000.0,2,1.0,1140,7435,1.0,0.0,0.0,3,7,1140,0,1952,1990,98125,47.73,-122.31,1320,9385,4,25,2015,Y,-180,-1950
6117501755,12/30/2014,355000.0,4,1.5,2230,11536,1.0,0.0,1.0,4,7,1220,1010,1954,0,98166,47.4409,-122.348,2170,12465,12,30,2014,UNK,60,-929
6163900411,10/3/2014,310000.0,2,1.0,1050,8220,1.0,0.0,0.0,4,6,780,270,1947,0,98155,47.7598,-122.316,1340,7651,10,3,2014,UNK,-290,569
1924069039,5/19/2014,869000.0,5,3.25,4180,49222,2.0,0.0,0.0,4,8,2880,1300,1979,0,98027,47.5488,-122.094,3170,8029,5,19,2014,UNK,1010,41193
4058801065,8/8/2014,272000.0,3,2.0,1200,5700,1.0,0.0,0.0,5,7,1200,0,1942,0,98178,47.5031,-122.242,1190,6384,8,8,2014,UNK,10,-684
1223089038,7/11/2014,665000.0,5,2.25,3320,60984,2.0,0.0,0.0,3,9,3320,0,2000,0,98045,47.4862,-121.71799999999999,1580,55322,7,11,2014,UNK,1740,5662
5420800090,11/17/2014,225000.0,3,2.5,1590,8449,2.0,0.0,0.0,3,7,1590,0,1989,0,98030,47.3493,-122.177,1750,7172,11,17,2014,UNK,-160,1277
2591720360,12/26/2014,375000.0,3,2.5,2750,37096,2.0,0.0,0.0,3,9,2750,0,1989,0,98038,47.3732,-122.023,2700,40091,12,26,2014,UNK,50,-2995
9286750100,6/10/2014,375500.0,3,1.5,1530,7200,1.0,0.0,0.0,3,8,1530,0,1975,0,98155,47.7691,-122.29700000000001,2150,7216,6,10,2014,UNK,-620,-16
2392100090,4/2/2015,550000.0,3,1.75,1570,6500,1.0,0.0,0.0,3,7,920,650,1948,0,98116,47.565,-122.398,1570,5750,4,2,2015,UNK,0,750
4302201085,9/18/2014,248000.0,3,1.0,1470,7680,1.0,0.0,0.0,3,7,1220,250,1946,0,98106,47.5276,-122.359,1470,6784,9,18,2014,UNK,0,896
4302201085,5/6/2015,546940.0,3,1.0,1470,7680,1.0,0.0,0.0,3,7,1220,250,1946,0,98106,47.5276,-122.359,1470,6784,5,6,2015,UNK,0,896
7215730580,9/2/2014,680000.0,4,3.0,3150,6175,2.0,0.0,0.0,3,9,3150,0,2001,0,98075,47.5968,-122.01700000000001,3150,6986,9,2,2014,UNK,0,-811
2095500120,7/18/2014,350000.0,4,2.5,2380,6124,2.0,0.0,0.0,3,8,2380,0,1997,0,98030,47.3662,-122.175,2170,6097,7,18,2014,UNK,210,27
136000220,3/25/2015,593000.0,2,2.5,2000,2500,3.0,0.0,1.0,3,8,1810,190,1994,0,98116,47.5788,-122.396,1970,5650,3,25,2015,UNK,30,-3150
3834000720,3/19/2015,390000.0,2,1.0,1140,8147,1.0,0.0,0.0,3,7,1140,0,1958,0,98125,47.7278,-122.289,1260,8148,3,19,2015,UNK,-120,-1
3523029077,10/7/2014,297000.0,3,1.0,1340,18000,1.0,0.0,0.0,4,7,1340,0,1924,0,98070,47.4443,-122.509,1660,196591,10,7,2014,UNK,-320,-178591
42000065,3/5/2015,355000.0,2,1.0,1450,9150,1.0,0.0,0.0,4,7,1450,0,1965,0,98188,47.4689,-122.277,1440,10636,3,5,2015,UNK,10,-1486
3275330120,8/14/2014,309900.0,3,2.5,2020,26670,2.0,0.0,0.0,3,7,2020,0,1987,0,98003,47.2597,-122.31,1680,10939,8,14,2014,UNK,340,15731
2312400230,9/24/2014,257000.0,3,2.25,1810,12000,2.0,0.0,0.0,3,7,1810,0,1992,0,98003,47.3476,-122.3,1720,9916,9,24,2014,UNK,90,2084
3472800065,8/26/2014,1700000.0,4,3.0,3600,9687,2.0,0.0,0.0,4,9,3600,0,1959,1995,98004,47.6257,-122.208,2620,10400,8,26,2014,Y,980,-713
7518501140,1/13/2015,300000.0,3,2.0,1260,2550,2.0,0.0,0.0,3,7,1260,0,1987,0,98117,47.6821,-122.37799999999999,1590,3825,1,13,2015,UNK,-330,-1275
9126100815,12/17/2014,500000.0,3,2.0,1560,1156,3.0,0.0,0.0,3,8,1560,0,2014,0,98122,47.605,-122.304,1560,1728,12,17,2014,N,0,-572
2769600590,10/16/2014,900000.0,8,4.0,4020,7500,1.0,0.0,0.0,3,8,2010,2010,1968,0,98107,47.6732,-122.363,1560,3737,10,16,2014,UNK,2460,3763
7215730040,5/15/2014,695000.0,4,3.0,3150,9130,2.0,0.0,0.0,3,9,3150,0,2001,0,98075,47.5974,-122.01700000000001,2970,6228,5,15,2014,UNK,180,2902
8155760040,12/18/2014,213400.0,4,2.5,1680,6655,2.0,0.0,0.0,3,7,1680,0,2001,0,98030,47.3867,-122.191,1680,6982,12,18,2014,UNK,0,-327
1376800220,7/9/2014,425000.0,2,1.0,1320,8830,1.0,0.0,0.0,3,7,1020,300,1939,0,98199,47.6433,-122.404,1620,8531,7,9,2014,UNK,-300,299
3623059101,8/11/2014,420000.0,3,3.0,2700,47050,2.0,0.0,0.0,4,9,1570,1130,1986,0,98058,47.4446,-122.104,2260,45901,8,11,2014,UNK,440,1149
7010701016,2/9/2015,411000.0,1,1.0,1080,5000,1.5,0.0,0.0,3,7,1080,0,1948,0,98199,47.6603,-122.39399999999999,1620,4000,2,9,2015,UNK,-540,1000
1025069210,2/9/2015,762500.0,4,2.25,3130,41382,2.0,0.0,0.0,3,9,3130,0,1986,0,98053,47.6683,-122.03399999999999,3130,54886,2,9,2015,UNK,0,-13504
721049096,5/27/2014,569950.0,5,4.5,4850,40902,2.0,0.0,0.0,3,10,4850,0,2001,0,98023,47.3181,-122.344,1640,13503,5,27,2014,UNK,3210,27399
7347600210,4/24/2015,258000.0,4,1.0,1220,8500,1.5,0.0,0.0,5,6,1220,0,1916,0,98168,47.4792,-122.277,1460,8500,4,24,2015,UNK,-240,0
3630030180,2/24/2015,499000.0,3,2.25,1780,3665,2.0,0.0,0.0,3,8,1780,0,2004,0,98029,47.5495,-121.99700000000001,1770,3669,2,24,2015,N,10,-4
9353300820,5/11/2015,310000.0,3,1.0,1250,10723,1.0,0.0,0.0,4,7,1250,0,1961,0,98059,47.4894,-122.135,1520,10723,5,11,2015,UNK,-270,0
4310702876,11/3/2014,398500.0,2,2.5,1780,1311,3.0,0.0,0.0,3,8,1350,430,2005,0,98103,47.6962,-122.34,1390,1227,11,3,2014,N,390,84
5647900120,6/13/2014,250600.0,4,2.5,1930,8660,1.0,0.0,0.0,3,7,1120,810,1981,0,98001,47.3261,-122.26,1830,9591,6,13,2014,UNK,100,-931
4123800580,8/12/2014,352000.0,4,2.5,2470,6116,1.0,0.0,0.0,3,7,1420,1050,1985,0,98038,47.3792,-122.04700000000001,1670,7627,8,12,2014,UNK,800,-1511
6169901006,7/15/2014,600000.0,2,1.0,1180,2160,1.0,0.0,1.0,3,7,940,240,1909,0,98119,47.6313,-122.368,2700,5400,7,15,2014,UNK,-1520,-3240
3735901080,3/24/2015,645000.0,3,1.0,2270,4182,1.0,0.0,0.0,4,7,1170,1100,1946,0,98115,47.688,-122.32,1860,4080,3,24,2015,UNK,410,102
5104520620,7/24/2014,291500.0,4,2.5,1770,5000,2.0,0.0,0.0,3,7,1770,0,2004,0,98038,47.3503,-122.005,2080,5100,7,24,2014,N,-310,-100
2422049107,5/8/2014,350000.0,4,1.75,2250,13515,1.0,0.0,0.0,4,8,2150,100,1940,0,98030,47.3789,-122.229,2150,12508,5,8,2014,UNK,100,1007
3260700360,9/19/2014,279000.0,3,2.5,1540,7280,1.0,0.0,0.0,3,7,1080,460,1974,0,98003,47.3102,-122.322,1220,6440,9,19,2014,UNK,320,840
1862400057,3/4/2015,320000.0,2,1.0,820,5400,1.0,0.0,0.0,3,6,820,0,1940,0,98117,47.6976,-122.375,1370,5632,3,4,2015,UNK,-550,-232
8682262720,3/10/2015,495000.0,2,2.0,1580,5203,1.0,0.0,0.0,3,8,1580,0,2004,0,98053,47.7174,-122.03200000000001,1560,4770,3,10,2015,N,20,433
3183110180,8/28/2014,490000.0,4,2.5,2430,42646,1.0,0.0,0.0,3,7,1450,980,1989,0,98014,47.6164,-121.95299999999999,2000,38159,8,28,2014,UNK,430,4487
7986400360,7/17/2014,770000.0,5,1.5,2160,5000,1.5,0.0,2.0,4,8,2160,0,1926,0,98107,47.6645,-122.36,1450,4265,7,17,2014,UNK,710,735
1789900065,7/9/2014,215000.0,3,1.75,1770,29004,1.0,0.0,0.0,3,8,1770,0,1959,0,98023,47.3204,-122.36399999999999,2300,24534,7,9,2014,UNK,-530,4470
222069057,3/30/2015,665000.0,3,3.5,3580,95832,1.5,0.0,0.0,3,9,3580,0,2005,0,98038,47.4239,-122.015,2880,60548,3,30,2015,N,700,35284
3822200164,8/19/2014,423500.0,3,2.25,1890,7498,1.0,0.0,0.0,3,7,1190,700,1987,0,98125,47.73,-122.29700000000001,1660,8100,8,19,2014,UNK,230,-602
1931300665,10/9/2014,850000.0,3,3.0,1910,4800,1.5,0.0,0.0,3,9,1910,0,1900,0,98103,47.6572,-122.346,1280,1310,10,9,2014,UNK,630,3490
1443500385,5/13/2014,155000.0,2,1.0,910,6232,1.0,0.0,0.0,3,6,910,0,1943,0,98118,47.5328,-122.272,1070,6232,5,13,2014,UNK,-160,0
259600410,4/13/2015,505000.0,3,2.25,1460,7210,1.0,0.0,0.0,3,7,1460,0,1963,0,98008,47.6316,-122.119,1850,7519,4,13,2015,UNK,-390,-309
3630120880,2/27/2015,780000.0,3,3.5,3310,5558,2.0,0.0,0.0,3,9,3310,0,2005,0,98029,47.5553,-122.00299999999999,3310,5270,2,27,2015,N,0,288
2822049210,8/25/2014,165000.0,3,1.5,1630,22764,1.0,0.0,0.0,3,7,1630,0,1970,0,98032,47.3611,-122.29299999999999,1620,17859,8,25,2014,UNK,10,4905
6821100015,8/28/2014,707000.0,2,2.5,2130,5001,1.0,0.0,0.0,5,8,1330,800,1972,0,98199,47.6573,-122.399,1750,6000,8,28,2014,UNK,380,-999
2267000458,5/1/2015,497000.0,3,2.5,1220,1475,3.0,0.0,0.0,3,8,1220,0,2000,0,98117,47.6909,-122.395,1220,1546,5,1,2015,UNK,0,-71
2976800115,11/5/2014,349170.0,4,1.75,1670,8856,1.0,0.0,2.0,3,7,1070,600,1955,0,98178,47.5056,-122.251,1660,8088,11,5,2014,UNK,10,768
7436600090,1/2/2015,287000.0,4,1.5,1300,10050,1.5,0.0,0.0,3,7,1300,0,1963,0,98059,47.4899,-122.116,1730,10050,1,2,2015,UNK,-430,0
6072800205,11/19/2014,2380000.0,4,2.5,3220,20251,1.0,0.0,0.0,3,10,3220,0,1969,0,98006,47.5692,-122.19200000000001,4200,22114,11,19,2014,UNK,-980,-1863
3296000110,6/2/2014,645000.0,4,2.5,2430,14400,1.0,0.0,0.0,5,8,1670,760,1963,0,98007,47.6202,-122.13799999999999,2140,9048,6,2,2014,UNK,290,5352
5054800110,10/16/2014,238000.0,5,2.25,2240,9652,2.0,0.0,0.0,3,7,2240,0,1990,0,98055,47.4249,-122.211,2180,11644,10,16,2014,UNK,60,-1992
5054800110,2/13/2015,328000.0,5,2.25,2240,9652,2.0,0.0,0.0,3,7,2240,0,1990,0,98055,47.4249,-122.211,2180,11644,2,13,2015,UNK,60,-1992
7443000652,11/3/2014,365000.0,2,1.5,790,1123,2.0,0.0,0.0,3,8,700,90,2003,0,98119,47.651,-122.368,1370,1281,11,3,2014,UNK,-580,-158
3995700220,3/17/2015,380000.0,3,1.0,1380,8147,1.0,0.0,0.0,4,7,1380,0,1948,0,98155,47.7407,-122.3,1360,8147,3,17,2015,UNK,20,0
4191400090,3/10/2015,525000.0,4,1.5,1680,10500,2.0,0.0,0.0,3,7,1680,0,1962,0,98033,47.6806,-122.166,1830,10264,3,10,2015,UNK,-150,236
7518505070,6/25/2014,402000.0,4,2.25,2000,3672,2.0,0.0,0.0,5,7,1650,350,1926,0,98117,47.6769,-122.383,2000,5100,6,25,2014,UNK,0,-1428
9144300110,4/24/2015,308000.0,2,1.0,1680,9250,1.0,0.0,0.0,3,7,860,820,1969,0,98072,47.7618,-122.162,1590,9542,4,24,2015,UNK,90,-292
7853301930,10/9/2014,405000.0,3,2.5,1960,6997,2.0,0.0,0.0,3,7,1960,0,2006,0,98065,47.5415,-121.887,2320,5178,10,9,2014,N,-360,1819
3586500770,9/23/2014,808000.0,3,1.75,2590,32380,1.0,0.0,0.0,3,8,2590,0,1951,1994,98177,47.7539,-122.37,2340,28456,9,23,2014,Y,250,3924
7203100730,2/10/2015,875000.0,4,3.5,3790,6874,2.5,0.0,0.0,3,9,3790,0,2010,0,98053,47.6956,-122.022,3370,6535,2,10,2015,N,420,339
8644400180,3/19/2015,860000.0,3,2.5,2370,55321,3.0,0.0,0.0,4,8,2370,0,1982,0,98074,47.6148,-122.057,2590,41553,3,19,2015,UNK,-220,13768
2071500011,8/11/2014,367500.0,4,2.25,1930,7925,1.0,0.0,0.0,3,8,1300,630,1960,0,98155,47.7626,-122.31200000000001,1930,7200,8,11,2014,UNK,0,725
5423600100,8/5/2014,604000.0,6,3.5,2580,13572,1.0,0.0,0.0,3,8,1290,1290,1987,0,98052,47.6796,-122.113,2020,11656,8,5,2014,UNK,560,1916
3734900110,2/4/2015,230000.0,2,0.75,890,19703,1.0,0.0,0.0,3,6,890,0,1934,0,98045,47.4922,-121.78299999999999,1270,9800,2,4,2015,UNK,-380,9903
2126049154,12/17/2014,435000.0,4,2.75,2160,8148,1.0,0.0,0.0,3,7,1410,750,1978,0,98125,47.7261,-122.306,2060,8100,12,17,2014,UNK,100,48
1864700300,10/10/2014,347500.0,4,2.5,1970,7098,2.0,0.0,0.0,3,7,1970,0,2007,0,98038,47.3576,-122.05799999999999,1970,5361,10,10,2014,N,0,1737
1310930100,3/18/2015,525000.0,4,1.75,1570,16697,1.0,0.0,2.0,3,7,1030,540,1981,0,98052,47.67100000000001,-122.135,1560,9698,3,18,2015,UNK,10,6999
8103000110,6/3/2014,280000.0,2,1.5,1480,15641,1.0,0.0,0.0,4,7,1480,0,1940,0,98146,47.5008,-122.366,1520,7525,6,3,2014,UNK,-40,8116
8103000110,2/5/2015,490000.0,2,1.5,1480,15641,1.0,0.0,0.0,4,7,1480,0,1940,0,98146,47.5008,-122.366,1520,7525,2,5,2015,UNK,-40,8116
7227501765,3/23/2015,265000.0,4,1.75,1430,5490,1.0,0.0,0.0,5,6,1430,0,1942,0,98056,47.494,-122.184,1030,5900,3,23,2015,UNK,400,-410
824069188,9/2/2014,645000.0,4,2.25,2720,18295,1.0,0.0,0.0,4,8,2000,720,1979,0,98075,47.5851,-122.073,2720,18295,9,2,2014,UNK,0,0
1402000210,4/27/2015,390000.0,3,2.25,2420,31497,1.0,0.0,0.0,4,8,1750,670,1964,0,98058,47.4422,-122.15100000000001,2040,30472,4,27,2015,UNK,380,1025
5412400180,4/17/2015,267500.0,3,2.5,1400,7629,1.0,0.0,0.0,3,7,1120,280,1988,0,98030,47.3788,-122.179,1530,7688,4,17,2015,UNK,-130,-59
8894200150,12/17/2014,1280000.0,4,3.5,5844,10766,2.0,0.0,1.0,3,11,5844,0,2007,0,98023,47.3293,-122.36399999999999,3413,10766,12,17,2014,N,2431,0
4037500110,5/6/2014,404000.0,4,1.75,1840,10720,1.0,0.0,0.0,3,7,960,880,1958,0,98008,47.6074,-122.125,1840,9044,5,6,2014,UNK,0,1676
1843100540,4/29/2015,380000.0,3,2.25,2530,12042,2.0,0.0,0.0,3,8,2530,0,1989,0,98042,47.3742,-122.125,2480,10172,4,29,2015,UNK,50,1870
7856620210,8/8/2014,812500.0,4,2.75,2810,10300,1.0,0.0,0.0,4,9,1810,1000,1978,0,98006,47.5626,-122.149,2710,9900,8,8,2014,UNK,100,400
425200145,7/3/2014,265000.0,3,1.0,1020,8610,1.0,0.0,0.0,5,7,1020,0,1959,0,98056,47.4974,-122.169,1070,5940,7,3,2014,UNK,-50,2670
6073300750,7/9/2014,480000.0,5,2.75,2550,7725,1.0,0.0,0.0,5,8,1390,1160,1967,0,98056,47.5388,-122.171,2450,7725,7,9,2014,UNK,100,0
6450301220,9/16/2014,264000.0,1,1.0,710,4725,1.0,0.0,0.0,3,6,710,0,1939,0,98133,47.7328,-122.34,900,5250,9,16,2014,UNK,-190,-525
3401700150,4/23/2015,1350000.0,5,3.0,5530,38816,1.5,0.0,2.0,3,10,5530,0,1969,0,98072,47.7352,-122.116,3800,44417,4,23,2015,UNK,1730,-5601
7200001254,7/9/2014,550000.0,4,1.75,2150,9000,1.0,0.0,0.0,4,7,1110,1040,1966,0,98052,47.6812,-122.113,2040,9000,7,9,2014,UNK,110,0
9828201745,5/4/2015,615000.0,2,1.5,880,2400,1.5,0.0,0.0,3,7,880,0,1929,0,98122,47.6144,-122.295,1220,4440,5,4,2015,UNK,-340,-2040
9238500410,5/19/2014,464000.0,3,1.75,1630,28600,1.0,0.0,0.0,3,8,1630,0,1967,0,98072,47.7742,-122.14,2260,26000,5,19,2014,UNK,-630,2600
2587910180,7/16/2014,365000.0,3,1.0,1380,30940,2.0,0.0,0.0,3,8,1380,0,1976,0,98042,47.333999999999996,-122.10600000000001,2350,32500,7,16,2014,UNK,-970,-1560
8663200450,7/15/2014,490000.0,4,2.25,2800,10800,1.0,0.0,0.0,3,8,1680,1120,1977,0,98011,47.7448,-122.177,2260,9800,7,15,2014,UNK,540,1000
1310960220,6/26/2014,280927.0,4,2.25,2070,7350,2.0,0.0,0.0,4,8,2070,0,1977,0,98032,47.3615,-122.274,2080,7210,6,26,2014,UNK,-10,140
396100110,5/16/2014,282613.0,2,1.0,830,6017,1.0,0.0,0.0,4,6,830,0,1954,0,98133,47.7466,-122.334,1340,6040,5,16,2014,UNK,-510,-23
7785350490,10/23/2014,675000.0,3,2.25,2770,15886,2.0,0.0,0.0,3,10,2770,0,1982,0,98177,47.7464,-122.36200000000001,3290,15886,10,23,2014,UNK,-520,0
1795900210,5/18/2014,575550.0,4,2.5,2060,7475,1.0,0.0,0.0,3,8,1440,620,1985,0,98052,47.7272,-122.105,2280,8396,5,18,2014,UNK,-220,-921
1796370730,5/20/2014,259900.0,3,2.0,1490,7770,1.0,0.0,0.0,4,7,1490,0,1990,0,98042,47.3686,-122.09,1540,7366,5,20,2014,UNK,-50,404
7787100210,12/9/2014,450000.0,4,2.25,2120,8267,2.0,0.0,0.0,3,8,2120,0,1996,0,98045,47.4885,-121.779,2150,7746,12,9,2014,UNK,-30,521
1137450120,7/29/2014,487500.0,4,2.5,2810,6296,2.0,0.0,0.0,3,9,2810,0,2013,0,98059,47.5019,-122.15100000000001,2850,6140,7,29,2014,N,-40,156
1921059303,1/28/2015,275000.0,4,2.25,2400,17842,2.0,0.0,0.0,4,7,2400,0,1973,0,98002,47.2866,-122.21700000000001,1610,12100,1,28,2015,UNK,790,5742
6699000610,8/11/2014,305000.0,3,2.5,2460,5027,2.0,0.0,0.0,3,8,2460,0,2002,0,98042,47.372,-122.102,2740,5000,8,11,2014,UNK,-280,27
3621059048,10/10/2014,395000.0,3,1.75,2030,217800,1.0,0.0,2.0,4,8,2030,0,1977,0,98092,47.2618,-122.12,2570,216057,10,10,2014,UNK,-540,1743
2620069077,4/22/2015,215000.0,3,1.0,880,7648,1.0,0.0,2.0,4,6,880,0,1940,0,98022,47.1963,-121.99700000000001,1020,7566,4,22,2015,UNK,-140,82
3083000910,7/8/2014,410000.0,3,2.0,1320,6000,1.5,0.0,0.0,4,7,1320,0,1920,0,98144,47.5752,-122.304,1620,4000,7,8,2014,UNK,-300,2000
192600100,6/26/2014,440000.0,4,2.5,2160,7826,1.0,0.0,0.0,4,7,1390,770,1976,0,98155,47.7754,-122.27600000000001,2190,9900,6,26,2014,UNK,-30,-2074
5608010750,8/29/2014,1160000.0,4,3.5,4190,15724,2.0,0.0,2.0,3,11,4190,0,1994,0,98027,47.5518,-122.096,3300,10113,8,29,2014,UNK,890,5611
6140100150,11/25/2014,500000.0,4,2.0,2280,7200,1.0,0.0,0.0,4,7,2280,0,1956,0,98133,47.7132,-122.355,1100,7620,11,25,2014,UNK,1180,-420
9550203690,11/20/2014,961000.0,5,2.75,2590,6120,2.0,0.0,0.0,3,8,2590,0,1909,0,98105,47.6667,-122.32700000000001,1390,3060,11,20,2014,UNK,1200,3060
5423010180,7/24/2014,825000.0,4,2.25,2770,9340,2.0,0.0,0.0,4,9,2770,0,1979,0,98027,47.5628,-122.081,3010,9340,7,24,2014,UNK,-240,0
2919200665,11/3/2014,734000.0,3,1.75,2145,3840,1.5,0.0,0.0,5,8,2145,0,1910,0,98103,47.6875,-122.35700000000001,1140,3840,11,3,2014,UNK,1005,0
2122059199,10/2/2014,490000.0,4,4.25,4480,5715,2.0,0.0,0.0,3,7,3680,800,2003,0,98030,47.37300000000001,-122.179,2190,6070,10,2,2014,UNK,2290,-355
3601200017,7/2/2014,175000.0,4,2.5,1780,6000,2.0,0.0,0.0,3,7,1780,0,1991,0,98198,47.3828,-122.302,1630,6000,7,2,2014,UNK,150,0
2658000115,6/18/2014,190000.0,1,1.0,720,4800,1.0,0.0,0.0,3,6,720,0,1914,0,98118,47.5303,-122.27,1240,4860,6,18,2014,UNK,-520,-60
7349400610,8/12/2014,305000.0,4,2.25,2050,12581,2.0,0.0,0.0,4,7,2050,0,1978,0,98002,47.3215,-122.204,1620,7400,8,12,2014,UNK,430,5181
868001790,3/16/2015,1300000.0,3,1.0,2040,7936,1.0,0.0,3.0,5,8,1680,360,1940,0,98177,47.7028,-122.385,2300,10080,3,16,2015,UNK,-260,-2144
1105000015,6/9/2014,417000.0,2,1.0,920,6600,1.0,0.0,0.0,3,6,920,0,1919,2003,98118,47.5452,-122.27,1510,5944,6,9,2014,Y,-590,656
2919201385,11/13/2014,275000.0,2,1.0,680,4190,1.0,0.0,0.0,2,5,680,0,1906,0,98103,47.6901,-122.35799999999999,1070,4175,11,13,2014,UNK,-390,15
7202470100,12/10/2014,661000.0,3,2.5,1940,8196,2.0,0.0,0.0,3,8,1940,0,1991,0,98052,47.6786,-122.15100000000001,2070,8514,12,10,2014,UNK,-130,-318
2832100910,7/8/2014,435000.0,4,2.75,2230,9640,1.0,0.0,0.0,3,8,1320,910,1998,0,98125,47.7269,-122.325,2100,9600,7,8,2014,UNK,130,40
4100000040,10/23/2014,788000.0,5,2.25,2910,9454,1.0,0.0,1.0,3,8,1910,1000,1972,0,98005,47.5871,-122.17299999999999,2400,10690,10,23,2014,UNK,510,-1236
9320100090,6/10/2014,1800000.0,5,3.25,5270,17232,2.0,0.0,1.0,3,10,4010,1260,1977,2003,98040,47.5536,-122.228,3550,13917,6,10,2014,Y,1720,3315
2589300180,6/30/2014,408000.0,5,3.25,2820,6589,1.5,0.0,0.0,3,7,2320,0,1906,2014,98118,47.5357,-122.273,1560,5647,6,30,2014,Y,1260,942
357000025,10/20/2014,570000.0,2,1.0,1790,3760,1.5,0.0,0.0,4,8,1490,300,1912,0,98144,47.5926,-122.29299999999999,1458,3760,10,20,2014,UNK,332,0
3179100180,5/7/2015,1540000.0,5,3.25,2920,6960,2.0,0.0,1.0,3,9,2120,800,1953,2008,98105,47.6712,-122.272,2470,6735,5,7,2015,Y,450,225
2487700065,5/5/2014,400000.0,2,1.0,840,5510,1.0,0.0,0.0,3,7,840,0,1955,0,98136,47.5247,-122.391,1630,5510,5,5,2014,UNK,-790,0
8732040820,10/17/2014,247000.0,3,1.75,1820,8740,1.0,0.0,0.0,4,8,1820,0,1987,0,98023,47.3074,-122.385,2210,8320,10,17,2014,UNK,-390,420
1160000300,3/4/2015,453000.0,3,1.75,1550,7200,1.0,0.0,0.0,3,7,1100,450,1949,0,98125,47.7071,-122.314,1560,7440,3,4,2015,UNK,-10,-240
3904100035,5/8/2014,235000.0,2,1.0,1270,3008,1.0,0.0,0.0,4,6,650,620,1923,0,98118,47.5351,-122.279,1270,1514,5,8,2014,UNK,0,1494
5288200230,4/21/2015,675000.0,4,1.75,2460,5750,1.5,0.0,3.0,5,7,1620,840,1919,0,98126,47.5601,-122.37799999999999,1760,4830,4,21,2015,UNK,700,920
3331500820,6/10/2014,516200.0,3,2.0,2110,5150,1.0,0.0,0.0,5,6,1080,1030,1919,0,98118,47.5521,-122.271,1170,5107,6,10,2014,UNK,940,43
3023039231,7/14/2014,650000.0,1,1.0,920,91476,1.5,0.0,0.0,3,6,920,0,1996,0,98070,47.448,-122.47200000000001,1746,91476,7,14,2014,UNK,-826,0
5595900355,12/16/2014,257100.0,3,1.5,1500,10227,1.0,0.0,0.0,4,7,1000,500,1945,0,98022,47.2043,-121.99600000000001,1490,7670,12,16,2014,UNK,10,2557
8682290360,3/30/2015,457000.0,2,2.0,1440,9985,1.0,0.0,0.0,3,8,1440,0,2006,0,98053,47.7217,-122.03,1510,4560,3,30,2015,N,-70,5425
5200100115,11/17/2014,540000.0,3,1.75,1610,3478,1.5,0.0,0.0,4,7,1060,550,1929,0,98117,47.6774,-122.37200000000001,1610,3478,11,17,2014,UNK,0,0
1310700210,6/3/2014,268000.0,3,1.75,1970,10270,1.0,0.0,0.0,4,8,1970,0,1966,0,98032,47.3619,-122.285,1970,8400,6,3,2014,UNK,0,1870
3298500690,7/8/2014,300000.0,3,1.0,1150,7314,1.0,0.0,0.0,3,7,1150,0,1960,0,98008,47.6246,-122.113,1350,7350,7,8,2014,UNK,-200,-36
722059002,9/9/2014,380000.0,2,2.5,2110,114127,1.0,0.0,0.0,4,8,1590,520,1975,0,98031,47.4137,-122.212,1960,11250,9,9,2014,UNK,150,102877
1022069183,6/27/2014,725000.0,3,2.5,3580,54450,1.5,0.0,0.0,3,9,3580,0,1990,0,98038,47.4026,-122.03299999999999,3090,35943,6,27,2014,UNK,490,18507
4053200933,6/23/2014,249000.0,3,1.0,1000,19204,1.0,0.0,0.0,3,7,1000,0,1968,0,98042,47.3167,-122.081,2450,25927,6,23,2014,UNK,-1450,-6723
5589300205,8/5/2014,274000.0,5,1.0,1680,9383,1.0,0.0,0.0,3,7,1400,280,1929,0,98155,47.7523,-122.311,1680,9458,8,5,2014,UNK,0,-75
644000040,4/29/2015,1780000.0,4,3.25,3950,10912,2.0,0.0,0.0,3,10,3950,0,2003,0,98004,47.5877,-122.196,3000,10998,4,29,2015,UNK,950,-86
1787600165,6/23/2014,396500.0,3,1.75,2390,7149,1.0,0.0,0.0,3,8,1350,1040,1955,0,98125,47.7244,-122.32600000000001,1710,7402,6,23,2014,UNK,680,-253
405100165,11/19/2014,460000.0,2,1.5,1820,7800,1.0,0.0,0.0,4,7,1240,580,1956,0,98133,47.7513,-122.35700000000001,1400,7800,11,19,2014,UNK,420,0
223049087,6/16/2014,277000.0,3,1.0,1100,8536,1.0,0.0,0.0,4,7,1100,0,1957,0,98118,47.5162,-122.26100000000001,1570,8040,6,16,2014,UNK,-470,496
2742100085,11/4/2014,449500.0,6,4.0,2280,5275,1.0,0.0,0.0,3,7,1270,1010,1998,0,98108,47.5556,-122.294,1760,6642,11,4,2014,UNK,520,-1367
3204300625,9/3/2014,785950.0,4,3.0,2530,4560,1.5,0.0,0.0,3,7,1540,990,1925,2014,98112,47.6287,-122.3,1640,4560,9,3,2014,Y,890,0
6619910230,6/16/2014,545000.0,3,2.5,1940,9775,1.0,0.0,2.0,3,8,1440,500,1975,0,98034,47.7142,-122.22200000000001,2830,9775,6,16,2014,UNK,-890,0
3275310220,12/22/2014,244000.0,3,2.0,1360,9688,1.0,0.0,0.0,4,7,1360,0,1983,0,98003,47.2574,-122.31,1390,9685,12,22,2014,UNK,-30,3
5466310730,8/22/2014,165000.0,3,2.5,1660,2415,2.0,0.0,0.0,3,7,1660,0,1983,0,98042,47.3763,-122.148,1740,2624,8,22,2014,UNK,-80,-209
2767704055,6/9/2014,435000.0,2,1.0,800,5000,1.0,0.0,0.0,3,7,800,0,1906,0,98107,47.6751,-122.37200000000001,1410,5000,6,9,2014,UNK,-610,0
7504100110,5/30/2014,642000.0,3,2.5,2670,10082,1.0,0.0,0.0,3,10,2670,0,1987,0,98074,47.6359,-122.045,2740,10854,5,30,2014,UNK,-70,-772
9320990110,4/9/2015,340000.0,3,2.5,1720,4120,2.0,0.0,0.0,3,7,1720,0,1999,0,98148,47.4319,-122.32799999999999,1720,5544,4,9,2015,UNK,0,-1424
1400700150,7/22/2014,730000.0,4,2.5,3550,35689,2.0,0.0,0.0,4,9,3550,0,1991,0,98077,47.7503,-122.074,3350,35711,7,22,2014,UNK,200,-22
1186000150,1/23/2015,563250.0,3,1.75,1370,2800,1.0,0.0,0.0,5,7,800,570,1982,0,98122,47.6157,-122.291,2270,3773,1,23,2015,UNK,-900,-973
1024069009,5/2/2014,675000.0,5,2.5,2820,67518,2.0,0.0,0.0,3,8,2820,0,1979,0,98029,47.5794,-122.025,2820,48351,5,2,2014,UNK,0,19167
464001115,5/12/2014,620000.0,3,1.5,1620,6630,1.0,0.0,0.0,3,8,1280,340,1954,0,98117,47.6948,-122.39399999999999,1880,5100,5,12,2014,UNK,-260,1530
886000015,12/10/2014,275000.0,2,2.0,1290,9041,1.0,0.0,0.0,3,7,950,340,1956,0,98108,47.5346,-122.291,1290,5000,12,10,2014,UNK,0,4041
3578600062,5/12/2014,270000.0,3,1.0,1830,8209,1.0,0.0,0.0,3,7,1830,0,1942,0,98028,47.7439,-122.228,2150,12000,5,12,2014,UNK,-320,-3791
1402950450,4/15/2015,325000.0,4,2.5,2040,5472,2.0,0.0,0.0,3,8,2040,0,2003,0,98092,47.3337,-122.189,2420,5782,4,15,2015,UNK,-380,-310
3629970620,10/3/2014,476100.0,4,2.5,1850,1836,2.0,0.0,0.0,3,7,1600,250,2005,0,98029,47.5529,-121.99600000000001,1770,2236,10,3,2014,N,80,-400
3537900180,10/20/2014,700000.0,2,1.0,1300,12000,1.0,0.0,0.0,4,8,1300,0,1959,0,98004,47.6366,-122.229,2420,15000,10,20,2014,UNK,-1120,-3000
8651442510,9/26/2014,220000.0,4,2.0,1620,5200,1.5,0.0,0.0,4,7,1620,0,1978,0,98042,47.3629,-122.09100000000001,1500,5200,9,26,2014,UNK,120,0
114700150,11/14/2014,236000.0,3,1.75,1560,10919,1.0,0.0,0.0,3,7,1560,0,1975,0,98023,47.2917,-122.366,1730,10919,11,14,2014,UNK,-170,0
472000620,5/2/2014,790000.0,3,2.5,2600,4750,1.0,0.0,0.0,4,9,1700,900,1951,0,98117,47.6833,-122.4,2380,4750,5,2,2014,UNK,220,0
5491200210,8/20/2014,350000.0,3,1.0,2010,6000,1.0,0.0,0.0,3,7,1210,800,1967,0,98108,47.5515,-122.29799999999999,2460,6000,8,20,2014,UNK,-450,0
7973202712,3/24/2015,130000.0,2,1.0,780,5300,1.0,0.0,0.0,3,6,780,0,1941,0,98146,47.51300000000001,-122.354,780,5300,3,24,2015,UNK,0,0
7970800100,5/27/2014,283200.0,4,2.5,1982,6406,2.0,0.0,0.0,3,8,1982,0,2004,0,98030,47.3636,-122.19200000000001,2340,6501,5,27,2014,N,-358,-95
8122600165,10/15/2014,273000.0,3,1.0,1500,6250,1.0,0.0,0.0,3,6,890,610,1945,0,98126,47.5365,-122.368,1210,6250,10,15,2014,UNK,290,0
686530110,12/15/2014,599000.0,5,2.25,2460,8710,1.0,0.0,0.0,4,8,1330,1130,1976,0,98052,47.6651,-122.15,2460,8870,12,15,2014,UNK,0,-160
5151600530,4/23/2015,460000.0,4,2.5,2680,11998,1.0,0.0,3.0,3,8,1510,1170,1960,0,98003,47.336999999999996,-122.321,2680,12746,4,23,2015,UNK,0,-748
1926069192,5/9/2014,1160000.0,4,4.25,5860,52889,2.0,0.0,0.0,4,10,4910,950,1996,0,98072,47.7245,-122.095,3320,39066,5,9,2014,UNK,2540,13823
5649000150,6/10/2014,385000.0,4,1.75,1720,8750,1.0,0.0,0.0,3,7,860,860,1971,0,98034,47.726000000000006,-122.21,1790,8750,6,10,2014,UNK,-70,0
7812800775,9/10/2014,264250.0,3,1.0,1420,7420,1.5,0.0,0.0,3,6,1420,0,1944,0,98178,47.4949,-122.23899999999999,1290,6600,9,10,2014,UNK,130,820
2770604410,10/29/2014,608000.0,3,2.5,1760,1472,3.0,0.0,0.0,3,8,1640,120,2006,0,98119,47.6473,-122.374,1760,5400,10,29,2014,N,0,-3928
9485951510,9/15/2014,450000.0,3,2.5,2790,48994,2.0,0.0,0.0,4,9,2790,0,1984,0,98042,47.3487,-122.088,2550,37834,9,15,2014,UNK,240,11160
1337800805,7/3/2014,1760000.0,3,2.0,2360,4800,2.0,0.0,0.0,3,9,2360,0,1909,0,98112,47.6317,-122.31200000000001,2260,4800,7,3,2014,UNK,100,0
4059400265,11/14/2014,339950.0,5,2.0,1890,6050,2.0,0.0,0.0,4,7,1890,0,1944,0,98178,47.5018,-122.242,1170,6050,11,14,2014,UNK,720,0
993000100,4/10/2015,760000.0,6,3.75,3810,6150,2.0,0.0,0.0,4,8,3810,0,1977,0,98103,47.693999999999996,-122.34,1830,5125,4,10,2015,UNK,1980,1025
2917200085,4/8/2015,350000.0,2,1.0,1160,5395,1.0,0.0,0.0,3,7,860,300,1940,0,98103,47.7007,-122.354,1664,5363,4,8,2015,UNK,-504,32
3914000090,4/21/2015,541500.0,3,1.75,2320,55847,1.0,0.0,2.0,4,8,2320,0,1960,0,98001,47.3121,-122.25299999999999,2400,26112,4,21,2015,UNK,-80,29735
4157600150,3/27/2015,730000.0,6,2.75,3280,16449,1.0,0.0,0.0,4,7,1910,1370,1963,0,98007,47.5914,-122.134,2550,9532,3,27,2015,UNK,730,6917
3624039111,4/29/2015,215000.0,3,1.0,980,5600,1.0,0.0,0.0,2,6,980,0,1949,0,98106,47.5308,-122.361,1840,5302,4,29,2015,UNK,-860,298
8099900490,5/15/2014,420000.0,3,2.0,1640,9972,1.0,0.0,0.0,4,7,1640,0,1977,0,98075,47.5812,-122.00200000000001,1680,10165,5,15,2014,UNK,-40,-193
1687910100,5/30/2014,655000.0,4,2.25,2060,8470,1.0,0.0,0.0,3,8,1440,620,1983,0,98006,47.5605,-122.124,2180,8978,5,30,2014,UNK,-120,-508
5419800330,1/15/2015,240000.0,3,2.5,1500,10652,2.0,0.0,0.0,4,7,1500,0,1981,0,98031,47.4015,-122.176,1610,7417,1,15,2015,UNK,-110,3235
5035300085,6/2/2014,730000.0,4,2.0,2360,6000,1.0,0.0,0.0,5,7,1260,1100,1939,0,98199,47.6534,-122.41,1720,6000,6,2,2014,UNK,640,0
325059131,10/13/2014,390000.0,4,1.5,1940,12100,1.0,0.0,0.0,3,7,1940,0,1962,0,98033,47.6892,-122.164,1380,12100,10,13,2014,UNK,560,0
2201500450,10/28/2014,473000.0,3,1.0,1280,10000,1.0,0.0,0.0,4,7,1280,0,1954,0,98006,47.5716,-122.139,1240,10000,10,28,2014,UNK,40,0
3342101270,3/24/2015,698000.0,4,3.5,3630,5670,2.0,0.0,0.0,3,10,3630,0,1970,0,98056,47.5189,-122.206,1620,5400,3,24,2015,UNK,2010,270
3574750150,5/14/2014,511000.0,3,2.5,1820,4883,2.0,0.0,0.0,3,9,1820,0,2005,0,98028,47.7355,-122.22399999999999,2720,5002,5,14,2014,N,-900,-119
9828702055,5/8/2014,358000.0,2,1.5,960,1808,2.0,0.0,0.0,3,7,960,0,1993,0,98122,47.6183,-122.29799999999999,1290,1668,5,8,2014,UNK,-330,140
2207100650,4/10/2015,499990.0,3,1.75,1630,8400,1.0,0.0,0.0,4,7,1060,570,1955,0,98007,47.5983,-122.149,1630,7245,4,10,2015,UNK,0,1155
240000031,3/13/2015,322000.0,4,2.25,1940,10200,1.0,0.0,0.0,3,7,1360,580,1960,0,98188,47.4253,-122.28299999999999,1940,10200,3,13,2015,UNK,0,0
2953000300,10/8/2014,201000.0,3,1.0,980,9682,1.0,0.0,0.0,3,7,980,0,1969,0,98031,47.4136,-122.20700000000001,1580,9682,10,8,2014,UNK,-600,0
6119700150,11/12/2014,765000.0,4,2.5,3140,16200,1.0,0.0,1.0,3,9,2570,570,1988,0,98166,47.4363,-122.34200000000001,2530,13200,11,12,2014,UNK,610,3000
9274200365,6/6/2014,920000.0,4,2.75,2880,5750,1.5,0.0,0.0,5,9,1710,1170,1928,0,98116,47.5874,-122.387,1640,5750,6,6,2014,UNK,1240,0
6187700501,4/15/2015,360000.0,4,2.0,1650,7552,1.0,0.0,0.0,4,7,860,790,1977,0,98155,47.7765,-122.324,1410,7199,4,15,2015,UNK,240,353
4137020910,5/7/2015,297300.0,3,1.75,1980,9220,2.0,0.0,0.0,3,8,1980,0,1987,0,98092,47.2602,-122.219,2080,8305,5,7,2015,UNK,-100,915
1233100720,9/25/2014,399000.0,3,1.0,860,9403,1.0,0.0,0.0,4,6,860,0,1942,0,98033,47.6815,-122.17299999999999,2136,13009,9,25,2014,UNK,-1276,-3606
3034200530,6/20/2014,400000.0,3,1.0,1430,10005,1.5,0.0,0.0,4,7,1430,0,1950,0,98133,47.7181,-122.338,1720,8822,6,20,2014,UNK,-290,1183
1463400081,8/27/2014,230000.0,3,1.75,1260,10164,1.0,0.0,0.0,4,6,1260,0,1964,0,98059,47.4752,-122.133,1190,10640,8,27,2014,UNK,70,-476
1773101050,2/20/2015,290000.0,3,1.0,960,4560,1.0,0.0,0.0,4,7,960,0,1968,0,98106,47.5539,-122.365,970,4800,2,20,2015,UNK,-10,-240
1895450090,4/30/2015,323800.0,3,2.5,2060,7658,2.0,0.0,0.0,3,8,2060,0,2003,0,98023,47.2923,-122.36,2250,7299,4,30,2015,UNK,-190,359
5101406384,10/20/2014,574500.0,4,1.5,1430,6380,1.5,0.0,0.0,4,9,1430,0,1930,0,98125,47.7014,-122.31299999999999,1220,5112,10,20,2014,UNK,210,1268
6821102346,5/22/2014,505000.0,3,2.25,1670,1596,2.0,0.0,0.0,3,8,1220,450,2002,0,98199,47.6474,-122.396,1670,1596,5,22,2014,UNK,0,0
1926049210,4/22/2015,372500.0,2,1.0,880,10950,1.0,0.0,0.0,4,7,880,0,1944,0,98133,47.7332,-122.352,1450,7560,4,22,2015,UNK,-570,3390
1842200040,7/1/2014,425000.0,3,1.5,1300,19163,1.0,0.0,0.0,3,7,1300,0,1964,0,98052,47.6686,-122.15299999999999,1590,9744,7,1,2014,UNK,-290,9419
2623089002,4/16/2015,446250.0,3,2.5,2380,214315,1.5,0.0,0.0,3,9,2380,0,2000,0,98045,47.4525,-121.74799999999999,2400,68824,4,16,2015,UNK,-20,145491
4391600065,8/14/2014,330000.0,2,0.75,520,6862,1.0,0.0,0.0,4,4,520,0,1924,1980,98010,47.326,-122.037,1170,8756,8,14,2014,Y,-650,-1894
3760500602,4/27/2015,608095.0,3,2.5,2680,17707,2.0,0.0,1.0,3,9,2680,0,1983,0,98034,47.7031,-122.22399999999999,2840,21743,4,27,2015,UNK,-160,-4036
6071000265,1/25/2015,550000.0,3,2.5,2140,10136,1.0,0.0,0.0,3,8,1320,820,1958,0,98006,47.5602,-122.184,1980,11200,1,25,2015,UNK,160,-1064
3222059206,8/28/2014,265000.0,4,2.5,1820,16103,2.0,0.0,0.0,3,7,1820,0,2004,0,98030,47.3553,-122.196,2120,21277,8,28,2014,N,-300,-5174
3034200933,6/19/2014,399888.0,4,2.25,1820,8255,1.5,0.0,0.0,4,7,1320,500,1930,0,98133,47.723,-122.337,1550,7628,6,19,2014,UNK,270,627
2028701165,6/27/2014,430000.0,2,1.0,1050,2570,1.0,0.0,0.0,5,7,850,200,1927,0,98117,47.6764,-122.366,1080,2800,6,27,2014,UNK,-30,-230
5634500234,5/13/2015,554990.0,3,2.5,2100,6092,2.0,0.0,0.0,3,8,2100,0,2013,0,98028,47.7508,-122.23899999999999,2250,8592,5,13,2015,N,-150,-2500
2310100180,11/7/2014,359950.0,3,2.5,2210,6280,2.0,0.0,0.0,3,8,2210,0,2003,0,98038,47.35,-122.04299999999999,2250,5972,11,7,2014,UNK,-40,308
2767600921,6/23/2014,405000.0,2,1.0,860,2599,1.0,0.0,0.0,4,6,860,0,1901,0,98107,47.675,-122.37899999999999,1300,3900,6,23,2014,UNK,-440,-1301
8835200790,4/6/2015,280000.0,2,1.0,870,4025,1.0,0.0,0.0,3,7,870,0,1981,0,98034,47.7243,-122.161,1370,3488,4,6,2015,UNK,-500,537
2473000410,4/8/2015,479950.0,4,2.25,2570,11070,2.0,0.0,0.0,4,8,2570,0,1966,0,98058,47.4507,-122.152,2210,9600,4,8,2015,UNK,360,1470
3286800110,9/4/2014,575000.0,5,1.75,2980,53578,1.0,0.0,0.0,4,9,2230,750,1976,0,98027,47.4908,-122.059,2860,75546,9,4,2014,UNK,120,-21968
1402600110,2/26/2015,392000.0,4,2.25,2360,7733,2.0,0.0,0.0,3,8,2360,0,1983,0,98058,47.4403,-122.137,2160,7733,2,26,2015,UNK,200,0
1126059170,2/25/2015,760500.0,4,2.25,2310,36136,2.0,0.0,0.0,4,9,2310,0,1977,0,98072,47.7506,-122.12200000000001,3930,36136,2,25,2015,UNK,-1620,0
8035350090,6/16/2014,435000.0,3,2.5,2300,9521,2.0,0.0,0.0,3,8,2300,0,2003,0,98019,47.7447,-121.976,3020,10042,6,16,2014,UNK,-720,-521
4389200753,8/19/2014,1570000.0,4,2.75,2810,8570,2.0,0.0,0.0,3,10,2810,0,1993,0,98004,47.6159,-122.211,2810,9621,8,19,2014,UNK,0,-1051
6818400110,12/3/2014,261000.0,4,1.5,2040,10488,1.0,0.0,0.0,3,7,1190,850,1961,0,98188,47.4557,-122.26899999999999,1960,10488,12,3,2014,UNK,80,0
4217401035,5/7/2015,1480000.0,3,2.25,3290,5000,2.0,0.0,0.0,3,9,2730,560,1939,0,98105,47.6582,-122.28,2340,4000,5,7,2015,UNK,950,1000
1683400165,4/30/2015,853800.0,7,4.0,2960,2665,2.0,0.0,0.0,3,9,1950,1010,1927,2013,98144,47.5835,-122.31299999999999,1970,4410,4,30,2015,Y,990,-1745
1939120450,5/22/2014,657500.0,3,2.5,2670,10496,2.0,0.0,0.0,3,9,2670,0,1989,0,98074,47.6272,-122.02600000000001,2490,8636,5,22,2014,UNK,180,1860
4137010530,5/4/2014,331950.0,4,2.5,2530,9933,2.0,0.0,2.0,3,8,2010,520,1990,0,98092,47.2654,-122.21600000000001,2140,9933,5,4,2014,UNK,390,0
2624039133,6/11/2014,514000.0,3,1.75,1720,5899,1.0,0.0,1.0,3,8,1220,500,1986,0,98136,47.5399,-122.385,1900,6244,6,11,2014,UNK,-180,-345
2794700120,9/12/2014,496000.0,3,3.5,3090,27598,2.0,0.0,2.0,4,9,2020,1070,1995,0,98070,47.3541,-122.45299999999999,2180,17085,9,12,2014,UNK,910,10513
2944010210,2/18/2015,1090000.0,4,2.5,3930,21894,2.0,0.0,0.0,3,11,3930,0,1987,0,98052,47.7209,-122.12799999999999,3930,20000,2,18,2015,UNK,0,1894
8651443360,11/6/2014,195700.0,3,1.0,1120,5200,1.0,0.0,0.0,5,7,1120,0,1976,0,98042,47.3638,-122.088,1690,5200,11,6,2014,UNK,-570,0
1338300180,7/29/2014,1400000.0,4,2.25,3960,8640,2.0,0.0,2.0,3,9,2630,1330,1925,0,98112,47.6317,-122.304,3850,8640,7,29,2014,UNK,110,0
624110540,12/5/2014,1180000.0,4,3.25,4060,20822,2.0,0.0,0.0,3,10,4060,0,1991,0,98077,47.7213,-122.055,4170,23958,12,5,2014,UNK,-110,-3136
4039700090,9/23/2014,643403.0,3,2.5,2350,9648,1.0,0.0,0.0,4,9,2350,0,1966,0,98008,47.6156,-122.10799999999999,2320,10512,9,23,2014,UNK,30,-864
6752601110,5/12/2014,357000.0,4,2.5,2380,7066,2.0,0.0,0.0,4,7,2380,0,1997,0,98031,47.3982,-122.17200000000001,2310,8127,5,12,2014,UNK,70,-1061
8861000210,4/8/2015,865000.0,3,1.75,1480,8163,1.0,0.0,0.0,3,7,1040,440,1953,0,98004,47.63800000000001,-122.206,2170,11124,4,8,2015,UNK,-690,-2961
1088700100,11/18/2014,905000.0,3,2.5,2930,9280,2.0,0.0,0.0,4,10,2930,0,1988,0,98007,47.6335,-122.15100000000001,2730,10090,11,18,2014,UNK,200,-810
7893207925,10/22/2014,265000.0,3,1.5,1290,7100,1.0,0.0,0.0,3,6,1290,0,1954,0,98198,47.4227,-122.33200000000001,1300,7183,10,22,2014,UNK,-10,-83
3449820100,12/24/2014,535000.0,2,2.5,2730,7246,2.0,0.0,0.0,3,9,2730,0,1998,0,98056,47.512,-122.175,3220,7214,12,24,2014,UNK,-490,32
1588600110,8/11/2014,450000.0,3,1.0,1290,5440,1.0,0.0,0.0,4,6,790,500,1929,0,98117,47.6951,-122.367,1220,5464,8,11,2014,UNK,70,-24
8079040300,2/18/2015,460500.0,4,2.5,2170,7533,2.0,0.0,0.0,3,8,2170,0,1991,0,98059,47.5057,-122.149,2170,8728,2,18,2015,UNK,0,-1195
7390400026,11/24/2014,315000.0,4,1.75,1850,8580,1.0,0.0,0.0,3,7,1140,710,1960,0,98178,47.4877,-122.24,2210,9240,11,24,2014,UNK,-360,-660
2425059144,2/13/2015,607500.0,4,2.5,2110,13939,1.0,0.0,0.0,3,8,1270,840,1978,0,98008,47.6431,-122.113,2140,8882,2,13,2015,UNK,-30,5057
7821200375,1/26/2015,432000.0,2,1.0,960,3235,1.0,0.0,0.0,4,7,960,0,1916,0,98103,47.661,-122.344,1290,2069,1,26,2015,UNK,-330,1166
1370800700,2/9/2015,1700000.0,3,4.0,3910,5350,2.0,0.0,2.0,5,10,2610,1300,1933,0,98199,47.6393,-122.40799999999999,2890,5350,2,9,2015,UNK,1020,0
8857640710,8/20/2014,479000.0,4,2.5,2590,6139,2.0,0.0,0.0,3,8,2590,0,2001,0,98038,47.3883,-122.035,2410,6139,8,20,2014,UNK,180,0
9558020240,3/20/2015,475000.0,5,2.75,3080,6600,2.0,0.0,0.0,3,9,3080,0,2002,0,98058,47.4501,-122.12200000000001,3080,6600,3,20,2015,UNK,0,0
3834000400,11/19/2014,415000.0,3,1.0,1630,8146,1.0,0.0,0.0,3,7,1630,0,1952,0,98125,47.7293,-122.29,1480,8146,11,19,2014,UNK,150,0
461002050,8/26/2014,450000.0,2,1.0,910,5000,1.0,0.0,0.0,4,6,910,0,1914,0,98117,47.683,-122.374,1480,5000,8,26,2014,UNK,-570,0
724069065,7/3/2014,1140000.0,3,2.5,2780,33503,1.5,0.0,1.0,4,8,2110,670,1969,0,98075,47.5844,-122.081,3150,15542,7,3,2014,UNK,-370,17961
4307351180,9/15/2014,430000.0,5,3.0,3880,8432,2.0,0.0,0.0,3,7,3880,0,2004,0,98056,47.4806,-122.176,2620,5623,9,15,2014,N,1260,2809
984100340,9/3/2014,296000.0,3,1.75,1360,10742,1.0,0.0,0.0,5,7,960,400,1971,0,98058,47.4351,-122.17299999999999,1830,9000,9,3,2014,UNK,-470,1742
8159620260,7/11/2014,303000.0,4,2.25,2560,8927,1.0,0.0,0.0,3,7,1790,770,1976,0,98001,47.34,-122.271,1920,9669,7,11,2014,UNK,640,-742
7559600200,10/21/2014,641000.0,4,2.5,2600,6015,2.0,0.0,0.0,3,8,2600,0,2004,0,98075,47.5971,-122.031,2910,5305,10,21,2014,N,-310,710
1995200320,2/10/2015,280000.0,3,2.25,1220,5739,1.0,0.0,0.0,3,7,790,430,1984,0,98115,47.6952,-122.32600000000001,1870,5739,2,10,2015,UNK,-650,0
4223000140,8/5/2014,260750.0,3,2.0,1560,9635,1.0,0.0,0.0,3,7,1260,300,1966,0,98003,47.341,-122.309,1570,8276,8,5,2014,UNK,-10,1359
7215730200,11/19/2014,601000.0,4,2.5,2080,5191,2.0,0.0,0.0,3,8,2080,0,2001,0,98075,47.5978,-122.01700000000001,2170,5518,11,19,2014,UNK,-90,-327
1900600105,8/28/2014,255000.0,3,1.5,1490,6604,1.0,0.0,0.0,4,6,1490,0,1918,0,98166,47.4683,-122.351,1330,6604,8,28,2014,UNK,160,0
8644300200,6/5/2014,555000.0,4,2.75,2020,10720,1.0,0.0,0.0,4,8,1420,600,1976,0,98052,47.6373,-122.104,2190,10164,6,5,2014,UNK,-170,556
3262301610,11/18/2014,865000.0,3,1.5,1530,10827,1.0,0.0,0.0,4,8,1530,0,1955,0,98039,47.6354,-122.234,2050,10827,11,18,2014,UNK,-520,0
524059250,9/22/2014,1390000.0,4,2.5,3450,17400,1.5,0.0,0.0,4,9,2180,1270,1964,0,98004,47.5969,-122.206,3770,19530,9,22,2014,UNK,-320,-2130
8594400350,5/20/2014,315000.0,3,2.25,1400,31626,1.0,0.0,0.0,2,7,1140,260,1987,0,98092,47.3029,-122.069,1680,35093,5,20,2014,UNK,-280,-3467
4031000260,6/6/2014,200000.0,2,1.0,1730,9610,1.0,0.0,0.0,3,7,1380,350,1962,0,98001,47.2956,-122.285,1310,9812,6,6,2014,UNK,420,-202
1454100260,11/17/2014,357000.0,3,1.0,1370,6450,1.0,0.0,0.0,3,7,1370,0,1948,0,98125,47.7195,-122.288,1550,6898,11,17,2014,UNK,-180,-448
1934800138,12/4/2014,390000.0,2,1.5,1050,934,2.0,0.0,0.0,3,8,960,90,2007,0,98122,47.6029,-122.309,1470,1885,12,4,2014,N,-420,-951
9508500075,7/29/2014,462000.0,5,1.75,2840,10220,1.0,0.0,0.0,4,7,2210,630,1954,0,98177,47.763999999999996,-122.36,2000,9750,7,29,2014,UNK,840,470
2946003415,5/16/2014,174500.0,2,1.0,1010,5200,1.0,0.0,0.0,3,7,1010,0,1955,0,98198,47.4166,-122.323,1580,7500,5,16,2014,UNK,-570,-2300
1926049326,2/10/2015,305000.0,2,1.0,1210,7140,1.5,0.0,0.0,3,6,1210,0,1921,0,98133,47.7225,-122.34899999999999,1150,7376,2,10,2015,UNK,60,-236
7655900187,2/5/2015,449000.0,5,1.75,1720,14040,1.0,0.0,0.0,4,8,1150,570,1956,0,98133,47.7365,-122.339,1750,7800,2,5,2015,UNK,-30,6240
7452500565,8/29/2014,260000.0,3,2.0,2710,5000,2.0,0.0,0.0,3,6,2710,0,1951,0,98126,47.5188,-122.37299999999999,850,5000,8,29,2014,UNK,1860,0
2871000400,5/12/2014,751000.0,4,2.5,3110,6142,2.0,0.0,0.0,3,9,3110,0,2004,0,98052,47.701,-122.111,3200,6826,5,12,2014,N,-90,-684
6150200060,4/1/2015,370037.0,2,1.0,1250,9270,1.0,0.0,0.0,4,7,1250,0,1948,0,98133,47.7284,-122.339,1130,6800,4,1,2015,UNK,120,2470
3668000830,8/25/2014,229950.0,3,1.75,1900,8910,2.0,0.0,0.0,4,7,1900,0,1988,0,98092,47.2769,-122.145,1610,8586,8,25,2014,UNK,290,324
2473460060,4/22/2015,349000.0,3,1.75,1740,7682,1.0,0.0,0.0,3,8,1330,410,1978,0,98058,47.4451,-122.126,2010,8820,4,22,2015,UNK,-270,-1138
9558021000,1/20/2015,348000.0,4,2.5,2070,3808,2.0,0.0,0.0,3,8,2070,0,2003,0,98058,47.4498,-122.12,1900,2992,1,20,2015,UNK,170,816
1250201610,4/17/2015,1220000.0,3,3.25,3030,5600,2.0,0.0,2.0,3,9,2220,810,1905,2005,98144,47.5978,-122.292,2040,6600,4,17,2015,Y,990,-1000
1321720160,1/2/2015,510000.0,4,3.0,3610,18948,2.0,0.0,0.0,3,10,3610,0,1993,0,98023,47.2911,-122.34200000000001,3568,18948,1,2,2015,UNK,42,0
5029450200,3/23/2015,265000.0,3,1.5,1520,6805,1.0,0.0,0.0,4,7,1040,480,1981,0,98023,47.2907,-122.367,1440,7041,3,23,2015,UNK,80,-236
723000226,10/28/2014,1250000.0,3,2.75,2780,4815,3.0,0.0,2.0,3,10,2780,0,1974,0,98105,47.6569,-122.286,2820,5000,10,28,2014,UNK,-40,-185
225079036,1/7/2015,937500.0,4,4.0,5545,871200,2.0,0.0,0.0,3,11,3605,1940,2003,0,98014,47.676,-121.882,3420,871200,1,7,2015,UNK,2125,0
5255700160,8/5/2014,485000.0,3,1.75,2590,8384,1.0,0.0,0.0,4,8,1590,1000,1971,0,98011,47.7739,-122.199,2590,8800,8,5,2014,UNK,0,-416
5683500030,3/20/2015,489000.0,4,1.0,1150,5217,1.5,0.0,0.0,3,7,1150,0,1951,0,98115,47.6806,-122.287,1220,5217,3,20,2015,UNK,-70,0
312000295,1/22/2015,400000.0,2,1.0,920,5120,1.0,0.0,0.0,5,7,920,0,1952,0,98136,47.5569,-122.39399999999999,1190,5120,1,22,2015,UNK,-270,0
9510970520,6/16/2014,638000.0,3,2.5,2110,3600,2.0,0.0,0.0,3,9,2110,0,2005,0,98052,47.665,-122.08200000000001,2540,4384,6,16,2014,N,-430,-784
193600200,6/19/2014,440000.0,3,1.75,1170,8740,1.0,0.0,0.0,4,7,1170,0,1968,0,98052,47.6849,-122.117,1870,8448,6,19,2014,UNK,-700,292
2568300045,6/25/2014,305000.0,6,2.0,1900,8240,1.0,0.0,0.0,2,7,1200,700,1964,0,98125,47.7037,-122.296,1900,8240,6,25,2014,UNK,0,0
2568300045,3/19/2015,649950.0,6,2.0,1900,8240,1.0,0.0,0.0,2,7,1200,700,1964,0,98125,47.7037,-122.296,1900,8240,3,19,2015,UNK,0,0
8691410310,2/13/2015,680000.0,4,2.5,3290,6012,2.0,0.0,0.0,3,9,3290,0,2005,0,98075,47.5961,-121.98,3210,6005,2,13,2015,N,80,7
1656600310,7/14/2014,629000.0,4,2.5,2660,22050,2.0,0.0,0.0,3,9,2660,0,1996,0,98059,47.4911,-122.125,3060,21111,7,14,2014,UNK,-400,939
3904940160,9/4/2014,555000.0,3,2.5,2160,7584,2.0,0.0,0.0,3,8,2160,0,1988,0,98029,47.5751,-122.014,2160,7372,9,4,2014,UNK,0,212
1774200060,6/17/2014,669000.0,4,2.75,2700,35362,2.0,0.0,0.0,5,8,2700,0,1976,0,98077,47.7628,-122.094,2810,35915,6,17,2014,UNK,-110,-553
4137070030,8/8/2014,272000.0,3,2.5,1980,6608,2.0,0.0,0.0,3,8,1980,0,1994,0,98092,47.2642,-122.213,2150,7495,8,8,2014,UNK,-170,-887
2144800117,6/26/2014,270000.0,4,2.25,2600,9900,1.0,0.0,0.0,3,7,1600,1000,1965,0,98178,47.4881,-122.23700000000001,1770,11250,6,26,2014,UNK,830,-1350
3392100140,1/6/2015,215000.0,3,1.0,1280,9775,1.0,0.0,0.0,3,6,1280,0,1964,0,98003,47.3262,-122.334,1230,8750,1,6,2015,UNK,50,1025
2581900060,4/2/2015,690000.0,3,1.5,1710,17707,1.0,0.0,0.0,4,7,1180,530,1947,0,98040,47.5393,-122.21600000000001,2590,9508,4,2,2015,UNK,-880,8199
4058801230,3/5/2015,256000.0,4,1.75,1270,6825,1.0,0.0,2.0,3,7,1270,0,1950,0,98178,47.5051,-122.242,1800,6930,3,5,2015,UNK,-530,-105
2787320140,3/24/2015,255000.0,3,2.25,1890,7314,1.0,0.0,0.0,3,7,1100,790,1981,0,98031,47.4121,-122.17200000000001,1520,7676,3,24,2015,UNK,370,-362
263000324,5/13/2014,550000.0,7,4.0,3440,8100,2.0,0.0,0.0,3,7,3440,0,1970,0,98103,47.6981,-122.34899999999999,1420,1560,5,13,2014,UNK,2020,6540
254000695,5/8/2015,410000.0,3,1.0,1190,5280,1.0,0.0,0.0,4,7,1190,0,1957,0,98146,47.5131,-122.383,1280,5280,5,8,2015,UNK,-90,0
3013300830,11/6/2014,410000.0,2,1.0,1030,4366,1.0,0.0,0.0,3,7,1030,0,1912,0,98136,47.5311,-122.384,1890,4499,11,6,2014,UNK,-860,-133
2475201070,7/16/2014,259000.0,3,1.75,1240,4000,1.0,0.0,0.0,3,7,1240,0,1986,0,98055,47.4728,-122.191,1570,4586,7,16,2014,UNK,-330,-586
798000421,3/27/2015,292000.0,3,1.0,1730,21183,1.0,0.0,0.0,3,7,1030,700,1955,0,98168,47.5024,-122.33200000000001,1610,13000,3,27,2015,UNK,120,8183
4104500181,8/12/2014,1650000.0,4,3.5,4610,12500,2.0,0.0,2.0,3,11,4610,0,2003,0,98033,47.6508,-122.20299999999999,2340,11538,8,12,2014,UNK,2270,962
8701600030,11/13/2014,518000.0,5,1.0,1590,5000,1.5,0.0,0.0,3,7,1190,400,1929,0,98116,47.5752,-122.381,1590,5000,11,13,2014,UNK,0,0
8944360390,3/5/2015,485000.0,3,2.5,1760,3097,2.0,0.0,0.0,3,8,1760,0,1992,0,98029,47.5764,-121.99600000000001,1760,3285,3,5,2015,UNK,0,-188
7968460270,3/3/2015,259500.0,3,2.0,1330,35060,1.0,0.0,0.0,3,7,1330,0,1989,0,98092,47.3128,-122.13,1660,35100,3,3,2015,UNK,-330,-40
9406570350,4/23/2015,354000.0,4,2.5,2340,5420,2.0,0.0,0.0,3,8,2340,0,2003,0,98038,47.3773,-122.029,2420,6252,4,23,2015,UNK,-80,-832
686900030,3/23/2015,999950.0,3,2.25,3740,22464,2.0,0.0,0.0,5,8,2330,1410,1966,0,98004,47.6354,-122.196,2680,19564,3,23,2015,UNK,1060,2900
6071300030,6/24/2014,464500.0,3,1.75,1150,10466,1.0,0.0,0.0,5,7,1150,0,1959,0,98006,47.5531,-122.177,1350,10384,6,24,2014,UNK,-200,82
5416500520,8/25/2014,300000.0,3,2.5,1750,4200,2.0,0.0,0.0,3,7,1750,0,2005,0,98038,47.3605,-122.04,1890,4048,8,25,2014,N,-140,152
1102000270,7/1/2014,1080000.0,3,2.75,3890,7216,2.0,0.0,1.0,3,8,3260,630,1967,2010,98118,47.5445,-122.266,2490,9920,7,1,2014,Y,1400,-2704
5422430320,7/21/2014,309950.0,4,2.5,1770,6666,2.0,0.0,0.0,3,7,1770,0,1989,0,98023,47.2877,-122.34899999999999,1780,6666,7,21,2014,UNK,-10,0
3157600340,9/17/2014,315000.0,3,1.0,1160,3700,1.5,0.0,0.0,3,7,1160,0,1909,0,98106,47.5651,-122.359,1340,3750,9,17,2014,UNK,-180,-50
2061100435,7/24/2014,499950.0,3,1.0,1440,5580,1.5,0.0,0.0,3,7,1440,0,1908,0,98115,47.6898,-122.32600000000001,2010,5580,7,24,2014,UNK,-570,0
7011201550,7/7/2014,780000.0,4,2.0,2600,4800,1.0,0.0,2.0,3,8,1400,1200,1953,0,98119,47.637,-122.37100000000001,2050,3505,7,7,2014,UNK,550,1295
2581300055,11/21/2014,885000.0,3,3.25,2640,16090,1.0,0.0,2.0,4,8,1960,680,1976,0,98040,47.5374,-122.213,3690,15000,11,21,2014,UNK,-1050,1090
1344300045,5/7/2014,500000.0,2,1.0,1010,3885,1.5,0.0,0.0,4,7,1010,0,1906,0,98112,47.6224,-122.304,1770,4200,5,7,2014,UNK,-760,-315
7575620640,12/19/2014,329000.0,3,2.0,1840,6755,1.0,0.0,2.0,3,8,1840,0,1989,0,98003,47.3512,-122.305,1790,6459,12,19,2014,UNK,50,296
8645500270,10/28/2014,246000.0,4,1.75,1720,7455,1.0,0.0,0.0,4,7,1020,700,1963,0,98058,47.4669,-122.182,1720,7700,10,28,2014,UNK,0,-245
1246700136,12/23/2014,405000.0,3,1.5,1280,9600,1.0,0.0,0.0,4,7,1280,0,1960,0,98033,47.6922,-122.163,1510,10005,12,23,2014,UNK,-230,-405
3211100240,5/29/2014,349000.0,4,1.75,1700,7800,1.0,0.0,0.0,5,7,1120,580,1981,0,98059,47.4801,-122.15799999999999,1560,7800,5,29,2014,UNK,140,0
8078100140,3/23/2015,374950.0,4,2.5,1980,12062,2.0,0.0,0.0,3,8,1980,0,1992,0,98031,47.4038,-122.167,2300,7902,3,23,2015,UNK,-320,4160
6675500105,7/29/2014,306000.0,3,2.0,1160,7217,1.0,0.0,0.0,3,7,1160,0,1969,0,98034,47.7279,-122.227,1870,9104,7,29,2014,UNK,-710,-1887
4040700310,8/5/2014,416000.0,4,1.75,1980,7840,1.0,0.0,0.0,4,7,990,990,1961,0,98008,47.6226,-122.115,1520,8400,8,5,2014,UNK,460,-560
6388910160,6/23/2014,560000.0,3,2.5,1960,12476,2.0,0.0,0.0,4,8,1960,0,1989,0,98056,47.5315,-122.17200000000001,2450,12177,6,23,2014,UNK,-490,299
4023500990,6/17/2014,260000.0,3,1.5,1270,20700,1.0,0.0,0.0,2,7,1150,120,1948,0,98155,47.7576,-122.296,1990,15000,6,17,2014,UNK,-720,5700
2921049121,5/16/2014,306500.0,3,2.25,2060,38377,1.0,0.0,0.0,4,8,1560,500,1978,0,98003,47.2752,-122.319,2080,60513,5,16,2014,UNK,-20,-22136
7229210060,12/11/2014,299950.0,3,1.75,1980,11274,1.0,0.0,0.0,4,7,1480,500,1968,0,98058,47.4474,-122.167,1520,8010,12,11,2014,UNK,460,3264
4137040060,4/6/2015,265500.0,3,2.5,1450,8977,1.0,0.0,0.0,3,8,1450,0,1990,0,98092,47.2576,-122.214,2410,8850,4,6,2015,UNK,-960,127
7982600030,8/12/2014,219000.0,3,1.5,1200,12000,1.0,0.0,0.0,3,7,1200,0,1986,0,98001,47.268,-122.245,1200,9405,8,12,2014,UNK,0,2595
1775930140,5/5/2015,365000.0,3,1.75,1830,17349,1.0,0.0,0.0,3,8,1230,600,1977,0,98072,47.7427,-122.109,1840,11694,5,5,2015,UNK,-10,5655
3222079083,5/14/2014,499000.0,3,2.0,2090,42689,1.5,0.0,0.0,3,7,2090,0,1959,1998,98010,47.3497,-121.944,1890,18276,5,14,2014,Y,200,24413
3585210200,6/2/2014,366000.0,3,1.75,1510,8301,1.0,0.0,0.0,3,7,1510,0,1967,0,98034,47.7243,-122.22200000000001,1460,7910,6,2,2014,UNK,50,391
2705600069,5/1/2015,514950.0,3,2.25,1310,1264,3.0,0.0,0.0,3,8,1310,0,2014,0,98117,47.6987,-122.366,1330,2183,5,1,2015,N,-20,-919
8691360200,6/4/2014,875000.0,4,2.75,3790,10669,2.0,0.0,0.0,3,10,3790,0,1999,0,98075,47.5976,-121.98299999999999,3750,11634,6,4,2014,UNK,40,-965
9541600350,1/20/2015,831000.0,3,2.25,2240,8800,1.0,0.0,0.0,5,8,2240,0,1957,0,98005,47.5937,-122.17200000000001,2240,8800,1,20,2015,UNK,0,0
8562740400,5/15/2014,689900.0,4,3.25,2740,7266,2.0,0.0,0.0,3,9,2060,680,2003,0,98027,47.5346,-122.066,3030,6546,5,15,2014,UNK,-290,720
705700960,7/24/2014,315000.0,3,2.5,1660,10763,2.0,0.0,0.0,3,7,1660,0,1994,0,98038,47.3812,-122.029,2010,7983,7,24,2014,UNK,-350,2780
2645500013,6/24/2014,336500.0,3,1.0,1480,7284,1.0,0.0,0.0,3,7,970,510,1963,0,98133,47.7757,-122.353,2020,7920,6,24,2014,UNK,-540,-636
5318100200,5/27/2014,1100000.0,3,2.75,2640,4050,1.5,0.0,0.0,5,8,1750,890,1926,0,98112,47.6332,-122.281,1920,3600,5,27,2014,UNK,720,450
2224700045,8/4/2014,375000.0,6,2.0,1900,8057,1.0,0.0,0.0,4,7,1170,730,1959,0,98133,47.762,-122.335,2090,8626,8,4,2014,UNK,-190,-569
4047200135,8/11/2014,289275.0,3,2.0,2860,24046,1.0,0.0,0.0,3,9,1700,1160,1985,0,98019,47.7718,-121.904,1460,13648,8,11,2014,UNK,1400,10398
2009000830,7/8/2014,455000.0,4,3.5,3440,6000,2.0,0.0,0.0,4,8,3440,0,2002,0,98198,47.4077,-122.331,1660,7800,7,8,2014,UNK,1780,-1800
6619910240,6/25/2014,505000.0,3,1.75,1640,10695,1.0,0.0,2.0,3,8,1640,0,1975,0,98034,47.7145,-122.22200000000001,2790,9775,6,25,2014,UNK,-1150,920
5288200070,7/30/2014,450000.0,3,1.0,1450,3350,1.5,0.0,0.0,4,7,1450,0,1919,0,98126,47.5607,-122.37799999999999,1340,4255,7,30,2014,UNK,110,-905
7852110070,6/8/2014,567500.0,3,2.5,2300,7398,2.0,0.0,0.0,3,8,2300,0,2001,0,98065,47.5369,-121.876,2580,6983,6,8,2014,UNK,-280,415
740500070,10/6/2014,265000.0,3,1.5,1460,8505,1.0,0.0,0.0,4,7,1460,0,1955,0,98055,47.4402,-122.195,1580,8505,10,6,2014,UNK,-120,0
4046601420,12/30/2014,340000.0,3,2.0,1570,14992,1.0,0.0,0.0,3,8,1570,0,2001,0,98014,47.6965,-121.92200000000001,1640,15000,12,30,2014,UNK,-70,-8
2130700860,4/30/2015,375000.0,3,2.0,1540,8885,1.5,0.0,0.0,5,6,1540,0,1939,0,98019,47.7403,-121.984,1730,5000,4,30,2015,UNK,-190,3885
3975400045,12/26/2014,920000.0,6,3.0,3300,4218,2.0,0.0,0.0,3,8,2200,1100,1970,0,98103,47.6557,-122.344,1420,4218,12,26,2014,UNK,1880,0
5451200520,6/12/2014,850000.0,4,2.25,2130,11843,2.0,0.0,0.0,4,9,2130,0,1972,0,98040,47.5358,-122.225,2380,11643,6,12,2014,UNK,-250,200
6600400270,12/10/2014,202000.0,3,1.0,1010,9750,1.0,0.0,0.0,5,7,1010,0,1969,0,98042,47.3244,-122.14399999999999,1230,9750,12,10,2014,UNK,-220,0
624100990,9/29/2014,725000.0,4,3.0,2420,12000,1.0,0.0,0.0,3,9,2420,0,1984,0,98077,47.7267,-122.06299999999999,3100,13020,9,29,2014,UNK,-680,-1020
2424059139,2/6/2015,900000.0,3,3.25,3870,33980,2.0,0.0,0.0,3,10,3150,720,1991,0,98006,47.5589,-122.117,3590,10750,2,6,2015,UNK,280,23230
2883200875,2/6/2015,680200.0,2,1.5,1960,6000,1.0,0.0,0.0,3,8,1210,750,1951,0,98103,47.6849,-122.333,2060,6000,2,6,2015,UNK,-100,0
1917300105,4/14/2015,216500.0,3,1.0,1170,9000,1.0,0.0,0.0,4,6,1170,0,1918,0,98022,47.2109,-121.98700000000001,1280,8160,4,14,2015,UNK,-110,840
7203000200,12/12/2014,325000.0,3,1.5,1890,7650,1.0,0.0,0.0,5,7,1890,0,1966,0,98003,47.3454,-122.314,1510,7560,12,12,2014,UNK,380,90
9510971070,8/12/2014,675000.0,3,2.5,2250,4134,2.0,0.0,0.0,3,9,2250,0,2004,0,98052,47.6651,-122.084,2390,4134,8,12,2014,N,-140,0
3760500240,5/12/2015,435000.0,2,0.75,750,16321,1.0,0.0,1.0,3,4,750,0,1936,0,98034,47.6985,-122.229,3020,10625,5,12,2015,UNK,-2270,5696
4068300160,1/22/2015,263500.0,3,1.75,1610,14000,1.0,0.0,0.0,4,7,1050,560,1977,0,98010,47.3429,-122.036,1550,10080,1,22,2015,UNK,60,3920
1774220070,5/7/2015,550000.0,4,2.25,2590,36256,2.0,0.0,0.0,3,8,2590,0,1978,0,98077,47.769,-122.094,2670,35657,5,7,2015,UNK,-80,599
1563102685,4/22/2015,875000.0,3,2.5,2520,3750,2.0,0.0,1.0,4,9,2520,0,1995,0,98116,47.5671,-122.404,2250,6200,4,22,2015,UNK,270,-2450
395800370,4/11/2015,246600.0,4,1.0,1340,8400,1.0,0.0,0.0,5,7,1340,0,1966,0,98023,47.3313,-122.34299999999999,1120,8400,4,11,2015,UNK,220,0
3918400013,7/1/2014,337000.0,3,2.25,1460,941,3.0,0.0,0.0,3,8,1460,0,2006,0,98133,47.7145,-122.35600000000001,1490,1399,7,1,2014,N,-30,-458
1545804820,11/11/2014,240000.0,3,1.75,1380,7500,1.0,0.0,0.0,3,7,1380,0,1988,0,98038,47.3628,-122.045,1530,7500,11,11,2014,UNK,-150,0
7811220070,9/10/2014,490000.0,3,1.75,1510,11120,1.0,0.0,0.0,4,8,1510,0,1984,0,98005,47.5931,-122.15799999999999,2660,10800,9,10,2014,UNK,-1150,320
5561100431,8/6/2014,510000.0,5,2.5,2510,83231,1.0,0.0,0.0,4,7,1260,1250,1975,0,98027,47.4576,-121.984,2460,46431,8,6,2014,UNK,50,36800
5145100310,3/7/2015,305000.0,3,1.0,910,8008,1.0,0.0,0.0,3,7,910,0,1971,0,98034,47.726000000000006,-122.22,1480,7404,3,7,2015,UNK,-570,604
255550270,4/3/2015,350000.0,3,2.5,1970,3655,2.0,0.0,0.0,3,7,1970,0,2003,0,98019,47.7453,-121.984,1970,2952,4,3,2015,UNK,0,703
1123049129,2/24/2015,284200.0,3,1.75,1540,6632,1.0,0.0,0.0,3,7,1070,470,1959,0,98178,47.4973,-122.25200000000001,2510,6618,2,24,2015,UNK,-970,14
9407150310,1/28/2015,357000.0,4,2.5,1980,9757,2.0,0.0,0.0,5,7,1980,0,1995,0,98038,47.3675,-122.01899999999999,1610,6147,1,28,2015,UNK,370,3610
7732501000,6/17/2014,854000.0,4,2.75,3150,38865,1.0,0.0,0.0,3,10,2480,670,1986,0,98052,47.7302,-122.10600000000001,3150,35880,6,17,2014,UNK,0,2985
1024069205,1/14/2015,1180000.0,4,2.5,4700,49658,2.0,0.0,0.0,3,10,4700,0,1999,0,98075,47.5878,-122.022,2870,49658,1,14,2015,UNK,1830,0
5426300060,10/8/2014,1000000.0,3,2.25,2300,15952,1.0,0.0,0.0,4,8,1150,1150,1963,0,98039,47.6322,-122.23200000000001,2200,14284,10,8,2014,UNK,100,1668
3797000400,11/25/2014,616500.0,4,2.25,1880,3000,2.0,0.0,0.0,3,8,1760,120,1909,1977,98103,47.6864,-122.34899999999999,1880,3000,11,25,2014,Y,0,0
2877102196,11/25/2014,750000.0,4,2.75,2640,3750,2.0,0.0,0.0,5,7,1840,800,1911,0,98117,47.6783,-122.363,1690,5000,11,25,2014,UNK,950,-1250
9265200060,10/7/2014,650000.0,6,4.5,3900,9100,2.0,0.0,0.0,3,8,2870,1030,1979,0,98052,47.6612,-122.137,2080,9216,10,7,2014,UNK,1820,-116
2894700270,7/15/2014,275000.0,4,2.25,2670,10050,1.0,0.0,0.0,4,8,1420,1250,1962,0,98032,47.3792,-122.28,2190,10050,7,15,2014,UNK,480,0
2862100260,10/3/2014,540000.0,4,1.75,1840,4280,1.0,0.0,0.0,4,7,920,920,1918,0,98105,47.6681,-122.32,1660,4280,10,3,2014,UNK,180,0
2730000070,8/14/2014,225000.0,3,1.0,1120,10665,1.0,0.0,0.0,4,6,1120,0,1961,0,98001,47.2886,-122.274,1240,10639,8,14,2014,UNK,-120,26
4139400060,4/9/2015,845000.0,4,2.5,2970,9072,2.0,0.0,0.0,3,10,2970,0,1991,0,98006,47.562,-122.11399999999999,2740,8729,4,9,2015,UNK,230,343
4365200520,3/12/2015,490000.0,3,2.25,1410,7740,1.0,0.0,0.0,5,6,1410,0,1923,0,98126,47.523,-122.37100000000001,1220,7740,3,12,2015,UNK,190,0
3629980350,12/9/2014,753000.0,4,2.5,3060,8167,2.0,0.0,0.0,3,9,3060,0,2005,0,98029,47.5521,-121.98899999999999,2930,4800,12,9,2014,N,130,3367
3211600140,2/9/2015,475000.0,3,1.75,2490,7210,1.0,0.0,0.0,3,7,1290,0,1972,0,98034,47.726000000000006,-122.198,1610,7210,2,9,2015,UNK,880,0
3598600049,10/3/2014,124000.0,1,0.75,840,7203,1.5,0.0,0.0,3,6,840,0,1949,0,98168,47.4756,-122.301,1560,8603,10,3,2014,UNK,-720,-1400
3598600049,4/24/2015,224000.0,1,0.75,840,7203,1.5,0.0,0.0,3,6,840,0,1949,0,98168,47.4756,-122.301,1560,8603,4,24,2015,UNK,-720,-1400
1232001070,8/14/2014,485000.0,2,1.0,1130,3800,1.0,0.0,0.0,4,7,1130,0,1916,0,98117,47.6862,-122.37799999999999,1470,3800,8,14,2014,UNK,-340,0
7812801925,6/24/2014,230000.0,4,1.75,1850,6000,1.0,0.0,0.0,4,6,1270,580,1944,0,98178,47.4923,-122.24700000000001,1270,6600,6,24,2014,UNK,580,-600
522059062,11/5/2014,372000.0,4,2.75,2330,14175,1.0,0.0,0.0,3,7,1800,530,1980,0,98031,47.4193,-122.194,1480,10125,11,5,2014,UNK,850,4050
4178500640,5/7/2015,306000.0,4,2.5,1880,9426,2.0,0.0,0.0,4,7,1880,0,1990,0,98042,47.3584,-122.089,1760,7040,5,7,2015,UNK,120,2386
9528104660,8/27/2014,905000.0,4,3.5,2980,3000,2.0,0.0,0.0,3,9,2340,640,2008,0,98115,47.6768,-122.32600000000001,1810,4545,8,27,2014,N,1170,-1545
5013500400,3/26/2015,440000.0,4,1.0,1440,6678,1.0,0.0,0.0,3,7,1040,400,1950,0,98116,47.57100000000001,-122.39200000000001,1320,6678,3,26,2015,UNK,120,0
2550820060,4/28/2015,280000.0,3,1.75,1630,10001,1.0,0.0,0.0,4,7,1100,530,1977,0,98042,47.3605,-122.12,1630,10001,4,28,2015,UNK,0,0
425079046,7/29/2014,435000.0,3,2.5,1778,147823,2.0,0.0,0.0,3,7,1778,0,1999,0,98014,47.6811,-121.915,2840,43676,7,29,2014,UNK,-1062,104147
3905050240,6/24/2014,425000.0,3,2.5,1930,4500,2.0,0.0,0.0,3,8,1930,0,1990,0,98029,47.5791,-122.001,1770,4500,6,24,2014,UNK,160,0
5381000070,8/26/2014,204950.0,2,0.75,1130,11429,1.0,0.0,0.0,3,7,1130,0,1956,0,98188,47.4526,-122.28399999999999,1550,10700,8,26,2014,UNK,-420,729
1245002445,7/14/2014,670000.0,2,1.75,1650,7500,1.0,0.0,0.0,4,7,1000,650,1959,0,98033,47.6871,-122.20700000000001,2530,9000,7,14,2014,UNK,-880,-1500
6865200831,5/7/2014,475000.0,2,1.0,820,2723,1.0,0.0,0.0,3,7,820,0,1921,0,98103,47.6623,-122.339,1370,3850,5,7,2014,UNK,-550,-1127
1446801000,3/20/2015,352000.0,5,2.5,2900,6650,1.0,0.0,0.0,3,7,1450,1450,1964,0,98168,47.4935,-122.33200000000001,1600,8246,3,20,2015,UNK,1300,-1596
4038700830,4/9/2015,575000.0,4,1.75,2330,8800,1.0,0.0,2.0,4,7,1260,1070,1961,0,98008,47.6148,-122.113,2270,8800,4,9,2015,UNK,60,0
4094800260,11/26/2014,1730000.0,4,3.5,4440,20668,2.0,0.0,2.0,5,10,3240,1200,1965,0,98040,47.5472,-122.235,4240,18650,11,26,2014,UNK,200,2018
2742100152,10/13/2014,491000.0,3,2.0,1660,5070,2.0,0.0,3.0,3,8,1660,0,1950,0,98108,47.5552,-122.296,2440,6664,10,13,2014,UNK,-780,-1594
8691410060,7/9/2014,750000.0,4,2.5,3020,7465,2.0,0.0,0.0,3,9,3020,0,2004,0,98075,47.5982,-121.98,3100,5587,7,9,2014,N,-80,1878
1325059083,5/27/2014,830000.0,4,2.5,1850,50662,1.0,0.0,0.0,3,8,1430,420,1978,0,98052,47.6535,-122.119,2090,10599,5,27,2014,UNK,-240,40063
7852011070,1/9/2015,1140000.0,6,3.75,5960,20197,2.0,0.0,4.0,3,10,3900,2060,2005,0,98065,47.5398,-121.869,3860,12800,1,9,2015,N,2100,7397
2323059074,7/9/2014,137124.0,3,1.0,960,27442,1.0,0.0,0.0,4,6,960,0,1970,0,98058,47.4676,-122.134,1100,29019,7,9,2014,UNK,-140,-1577
7950304075,8/13/2014,225000.0,4,1.0,1150,6000,1.5,0.0,0.0,3,6,1150,0,1907,0,98118,47.562,-122.28299999999999,840,3030,8,13,2014,UNK,310,2970
3260000340,6/22/2014,732600.0,4,2.5,2130,7300,1.0,0.0,0.0,4,7,1230,900,1963,0,98005,47.605,-122.167,2130,7560,6,22,2014,UNK,0,-260
9552701000,3/16/2015,818000.0,4,2.25,2460,8001,2.0,0.0,0.0,4,8,2460,0,1984,0,98006,47.548,-122.154,2460,9126,3,16,2015,UNK,0,-1125
5469501200,8/20/2014,431000.0,3,2.25,2360,14950,1.0,0.0,0.0,4,9,2360,0,1978,0,98042,47.3856,-122.15799999999999,2720,14388,8,20,2014,UNK,-360,562
6300500105,10/2/2014,304000.0,2,2.25,1320,1034,3.0,0.0,0.0,3,7,1320,0,1996,0,98133,47.7039,-122.344,1330,1206,10,2,2014,UNK,-10,-172
4400200060,10/21/2014,650000.0,5,2.0,1910,4667,1.0,0.0,0.0,3,7,1010,900,1908,0,98112,47.6236,-122.306,1230,2545,10,21,2014,UNK,680,2122
5422560860,4/10/2015,450000.0,2,2.0,1610,6160,2.0,0.0,0.0,4,8,1610,0,1977,0,98052,47.6644,-122.13,1750,6305,4,10,2015,UNK,-140,-145
7789000260,8/22/2014,269000.0,4,1.0,1610,8401,1.0,0.0,0.0,3,7,1610,0,1958,0,98056,47.5104,-122.165,1610,8401,8,22,2014,UNK,0,0
8861000060,12/31/2014,875000.0,3,1.0,1160,10732,1.0,0.0,0.0,3,7,1160,0,1953,0,98004,47.6391,-122.205,2390,13656,12,31,2014,UNK,-1230,-2924
9350900550,4/29/2015,890000.0,4,2.25,2870,8393,1.0,0.0,0.0,4,8,1480,1390,1977,0,98040,47.5787,-122.245,2930,9850,4,29,2015,UNK,-60,-1457
9560800310,10/9/2014,565000.0,4,2.5,2280,9725,2.0,0.0,0.0,3,8,2280,0,1986,0,98072,47.7568,-122.141,2140,8780,10,9,2014,UNK,140,945
9187200228,3/13/2015,448175.0,2,2.0,1370,1339,2.0,0.0,0.0,4,8,1150,220,2006,0,98122,47.6021,-122.295,1370,1339,3,13,2015,N,0,0
7215730070,9/11/2014,680000.0,5,3.0,2970,6500,2.0,0.0,0.0,3,9,2970,0,2000,0,98075,47.5973,-122.01799999999999,2970,6588,9,11,2014,UNK,0,-88
121039083,2/6/2015,629000.0,3,1.75,1460,12367,2.0,1.0,4.0,4,8,1120,340,1970,0,98023,47.3311,-122.375,1970,18893,2,6,2015,UNK,-510,-6526
2770601677,4/22/2015,494000.0,3,3.5,1570,1486,2.5,0.0,0.0,3,8,1330,240,2000,0,98199,47.652,-122.384,1610,1486,4,22,2015,UNK,-40,0
3720800070,1/27/2015,1100000.0,4,3.0,2880,5500,2.0,0.0,0.0,4,9,1920,960,1926,0,98102,47.6448,-122.31700000000001,2110,5500,1,27,2015,UNK,770,0
3558910570,1/16/2015,450000.0,5,2.5,1900,9460,1.0,0.0,0.0,3,7,1190,710,1969,0,98034,47.7096,-122.20200000000001,1940,8360,1,16,2015,UNK,-40,1100
1081300390,10/30/2014,330000.0,3,1.75,2020,11050,1.0,0.0,0.0,4,8,1320,700,1969,0,98059,47.4706,-122.119,1940,11050,10,30,2014,UNK,80,0
7805450560,8/20/2014,960000.0,4,2.5,3110,11397,2.0,0.0,3.0,4,10,3110,0,1984,0,98006,47.5623,-122.10600000000001,3110,11586,8,20,2014,UNK,0,-189
6648770240,12/24/2014,360000.0,4,2.5,2390,7056,2.0,0.0,0.0,3,9,2390,0,1990,0,98001,47.3385,-122.264,2590,7801,12,24,2014,UNK,-200,-745
5104520810,8/10/2014,378000.0,3,2.5,2150,11672,2.0,0.0,0.0,3,8,2150,0,2004,0,98038,47.3515,-122.006,2150,5450,8,10,2014,N,0,6222
2719100400,9/12/2014,499950.0,3,1.75,1340,6250,1.0,0.0,0.0,4,7,1090,250,1941,0,98136,47.5427,-122.38600000000001,1550,1755,9,12,2014,UNK,-210,4495
255000320,7/24/2014,450000.0,3,2.5,1990,12866,2.0,0.0,0.0,4,7,1990,0,1986,0,98072,47.7477,-122.17,2310,8803,7,24,2014,UNK,-320,4063
5398600075,8/25/2014,523500.0,2,2.0,1600,5969,1.0,0.0,0.0,4,7,800,800,1950,0,98116,47.5691,-122.39399999999999,1520,5969,8,25,2014,UNK,80,0
7695470200,12/8/2014,600000.0,3,2.5,2680,43995,2.0,0.0,0.0,3,9,2680,0,1986,0,98077,47.7655,-122.086,2520,37277,12,8,2014,UNK,160,6718
6892510200,6/2/2014,290000.0,3,2.5,2080,4828,2.0,0.0,0.0,3,8,2080,0,2002,0,98042,47.3737,-122.132,2190,4620,6,2,2014,UNK,-110,208
4123800320,2/6/2015,176000.0,3,3.25,1340,5434,2.0,0.0,0.0,3,7,1340,0,1986,0,98038,47.3779,-122.045,1670,6203,2,6,2015,UNK,-330,-769
809001505,9/18/2014,885000.0,3,2.0,2590,3750,1.5,0.0,0.0,5,7,1790,800,1904,0,98109,47.635,-122.353,2440,4000,9,18,2014,UNK,150,-250
3856905185,6/24/2014,483000.0,2,1.75,1240,3000,1.5,0.0,0.0,3,7,1240,0,1906,0,98105,47.6689,-122.32600000000001,1800,4080,6,24,2014,UNK,-560,-1080
4051100390,5/8/2015,240000.0,3,1.0,1310,7125,1.0,0.0,0.0,4,7,1310,0,1978,0,98042,47.3739,-122.148,1650,7290,5,8,2015,UNK,-340,-165
579003240,9/25/2014,720000.0,4,2.25,2530,5200,1.0,0.0,1.0,4,8,1530,1000,1957,0,98117,47.6985,-122.382,2240,5200,9,25,2014,UNK,290,0
2333230060,11/5/2014,311000.0,4,2.5,1780,5822,2.0,0.0,0.0,3,7,1780,0,2001,0,98058,47.4455,-122.169,1990,4092,11,5,2014,UNK,-210,1730
7129303240,1/2/2015,332500.0,3,2.0,1600,7995,1.0,0.0,0.0,3,7,1600,0,1950,1984,98118,47.5177,-122.257,2440,6900,1,2,2015,Y,-840,1095
1219000473,6/26/2014,164950.0,3,1.75,1570,15330,1.0,0.0,0.0,3,7,1080,490,1956,0,98166,47.4608,-122.34,1250,13330,6,26,2014,UNK,320,2000
1219000473,3/23/2015,371000.0,3,1.75,1570,15330,1.0,0.0,0.0,3,7,1080,490,1956,0,98166,47.4608,-122.34,1250,13330,3,23,2015,UNK,320,2000
5469700060,1/23/2015,264500.0,3,1.75,1650,16200,1.0,0.0,0.0,3,7,1650,0,1976,0,98031,47.3926,-122.16799999999999,1650,8680,1,23,2015,UNK,0,7520
1118000935,7/5/2014,1740000.0,4,2.25,2920,6513,2.0,0.0,0.0,4,9,2260,660,1937,0,98112,47.63800000000001,-122.29,4510,9248,7,5,2014,UNK,-1590,-2735
8819900055,3/30/2015,503000.0,2,1.0,870,4280,1.0,0.0,2.0,4,6,870,0,1921,0,98105,47.6697,-122.29,1750,4280,3,30,2015,UNK,-880,0
1995200338,10/29/2014,738000.0,4,2.5,2830,5010,2.0,0.0,0.0,3,9,2170,660,2000,0,98115,47.6952,-122.32700000000001,1880,5739,10,29,2014,UNK,950,-729
91000320,9/23/2014,393000.0,2,1.0,980,3350,1.0,0.0,0.0,4,7,980,0,1925,0,98103,47.6858,-122.352,1260,4000,9,23,2014,UNK,-280,-650
8887001600,4/12/2015,280000.0,2,1.0,990,45528,1.0,0.0,0.0,4,7,990,0,1992,0,98070,47.5013,-122.463,1730,45528,4,12,2015,UNK,-740,0
7183000060,3/25/2015,260000.0,4,2.5,2360,9647,1.0,0.0,2.0,3,8,1530,830,1964,0,98003,47.3367,-122.33200000000001,2580,9680,3,25,2015,UNK,-220,-33
194000565,4/9/2015,505000.0,2,1.0,1000,4640,1.0,0.0,2.0,3,7,1000,0,1915,0,98116,47.5659,-122.389,1940,5800,4,9,2015,UNK,-940,-1160
3830610320,1/5/2015,241000.0,3,1.5,1660,8000,1.0,0.0,0.0,4,7,1120,540,1976,0,98030,47.353,-122.17200000000001,1900,7500,1,5,2015,UNK,-240,500
7922710320,3/16/2015,530000.0,3,1.75,1520,9605,1.0,0.0,0.0,3,7,1520,0,1975,0,98052,47.667,-122.14200000000001,2040,9900,3,16,2015,UNK,-520,-295
1231000310,8/12/2014,713000.0,1,1.0,1180,4000,1.5,0.0,2.0,4,8,840,340,1910,0,98118,47.5561,-122.266,1420,4000,8,12,2014,UNK,-240,0
173000140,7/22/2014,487000.0,3,1.75,1770,10125,2.0,0.0,0.0,3,7,1770,0,1944,0,98133,47.7289,-122.353,1680,9825,7,22,2014,UNK,90,300
8651411260,11/13/2014,128000.0,2,1.0,980,5393,1.0,0.0,0.0,3,6,980,0,1969,0,98042,47.3674,-122.081,980,5200,11,13,2014,UNK,0,193
7272000260,11/13/2014,210500.0,3,1.0,1840,10178,1.0,0.0,0.0,3,7,1040,800,1960,0,98198,47.3979,-122.31700000000001,2040,10660,11,13,2014,UNK,-200,-482
2787700060,1/15/2015,420000.0,3,2.5,1810,7210,1.0,0.0,0.0,5,7,1210,600,1968,0,98059,47.5067,-122.163,1770,7210,1,15,2015,UNK,40,0
5499700045,10/30/2014,679000.0,3,2.5,1780,4320,2.0,0.0,0.0,4,8,1780,0,1930,1986,98115,47.6809,-122.29299999999999,1690,4952,10,30,2014,Y,90,-632
9433000390,12/18/2014,784950.0,4,2.75,2840,4227,3.0,0.0,0.0,3,9,2840,0,2014,0,98052,47.7097,-122.10700000000001,2880,4227,12,18,2014,N,-40,0
7300400200,11/19/2014,352000.0,4,2.5,2650,6366,2.0,0.0,0.0,3,9,2650,0,1998,0,98092,47.3325,-122.171,2650,6200,11,19,2014,UNK,0,166
2771101963,6/11/2014,386000.0,3,1.5,1270,1318,2.0,0.0,0.0,3,7,1080,190,2004,0,98199,47.6526,-122.384,1360,1488,6,11,2014,N,-90,-170
123039346,4/30/2015,335000.0,3,1.75,1260,17000,1.0,0.0,0.0,3,7,1260,0,1994,0,98146,47.5114,-122.361,1540,7213,4,30,2015,UNK,-280,9787
524069116,6/2/2014,472500.0,3,2.0,1750,15500,1.0,0.0,0.0,3,7,1490,260,1982,0,98075,47.5887,-122.065,2450,50094,6,2,2014,UNK,-700,-34594
3583300075,11/3/2014,599950.0,5,2.25,2680,13292,1.0,0.0,0.0,3,8,1340,1340,1976,0,98028,47.7422,-122.257,2220,13181,11,3,2014,UNK,460,111
7203220030,7/24/2014,963990.0,4,3.25,3830,6765,2.0,0.0,0.0,3,9,3830,0,2014,0,98053,47.685,-122.016,3830,6507,7,24,2014,N,0,258
1250201550,9/25/2014,735000.0,3,2.0,1610,3600,2.0,0.0,2.0,5,8,1610,0,1925,0,98144,47.5969,-122.29299999999999,2540,6600,9,25,2014,UNK,-930,-3000
8651611260,3/17/2015,858450.0,3,4.25,3840,9751,2.0,0.0,0.0,3,10,3840,0,1998,0,98074,47.6347,-122.064,3230,7189,3,17,2015,UNK,610,2562
1797501275,5/7/2015,665000.0,5,2.75,2670,4000,2.0,0.0,0.0,4,7,1800,870,1914,0,98105,47.6711,-122.315,2460,4000,5,7,2015,UNK,210,0
2215900800,7/31/2014,290000.0,3,2.5,2000,7414,2.0,0.0,0.0,4,7,2000,0,1993,0,98038,47.3508,-122.057,2000,7414,7,31,2014,UNK,0,0
7883602650,4/13/2015,250000.0,2,1.0,860,4320,1.0,0.0,0.0,3,7,860,0,1925,0,98108,47.5263,-122.325,980,6000,4,13,2015,UNK,-120,-1680
3546000340,10/8/2014,192500.0,3,1.75,1420,7205,1.0,0.0,0.0,3,7,1420,0,1986,0,98030,47.3555,-122.175,1690,7405,10,8,2014,UNK,-270,-200
6118600045,8/25/2014,350000.0,4,2.0,2060,13400,1.0,0.0,2.0,4,8,2060,0,1957,0,98166,47.4404,-122.34,1950,10370,8,25,2014,UNK,110,3030
1123059116,3/19/2015,518000.0,4,2.5,2790,9910,2.0,0.0,0.0,3,8,2790,0,2003,0,98059,47.4891,-122.141,2590,9910,3,19,2015,UNK,200,0
124000160,7/1/2014,563000.0,4,1.0,1410,3376,1.5,0.0,0.0,5,7,1410,0,1911,0,98107,47.6606,-122.365,1040,3600,7,1,2014,UNK,370,-224
8733000045,10/7/2014,375000.0,4,3.0,2420,9566,2.0,0.0,0.0,3,7,2420,0,2003,0,98188,47.4693,-122.266,2420,9135,10,7,2014,UNK,0,431
263000327,2/27/2015,400000.0,3,2.5,1460,1319,3.0,0.0,0.0,3,8,1460,0,2002,0,98103,47.698,-122.34899999999999,1430,1530,2,27,2015,UNK,30,-211
5153200358,10/29/2014,240000.0,5,1.75,2460,16000,1.0,0.0,0.0,3,7,1230,1230,1957,0,98023,47.3305,-122.351,1990,16000,10,29,2014,UNK,470,0
2258500045,9/23/2014,317500.0,2,1.0,1000,5120,1.0,0.0,0.0,3,6,1000,0,1902,0,98122,47.6088,-122.307,1940,4300,9,23,2014,UNK,-940,820
6137500310,2/13/2015,1320000.0,5,4.0,4420,36342,2.0,0.0,0.0,5,10,2740,1680,1982,0,98007,47.6468,-122.15100000000001,3720,37034,2,13,2015,UNK,700,-692
3323069045,11/10/2014,234000.0,3,1.0,1240,239144,1.0,0.0,0.0,3,6,1240,0,1921,1992,98038,47.4303,-122.046,1990,109335,11,10,2014,Y,-750,129809
8563070030,5/13/2014,645000.0,3,2.5,1740,13750,2.0,0.0,0.0,4,9,1740,0,1975,0,98008,47.6264,-122.09200000000001,2540,14300,5,13,2014,UNK,-800,-550
425049036,3/9/2015,649000.0,2,1.0,1280,4840,1.0,0.0,0.0,3,7,1200,80,1908,0,98115,47.6762,-122.29899999999999,1860,5500,3,9,2015,UNK,-580,-660
8562750550,4/17/2015,605000.0,4,2.5,2520,3980,2.0,0.0,0.0,3,8,2520,0,2004,0,98027,47.5399,-122.07,2580,3980,4,17,2015,N,-60,0
767000159,8/21/2014,337900.0,3,3.5,1500,1471,3.0,0.0,0.0,3,7,1500,0,1999,0,98177,47.7034,-122.36200000000001,1500,1445,8,21,2014,UNK,0,26
5366200030,2/5/2015,535000.0,3,2.75,2490,3600,2.0,0.0,0.0,3,8,2290,200,1906,0,98122,47.6098,-122.292,1880,3600,2,5,2015,UNK,610,0
7857000861,9/22/2014,325000.0,4,1.0,1530,5684,1.0,0.0,0.0,3,7,1130,400,1957,0,98108,47.5507,-122.29799999999999,1540,6095,9,22,2014,UNK,-10,-411
1094000030,12/15/2014,429950.0,4,2.25,1740,10875,1.0,0.0,0.0,3,8,1740,0,1967,0,98059,47.5132,-122.15700000000001,1680,10701,12,15,2014,UNK,60,174
1853000030,4/16/2015,775000.0,3,2.5,3550,32807,2.0,0.0,0.0,3,9,3550,0,1989,0,98077,47.7292,-122.08200000000001,3270,35001,4,16,2015,UNK,280,-2194
5318101040,7/31/2014,650000.0,2,1.0,1280,6000,1.0,0.0,0.0,3,7,1280,0,1965,0,98112,47.6339,-122.28200000000001,2460,4800,7,31,2014,UNK,-1180,1200
3623500049,5/1/2015,1200000.0,4,2.25,2320,13114,2.0,0.0,0.0,5,8,2320,0,1967,0,98040,47.5762,-122.23899999999999,2740,15000,5,1,2015,UNK,-420,-1886
1026049036,9/10/2014,275000.0,2,1.0,1140,10404,1.0,0.0,0.0,3,5,1140,0,1935,0,98155,47.7497,-122.286,2200,11550,9,10,2014,UNK,-1060,-1146
8568030030,7/29/2014,575000.0,4,3.5,3930,16970,2.0,0.0,0.0,3,9,3930,0,1997,0,98019,47.7412,-121.96600000000001,2740,17219,7,29,2014,UNK,1190,-249
4022906531,8/6/2014,540000.0,3,2.5,2370,16455,1.0,0.0,0.0,5,7,1640,730,1959,0,98155,47.7634,-122.277,2170,15551,8,6,2014,UNK,200,904
5700002325,6/5/2014,640000.0,3,1.75,2340,4206,1.0,0.0,0.0,5,7,1170,1170,1917,0,98144,47.5759,-122.288,1360,4725,6,5,2014,UNK,980,-519
2473100510,9/23/2014,275000.0,3,1.5,1240,9125,1.0,0.0,0.0,4,7,1240,0,1967,0,98058,47.4469,-122.155,1670,9125,9,23,2014,UNK,-430,0
629811600,7/24/2014,672800.0,4,2.5,2740,10533,2.0,0.0,0.0,3,9,2740,0,1997,0,98074,47.6095,-122.006,2760,8603,7,24,2014,UNK,-20,1930
7923300310,5/27/2014,495000.0,4,2.25,1940,9144,1.0,0.0,0.0,4,7,1430,510,1956,0,98007,47.5942,-122.135,1460,9437,5,27,2014,UNK,480,-293
4054560140,9/26/2014,820000.0,3,2.5,2950,35108,1.5,0.0,0.0,3,10,2950,0,1995,0,98077,47.7316,-122.035,3810,35181,9,26,2014,UNK,-860,-73
4027700632,6/9/2014,475000.0,4,2.75,1980,11443,1.0,0.0,0.0,5,7,1980,0,1952,0,98155,47.7707,-122.273,2080,15700,6,9,2014,UNK,-100,-4257
2818100060,5/20/2014,1280000.0,4,2.0,2850,7861,1.0,0.0,4.0,4,10,1450,1400,1970,0,98117,47.6995,-122.397,2810,8087,5,20,2014,UNK,40,-226
1771000960,4/29/2015,380000.0,3,1.0,1160,9375,1.0,0.0,0.0,3,7,1160,0,1967,0,98077,47.7419,-122.073,1160,9650,4,29,2015,UNK,0,-275
2591830350,8/20/2014,397500.0,3,2.0,2130,8225,1.0,0.0,0.0,4,8,2130,0,1987,0,98058,47.4396,-122.162,2580,8225,8,20,2014,UNK,-450,0
8842400071,5/7/2014,352000.0,5,2.5,2420,8560,1.0,0.0,2.0,3,7,1620,800,1978,0,98118,47.532,-122.285,2210,7040,5,7,2014,UNK,210,1520
7856700060,4/13/2015,893880.0,6,2.5,2820,8600,1.0,0.0,0.0,5,8,1430,1390,1967,0,98006,47.565,-122.14399999999999,2070,8900,4,13,2015,UNK,750,-300
9186300060,9/16/2014,635000.0,5,3.25,3710,34200,2.0,0.0,0.0,3,8,2510,1200,1986,0,98074,47.6101,-122.04700000000001,1720,23100,9,16,2014,UNK,1990,11100
3275740030,5/7/2014,420000.0,3,2.25,1770,8165,2.0,0.0,0.0,3,7,1770,0,1977,0,98034,47.7166,-122.236,1650,8165,5,7,2014,UNK,120,0
452001860,3/21/2015,503000.0,3,2.0,1260,2500,1.0,0.0,0.0,4,7,750,510,1987,0,98107,47.6748,-122.37100000000001,1710,5000,3,21,2015,UNK,-450,-2500
7779200075,9/9/2014,689000.0,2,1.75,2330,10143,1.0,0.0,2.0,4,7,1220,1110,1953,0,98146,47.4899,-122.359,2560,9750,9,9,2014,UNK,-230,393
3975400260,9/2/2014,749500.0,4,2.75,2490,3840,1.5,0.0,0.0,4,7,1610,880,1922,0,98103,47.6551,-122.344,1420,4000,9,2,2014,UNK,1070,-160
2225059336,10/6/2014,1150000.0,6,3.75,4090,49542,2.0,0.0,0.0,3,9,3100,990,1984,0,98005,47.6408,-122.15299999999999,2980,43357,10,6,2014,UNK,1110,6185
8567450060,6/9/2014,563500.0,4,2.5,2800,12831,2.0,0.0,0.0,3,8,2800,0,2001,0,98019,47.7392,-121.96600000000001,2810,10235,6,9,2014,UNK,-10,2596
6178930340,6/30/2014,480000.0,4,3.0,2440,9664,2.0,0.0,0.0,3,8,1890,550,1981,0,98028,47.7649,-122.25299999999999,2380,9609,6,30,2014,UNK,60,55
8731990370,4/22/2015,374950.0,4,3.0,2540,8800,1.0,0.0,1.0,3,9,1620,920,1977,0,98023,47.3204,-122.387,2540,8800,4,22,2015,UNK,0,0
9407150350,4/10/2015,308950.0,3,2.5,1600,6250,2.0,0.0,0.0,3,7,1600,0,1995,0,98038,47.3675,-122.02,1760,6110,4,10,2015,UNK,-160,140
3438502200,9/17/2014,445000.0,4,2.75,2680,16934,1.0,0.0,0.0,4,7,1340,1340,1958,0,98106,47.542,-122.36399999999999,1240,7000,9,17,2014,UNK,1440,9934
1274500700,4/21/2015,237200.0,3,1.5,1220,9000,1.0,0.0,0.0,4,7,1220,0,1968,0,98042,47.3642,-122.109,1220,9472,4,21,2015,UNK,0,-472
5667100045,9/2/2014,453500.0,3,1.75,1550,7270,1.5,0.0,0.0,5,7,1550,0,1953,0,98125,47.72,-122.31700000000001,1050,7210,9,2,2014,UNK,500,60
2887700560,5/7/2015,616500.0,3,2.0,2080,4549,1.0,0.0,0.0,5,7,1040,1040,1954,0,98115,47.6886,-122.309,1620,4549,5,7,2015,UNK,460,0
7215720070,8/6/2014,1250000.0,5,5.0,5000,32909,2.0,0.0,0.0,3,10,5000,0,2000,0,98075,47.6012,-122.022,3030,12601,8,6,2014,UNK,1970,20308
6638900550,4/7/2015,396000.0,1,1.0,630,5150,1.0,0.0,0.0,4,5,630,0,1954,0,98117,47.6923,-122.369,1390,5150,4,7,2015,UNK,-760,0
723049307,7/8/2014,210000.0,3,1.0,1070,8179,1.0,0.0,0.0,3,6,1070,0,1949,0,98146,47.5015,-122.34899999999999,1050,8177,7,8,2014,UNK,20,2
7577700521,10/1/2014,539000.0,2,1.75,1900,5175,1.0,0.0,0.0,3,7,1200,700,1919,0,98116,47.5689,-122.38600000000001,1370,5175,10,1,2014,UNK,530,0
7888700030,8/25/2014,605000.0,3,2.5,2960,18600,2.0,0.0,0.0,3,8,2960,0,1979,0,98166,47.4358,-122.344,2740,15681,8,25,2014,UNK,220,2919
3501600135,7/7/2014,437500.0,3,2.0,1490,4800,2.0,0.0,0.0,5,6,1490,0,1948,0,98117,47.6933,-122.361,1500,4800,7,7,2014,UNK,-10,0
1822059331,7/16/2014,215000.0,3,1.5,1500,15000,1.0,0.0,0.0,3,7,1500,0,1952,0,98031,47.3926,-122.208,1790,13905,7,16,2014,UNK,-290,1095
7852030310,6/18/2014,440000.0,4,2.5,2410,4780,2.0,0.0,0.0,3,7,2410,0,2000,0,98065,47.5326,-121.87899999999999,2410,4025,6,18,2014,UNK,0,755
8901001090,11/17/2014,525000.0,3,1.0,2000,22500,1.0,0.0,0.0,3,7,1680,320,1939,0,98125,47.71100000000001,-122.30799999999999,2000,10000,11,17,2014,UNK,0,12500
192450200,8/21/2014,319900.0,3,1.5,1140,20383,1.0,0.0,0.0,3,7,840,300,1985,0,98045,47.4755,-121.758,1200,15625,8,21,2014,UNK,-60,4758
1771100030,1/6/2015,335000.0,3,1.0,1120,9075,1.0,0.0,0.0,3,7,1120,0,1977,0,98077,47.7551,-122.072,1120,9705,1,6,2015,UNK,0,-630
1560920370,11/7/2014,485000.0,3,2.25,2900,35273,2.0,0.0,0.0,3,9,2900,0,1986,0,98038,47.4013,-122.03,2510,38487,11,7,2014,UNK,390,-3214
8731981360,9/25/2014,359999.0,4,2.25,3220,7700,2.0,0.0,0.0,4,8,3220,0,1976,0,98023,47.3188,-122.38,2570,7700,9,25,2014,UNK,650,0
9541600060,8/7/2014,799000.0,5,2.75,2500,19783,1.0,0.0,3.0,4,8,2500,0,1959,0,98005,47.5938,-122.17399999999999,1700,15375,8,7,2014,UNK,800,4408
2923049468,9/12/2014,280000.0,3,2.25,1610,10454,1.0,0.0,0.0,3,7,1610,0,1977,0,98148,47.4517,-122.331,1720,9583,9,12,2014,UNK,-110,871
8722100810,7/8/2014,1050000.0,4,2.75,2250,3433,1.5,0.0,0.0,3,8,1500,750,1927,2013,98112,47.6382,-122.307,1970,3484,7,8,2014,Y,280,-51
7840800135,11/19/2014,290000.0,1,2.0,1240,4800,2.0,0.0,0.0,3,6,1240,0,1910,0,98055,47.4778,-122.211,1030,4800,11,19,2014,UNK,210,0
8083350070,12/17/2014,235000.0,2,2.25,1660,2748,2.0,0.0,0.0,3,7,1660,0,1995,0,98055,47.4333,-122.212,1620,3167,12,17,2014,UNK,40,-419
1923800135,10/1/2014,495000.0,3,1.75,2080,3000,1.0,0.0,0.0,4,7,1040,1040,1925,0,98103,47.6853,-122.35,1000,3193,10,1,2014,UNK,1080,-193
1310980070,2/24/2015,290000.0,3,2.25,1880,7488,2.0,0.0,0.0,3,8,1880,0,1980,0,98032,47.3631,-122.277,2180,7344,2,24,2015,UNK,-300,144
3110800030,10/28/2014,230000.0,4,1.5,1050,9516,1.0,0.0,0.0,4,7,1050,0,1969,0,98031,47.4151,-122.181,1390,9600,10,28,2014,UNK,-340,-84
8731801260,2/20/2015,234000.0,3,1.75,1480,8475,1.0,0.0,0.0,4,7,1480,0,1968,0,98023,47.3126,-122.361,1800,8800,2,20,2015,UNK,-320,-325
7202270700,10/3/2014,597400.0,4,2.5,2420,4500,2.0,0.0,0.0,3,7,2420,0,2001,0,98053,47.6874,-122.037,2280,4500,10,3,2014,UNK,140,0
7230300060,8/5/2014,370000.0,4,2.5,2190,17600,1.0,0.0,0.0,4,7,1110,1080,1966,0,98059,47.4712,-122.11200000000001,1820,17600,8,5,2014,UNK,370,0
11510700,5/19/2014,755000.0,4,2.5,2660,10452,2.0,0.0,0.0,3,9,2660,0,1993,0,98052,47.6972,-122.104,2890,9025,5,19,2014,UNK,-230,1427
586470350,4/3/2015,342000.0,3,2.5,2430,5715,2.0,0.0,0.0,3,7,2430,0,1999,0,98030,47.3718,-122.16799999999999,3040,5702,4,3,2015,UNK,-610,13
6840700036,7/28/2014,497000.0,2,1.0,770,3325,1.0,0.0,0.0,3,7,770,0,1918,0,98122,47.6102,-122.29899999999999,960,4800,7,28,2014,UNK,-190,-1475
1824069083,4/29/2015,835000.0,3,1.0,3060,30166,1.0,0.0,0.0,5,8,3060,0,1959,0,98027,47.5656,-122.09299999999999,1880,19602,4,29,2015,UNK,1180,10564
1836980240,10/15/2014,730000.0,4,2.75,2920,4500,2.0,0.0,0.0,3,9,2920,0,1999,0,98006,47.5646,-122.124,2920,4505,10,15,2014,UNK,0,-5
3528900160,10/1/2014,655000.0,3,1.0,1370,5250,1.0,0.0,0.0,3,7,1070,300,1939,0,98109,47.6421,-122.348,2410,4200,10,1,2014,UNK,-1040,1050
1442800060,11/20/2014,205000.0,3,2.5,1870,3118,2.0,0.0,0.0,3,8,1870,0,1993,0,98038,47.3739,-122.056,1580,3601,11,20,2014,UNK,290,-483
8722100030,4/7/2015,632750.0,4,2.0,1800,4800,1.5,0.0,0.0,3,7,1800,0,1918,0,98112,47.6388,-122.302,1950,4800,4,7,2015,UNK,-150,0
1723049624,5/12/2014,330000.0,5,3.0,2100,7715,1.0,0.0,0.0,3,7,1250,850,2013,0,98168,47.4866,-122.319,2100,7959,5,12,2014,N,0,-244
4040400200,10/7/2014,527500.0,5,2.25,2530,8250,2.0,0.0,0.0,4,7,2530,0,1961,0,98007,47.6117,-122.134,2020,8250,10,7,2014,UNK,510,0
8691391090,5/8/2014,716500.0,4,2.5,3290,6465,2.0,0.0,0.0,3,9,3290,0,2002,0,98075,47.5981,-121.976,3100,5929,5,8,2014,UNK,190,536
7853302190,12/17/2014,388500.0,4,2.5,1890,5395,2.0,0.0,0.0,3,7,1890,0,2006,0,98065,47.5415,-121.883,2060,5395,12,17,2014,N,-170,0
3260000700,9/4/2014,530000.0,3,1.75,1680,7770,1.0,0.0,0.0,4,7,1680,0,1967,0,98005,47.6028,-122.167,1880,7770,9,4,2014,UNK,-200,0
5126300510,1/8/2015,419000.0,3,2.5,2170,4517,2.0,0.0,0.0,3,8,2170,0,2002,0,98059,47.4819,-122.14,2610,4770,1,8,2015,UNK,-440,-253
7199330370,3/9/2015,385000.0,3,1.75,1200,7360,1.0,0.0,0.0,4,7,1200,0,1978,0,98052,47.6979,-122.13,1200,7500,3,9,2015,UNK,0,-140
1854900240,5/28/2014,655000.0,4,2.5,2990,5669,2.0,0.0,0.0,3,8,2990,0,2003,0,98074,47.6119,-122.01100000000001,3110,5058,5,28,2014,UNK,-120,611
6738700335,7/1/2014,1700000.0,4,2.75,3770,10900,2.0,0.0,2.0,5,9,3070,700,1924,0,98144,47.5849,-122.29,3000,5000,7,1,2014,UNK,770,5900
322059264,9/26/2014,279000.0,2,1.0,1020,47044,1.0,0.0,0.0,5,7,1020,0,1904,0,98042,47.4206,-122.155,1930,12139,9,26,2014,UNK,-910,34905
5557500270,2/9/2015,262000.0,3,1.5,1700,9579,1.0,0.0,0.0,4,7,1100,600,1962,0,98023,47.3209,-122.338,1700,9628,2,9,2015,UNK,0,-49
9164100125,8/7/2014,533000.0,4,1.0,1550,4750,1.5,0.0,0.0,3,7,1550,0,1919,0,98117,47.6824,-122.389,1320,4750,8,7,2014,UNK,230,0
7370600045,4/2/2015,640000.0,3,1.75,1680,8100,1.0,0.0,2.0,3,8,1680,0,1950,0,98177,47.7212,-122.36399999999999,1880,7750,4,2,2015,UNK,-200,350
8594400060,6/9/2014,285000.0,3,2.25,1680,35127,2.0,0.0,0.0,3,7,1680,0,1987,0,98092,47.3025,-122.06700000000001,1820,35166,6,9,2014,UNK,-140,-39
7818900060,7/8/2014,458400.0,4,2.5,1910,10300,1.0,0.0,0.0,3,8,1910,0,1921,0,98177,47.7581,-122.359,1910,7750,7,8,2014,UNK,0,2550
2126059139,3/18/2015,620000.0,5,3.25,3160,10587,1.0,0.0,0.0,5,7,2190,970,1960,0,98034,47.7238,-122.165,2200,7761,3,18,2015,UNK,960,2826
1759701600,5/12/2014,465000.0,3,1.5,2020,11358,1.0,0.0,0.0,4,6,1190,830,1956,0,98033,47.6641,-122.185,2370,9520,5,12,2014,UNK,-350,1838
1795920310,8/4/2014,690000.0,4,3.75,3210,7054,2.0,0.0,0.0,4,8,3210,0,1985,0,98052,47.7268,-122.103,2350,8020,8,4,2014,UNK,860,-966
1626069139,8/21/2014,462500.0,3,2.25,2350,51400,1.0,0.0,0.0,3,7,1390,960,1977,0,98077,47.7417,-122.053,2350,51400,8,21,2014,UNK,0,0
3303951600,8/20/2014,369950.0,4,2.5,1910,10221,2.0,0.0,0.0,3,8,1910,0,1994,0,98038,47.381,-122.035,2210,8705,8,20,2014,UNK,-300,1516
3353402400,3/26/2015,124500.0,2,1.0,840,6480,1.0,0.0,0.0,4,5,840,0,1954,0,98001,47.263999999999996,-122.258,1100,7300,3,26,2015,UNK,-260,-820
2332700060,8/6/2014,950000.0,4,2.25,2620,10920,1.0,0.0,0.0,3,9,2620,0,1965,0,98005,47.6117,-122.164,2370,11907,8,6,2014,UNK,250,-987
4040800260,6/16/2014,418000.0,4,1.5,1220,10580,1.0,0.0,0.0,3,7,1220,0,1965,0,98008,47.6205,-122.116,1350,7800,6,16,2014,UNK,-130,2780
1202000140,12/10/2014,160000.0,3,1.0,1060,8000,1.0,0.0,0.0,4,6,1060,0,1927,0,98002,47.305,-122.21799999999999,1060,4697,12,10,2014,UNK,0,3303
4022902050,4/15/2015,457000.0,4,2.5,2200,10800,1.0,0.0,0.0,3,8,1500,700,1964,0,98155,47.7711,-122.288,2280,10800,4,15,2015,UNK,-80,0
4364200125,1/29/2015,530000.0,2,1.75,2120,7680,1.0,0.0,0.0,5,6,1130,990,1948,0,98126,47.5304,-122.374,1220,7680,1,29,2015,UNK,900,0
4036801245,5/22/2014,385000.0,3,1.0,1250,7300,1.0,0.0,0.0,4,7,1250,0,1956,0,98008,47.6032,-122.125,1540,7400,5,22,2014,UNK,-290,-100
7375100070,3/18/2015,491000.0,3,1.75,1440,7800,1.0,0.0,0.0,4,7,1440,0,1958,0,98008,47.5996,-122.12,1440,7800,3,18,2015,UNK,0,0
686400060,8/20/2014,521000.0,4,2.25,1890,8034,1.0,0.0,0.0,4,8,1890,0,1967,0,98008,47.6338,-122.117,1920,7210,8,20,2014,UNK,-30,824
1645000710,4/10/2015,255000.0,3,1.0,1140,8528,1.0,0.0,0.0,5,7,1140,0,1967,0,98022,47.2098,-122.00399999999999,1140,8112,4,10,2015,UNK,0,416
5476800069,5/27/2014,292050.0,5,3.0,2840,7199,1.0,0.0,0.0,3,7,1710,1130,2003,0,98178,47.5065,-122.275,2210,10800,5,27,2014,UNK,630,-3601
823059185,5/20/2014,326000.0,6,3.0,1880,7200,1.0,0.0,0.0,4,7,1880,0,1966,0,98056,47.5029,-122.18799999999999,1540,13022,5,20,2014,UNK,340,-5822
4364200075,6/24/2014,300000.0,2,1.0,750,5120,1.0,0.0,0.0,4,6,750,0,1941,0,98126,47.5312,-122.375,930,7200,6,24,2014,UNK,-180,-2080
2473420070,4/30/2015,291600.0,3,1.75,1630,7480,1.0,0.0,0.0,3,7,1330,300,1979,0,98058,47.4514,-122.15899999999999,1940,7480,4,30,2015,UNK,-310,0
5706201360,2/19/2015,435000.0,5,1.5,1720,12551,1.0,0.0,0.0,3,7,1720,0,1967,0,98027,47.5241,-122.053,1560,12960,2,19,2015,UNK,160,-409
4442800012,12/18/2014,465000.0,3,2.5,1600,1311,3.0,0.0,0.0,3,8,1600,0,2005,0,98117,47.6903,-122.39399999999999,1390,1321,12,18,2014,N,210,-10
3339900640,6/20/2014,200000.0,3,2.25,1230,7420,1.5,0.0,0.0,5,7,1230,0,1913,0,98002,47.3184,-122.22,1260,7556,6,20,2014,UNK,-30,-136
425400070,7/17/2014,238000.0,3,1.5,1610,6132,1.0,0.0,2.0,4,7,1090,520,1959,0,98056,47.5017,-122.17399999999999,1650,6132,7,17,2014,UNK,-40,0
4036800370,11/3/2014,455000.0,4,2.5,1320,7000,1.0,0.0,0.0,4,7,1320,0,1956,0,98008,47.6007,-122.12700000000001,1550,8610,11,3,2014,UNK,-230,-1610
2412600070,10/30/2014,230000.0,6,3.0,2180,7220,2.0,0.0,0.0,3,7,2180,0,1980,0,98003,47.3046,-122.305,2260,7344,10,30,2014,UNK,-80,-124
8805900570,9/11/2014,808000.0,4,2.25,2190,4104,2.0,0.0,0.0,5,8,1410,780,1928,0,98112,47.6419,-122.306,1990,3860,9,11,2014,UNK,200,244
9178600810,12/17/2014,578500.0,3,1.0,1490,5700,1.5,0.0,0.0,3,7,1490,0,1916,0,98103,47.6549,-122.331,2290,5700,12,17,2014,UNK,-800,0
2979800764,6/5/2014,390000.0,3,2.0,1463,868,3.0,0.0,0.0,3,7,1463,0,2003,0,98115,47.6843,-122.31700000000001,1484,4320,6,5,2014,UNK,-21,-3452
3904980270,5/5/2015,517500.0,3,2.5,1800,3933,2.0,0.0,0.0,3,8,1800,0,1989,0,98029,47.5746,-122.009,1800,4659,5,5,2015,UNK,0,-726
6738700075,6/26/2014,755000.0,4,2.75,2880,4000,1.5,0.0,0.0,3,9,2100,780,1912,2000,98144,47.5843,-122.29299999999999,2110,4000,6,26,2014,Y,770,0
1646501920,10/30/2014,579500.0,3,1.75,1250,4120,1.0,0.0,0.0,4,7,980,270,1925,0,98117,47.685,-122.36,1250,4120,10,30,2014,UNK,0,0
2997800075,9/29/2014,649950.0,3,2.75,1670,1350,3.0,0.0,0.0,3,9,1350,320,2014,0,98116,47.5764,-122.40799999999999,1520,4800,9,29,2014,N,150,-3450
4440400125,5/8/2014,228000.0,4,1.75,2000,6120,1.0,0.0,0.0,3,7,1100,900,1965,0,98178,47.5035,-122.258,1880,6120,5,8,2014,UNK,120,0
3423600060,12/2/2014,665000.0,4,1.75,2280,3680,1.5,0.0,0.0,5,7,1470,810,1926,0,98115,47.6754,-122.3,1850,3680,12,2,2014,UNK,430,0
1523560030,3/25/2015,689000.0,4,2.5,2110,6069,2.0,0.0,0.0,3,9,2110,0,1999,0,98052,47.6374,-122.111,2180,9000,3,25,2015,UNK,-70,-2931
2896000710,10/22/2014,560000.0,4,2.5,2520,11240,1.0,0.0,0.0,3,8,1440,1080,1977,0,98052,47.6748,-122.14399999999999,2360,10345,10,22,2014,UNK,160,895
9238900060,5/29/2014,529000.0,3,1.0,1590,6420,1.0,0.0,0.0,3,7,1590,0,1944,0,98136,47.5355,-122.39200000000001,1780,5900,5,29,2014,UNK,-190,520
1081310060,1/8/2015,375000.0,5,2.5,2100,14858,1.0,0.0,0.0,5,8,2100,0,1970,0,98059,47.4721,-122.12299999999999,1980,11730,1,8,2015,UNK,120,3128
3256400060,9/23/2014,325000.0,4,2.75,2090,9240,1.0,0.0,0.0,4,6,2090,0,1949,0,98146,47.4854,-122.34299999999999,1460,9240,9,23,2014,UNK,630,0
8914200060,1/15/2015,583000.0,4,2.5,3390,10519,2.0,0.0,2.0,3,10,3390,0,1990,0,98003,47.332,-122.334,2830,10519,1,15,2015,UNK,560,0
732000160,4/29/2015,330000.0,2,1.0,790,9784,1.0,0.0,0.0,3,6,790,0,1932,0,98155,47.7634,-122.28399999999999,2350,10102,4,29,2015,UNK,-1560,-318
1592080060,4/17/2015,262000.0,3,2.5,1970,8727,2.0,0.0,0.0,3,7,1970,0,1995,0,98092,47.3263,-122.189,1670,9168,4,17,2015,UNK,300,-441
7852190320,3/13/2015,555000.0,4,2.5,2870,6776,2.0,0.0,0.0,3,8,2870,0,2004,0,98065,47.538999999999994,-121.87799999999999,2770,6658,3,13,2015,N,100,118
7950303270,3/2/2015,585000.0,2,1.0,1110,6000,1.0,0.0,0.0,3,7,1010,100,1951,0,98118,47.5632,-122.28200000000001,1410,3500,3,2,2015,UNK,-300,2500
7853340960,2/27/2015,425590.0,3,2.75,1940,3088,2.0,0.0,3.0,3,8,1770,170,2008,0,98065,47.5185,-121.87799999999999,1410,2335,2,27,2015,N,530,753
7312900060,6/3/2014,235000.0,2,1.0,720,4840,1.0,0.0,0.0,4,6,720,0,1947,0,98126,47.5534,-122.375,1510,4840,6,3,2014,UNK,-790,0
1231001090,7/24/2014,362362.0,2,1.0,710,4000,1.0,0.0,0.0,3,6,710,0,1909,0,98118,47.5535,-122.26899999999999,960,4000,7,24,2014,UNK,-250,0
1545805460,2/4/2015,252000.0,3,2.0,1370,7500,1.0,0.0,0.0,3,7,1370,0,1997,0,98038,47.3634,-122.046,1420,7500,2,4,2015,UNK,-50,0
1473120390,12/24/2014,439000.0,4,2.5,2690,9551,2.0,0.0,0.0,3,9,2690,0,1992,0,98058,47.4343,-122.156,2890,9121,12,24,2014,UNK,-200,430
1657300070,8/12/2014,465000.0,4,2.25,3360,10810,2.0,0.0,0.0,4,9,3360,0,1988,0,98092,47.3316,-122.20299999999999,2590,10810,8,12,2014,UNK,770,0
104501040,10/3/2014,249900.0,4,2.0,1500,7854,1.5,0.0,0.0,3,7,1500,0,1983,0,98023,47.3127,-122.354,1500,7334,10,3,2014,UNK,0,520
9345400350,7/18/2014,665000.0,2,2.5,2600,5000,1.0,0.0,0.0,5,8,1300,1300,1926,0,98126,47.5806,-122.37899999999999,2260,5000,7,18,2014,UNK,340,0
2592400400,10/14/2014,370000.0,3,1.75,1160,8774,1.0,0.0,0.0,3,7,1160,0,1972,0,98034,47.7159,-122.165,1990,7908,10,14,2014,UNK,-830,866
6788200295,6/12/2014,620000.0,2,1.0,1430,3000,1.5,0.0,0.0,3,7,1300,130,1929,0,98112,47.6415,-122.303,1750,4000,6,12,2014,UNK,-320,-1000
7308900445,7/24/2014,375000.0,3,1.0,1870,7671,1.0,0.0,0.0,4,8,1720,150,1937,0,98177,47.7162,-122.36,1460,7679,7,24,2014,UNK,410,-8
3034200435,8/27/2014,552625.0,4,2.0,2560,9390,1.0,0.0,0.0,5,8,1280,1280,1957,0,98133,47.7169,-122.329,1830,8169,8,27,2014,UNK,730,1221
3755000060,9/30/2014,315500.0,3,1.0,1160,10500,1.0,0.0,0.0,4,7,1160,0,1966,0,98034,47.7267,-122.227,1520,10500,9,30,2014,UNK,-360,0
7524950710,9/19/2014,620000.0,2,1.75,1680,8187,1.0,0.0,0.0,4,8,1680,0,1983,0,98027,47.5603,-122.081,2390,7801,9,19,2014,UNK,-710,386
6071200400,11/25/2014,510000.0,4,2.5,2010,9075,1.0,0.0,0.0,4,8,1310,700,1959,0,98006,47.553000000000004,-122.182,1850,9220,11,25,2014,UNK,160,-145
1939000030,6/27/2014,652500.0,4,2.5,2540,38677,2.0,0.0,0.0,3,9,2540,0,1987,0,98053,47.6694,-122.044,2560,36280,6,27,2014,UNK,-20,2397
6979900370,11/14/2014,574000.0,4,2.5,3240,22795,2.0,0.0,0.0,3,8,3240,0,1998,0,98053,47.6329,-121.969,2570,29761,11,14,2014,UNK,670,-6966
3303860160,2/24/2015,430000.0,3,2.5,2670,12806,2.0,0.0,0.0,3,9,2670,0,2010,0,98038,47.3686,-122.059,3010,7231,2,24,2015,N,-340,5575
6413100311,6/3/2014,390000.0,3,2.0,1080,7236,1.0,0.0,0.0,5,7,1080,0,1947,0,98125,47.7143,-122.32,1120,8008,6,3,2014,UNK,-40,-772
1232002015,6/5/2014,466500.0,3,1.0,1430,3840,1.0,0.0,0.0,3,7,950,480,1945,0,98117,47.6847,-122.381,1430,3840,6,5,2014,UNK,0,0
5116060030,10/28/2014,315000.0,2,2.25,1290,2436,2.0,0.0,0.0,3,7,1290,0,1984,0,98052,47.6803,-122.156,1360,3088,10,28,2014,UNK,-70,-652
1898700310,5/5/2014,220000.0,4,1.5,1240,9600,1.0,0.0,0.0,3,7,1240,0,1971,0,98023,47.3206,-122.397,1240,9592,5,5,2014,UNK,0,8
1079600270,3/6/2015,325000.0,3,1.75,1840,17286,1.0,0.0,0.0,4,7,1440,400,1978,0,98030,47.371,-122.17299999999999,1840,14541,3,6,2015,UNK,0,2745
1073100030,4/28/2015,365000.0,3,1.0,1120,8443,1.0,0.0,0.0,3,7,1120,0,1953,0,98133,47.7715,-122.336,1450,8433,4,28,2015,UNK,-330,10
1157200189,5/14/2014,356000.0,3,3.5,2100,12384,2.0,0.0,0.0,3,9,2100,0,1980,0,98188,47.4687,-122.26299999999999,2400,7776,5,14,2014,UNK,-300,4608
3822200105,9/23/2014,380000.0,4,1.75,2030,12518,1.0,0.0,0.0,3,8,1610,420,1950,0,98125,47.7278,-122.29700000000001,1650,7872,9,23,2014,UNK,380,4646
8121200700,7/13/2014,579000.0,4,2.25,2030,8764,2.0,0.0,0.0,4,8,2030,0,1983,0,98052,47.7214,-122.11,1950,8750,7,13,2014,UNK,80,14
4221900030,5/1/2015,682000.0,2,1.0,890,5000,1.0,0.0,0.0,3,7,890,0,1943,0,98105,47.6666,-122.279,1680,5000,5,1,2015,UNK,-790,0
9475200030,6/16/2014,499000.0,3,1.75,1750,12325,1.0,0.0,0.0,4,7,1470,280,1968,0,98052,47.6832,-122.118,1820,9750,6,16,2014,UNK,-70,2575
3585220070,4/23/2015,333760.0,3,1.0,1300,5880,1.0,0.0,0.0,3,7,1300,0,1968,0,98052,47.6937,-122.113,1300,7700,4,23,2015,UNK,0,-1820
8644220070,9/10/2014,745000.0,4,2.5,2650,18903,2.0,0.0,0.0,3,11,2650,0,1994,0,98075,47.5761,-121.98899999999999,3270,18843,9,10,2014,UNK,-620,60
9225900055,7/22/2014,380000.0,3,1.75,1750,10870,1.0,0.0,0.0,5,7,1750,0,1968,0,98056,47.4989,-122.18799999999999,1230,10868,7,22,2014,UNK,520,2
1972202010,8/1/2014,435000.0,3,3.0,1440,1350,3.5,0.0,2.0,3,8,1440,0,2005,0,98103,47.6525,-122.345,1440,1350,8,1,2014,N,0,0
9547200340,1/20/2015,520000.0,3,2.75,1700,3264,1.0,0.0,0.0,3,7,1060,640,1919,0,98115,47.6767,-122.311,1880,4080,1,20,2015,UNK,-180,-816
2481630030,4/27/2015,965000.0,4,2.5,3920,41206,2.0,0.0,0.0,4,10,3920,0,1988,0,98072,47.7325,-122.132,3780,36562,4,27,2015,UNK,140,4644
3092000030,8/8/2014,270000.0,3,2.25,1470,16728,1.0,0.0,0.0,4,7,1350,120,1959,0,98168,47.4968,-122.302,1540,9000,8,8,2014,UNK,-70,7728
3592500340,3/13/2015,1100000.0,5,2.75,2520,4643,1.5,0.0,0.0,4,8,2120,400,1916,0,98112,47.6348,-122.301,2100,4564,3,13,2015,UNK,420,79
3447000060,10/8/2014,577500.0,3,1.75,2140,13286,1.0,0.0,0.0,4,8,1220,920,1964,0,98006,47.5722,-122.12799999999999,2250,13286,10,8,2014,UNK,-110,0
2767704860,7/28/2014,650000.0,3,1.75,1550,5000,1.0,0.0,0.0,3,7,1250,300,1911,2011,98107,47.6722,-122.37200000000001,1110,5000,7,28,2014,Y,440,0
4141000060,12/5/2014,1230000.0,4,2.5,3180,10319,2.0,0.0,0.0,4,11,3180,0,1986,0,98040,47.5372,-122.23200000000001,3130,12120,12,5,2014,UNK,50,-1801
7767000060,9/12/2014,1900000.0,5,4.25,6510,16471,2.0,0.0,3.0,4,11,3250,3260,1980,0,98040,47.5758,-122.242,4480,16471,9,12,2014,UNK,2030,0
2061100390,7/21/2014,475000.0,2,2.0,1440,3720,1.5,0.0,0.0,3,7,1440,0,1983,0,98115,47.6902,-122.325,1490,4308,7,21,2014,UNK,-50,-588
4388000260,3/30/2015,200000.0,3,1.0,1150,10132,1.0,0.0,0.0,4,7,1150,0,1970,0,98023,47.3172,-122.37200000000001,1180,8713,3,30,2015,UNK,-30,1419
7787110510,6/20/2014,397000.0,4,2.5,2320,11717,2.0,0.0,0.0,3,8,2320,0,1997,0,98045,47.483999999999995,-121.78,2320,9714,6,20,2014,UNK,0,2003
4024100982,2/19/2015,383610.0,3,2.0,1230,8450,1.0,0.0,0.0,3,7,1230,0,1989,0,98155,47.7548,-122.305,2110,8536,2,19,2015,UNK,-880,-86
2621420060,7/28/2014,275000.0,4,2.5,2060,5742,2.0,0.0,0.0,3,7,2060,0,1999,0,98030,47.3612,-122.185,1610,7298,7,28,2014,UNK,450,-1556
4319200060,7/9/2014,840000.0,3,2.0,2783,11177,2.0,0.0,0.0,3,8,2783,0,1910,1999,98126,47.538000000000004,-122.38,1730,8018,7,9,2014,Y,1053,3159
2473480310,9/18/2014,365000.0,4,2.5,2140,7350,2.0,0.0,0.0,3,8,2140,0,1985,0,98058,47.4483,-122.124,2120,8395,9,18,2014,UNK,20,-1045
3629960060,9/4/2014,362000.0,3,2.75,1420,955,2.0,0.0,0.0,3,8,1160,260,2004,0,98029,47.5477,-122.00299999999999,1420,955,9,4,2014,N,0,0
7857000732,11/1/2014,350000.0,3,1.75,2090,6258,1.0,0.0,0.0,3,7,1390,700,1956,0,98108,47.5503,-122.301,1790,5793,11,1,2014,UNK,300,465
7805600070,11/11/2014,200000.0,2,1.75,1320,13052,1.5,0.0,0.0,3,7,1320,0,1980,0,98014,47.711999999999996,-121.352,1320,13052,11,11,2014,UNK,0,0
109200140,5/6/2015,299000.0,4,2.5,2300,8100,1.0,0.0,0.0,4,8,1360,940,1979,0,98023,47.2979,-122.37100000000001,1910,7630,5,6,2015,UNK,390,470
3224059033,10/7/2014,555000.0,4,1.5,3050,82764,1.0,0.0,0.0,3,8,1650,1400,1966,0,98056,47.5266,-122.189,2930,10074,10,7,2014,UNK,120,72690
868002015,2/25/2015,1330000.0,3,2.25,2960,8330,1.0,0.0,3.0,4,10,2260,700,1953,0,98177,47.7035,-122.385,2960,8840,2,25,2015,UNK,0,-510
321100260,6/30/2014,896000.0,5,2.75,2520,16100,1.0,0.0,3.0,4,8,1570,950,1960,0,98040,47.528,-122.22399999999999,2760,16988,6,30,2014,UNK,-240,-888
2325039084,12/17/2014,550000.0,2,1.75,1740,7290,1.0,0.0,0.0,3,8,1280,0,1950,0,98199,47.6461,-122.397,1820,6174,12,17,2014,UNK,-80,1116
2126049083,5/8/2015,324500.0,2,1.0,1300,6617,1.0,0.0,0.0,3,7,1300,0,1986,0,98125,47.7238,-122.302,1820,7800,5,8,2015,UNK,-520,-1183
3298400350,1/5/2015,312500.0,3,1.0,1170,7350,1.0,0.0,0.0,4,7,1170,0,1960,0,98008,47.625,-122.117,1170,7350,1,5,2015,UNK,0,0
7558800240,4/14/2015,485000.0,4,3.25,1946,17786,2.0,0.0,1.0,4,7,1946,0,1990,0,98070,47.358999999999995,-122.45200000000001,1460,16661,4,14,2015,UNK,486,1125
5100402782,10/20/2014,511000.0,2,1.0,1250,5413,1.0,0.0,0.0,4,7,1250,0,1923,0,98115,47.6945,-122.315,1250,5413,10,20,2014,UNK,0,0
5466310060,3/24/2015,139500.0,2,1.5,1230,1561,2.0,0.0,0.0,3,7,1230,0,1983,0,98042,47.3768,-122.149,1660,2243,3,24,2015,UNK,-430,-682
8079010310,6/11/2014,464000.0,4,2.5,2180,7203,2.0,0.0,0.0,4,8,2180,0,1989,0,98059,47.5119,-122.15100000000001,2350,7334,6,11,2014,UNK,-170,-131
8581200240,4/29/2015,255000.0,3,1.75,1740,8800,1.0,0.0,0.0,3,7,1140,600,1978,0,98023,47.2968,-122.37200000000001,1690,7920,4,29,2015,UNK,50,880
7853250070,4/17/2015,679975.0,4,2.5,3830,4644,2.0,0.0,0.0,3,8,2900,930,2004,0,98065,47.5384,-121.88,3400,6163,4,17,2015,N,430,-1519
7785000260,7/9/2014,624800.0,3,2.0,2250,14274,1.0,0.0,0.0,4,8,1500,750,1964,0,98040,47.5762,-122.21700000000001,2820,13813,7,9,2014,UNK,-570,461
3525069037,11/20/2014,920000.0,3,2.75,2590,223027,2.0,0.0,0.0,3,9,2590,0,1983,0,98074,47.6145,-122.001,3410,212137,11,20,2014,UNK,-820,10890
4217401180,5/30/2014,1370000.0,3,2.5,2090,6000,1.5,0.0,0.0,4,9,2090,0,1928,0,98105,47.6567,-122.281,2730,6000,5,30,2014,UNK,-640,0
8861700030,12/12/2014,510000.0,3,1.5,2400,10275,1.0,0.0,0.0,4,8,1540,860,1964,0,98052,47.6888,-122.126,2380,10125,12,12,2014,UNK,20,150
2287400030,6/26/2014,289659.0,4,2.25,2260,7200,2.0,0.0,0.0,4,7,2260,0,1984,0,98031,47.4121,-122.18299999999999,1720,7200,6,26,2014,UNK,540,0
7852010510,4/24/2015,585000.0,4,2.5,2910,6250,2.0,0.0,0.0,3,8,2910,0,1999,0,98065,47.538000000000004,-121.87,2550,6250,4,24,2015,UNK,360,0
5104512180,6/26/2014,555000.0,5,3.0,3640,6930,2.0,0.0,0.0,3,8,3640,0,2004,0,98038,47.3521,-122.012,3740,7182,6,26,2014,N,-100,-252
9201000030,3/13/2015,940000.0,4,2.75,3770,24897,2.0,0.0,2.0,4,8,2550,1220,1964,0,98075,47.5824,-122.07799999999999,2640,11502,3,13,2015,UNK,1130,13395
7199340560,9/9/2014,460000.0,3,2.0,1600,7350,1.0,0.0,0.0,4,7,1600,0,1979,0,98052,47.6977,-122.126,1600,7200,9,9,2014,UNK,0,150
5561700340,11/21/2014,319000.0,3,2.5,2110,7434,2.0,0.0,0.0,4,7,2110,0,1978,0,98031,47.3935,-122.169,2100,7749,11,21,2014,UNK,10,-315
1657530350,5/19/2014,280000.0,3,2.5,1720,1916,2.0,0.0,0.0,3,7,1720,0,2005,0,98059,47.4895,-122.166,1760,1916,5,19,2014,N,-40,0
9423800030,11/18/2014,250000.0,3,1.0,1100,7470,1.0,0.0,0.0,4,5,1100,0,1917,0,98065,47.5242,-121.831,1280,7055,11,18,2014,UNK,-180,415
1939100560,1/16/2015,749950.0,4,2.5,2620,8312,2.0,0.0,0.0,3,9,2620,0,1990,0,98074,47.6272,-122.03299999999999,2260,8515,1,16,2015,UNK,360,-203
626059276,5/30/2014,458000.0,5,2.5,3090,23265,1.0,0.0,0.0,3,8,2990,100,1957,0,98011,47.7709,-122.212,2560,18773,5,30,2014,UNK,530,4492
7852020800,4/2/2015,465000.0,3,2.5,1890,4808,2.0,0.0,0.0,3,8,1890,0,2000,0,98065,47.5348,-121.866,2460,5348,4,2,2015,UNK,-570,-540
1994200012,4/13/2015,580000.0,3,1.75,1850,2797,1.0,0.0,0.0,3,8,1150,700,1977,0,98103,47.6871,-122.336,1450,4599,4,13,2015,UNK,400,-1802
6626100260,8/6/2014,700000.0,4,2.5,3100,36562,2.0,0.0,0.0,3,10,3100,0,1994,0,98077,47.7646,-122.065,3080,39351,8,6,2014,UNK,20,-2789
4166800320,11/10/2014,350000.0,4,2.5,2506,7206,2.0,0.0,0.0,3,8,2506,0,2007,0,98023,47.3236,-122.337,2441,7220,11,10,2014,N,65,-14
5490210200,9/5/2014,456000.0,4,1.0,1700,7689,1.0,0.0,0.0,3,7,1080,620,1977,0,98052,47.6955,-122.116,1700,7333,9,5,2014,UNK,0,356
5067400162,2/18/2015,290000.0,3,2.0,1550,18958,1.5,0.0,0.0,3,7,1550,0,1983,0,98198,47.3699,-122.319,1840,12826,2,18,2015,UNK,-290,6132
4306500070,7/11/2014,475000.0,4,2.75,2200,16288,1.0,0.0,0.0,3,7,1290,910,1980,0,98059,47.4793,-122.12200000000001,2650,6620,7,11,2014,UNK,-450,9668
5416500260,9/8/2014,285000.0,3,2.5,1890,3629,2.0,0.0,0.0,3,7,1890,0,2005,0,98038,47.3613,-122.041,1980,4000,9,8,2014,N,-90,-371
1446800710,2/27/2015,309000.0,3,1.0,1140,6400,1.0,0.0,0.0,3,7,1140,0,1962,0,98168,47.4902,-122.331,1340,6650,2,27,2015,UNK,-200,-250
2324800350,5/6/2014,860000.0,4,2.0,3740,32417,2.0,0.0,0.0,3,9,3740,0,2000,0,98053,47.6728,-122.012,3180,32417,5,6,2014,UNK,560,0
6648500390,2/26/2015,219000.0,3,2.25,1940,6500,1.0,0.0,0.0,3,8,1440,500,1979,0,98042,47.3565,-122.149,1880,8991,2,26,2015,UNK,60,-2491
8078440140,10/9/2014,546500.0,3,2.5,2130,7199,2.0,0.0,0.0,3,8,2130,0,1990,0,98074,47.6331,-122.027,1890,7546,10,9,2014,UNK,240,-347
2624049050,2/13/2015,338000.0,2,1.0,1470,5566,1.0,0.0,0.0,4,7,770,700,1919,0,98118,47.5348,-122.26899999999999,1410,5808,2,13,2015,UNK,60,-242
1862400226,3/11/2015,505000.0,2,1.0,1070,8130,1.0,0.0,0.0,3,7,1070,0,1942,0,98117,47.696999999999996,-122.37,1360,7653,3,11,2015,UNK,-290,477
4046700140,10/2/2014,340000.0,4,1.75,1680,15084,1.0,0.0,0.0,4,7,840,840,1979,0,98014,47.6895,-121.912,1800,15092,10,2,2014,UNK,-120,-8
3066410810,8/22/2014,678000.0,3,2.25,2730,10675,2.0,0.0,0.0,3,9,2730,0,1990,0,98074,47.6289,-122.042,2770,10570,8,22,2014,UNK,-40,105
5453700140,12/8/2014,800000.0,3,1.75,1890,10292,1.0,0.0,0.0,4,8,1890,0,1969,0,98040,47.535,-122.234,2630,10625,12,8,2014,UNK,-740,-333
2648500030,7/25/2014,112000.0,1,1.0,1080,3230,1.0,0.0,0.0,3,6,1080,0,1963,0,98002,47.3075,-122.21700000000001,1210,5760,7,25,2014,UNK,-130,-2530
4167100240,3/10/2015,252000.0,3,1.75,1440,16819,1.5,0.0,0.0,4,6,1440,0,1925,0,98023,47.3318,-122.37299999999999,1560,12376,3,10,2015,UNK,-120,4443
2460700030,6/4/2014,335000.0,4,2.75,2540,7210,1.0,0.0,0.0,4,7,1600,940,1979,0,98058,47.4601,-122.165,1820,7766,6,4,2014,UNK,720,-556
682000030,7/3/2014,610000.0,3,2.0,2300,13418,1.0,0.0,0.0,3,8,1430,870,1955,0,98004,47.6075,-122.2,2140,9380,7,3,2014,UNK,160,4038
9211500560,10/28/2014,245000.0,3,2.0,1690,6790,1.0,0.0,0.0,3,7,1360,330,1979,0,98023,47.2981,-122.38,1740,6790,10,28,2014,UNK,-50,0
3211800140,2/5/2015,493500.0,3,1.75,1800,16026,1.0,0.0,0.0,3,8,1390,410,1972,0,98008,47.5815,-122.12100000000001,2210,13959,2,5,2015,UNK,-410,2067
2193340260,1/7/2015,596500.0,4,2.25,1770,8505,2.0,0.0,0.0,3,8,1770,0,1986,0,98052,47.6904,-122.102,1880,8939,1,7,2015,UNK,-110,-434
3419600125,7/1/2014,245000.0,3,2.0,1190,4072,1.5,0.0,0.0,5,6,1190,0,1907,0,98118,47.5276,-122.274,1680,5850,7,1,2014,UNK,-490,-1778
1357300240,10/27/2014,333500.0,3,1.75,1320,7200,1.0,0.0,0.0,4,7,1320,0,1977,0,98028,47.7341,-122.23700000000001,1750,7260,10,27,2014,UNK,-430,-60
3876820140,11/10/2014,373000.0,3,1.0,1290,8974,1.0,0.0,0.0,5,7,1290,0,1976,0,98072,47.74,-122.17299999999999,1540,7500,11,10,2014,UNK,-250,1474
9526600710,7/24/2014,759900.0,4,2.5,3000,5639,2.0,0.0,0.0,3,8,3000,0,2008,0,98052,47.7066,-122.115,3000,4587,7,24,2014,N,0,1052
2291400350,8/26/2014,317000.0,3,2.25,1358,1204,3.0,0.0,0.0,3,7,1358,0,2007,0,98133,47.7054,-122.346,1358,1196,8,26,2014,N,0,8
9834200390,5/12/2015,670000.0,3,1.5,1220,4080,1.5,0.0,0.0,5,7,1220,0,1914,0,98144,47.5746,-122.289,1320,4080,5,12,2015,UNK,-100,0
7631200310,11/6/2014,985000.0,2,2.5,2720,26761,2.0,1.0,4.0,3,7,2720,0,1990,0,98166,47.4499,-122.376,1870,12396,11,6,2014,UNK,850,14365
3438500796,4/30/2015,310000.0,3,1.5,1060,6954,1.0,0.0,0.0,4,6,1060,0,1983,0,98106,47.5497,-122.355,1560,6372,4,30,2015,UNK,-500,582
11520200,10/15/2014,750000.0,4,2.5,3020,13122,2.0,0.0,0.0,3,9,2540,480,1997,0,98052,47.6989,-122.111,3020,10873,10,15,2014,UNK,0,2249
339600070,7/21/2014,408000.0,3,2.0,1640,3440,2.0,0.0,0.0,3,7,1640,0,1987,0,98052,47.6829,-122.09700000000001,1070,3549,7,21,2014,UNK,570,-109
629810800,6/17/2014,900000.0,5,3.75,3870,8225,2.0,0.0,0.0,3,10,3870,0,1998,0,98074,47.6078,-122.01,3600,9361,6,17,2014,UNK,270,-1136
8665900070,1/23/2015,460000.0,4,2.25,2860,15054,1.0,0.0,0.0,3,8,1460,1400,1957,0,98155,47.7655,-122.3,1730,18525,1,23,2015,UNK,1130,-3471
9282800075,3/17/2015,339000.0,4,2.5,1740,6000,1.0,0.0,0.0,4,7,1740,0,1952,0,98178,47.5026,-122.236,1190,6000,3,17,2015,UNK,550,0
809002675,4/13/2015,660000.0,3,2.0,1140,6000,1.0,0.0,0.0,3,7,1140,0,1909,0,98109,47.637,-122.355,1260,4000,4,13,2015,UNK,-120,2000
6305900350,4/22/2015,449950.0,4,3.0,3290,10783,2.0,0.0,0.0,3,9,3290,0,1990,0,98031,47.3904,-122.178,2810,10783,4,22,2015,UNK,480,0
1180002075,8/25/2014,235000.0,3,1.0,1210,6000,1.0,0.0,0.0,3,7,1210,0,1930,0,98178,47.4984,-122.22399999999999,1210,6000,8,25,2014,UNK,0,0
8832900135,1/13/2015,769000.0,5,2.25,3320,13138,1.0,0.0,2.0,4,9,1900,0,1964,0,98028,47.75899999999999,-122.26899999999999,2820,13138,1,13,2015,UNK,500,0
8682230400,5/7/2014,428000.0,2,2.0,1350,3900,1.0,0.0,0.0,3,8,1350,0,2003,0,98053,47.7094,-122.03,1440,3900,5,7,2014,UNK,-90,0
9560800390,5/16/2014,445000.0,3,2.25,1990,7340,2.0,0.0,0.0,3,8,1990,0,1984,0,98072,47.7579,-122.141,2180,11223,5,16,2014,UNK,-190,-3883
2558630350,3/21/2015,462000.0,4,2.5,2060,6958,1.0,0.0,0.0,3,7,1220,840,1974,0,98034,47.7251,-122.16799999999999,1760,7350,3,21,2015,UNK,300,-392
7517500310,5/6/2015,775000.0,3,1.0,1460,6198,1.5,0.0,0.0,4,7,1460,0,1916,0,98107,47.6626,-122.361,2280,5160,5,6,2015,UNK,-820,1038
4141400030,12/1/2014,605000.0,4,1.75,2250,10108,1.0,0.0,0.0,4,8,2250,0,1967,0,98008,47.5922,-122.118,2050,9750,12,1,2014,UNK,200,358
8570900162,10/16/2014,193500.0,2,1.0,950,15996,1.0,0.0,0.0,4,7,950,0,1946,1995,98045,47.4987,-121.787,950,25510,10,16,2014,Y,0,-9514
6837820030,5/22/2014,389950.0,4,2.5,3140,8060,2.0,0.0,0.0,3,9,3140,0,1991,0,98023,47.3091,-122.34299999999999,3000,8060,5,22,2014,UNK,140,0
98030400,7/11/2014,790000.0,4,3.5,3560,6098,2.0,0.0,0.0,3,10,3560,0,2006,0,98075,47.5828,-121.97200000000001,3660,6846,7,11,2014,N,-100,-748
7312400030,1/30/2015,442000.0,2,1.0,1410,5000,1.0,0.0,2.0,4,7,940,470,1918,0,98126,47.5531,-122.37899999999999,1450,5000,1,30,2015,UNK,-40,0
5452800800,6/13/2014,890000.0,4,2.25,2770,13500,2.0,0.0,0.0,3,8,2770,0,1974,0,98040,47.543,-122.23100000000001,2300,13500,6,13,2014,UNK,470,0
7889000125,3/19/2015,235000.0,3,1.0,1864,6978,1.0,0.0,0.0,4,7,1864,0,1958,0,98002,47.285,-122.206,990,8000,3,19,2015,UNK,874,-1022
5101402276,12/17/2014,495000.0,4,1.75,1930,6720,1.0,0.0,2.0,3,8,1130,800,1959,0,98115,47.6935,-122.31200000000001,1850,6380,12,17,2014,UNK,80,340
1621069045,1/5/2015,600000.0,4,2.5,3870,50965,2.0,0.0,0.0,3,10,3870,0,2007,0,98010,47.3109,-122.045,2170,65843,1,5,2015,N,1700,-14878
1370800935,6/18/2014,1400000.0,3,2.0,2020,5500,1.5,0.0,3.0,3,10,1790,230,1937,0,98199,47.6388,-122.40899999999999,2580,5500,6,18,2014,UNK,-560,0
7522600030,8/26/2014,251000.0,3,2.0,1300,8400,1.0,0.0,0.0,4,7,1300,0,1967,0,98198,47.368,-122.315,1300,7500,8,26,2014,UNK,0,900
123059046,3/26/2015,471000.0,4,2.25,3410,57063,2.0,0.0,0.0,4,8,2410,1000,1978,0,98059,47.505,-122.11,2870,145490,3,26,2015,UNK,540,-88427
5201000030,3/23/2015,597000.0,4,2.5,2370,41338,2.0,0.0,0.0,3,8,2370,0,1995,0,98077,47.7379,-122.052,2340,46661,3,23,2015,UNK,30,-5323
8965500030,9/23/2014,804000.0,5,3.5,2770,9305,2.0,0.0,0.0,3,9,2770,0,1985,0,98006,47.5628,-122.11399999999999,2520,9773,9,23,2014,UNK,250,-468
4019300030,10/13/2014,357000.0,3,1.75,1250,17493,1.0,0.0,0.0,3,7,1250,0,1972,0,98155,47.7613,-122.274,2180,19553,10,13,2014,UNK,-930,-2060
8929000030,8/21/2014,419990.0,3,2.5,1690,1689,2.0,0.0,0.0,3,8,1150,540,2014,0,98029,47.5528,-121.999,1540,1689,8,21,2014,N,150,0
7880020030,11/10/2014,725000.0,4,2.5,3040,35201,2.0,0.0,0.0,4,10,3040,0,1987,0,98027,47.4872,-122.066,2990,35416,11,10,2014,UNK,50,-215
806800400,2/9/2015,275000.0,3,2.5,2710,5733,2.0,0.0,0.0,3,7,2710,0,2003,0,98092,47.3357,-122.171,2720,5733,2,9,2015,UNK,-10,0
7327500270,9/25/2014,445000.0,3,2.25,1190,13630,1.0,0.0,0.0,3,7,1190,0,1984,0,98045,47.4813,-121.735,1630,14405,9,25,2014,UNK,-440,-775
8568010310,9/12/2014,510000.0,3,2.5,2300,27566,2.0,0.0,0.0,3,9,2300,0,1995,0,98019,47.7369,-121.96,2480,16650,9,12,2014,UNK,-180,10916
1126049105,5/27/2014,330000.0,4,1.0,1360,13372,1.0,0.0,0.0,3,7,1360,0,1955,0,98028,47.7622,-122.26299999999999,1540,10283,5,27,2014,UNK,-180,3089
3438501662,8/18/2014,270000.0,3,1.0,1500,5605,1.0,0.0,0.0,5,6,750,750,1942,0,98106,47.5456,-122.359,1050,9100,8,18,2014,UNK,450,-3495
293000036,4/3/2015,495000.0,4,2.0,1610,4770,1.0,0.0,0.0,4,7,1230,380,1941,0,98126,47.5333,-122.381,1180,6120,4,3,2015,UNK,430,-1350
2648000071,3/6/2015,225000.0,4,1.75,1420,10300,2.0,0.0,0.0,3,7,1420,0,1950,2001,98002,47.3121,-122.215,1420,10300,3,6,2015,Y,0,0
5273200060,5/4/2015,716528.0,3,1.5,1750,5400,1.0,0.0,0.0,4,7,1050,700,1952,0,98115,47.6799,-122.279,1750,5400,5,4,2015,UNK,0,0
2025701360,10/14/2014,260000.0,3,2.5,1510,6095,2.0,0.0,0.0,4,7,1510,0,1991,0,98038,47.3498,-122.037,1520,6000,10,14,2014,UNK,-10,95
7787120260,6/9/2014,471000.0,4,2.5,2330,9928,2.0,0.0,0.0,3,8,2330,0,1998,0,98045,47.4836,-121.78299999999999,2430,8175,6,9,2014,UNK,-100,1753
4154305085,2/26/2015,690000.0,5,3.5,2690,4800,2.0,0.0,2.0,3,8,1930,760,1919,1984,98118,47.5592,-122.26899999999999,2080,4900,2,26,2015,Y,610,-100
967000400,4/28/2015,548000.0,5,1.5,1700,7200,1.5,0.0,0.0,3,7,1700,0,1937,0,98011,47.7614,-122.20299999999999,1460,7194,4,28,2015,UNK,240,6
5101401816,7/26/2014,505000.0,3,1.0,1020,5410,1.0,0.0,0.0,4,7,880,140,1928,0,98115,47.6924,-122.31,1580,5376,7,26,2014,UNK,-560,34
3755000310,12/17/2014,325000.0,3,1.0,1160,11799,1.0,0.0,0.0,3,7,1160,0,1966,0,98034,47.7263,-122.229,1220,10500,12,17,2014,UNK,-60,1299
7300200400,11/5/2014,682000.0,4,2.25,2450,34092,2.0,0.0,0.0,4,8,2450,0,1980,0,98075,47.5751,-122.04899999999999,2410,35378,11,5,2014,UNK,40,-1286
1795920350,6/17/2014,605000.0,3,2.25,2010,10760,2.0,0.0,0.0,3,8,2010,0,1985,0,98052,47.7276,-122.103,2240,9357,6,17,2014,UNK,-230,1403
3530440140,5/5/2015,276200.0,2,1.75,1370,4495,1.0,0.0,0.0,4,8,1370,0,1975,0,98198,47.3794,-122.31700000000001,1370,4686,5,5,2015,UNK,0,-191
6690500060,7/24/2014,530000.0,3,1.0,1370,4040,1.5,0.0,0.0,3,7,1370,0,1906,0,98103,47.6867,-122.354,1220,3030,7,24,2014,UNK,150,1010
3568200060,9/2/2014,245000.0,3,3.0,1990,9600,1.0,0.0,0.0,3,7,1440,550,1988,0,98003,47.3499,-122.296,1670,9600,9,2,2014,UNK,320,0
3530200160,6/3/2014,654950.0,4,2.5,2790,45902,2.0,0.0,0.0,3,9,2790,0,1987,0,98077,47.7674,-122.086,2890,42421,6,3,2014,UNK,-100,3481
40000228,10/15/2014,221900.0,2,1.0,780,6727,1.0,0.0,0.0,3,6,780,0,1939,0,98168,47.4733,-122.281,1860,10124,10,15,2014,UNK,-1080,-3397
3878900270,4/29/2015,466000.0,4,2.0,2240,4508,1.0,0.0,2.0,4,8,1340,900,1926,0,98178,47.5096,-122.25,1930,5250,4,29,2015,UNK,310,-742
8029600400,2/13/2015,383150.0,3,2.0,2210,6387,1.0,0.0,0.0,3,8,2210,0,2003,0,98003,47.265,-122.302,2570,6497,2,13,2015,UNK,-360,-110
4083300510,5/5/2014,657100.0,4,1.0,1390,4240,1.0,0.0,0.0,3,7,1050,340,1924,0,98103,47.6596,-122.338,1810,4240,5,5,2014,UNK,-420,0
1026069155,3/12/2015,539000.0,3,2.0,1800,43995,2.0,0.0,0.0,3,8,1800,0,1988,0,98077,47.7585,-122.022,2290,51400,3,12,2015,UNK,-490,-7405
3298600340,9/5/2014,400000.0,6,3.0,3320,15600,1.0,0.0,0.0,4,8,1660,1660,1977,0,98092,47.2983,-122.166,2330,15360,9,5,2014,UNK,990,240
1921059235,6/20/2014,215000.0,4,2.5,1960,11600,1.0,0.0,0.0,5,6,980,980,1931,0,98002,47.2898,-122.22200000000001,1160,7685,6,20,2014,UNK,800,3915
2887701420,11/24/2014,489000.0,2,1.0,850,2850,1.0,0.0,0.0,4,7,850,0,1927,0,98115,47.6875,-122.309,1450,4015,11,24,2014,UNK,-600,-1165
2553300270,11/5/2014,649000.0,4,2.5,2980,12764,2.0,0.0,0.0,3,10,2980,0,1994,0,98075,47.5857,-122.027,3080,9810,11,5,2014,UNK,-100,2954
6206100075,5/12/2015,700000.0,4,1.75,1980,10800,1.0,0.0,0.0,4,8,1320,660,1953,0,98005,47.5899,-122.17299999999999,2310,10800,5,12,2015,UNK,-330,0
1397300055,5/20/2014,268500.0,2,1.0,790,8424,1.0,0.0,0.0,4,6,790,0,1953,0,98133,47.7511,-122.352,1470,8424,5,20,2014,UNK,-680,0
1357900060,6/10/2014,515000.0,3,2.5,1800,5001,2.0,0.0,0.0,3,7,1800,0,1996,0,98034,47.7126,-122.23100000000001,2106,5618,6,10,2014,UNK,-306,-617
9346700030,2/23/2015,685000.0,4,2.0,2260,10800,1.0,0.0,0.0,3,9,2260,0,1978,0,98007,47.6124,-122.15299999999999,2650,9900,2,23,2015,UNK,-390,900
730000139,10/16/2014,305000.0,2,1.5,800,2142,2.0,0.0,0.0,3,7,800,0,2006,0,98144,47.5917,-122.29700000000001,1320,2742,10,16,2014,N,-520,-600
4219400465,1/12/2015,950000.0,4,2.0,2490,4600,1.5,0.0,2.0,3,8,2090,400,1926,0,98105,47.6557,-122.27799999999999,2910,5000,1,12,2015,UNK,-420,-400
8947250060,3/26/2015,292500.0,4,2.5,1610,4568,2.0,0.0,0.0,3,7,1610,0,2006,0,98001,47.3351,-122.289,1834,4604,3,26,2015,N,-224,-36
3293700496,8/14/2014,270000.0,4,1.75,1850,7730,1.0,0.0,0.0,5,7,1100,750,1956,0,98133,47.7481,-122.355,2260,8581,8,14,2014,UNK,-410,-851
3293700496,12/4/2014,450000.0,4,1.75,1850,7730,1.0,0.0,0.0,5,7,1100,750,1956,0,98133,47.7481,-122.355,2260,8581,12,4,2014,UNK,-410,-851
2921700060,10/27/2014,535000.0,4,1.0,1920,6480,1.5,0.0,0.0,3,7,1920,0,1920,0,98117,47.6897,-122.374,1600,6470,10,27,2014,UNK,320,10
3629870200,3/6/2015,550000.0,3,2.5,1740,3082,2.0,0.0,0.0,3,8,1740,0,2000,0,98029,47.5489,-122.006,1910,3075,3,6,2015,UNK,-170,7
6909200335,6/24/2014,457500.0,3,2.25,1430,2003,2.0,0.0,0.0,3,8,980,450,1996,0,98144,47.5908,-122.292,2210,4000,6,24,2014,UNK,-780,-1997
8945100320,5/6/2014,136500.0,3,1.5,1420,8580,1.0,0.0,0.0,3,6,1420,0,1962,0,98023,47.3076,-122.36200000000001,1200,8580,5,6,2014,UNK,220,0
8945100320,10/8/2014,224097.0,3,1.5,1420,8580,1.0,0.0,0.0,3,6,1420,0,1962,0,98023,47.3076,-122.36200000000001,1200,8580,10,8,2014,UNK,220,0
6792200282,9/22/2014,254000.0,3,2.5,1560,10608,2.0,0.0,0.0,3,7,1560,0,1994,0,98042,47.3572,-122.161,1360,10608,9,22,2014,UNK,200,0
1471701170,6/11/2014,335000.0,4,2.25,2030,13500,1.0,0.0,0.0,3,7,1230,800,1963,0,98059,47.4596,-122.066,1830,13800,6,11,2014,UNK,200,-300
8564850200,4/2/2015,594950.0,5,2.5,3280,6553,2.0,0.0,0.0,3,9,3280,0,2012,0,98045,47.475,-121.73700000000001,3360,7242,4,2,2015,N,-80,-689
1471610070,8/27/2014,350000.0,3,1.75,1360,18123,1.0,0.0,0.0,3,8,1360,0,1983,0,98045,47.4716,-121.756,1570,16817,8,27,2014,UNK,-210,1306
3384300160,9/16/2014,169950.0,3,1.0,1180,9832,1.0,0.0,0.0,3,7,1180,0,1970,0,98042,47.3845,-122.085,1220,9894,9,16,2014,UNK,-40,-62
6139800390,10/6/2014,432500.0,3,2.5,1940,10800,1.0,0.0,0.0,3,8,1340,600,1979,0,98077,47.7471,-122.075,2080,9600,10,6,2014,UNK,-140,1200
8819900270,5/20/2014,440000.0,2,1.75,1300,4000,2.0,0.0,0.0,3,7,1300,0,1948,0,98105,47.6687,-122.288,1350,4013,5,20,2014,UNK,-50,-13
8944290200,9/18/2014,233703.0,3,2.25,1650,3788,2.0,0.0,0.0,3,7,1650,0,1985,0,98031,47.3908,-122.167,1510,3994,9,18,2014,UNK,140,-206
4057300030,11/14/2014,310000.0,3,1.5,1140,3292,2.0,0.0,0.0,3,7,1140,0,1988,0,98029,47.5701,-122.01700000000001,1150,3592,11,14,2014,UNK,-10,-300
1277000240,4/2/2015,735000.0,3,2.5,2540,6762,2.0,0.0,0.0,3,10,2540,0,1998,0,98007,47.6239,-122.14399999999999,2870,6631,4,2,2015,UNK,-330,131
3345100002,12/17/2014,730000.0,4,2.75,3440,8150,2.0,0.0,0.0,3,10,3440,0,2014,0,98056,47.5168,-122.189,2560,8315,12,17,2014,N,880,-165
179000505,10/24/2014,257000.0,3,1.75,1800,9000,1.0,0.0,0.0,3,7,1200,600,1961,0,98178,47.4932,-122.27799999999999,980,6000,10,24,2014,UNK,820,3000
1972200751,5/19/2014,485000.0,2,2.25,1260,1240,3.0,0.0,0.0,3,8,1260,0,2004,0,98103,47.6531,-122.352,1330,1300,5,19,2014,N,-70,-60
868002080,6/19/2014,899000.0,4,2.25,2370,6000,1.0,0.0,2.0,3,8,1440,930,1959,0,98177,47.7023,-122.38799999999999,3280,8843,6,19,2014,UNK,-910,-2843
4426600125,11/18/2014,279000.0,3,1.0,1520,8055,1.5,0.0,0.0,3,7,1520,0,1952,0,98125,47.7222,-122.305,1560,8160,11,18,2014,UNK,-40,-105
1683500140,12/11/2014,225000.0,4,2.0,1750,7245,1.0,0.0,0.0,4,7,1050,700,1974,0,98092,47.3164,-122.196,1640,7245,12,11,2014,UNK,110,0
1689401230,6/25/2014,1360000.0,3,1.5,2680,4775,2.0,0.0,2.0,5,8,1880,800,1913,0,98109,47.6333,-122.34700000000001,2280,5947,6,25,2014,UNK,400,-1172
7852060370,8/11/2014,355000.0,3,2.5,1590,4242,2.0,0.0,0.0,3,7,1590,0,2000,0,98065,47.5309,-121.876,1590,3702,8,11,2014,UNK,0,540
3876200060,5/2/2014,382500.0,4,1.75,1560,8700,1.0,0.0,0.0,4,7,1560,0,1967,0,98034,47.7274,-122.181,2080,8000,5,2,2014,UNK,-520,700
2571910260,11/7/2014,324360.0,3,2.5,2000,9669,2.0,0.0,0.0,4,8,2000,0,1992,0,98022,47.1964,-122.009,1930,9202,11,7,2014,UNK,70,467
8731900640,3/24/2015,315000.0,3,1.75,2380,10450,1.5,0.0,0.0,3,8,2380,0,1966,0,98023,47.3143,-122.37,2320,8500,3,24,2015,UNK,60,1950
1826049094,7/16/2014,426000.0,2,1.0,2230,11472,2.0,0.0,0.0,3,7,2230,0,1951,0,98133,47.7372,-122.35,1870,8649,7,16,2014,UNK,360,2823
2345700260,4/6/2015,395000.0,5,2.5,2820,6305,2.0,0.0,0.0,3,8,2820,0,2003,0,98003,47.2616,-122.296,2610,6306,4,6,2015,UNK,210,-1
3622069050,11/21/2014,212644.0,3,1.0,1570,9650,1.5,0.0,0.0,5,5,1570,0,1922,0,98010,47.3531,-121.98200000000001,1330,9650,11,21,2014,UNK,240,0
3342100160,10/9/2014,510000.0,3,3.0,1845,5100,2.0,0.0,2.0,5,8,1845,0,1947,0,98056,47.5204,-122.208,2100,7650,10,9,2014,UNK,-255,-2550
2422049104,9/15/2014,85000.0,2,1.0,830,9000,1.0,0.0,0.0,3,6,830,0,1939,0,98032,47.3813,-122.243,1160,7680,9,15,2014,UNK,-330,1320
2422049104,12/30/2014,235000.0,2,1.0,830,9000,1.0,0.0,0.0,3,6,830,0,1939,0,98032,47.3813,-122.243,1160,7680,12,30,2014,UNK,-330,1320
6600350140,4/8/2015,295000.0,4,2.5,2030,5754,2.0,0.0,0.0,3,8,2030,0,2001,0,98042,47.3542,-122.137,2030,5784,4,8,2015,UNK,0,-30
510003230,8/10/2014,720001.0,3,2.5,1430,2200,1.5,0.0,0.0,4,7,1430,0,1910,0,98103,47.6601,-122.331,1740,4275,8,10,2014,UNK,-310,-2075
1995200200,5/6/2014,313950.0,3,1.0,1510,6083,1.0,0.0,0.0,4,6,860,650,1940,0,98115,47.6966,-122.324,1510,5712,5,6,2014,UNK,0,371
1995200200,10/8/2014,415000.0,3,1.0,1510,6083,1.0,0.0,0.0,4,6,860,650,1940,0,98115,47.6966,-122.324,1510,5712,10,8,2014,UNK,0,371
2473480350,5/19/2014,305000.0,3,1.75,1610,12247,1.0,0.0,0.0,3,8,1610,0,1981,0,98058,47.4476,-122.124,2010,9271,5,19,2014,UNK,-400,2976
1189000700,10/1/2014,625000.0,3,1.5,1600,4128,1.5,0.0,0.0,3,8,1250,350,1906,0,98122,47.6122,-122.29700000000001,1540,3976,10,1,2014,UNK,60,152
7923700030,4/14/2015,490000.0,3,1.0,1420,11040,1.0,0.0,0.0,4,7,1420,0,1961,0,98007,47.5969,-122.14,1530,8208,4,14,2015,UNK,-110,2832
1796360340,7/22/2014,269950.0,3,2.0,1660,8641,2.0,0.0,0.0,4,8,1660,0,1987,0,98042,47.3663,-122.088,1490,8641,7,22,2014,UNK,170,0
625059036,8/13/2014,2700000.0,5,4.0,4230,27295,2.0,1.0,4.0,3,8,3230,1000,1949,0,98033,47.6803,-122.214,2660,27295,8,13,2014,UNK,1570,0
5694500200,8/13/2014,829000.0,4,3.0,3310,4500,2.5,0.0,0.0,5,9,2910,400,1900,0,98103,47.6594,-122.345,1440,3750,8,13,2014,UNK,1870,750
224069114,8/29/2014,635000.0,4,2.5,2470,77550,1.0,0.0,0.0,4,7,2470,0,1987,0,98075,47.5888,-122.01100000000001,2490,40894,8,29,2014,UNK,-20,36656
5379802871,3/12/2015,217500.0,3,1.0,1040,9750,1.0,0.0,0.0,3,7,1040,0,1959,0,98188,47.4553,-122.274,1510,11100,3,12,2015,UNK,-470,-1350
1311600030,7/16/2014,270000.0,4,1.75,1850,7350,1.0,0.0,0.0,3,7,1050,800,1965,0,98001,47.3413,-122.277,1450,7250,7,16,2014,UNK,400,100
669000350,9/26/2014,1250000.0,3,3.0,4610,8400,2.0,0.0,2.0,3,8,2790,1820,1947,1999,98144,47.5854,-122.292,2160,5000,9,26,2014,Y,2450,3400
2494000070,1/27/2015,480000.0,4,2.5,2480,5100,2.0,0.0,0.0,3,8,2480,0,2007,0,98019,47.7383,-121.969,2270,5115,1,27,2015,N,210,-15
2771600350,5/6/2014,575000.0,3,1.75,2130,6500,1.0,0.0,2.0,3,8,1170,960,1954,0,98199,47.6424,-122.38600000000001,2020,5000,5,6,2014,UNK,110,1500
1091310140,11/3/2014,426950.0,4,2.75,2350,5589,2.0,0.0,0.0,3,7,2350,0,2001,0,98059,47.5098,-122.155,2014,6365,11,3,2014,UNK,336,-776
1450100390,9/5/2014,125000.0,3,1.0,920,7314,1.0,0.0,0.0,3,6,920,0,1960,0,98002,47.2892,-122.22,1010,7420,9,5,2014,UNK,-90,-106
1450100390,3/16/2015,208000.0,3,1.0,920,7314,1.0,0.0,0.0,3,6,920,0,1960,0,98002,47.2892,-122.22,1010,7420,3,16,2015,UNK,-90,-106
2473250400,9/24/2014,325000.0,4,2.0,1780,10622,1.0,0.0,0.0,4,7,900,880,1976,0,98058,47.4573,-122.15799999999999,1550,8900,9,24,2014,UNK,230,1722
1420700030,9/22/2014,597157.0,7,4.0,2690,10880,1.0,0.0,0.0,4,8,2690,0,1960,0,98033,47.6787,-122.16799999999999,1840,10836,9,22,2014,UNK,850,44
3630110340,1/7/2015,728725.0,4,2.5,3010,3120,2.5,0.0,2.0,3,8,3010,0,2006,0,98029,47.5539,-121.99600000000001,2140,3840,1,7,2015,N,870,-720
1313000240,8/18/2014,708000.0,5,2.0,3180,10800,1.0,0.0,0.0,3,8,1910,1270,1968,0,98052,47.6354,-122.103,2440,9750,8,18,2014,UNK,740,1050
1441600160,7/23/2014,1300000.0,4,3.0,4120,14021,2.0,0.0,0.0,3,11,4120,0,2005,0,98075,47.5985,-122.02600000000001,4390,14684,7,23,2014,N,-270,-663
8807600140,4/24/2015,405000.0,3,1.0,1280,11625,1.0,0.0,0.0,4,7,1280,0,1977,0,98053,47.6827,-122.059,1320,10875,4,24,2015,UNK,-40,750
8928100125,10/28/2014,550000.0,4,2.75,1690,6090,1.5,0.0,0.0,3,7,1400,290,1945,0,98115,47.6814,-122.26899999999999,1820,6090,10,28,2014,UNK,-130,0
7853302180,4/9/2015,451000.0,4,2.5,2320,5375,2.0,0.0,0.0,3,7,2320,0,2006,0,98065,47.5415,-121.883,2060,5395,4,9,2015,N,260,-20
9325200160,6/19/2014,540500.0,5,3.75,3090,7415,2.0,0.0,0.0,3,8,3090,0,2014,0,98166,47.435,-122.329,2790,7425,6,19,2014,N,300,-10
98001000,10/7/2014,1030000.0,5,3.5,5050,16500,2.0,0.0,2.0,3,11,5050,0,2001,0,98075,47.5863,-121.96700000000001,4570,16500,10,7,2014,UNK,480,0
3306200240,11/25/2014,218000.0,4,1.0,1640,10455,1.0,0.0,0.0,3,7,950,690,1963,0,98023,47.2974,-122.366,1360,9750,11,25,2014,UNK,280,705
7436500060,10/20/2014,562000.0,4,2.25,2170,7007,1.0,0.0,0.0,3,8,1540,630,1974,0,98033,47.672,-122.169,2040,7700,10,20,2014,UNK,130,-693
1022059032,8/12/2014,401500.0,4,2.5,3140,94525,2.0,0.0,0.0,4,8,2280,860,1977,0,98042,47.4155,-122.163,1910,14300,8,12,2014,UNK,1230,80225
1523049083,11/12/2014,196700.0,2,1.0,1090,9994,1.0,0.0,0.0,3,7,1090,0,1954,0,98168,47.4761,-122.287,1090,11700,11,12,2014,UNK,0,-1706
9346920070,8/22/2014,583000.0,3,1.75,1930,10183,1.0,0.0,0.0,4,8,1480,450,1975,0,98006,47.5624,-122.135,2320,10000,8,22,2014,UNK,-390,183
5709200030,12/4/2014,309900.0,5,2.5,2100,17825,1.0,0.0,0.0,4,7,1400,700,1974,0,98092,47.3094,-122.191,2200,14602,12,4,2014,UNK,-100,3223
5104470070,10/16/2014,485000.0,4,3.0,3110,18843,2.0,0.0,0.0,3,9,3110,0,1995,0,98058,47.4619,-122.154,3080,14735,10,16,2014,UNK,30,4108
3330500075,4/24/2015,465000.0,3,1.0,930,3348,1.0,0.0,0.0,4,6,930,0,1926,0,98118,47.5532,-122.277,1210,3348,4,24,2015,UNK,-280,0
200800200,8/12/2014,595000.0,4,2.25,2050,8372,2.0,0.0,0.0,4,8,2050,0,1984,0,98052,47.7234,-122.10700000000001,2010,8037,8,12,2014,UNK,40,335
1432400570,7/18/2014,254000.0,3,1.0,1160,7560,1.0,0.0,0.0,4,6,1160,0,1958,0,98058,47.45,-122.179,1160,7560,7,18,2014,UNK,0,0
1552510160,10/30/2014,488500.0,3,2.75,1820,9490,2.0,0.0,0.0,3,7,1820,0,1994,0,98011,47.7481,-122.178,1950,8851,10,30,2014,UNK,-130,639
2473460860,10/27/2014,260000.0,4,2.5,2110,8990,2.0,0.0,0.0,3,8,2110,0,1977,0,98058,47.4457,-122.12700000000001,2040,8800,10,27,2014,UNK,70,190
7812800681,1/2/2015,166000.0,2,1.0,870,8487,1.0,0.0,0.0,4,6,870,0,1944,0,98178,47.4955,-122.23899999999999,1350,6850,1,2,2015,UNK,-480,1637
579000550,11/7/2014,440000.0,2,1.5,1080,6760,1.0,0.0,2.0,3,6,1080,0,1923,0,98117,47.7008,-122.38600000000001,2080,5800,11,7,2014,UNK,-1000,960
2916200138,2/2/2015,375000.0,3,2.0,1260,7560,2.0,0.0,0.0,5,6,1260,0,1943,0,98133,47.7225,-122.351,1260,7595,2,2,2015,UNK,0,-35
6821100125,2/25/2015,529500.0,2,1.0,900,4800,1.0,0.0,0.0,4,6,780,120,1944,0,98199,47.6575,-122.4,1270,5520,2,25,2015,UNK,-370,-720
1529300135,10/14/2014,338000.0,2,1.0,750,6439,1.0,0.0,0.0,4,6,750,0,1934,0,98103,47.6995,-122.354,1470,6374,10,14,2014,UNK,-720,65
4124000320,3/16/2015,335620.0,3,2.25,1800,15903,1.0,0.0,0.0,3,8,1340,460,1986,0,98038,47.3813,-122.04299999999999,2000,15233,3,16,2015,UNK,-200,670
1775910370,2/5/2015,464000.0,4,2.25,2220,15232,1.0,0.0,0.0,3,9,1690,530,1978,0,98072,47.7449,-122.103,2110,15280,2,5,2015,UNK,110,-48
4365200505,10/3/2014,354000.0,2,1.0,1390,7740,1.0,0.0,0.0,4,6,1390,0,1925,0,98126,47.5232,-122.37100000000001,1290,7740,10,3,2014,UNK,100,0
7960100030,8/14/2014,601000.0,4,3.5,2160,3600,2.0,0.0,0.0,3,8,1660,500,1998,0,98122,47.6103,-122.29700000000001,1230,3840,8,14,2014,UNK,930,-240
9264900350,4/24/2015,285000.0,3,2.25,1840,9040,1.0,0.0,0.0,3,8,1370,470,1979,0,98023,47.3144,-122.339,1870,8992,4,24,2015,UNK,-30,48
955000060,9/30/2014,462500.0,2,2.0,1690,4200,2.0,0.0,0.0,3,7,1690,0,1906,0,98112,47.621,-122.303,1540,4200,9,30,2014,UNK,150,0
5205000160,7/11/2014,350000.0,4,2.5,2650,10459,2.0,0.0,0.0,4,8,2650,0,1989,0,98003,47.2739,-122.29299999999999,2340,8777,7,11,2014,UNK,310,1682
6145600955,12/24/2014,329000.0,4,1.0,1120,3844,1.0,0.0,0.0,3,7,1120,0,1972,0,98133,47.7038,-122.352,1480,3844,12,24,2014,UNK,-360,0
2472950350,4/11/2015,312500.0,4,2.5,2500,11983,1.0,0.0,0.0,3,7,1320,1180,1984,2008,98058,47.4292,-122.148,1460,9005,4,11,2015,Y,1040,2978
9475710060,6/13/2014,370000.0,4,2.5,2220,5338,2.0,0.0,0.0,3,7,2220,0,2001,0,98059,47.4887,-122.15,2220,5338,6,13,2014,UNK,0,0
1112700060,3/11/2015,399900.0,3,1.75,1260,12750,1.0,0.0,0.0,3,7,1260,0,1979,0,98034,47.7289,-122.23299999999999,1460,7865,3,11,2015,UNK,-200,4885
66000140,11/20/2014,398000.0,3,1.0,1480,6550,1.5,0.0,0.0,4,6,1480,0,1925,0,98126,47.5498,-122.381,1200,6550,11,20,2014,UNK,280,0
1021000060,3/4/2015,550500.0,2,1.5,930,7400,1.0,0.0,2.0,4,7,830,100,1909,0,98116,47.5691,-122.40799999999999,1920,4152,3,4,2015,UNK,-990,3248
4154304740,2/24/2015,709000.0,3,2.75,2780,7200,1.5,0.0,0.0,4,8,1870,910,1913,0,98118,47.5632,-122.27,1700,7200,2,24,2015,UNK,1080,0
7972604215,12/12/2014,402000.0,5,2.75,2770,7620,1.0,0.0,0.0,3,7,1700,1070,1965,0,98106,47.5188,-122.348,1720,7620,12,12,2014,UNK,1050,0
7979900126,6/26/2014,450000.0,3,1.5,1530,23660,1.0,0.0,0.0,3,7,1530,0,1952,0,98155,47.7467,-122.295,1800,11407,6,26,2014,UNK,-270,12253
2821100125,11/20/2014,524000.0,3,2.25,2140,6720,1.0,0.0,0.0,3,8,1440,700,1961,0,98117,47.6949,-122.396,2060,6720,11,20,2014,UNK,80,0
2323089065,12/17/2014,800000.0,4,2.75,4600,322188,1.0,0.0,4.0,3,10,2400,2200,1989,0,98045,47.4626,-121.73899999999999,3740,114562,12,17,2014,UNK,860,207626
6623400187,9/23/2014,185000.0,4,1.0,1760,8906,1.0,0.0,0.0,3,7,1230,530,1966,0,98055,47.4288,-122.198,1180,10407,9,23,2014,UNK,580,-1501
6623400187,2/20/2015,365000.0,4,1.0,1760,8906,1.0,0.0,0.0,3,7,1230,530,1966,0,98055,47.4288,-122.198,1180,10407,2,20,2015,UNK,580,-1501
325049234,9/9/2014,925000.0,4,2.5,3110,11422,2.0,0.0,0.0,3,9,3110,0,1989,0,98115,47.6833,-122.271,2850,7254,9,9,2014,UNK,260,4168
8016300240,4/2/2015,714000.0,3,1.75,2260,11781,1.0,0.0,0.0,4,8,1520,740,1968,0,98008,47.5982,-122.12799999999999,2530,10176,4,2,2015,UNK,-270,1605
7955040160,10/16/2014,495000.0,3,2.0,1460,9759,1.0,0.0,0.0,5,7,1460,0,1972,0,98052,47.6644,-122.14399999999999,1620,8421,10,16,2014,UNK,-160,1338
6414600232,4/20/2015,535000.0,3,2.25,2050,6648,1.0,0.0,0.0,3,7,1230,820,1990,0,98133,47.7258,-122.33200000000001,1760,7200,4,20,2015,UNK,290,-552
1824059070,10/24/2014,880000.0,4,2.5,2340,10800,1.0,0.0,0.0,3,8,2340,0,1953,2007,98040,47.5715,-122.225,2650,13500,10,24,2014,Y,-310,-2700
6031400013,6/16/2014,150000.0,3,1.5,1230,8056,1.0,0.0,0.0,4,6,1230,0,1949,0,98168,47.4878,-122.314,850,6714,6,16,2014,UNK,380,1342
9557300570,3/27/2015,554500.0,3,2.25,1880,6565,1.0,0.0,0.0,4,8,1420,460,1972,0,98008,47.6396,-122.113,2060,7280,3,27,2015,UNK,-180,-715
4443800960,4/8/2015,520000.0,3,1.75,1280,3880,1.5,0.0,0.0,5,7,1280,0,1916,0,98117,47.6871,-122.391,980,3880,4,8,2015,UNK,300,0
7203220310,8/22/2014,839990.0,4,2.75,3660,5637,2.0,0.0,0.0,3,9,3660,0,2014,0,98053,47.6845,-122.01700000000001,3625,5639,8,22,2014,N,35,-2
7202330030,8/22/2014,500000.0,3,2.5,1650,5683,2.0,0.0,0.0,3,7,1650,0,2003,0,98053,47.683,-122.035,1650,4193,8,22,2014,UNK,0,1490
3353404510,1/7/2015,305000.0,2,1.0,1960,186872,1.5,0.0,0.0,4,6,1960,0,1936,0,98001,47.2681,-122.26700000000001,1650,19200,1,7,2015,UNK,310,167672
6064800550,8/2/2014,247800.0,3,2.5,1580,2170,2.0,0.0,0.0,3,7,1580,0,2003,0,98118,47.5418,-122.289,1610,1917,8,2,2014,UNK,-30,253
1786630160,7/11/2014,344200.0,4,2.5,2490,5812,2.0,0.0,0.0,3,8,2490,0,2000,0,98042,47.3875,-122.155,2690,6012,7,11,2014,UNK,-200,-200
3709500140,6/23/2014,459950.0,4,2.5,2000,6107,2.0,0.0,0.0,3,8,2000,0,2003,0,98011,47.7557,-122.221,2040,6520,6,23,2014,UNK,-40,-413
7942300070,9/15/2014,229900.0,4,1.75,1550,9899,1.0,0.0,0.0,4,7,1550,0,1967,0,98030,47.3583,-122.18299999999999,1500,11272,9,15,2014,UNK,50,-1373
7525300240,2/19/2015,750000.0,4,2.25,2820,9602,1.0,0.0,1.0,3,8,1950,870,1974,0,98008,47.5881,-122.113,2890,9602,2,19,2015,UNK,-70,0
3579000800,10/24/2014,509000.0,4,2.5,2600,9355,1.0,0.0,0.0,3,9,1840,760,1983,0,98028,47.7446,-122.249,2250,7691,10,24,2014,UNK,350,1664
3577000116,3/25/2015,680000.0,4,1.0,2200,12137,1.0,0.0,4.0,4,8,1640,560,1956,0,98028,47.7473,-122.26100000000001,3250,17153,3,25,2015,UNK,-1050,-5016
5490210320,6/27/2014,661500.0,5,2.5,2500,7200,1.0,0.0,0.0,4,7,1490,1010,1977,0,98052,47.6964,-122.12,1960,8325,6,27,2014,UNK,540,-1125
3259400030,11/25/2014,370000.0,2,1.0,1270,1399,3.0,0.0,0.0,3,7,1270,0,2000,0,98136,47.5552,-122.381,1140,1442,11,25,2014,UNK,130,-43
3134100162,7/17/2014,785000.0,4,2.75,2900,17400,1.0,0.0,0.0,4,8,2410,490,1978,0,98052,47.6431,-122.10799999999999,2620,12240,7,17,2014,UNK,280,5160
9277700075,8/18/2014,355000.0,2,1.0,840,6720,1.0,0.0,0.0,3,7,840,0,1952,0,98116,47.5707,-122.396,1250,6720,8,18,2014,UNK,-410,0
1172000135,7/31/2014,446000.0,4,2.0,1940,6350,1.0,0.0,0.0,4,7,970,970,1951,0,98103,47.6948,-122.35700000000001,960,6350,7,31,2014,UNK,980,0
1025059094,1/28/2015,830000.0,5,3.5,3490,21780,2.0,0.0,0.0,3,8,3490,0,1996,0,98052,47.6707,-122.14399999999999,3070,7829,1,28,2015,UNK,420,13951
6705900070,10/28/2014,324000.0,3,2.5,1940,8347,2.0,0.0,0.0,3,8,1940,0,1990,0,98042,47.3654,-122.164,1940,7131,10,28,2014,UNK,0,1216
9522400350,10/8/2014,500000.0,4,2.25,2490,23478,2.0,0.0,0.0,3,8,2490,0,1981,0,98072,47.7547,-122.094,2030,12611,10,8,2014,UNK,460,10867
650000030,10/17/2014,745000.0,3,1.0,1390,9112,1.0,0.0,0.0,4,7,1390,0,1951,0,98004,47.6071,-122.197,2290,9112,10,17,2014,UNK,-900,0
8712100435,11/10/2014,1200000.0,4,2.5,3940,4407,2.0,0.0,0.0,4,8,2620,1320,1921,0,98112,47.6374,-122.29899999999999,1790,4407,11,10,2014,UNK,2150,0
1530900560,12/15/2014,385000.0,2,2.5,1760,3710,1.0,0.0,0.0,3,8,1130,630,1988,0,98072,47.7335,-122.16,1760,4200,12,15,2014,UNK,0,-490
6868200060,12/11/2014,565000.0,3,2.25,2560,8040,1.0,0.0,0.0,3,8,1510,1050,1958,0,98125,47.7124,-122.303,1980,8040,12,11,2014,UNK,580,0
7767400060,11/19/2014,465000.0,4,2.5,2300,7314,1.0,0.0,0.0,4,8,1420,880,1979,0,98133,47.7671,-122.33,2010,7314,11,19,2014,UNK,290,0
820000012,8/27/2014,401000.0,3,3.25,1770,1977,3.0,0.0,0.0,3,8,1770,0,2001,0,98125,47.7186,-122.314,1860,2210,8,27,2014,UNK,-90,-233
3308030060,6/19/2014,385000.0,3,1.75,2310,11200,1.0,0.0,0.0,4,8,1630,680,1978,0,98030,47.3637,-122.21,2350,13300,6,19,2014,UNK,-40,-2100
9485750240,10/17/2014,395000.0,3,2.5,2310,4930,2.0,0.0,0.0,4,8,2310,0,1989,0,98055,47.4512,-122.208,2230,5324,10,17,2014,UNK,80,-394
3826000550,4/14/2015,245000.0,5,1.5,2000,8100,1.5,0.0,0.0,3,6,2000,0,1946,0,98168,47.4945,-122.304,960,9239,4,14,2015,UNK,1040,-1139
7960100075,3/25/2015,500000.0,3,2.0,1540,3600,1.0,0.0,0.0,3,7,890,650,1994,0,98122,47.6103,-122.296,1540,3600,3,25,2015,UNK,0,0
7461400400,11/3/2014,334000.0,5,1.75,2590,6720,1.0,0.0,0.0,4,7,1750,840,1979,0,98055,47.435,-122.19200000000001,1820,7521,11,3,2014,UNK,770,-801
6206100030,5/1/2015,550000.0,3,1.0,980,10960,1.0,0.0,0.0,4,7,980,0,1953,0,98005,47.5908,-122.17299999999999,2100,10960,5,1,2015,UNK,-1120,0
7888300340,11/24/2014,216000.0,3,1.0,1730,7950,1.0,0.0,0.0,4,7,1180,550,1961,0,98198,47.3644,-122.31200000000001,1830,8890,11,24,2014,UNK,-100,-940
1180000885,10/30/2014,340500.0,3,2.5,3070,5871,3.0,0.0,0.0,4,8,2510,560,1928,0,98178,47.5007,-122.223,2220,4000,10,30,2014,UNK,850,1871
1081330060,8/13/2014,375000.0,4,2.25,2100,12738,2.0,0.0,0.0,4,8,2100,0,1975,0,98059,47.4698,-122.118,2000,12090,8,13,2014,UNK,100,648
9536600105,1/9/2015,600000.0,3,2.75,2080,16740,1.0,0.0,3.0,3,8,1580,500,1966,0,98198,47.3632,-122.324,2175,7568,1,9,2015,UNK,-95,9172
2783100160,5/15/2014,375000.0,4,1.75,1890,8000,1.0,0.0,0.0,4,7,1250,640,1960,0,98133,47.7576,-122.333,1870,8270,5,15,2014,UNK,20,-270
9297301505,5/9/2014,536500.0,4,1.75,2000,4000,1.5,0.0,0.0,5,7,1450,550,1926,0,98126,47.5659,-122.375,1430,4000,5,9,2014,UNK,570,0
5561300340,9/24/2014,599900.0,3,3.0,3030,35123,2.0,0.0,0.0,4,8,1760,1270,1984,0,98027,47.4694,-122.006,2810,36205,9,24,2014,UNK,220,-1082
1794500695,3/4/2015,750000.0,2,1.5,1110,3600,1.0,0.0,0.0,5,7,1110,0,1904,0,98119,47.6382,-122.359,1670,5400,3,4,2015,UNK,-560,-1800
2797500030,2/11/2015,355000.0,3,1.0,1650,10075,1.0,0.0,0.0,3,7,1170,480,1955,0,98177,47.7695,-122.359,1690,8125,2,11,2015,UNK,-40,1950
9214400125,7/1/2014,590000.0,3,2.0,1410,6413,1.0,0.0,0.0,4,7,910,500,1947,0,98115,47.6826,-122.29799999999999,1330,6050,7,1,2014,UNK,80,363
6821101895,5/7/2015,680000.0,2,1.0,2140,6000,1.0,0.0,0.0,4,7,1070,1070,1946,0,98199,47.651,-122.399,1560,6000,5,7,2015,UNK,580,0
8079040140,10/6/2014,429000.0,3,2.5,1860,11122,2.0,0.0,0.0,3,8,1860,0,1994,0,98059,47.5062,-122.15100000000001,2420,8542,10,6,2014,UNK,-560,2580
7518507580,5/2/2015,581000.0,2,1.0,1170,4080,1.0,0.0,0.0,4,7,1170,0,1909,0,98117,47.6784,-122.38600000000001,1560,4586,5,2,2015,UNK,-390,-506
3863800030,3/31/2015,463800.0,3,1.5,980,7770,1.0,0.0,0.0,4,7,980,0,1968,0,98033,47.6923,-122.20100000000001,1470,7350,3,31,2015,UNK,-490,420
3303850390,12/12/2014,2980000.0,5,5.5,7400,18898,2.0,0.0,3.0,3,13,6290,1110,2001,0,98006,47.5431,-122.11200000000001,6110,26442,12,12,2014,UNK,1290,-7544
7128300060,7/7/2014,443000.0,5,1.75,1650,3000,1.5,0.0,0.0,3,8,1650,0,1902,0,98144,47.5955,-122.306,1740,4000,7,7,2014,UNK,-90,-1000
104510340,9/25/2014,276200.0,3,2.5,1480,7210,1.0,0.0,0.0,3,7,1180,300,1986,0,98023,47.3124,-122.351,1690,7396,9,25,2014,UNK,-210,-186
114101505,4/23/2015,630000.0,5,3.5,4060,8309,2.0,0.0,0.0,3,9,2960,1100,2001,0,98028,47.757,-122.228,1730,11711,4,23,2015,UNK,2330,-3402
1928300350,12/22/2014,570000.0,3,1.75,1370,3300,2.0,0.0,0.0,5,7,1370,0,1927,0,98105,47.6714,-122.32,1560,3927,12,22,2014,UNK,-190,-627
1370800560,10/13/2014,979700.0,4,2.25,2480,6000,2.0,0.0,2.0,3,10,2380,100,1929,0,98199,47.6392,-122.406,3030,5600,10,13,2014,UNK,-550,400
8825900310,12/11/2014,730000.0,4,2.5,2030,4080,1.5,0.0,0.0,4,8,1730,300,1921,0,98115,47.6753,-122.311,1980,4080,12,11,2014,UNK,50,0
4167700240,12/4/2014,268450.0,5,2.25,2200,9600,1.0,0.0,0.0,4,7,1100,1100,1963,0,98023,47.3263,-122.36399999999999,1780,9680,12,4,2014,UNK,420,-80
2138800060,3/4/2015,490000.0,3,1.75,1770,7508,1.0,0.0,0.0,3,7,1270,500,1962,0,98133,47.7354,-122.34299999999999,1690,8880,3,4,2015,UNK,80,-1372
579002220,8/27/2014,808000.0,3,2.5,2550,6240,1.0,0.0,3.0,5,8,1750,800,1957,0,98117,47.6992,-122.387,2180,5200,8,27,2014,UNK,370,1040
9144300060,4/30/2015,350000.0,3,1.0,1250,9786,1.0,0.0,0.0,4,7,1250,0,1969,0,98072,47.7622,-122.163,1660,9621,4,30,2015,UNK,-410,165
4441300416,10/28/2014,695000.0,4,1.75,2390,5880,1.0,0.0,2.0,3,8,1390,1000,1957,0,98117,47.6956,-122.399,2210,6260,10,28,2014,UNK,180,-380
3225069301,6/12/2014,1230000.0,4,2.5,5730,44947,2.0,0.0,4.0,3,11,4280,1450,1991,0,98074,47.6052,-122.064,3310,17628,6,12,2014,UNK,2420,27319
6620400400,8/13/2014,309950.0,1,1.0,1120,11800,1.5,0.0,0.0,3,7,1120,0,1950,0,98168,47.5123,-122.331,2330,9290,8,13,2014,UNK,-1210,2510
3361402041,10/30/2014,134000.0,3,1.0,1270,8508,1.0,0.0,0.0,4,6,650,620,1942,0,98168,47.4961,-122.322,1200,9415,10,30,2014,UNK,70,-907
1150000340,11/18/2014,645500.0,4,2.5,2390,9638,2.0,0.0,0.0,3,10,2390,0,1988,0,98029,47.5598,-122.01799999999999,2630,9258,11,18,2014,UNK,-240,380
7015200800,3/9/2015,750000.0,3,2.0,1760,5488,1.5,0.0,0.0,3,7,1540,220,1927,0,98119,47.6479,-122.367,1760,5943,3,9,2015,UNK,0,-455
5316100106,10/10/2014,1400000.0,3,2.5,2560,3600,2.0,0.0,0.0,3,9,2110,450,1967,0,98112,47.632,-122.279,2690,4800,10,10,2014,UNK,-130,-1200
3102700160,9/25/2014,344900.0,4,1.75,1820,7700,1.0,0.0,0.0,4,7,1100,720,1955,0,98177,47.7545,-122.35700000000001,1700,8500,9,25,2014,UNK,120,-800
8129700565,10/8/2014,601450.0,2,3.25,1840,1500,3.0,0.0,0.0,3,8,1840,0,2001,0,98103,47.6595,-122.354,1910,2500,10,8,2014,UNK,-70,-1000
9839300125,1/7/2015,575000.0,4,2.0,1810,4400,2.0,0.0,0.0,3,8,1700,110,1909,0,98122,47.6132,-122.292,1470,4400,1,7,2015,UNK,340,0
2011400710,5/21/2014,405000.0,3,1.75,2470,9620,1.0,0.0,1.0,4,7,1570,900,1962,0,98198,47.3996,-122.32,2600,9620,5,21,2014,UNK,-130,0
1522700060,6/24/2014,518000.0,4,2.75,2520,14021,2.0,0.0,0.0,3,9,2520,0,1999,0,98019,47.7344,-121.95700000000001,2330,14007,6,24,2014,UNK,190,14
7568700135,7/17/2014,265000.0,2,1.0,1600,7936,1.0,0.0,0.0,3,7,1600,0,1947,0,98155,47.7411,-122.322,1580,7440,7,17,2014,UNK,20,496
8651411070,9/25/2014,180000.0,3,1.0,1280,4875,1.0,0.0,0.0,5,6,1280,0,1969,0,98042,47.3686,-122.081,1060,4875,9,25,2014,UNK,220,0
2616700520,3/18/2015,285000.0,3,2.5,1590,9736,2.0,0.0,0.0,3,7,1590,0,1985,0,98001,47.33,-122.27799999999999,1580,7500,3,18,2015,UNK,10,2236
4415600030,3/16/2015,433000.0,3,2.75,2000,7200,1.0,0.0,0.0,3,7,1000,1000,1954,2014,98166,47.4531,-122.352,1440,7200,3,16,2015,Y,560,0
1072000260,2/23/2015,399000.0,3,1.75,1780,11440,1.0,0.0,0.0,3,8,1350,430,1977,0,98059,47.474,-122.139,2180,11440,2,23,2015,UNK,-400,0
8045000340,8/2/2014,565000.0,3,2.5,1700,7210,2.0,0.0,0.0,5,7,1700,0,1966,0,98052,47.6688,-122.161,1700,7566,8,2,2014,UNK,0,-356
42000127,2/24/2015,406500.0,3,1.5,1970,10080,1.0,0.0,0.0,3,7,1970,0,1966,0,98168,47.4703,-122.27600000000001,2240,10080,2,24,2015,UNK,-270,0
2205500335,8/7/2014,420000.0,4,1.75,1940,11500,1.0,0.0,0.0,4,7,1090,850,1955,0,98006,47.5774,-122.147,1700,8360,8,7,2014,UNK,240,3140
1814800060,2/20/2015,965000.0,4,3.5,3290,5559,1.5,0.0,0.0,3,8,2290,1000,1906,2004,98103,47.6788,-122.346,1790,6000,2,20,2015,Y,1500,-441
3885804260,10/24/2014,1380000.0,4,3.5,3500,9523,2.0,0.0,0.0,3,10,2460,1040,1996,0,98033,47.6848,-122.208,3160,5997,10,24,2014,UNK,340,3526
9264920270,10/7/2014,353950.0,5,2.25,3260,7969,2.0,0.0,0.0,4,8,3260,0,1982,0,98023,47.31399999999999,-122.344,2070,7962,10,7,2014,UNK,1190,7
1778350160,7/10/2014,847700.0,5,3.25,4230,10260,2.0,0.0,0.0,3,10,3860,370,1996,0,98027,47.5503,-122.081,2980,10997,7,10,2014,UNK,1250,-737
623049185,7/2/2014,185000.0,5,1.0,1590,6700,1.5,0.0,0.0,3,6,1090,500,1942,0,98146,47.5075,-122.35,1370,8040,7,2,2014,UNK,220,-1340
1180002735,11/19/2014,269000.0,2,1.5,1010,6000,1.0,0.0,0.0,4,7,1010,0,1923,0,98178,47.49800000000001,-122.22200000000001,1290,6000,11,19,2014,UNK,-280,0
3876313100,12/24/2014,422800.0,3,1.75,1820,8400,1.0,0.0,0.0,3,7,1340,480,1976,0,98072,47.733999999999995,-122.17,1900,8112,12,24,2014,UNK,-80,288
826000295,12/15/2014,379950.0,2,1.0,870,7500,1.0,0.0,0.0,3,7,870,0,1947,0,98136,47.5465,-122.384,1240,5709,12,15,2014,UNK,-370,1791
3876311860,12/26/2014,525000.0,3,2.0,1620,7800,1.0,0.0,0.0,3,7,1200,420,1969,0,98034,47.7288,-122.171,1540,7565,12,26,2014,UNK,80,235
2224079050,7/18/2014,810000.0,4,3.5,3980,209523,2.0,0.0,2.0,3,9,3980,0,2006,0,98024,47.5574,-121.89,2220,65775,7,18,2014,N,1760,143748
8945000260,7/22/2014,209950.0,4,1.0,1630,8400,1.0,0.0,0.0,3,6,1630,0,1962,0,98023,47.3052,-122.36200000000001,1190,8989,7,22,2014,UNK,440,-589
2768301182,12/4/2014,439950.0,3,2.0,1230,1613,2.0,0.0,0.0,3,8,1010,220,2003,0,98107,47.6661,-122.37,1610,1873,12,4,2014,UNK,-380,-260
1827200135,5/23/2014,554820.0,4,2.0,3510,12905,1.0,0.0,2.0,3,8,2210,1300,1965,0,98166,47.4466,-122.36,2530,16143,5,23,2014,UNK,980,-3238
4307300520,4/23/2015,359000.0,4,2.5,2160,4500,2.0,0.0,0.0,3,7,2160,0,2002,0,98056,47.4819,-122.182,2160,4496,4,23,2015,UNK,0,4
6632900354,9/10/2014,242500.0,3,1.0,1020,5870,1.0,0.0,0.0,3,6,1020,0,1941,0,98155,47.74100000000001,-122.314,1160,6901,9,10,2014,UNK,-140,-1031
9540100060,9/26/2014,330000.0,3,1.75,1590,9417,1.0,0.0,0.0,4,7,1590,0,1954,0,98177,47.7617,-122.36,1600,9272,9,26,2014,UNK,-10,145
2424059116,11/5/2014,740000.0,3,2.25,3440,44374,2.0,0.0,3.0,4,10,2190,1250,1979,0,98006,47.547,-122.111,3470,40185,11,5,2014,UNK,-30,4189
7600125,12/18/2014,630000.0,5,1.0,3020,4800,2.0,0.0,0.0,3,7,3020,0,1901,0,98122,47.6025,-122.31299999999999,1350,1307,12,18,2014,UNK,1670,3493
579003645,8/15/2014,750000.0,3,1.75,2280,7800,1.0,0.0,3.0,4,8,1360,920,1941,0,98117,47.6985,-122.387,2280,5200,8,15,2014,UNK,0,2600
3224600340,10/13/2014,695000.0,4,2.5,2790,6540,2.0,0.0,0.0,3,9,2790,0,1999,0,98074,47.6087,-122.016,2790,6270,10,13,2014,UNK,0,270
7129800036,1/14/2015,109000.0,2,0.5,580,6900,1.0,0.0,0.0,3,5,580,0,1941,0,98118,47.5135,-122.262,1570,5040,1,14,2015,UNK,-990,1860
3294700421,2/25/2015,389000.0,3,1.5,2030,10075,1.0,0.0,0.0,5,7,1080,950,1961,0,98055,47.4713,-122.197,2210,10075,2,25,2015,UNK,-180,0
6746700565,10/23/2014,447000.0,2,1.0,850,2700,1.0,0.0,0.0,5,6,850,0,1924,0,98105,47.6684,-122.316,1630,3000,10,23,2014,UNK,-780,-300
742000060,12/30/2014,1200000.0,3,2.0,2480,13310,1.0,0.0,0.0,2,7,2480,0,1955,0,98052,47.6759,-122.11399999999999,2400,11340,12,30,2014,UNK,80,1970
626059155,12/10/2014,315000.0,3,1.75,1010,12000,1.0,0.0,0.0,4,7,1010,0,1977,0,98011,47.77,-122.20700000000001,1080,10619,12,10,2014,UNK,-70,1381
1150000200,4/14/2015,640000.0,3,2.5,2420,8244,2.0,0.0,0.0,3,10,2420,0,1988,0,98029,47.5595,-122.01899999999999,2500,9320,4,14,2015,UNK,-80,-1076
1592000640,11/19/2014,570000.0,3,2.25,2180,9246,2.0,0.0,0.0,3,9,2180,0,1984,0,98074,47.6215,-122.031,2300,9298,11,19,2014,UNK,-120,-52
3123039171,8/5/2014,495000.0,3,2.75,1830,208216,2.0,0.0,0.0,3,8,1830,0,1997,0,98070,47.4377,-122.464,1530,16988,8,5,2014,UNK,300,191228
3876312010,6/3/2014,449500.0,5,2.75,2040,7488,1.0,0.0,0.0,4,7,1200,840,1969,0,98034,47.7289,-122.17200000000001,1530,7488,6,3,2014,UNK,510,0
5364200695,3/17/2015,1080000.0,4,2.75,2640,5000,2.0,0.0,0.0,3,9,1840,800,1943,0,98105,47.6619,-122.275,2010,5000,3,17,2015,UNK,630,0
7979900806,3/11/2015,294950.0,2,1.0,1060,7868,1.0,0.0,0.0,3,7,1060,0,1952,0,98155,47.7414,-122.295,1530,10728,3,11,2015,UNK,-470,-2860
8643200060,9/23/2014,170500.0,3,1.0,1640,13939,1.0,0.0,0.0,3,7,1040,600,1960,0,98198,47.3947,-122.31299999999999,2080,13000,9,23,2014,UNK,-440,939
7972602080,12/8/2014,312000.0,4,1.0,1190,7620,1.5,0.0,0.0,3,6,1190,0,1926,0,98106,47.5281,-122.348,1060,7320,12,8,2014,UNK,130,300
7212650200,10/27/2014,350000.0,3,2.5,2180,15484,1.0,0.0,0.0,3,8,2180,0,1992,0,98003,47.2688,-122.309,2090,10775,10,27,2014,UNK,90,4709
8079100140,7/28/2014,690000.0,4,2.5,2120,8448,2.0,0.0,0.0,4,9,2120,0,1989,0,98029,47.5654,-122.01,2140,8122,7,28,2014,UNK,-20,326
8091800140,6/10/2014,375000.0,4,2.5,2210,9427,2.0,0.0,0.0,3,7,2210,0,1999,0,98148,47.4323,-122.32700000000001,1770,8770,6,10,2014,UNK,440,657
7214720510,8/6/2014,575000.0,4,2.5,2510,47044,2.0,0.0,0.0,3,9,2510,0,1987,0,98077,47.7699,-122.085,2600,42612,8,6,2014,UNK,-90,4432
9346920260,6/4/2014,646000.0,4,2.25,2500,8500,1.0,0.0,0.0,4,8,1600,900,1978,0,98006,47.5615,-122.131,2290,8927,6,4,2014,UNK,210,-427
3750603471,3/27/2015,239950.0,3,2.5,1560,4800,2.0,0.0,0.0,4,7,1560,0,1974,0,98001,47.2653,-122.285,1510,12240,3,27,2015,UNK,50,-7440
3438502501,7/29/2014,400000.0,5,2.5,2510,7525,1.5,0.0,0.0,4,7,1710,800,1929,0,98106,47.5422,-122.359,1270,6741,7,29,2014,UNK,1240,784
1775500310,1/21/2015,455000.0,4,1.75,3060,94089,1.0,0.0,0.0,3,8,3060,0,1958,0,98072,47.744,-122.087,2180,43995,1,21,2015,UNK,880,50094
1796380310,9/4/2014,240000.0,3,2.0,1310,8069,1.0,0.0,0.0,3,7,1310,0,1990,0,98042,47.3694,-122.083,1310,8392,9,4,2014,UNK,0,-323
1118000320,5/8/2015,3400000.0,4,4.0,4260,11765,2.0,0.0,0.0,3,11,3280,980,1939,2010,98112,47.63800000000001,-122.288,4260,10408,5,8,2015,Y,0,1357
3362401000,7/1/2014,695000.0,3,2.0,2500,4080,1.5,0.0,0.0,5,7,1680,820,1922,0,98103,47.6813,-122.346,1550,3060,7,1,2014,UNK,950,1020
7454000990,9/24/2014,304950.0,2,1.0,670,6720,1.0,0.0,0.0,5,6,670,0,1942,0,98126,47.5151,-122.37200000000001,710,6720,9,24,2014,UNK,-40,0
5244800125,8/5/2014,650000.0,3,1.75,1840,2310,1.0,0.0,2.0,4,8,1140,700,1914,0,98109,47.6462,-122.351,1670,4000,8,5,2014,UNK,170,-1690
789000520,7/15/2014,402500.0,3,1.75,1480,2211,2.0,0.0,0.0,3,7,1480,0,1995,0,98103,47.6966,-122.35,1480,2197,7,15,2014,UNK,0,14
7852000340,6/25/2014,482000.0,3,2.5,2420,7307,2.0,0.0,0.0,3,7,2420,0,1998,0,98065,47.5361,-121.87100000000001,2420,5577,6,25,2014,UNK,0,1730
8827900560,10/31/2014,655000.0,3,2.0,1820,4480,1.0,0.0,0.0,5,7,1120,700,1923,0,98105,47.6717,-122.295,1920,4480,10,31,2014,UNK,-100,0
2768000390,9/26/2014,577000.0,5,2.75,1940,5000,2.0,0.0,0.0,5,7,1940,0,1951,0,98107,47.6704,-122.36200000000001,1940,4230,9,26,2014,UNK,0,770
2475200370,10/20/2014,350000.0,3,2.5,1630,5996,2.0,0.0,0.0,3,7,1630,0,1986,0,98055,47.4738,-122.19,1660,4504,10,20,2014,UNK,-30,1492
8731981940,9/8/2014,415000.0,4,2.25,2520,8000,1.0,0.0,2.0,3,8,1680,840,1970,0,98023,47.3202,-122.383,2300,8000,9,8,2014,UNK,220,0
3626079032,7/30/2014,396400.0,4,2.5,2120,215186,2.0,0.0,0.0,2,7,2120,0,1983,0,98014,47.701,-121.85700000000001,2000,215186,7,30,2014,UNK,120,0
6646200710,4/9/2015,654300.0,3,2.5,2490,8582,2.0,0.0,0.0,3,9,2490,0,2000,0,98074,47.625,-122.042,2870,7598,4,9,2015,UNK,-380,984
7167000060,11/24/2014,774950.0,4,2.5,3410,179419,2.0,0.0,0.0,3,10,3410,0,2004,0,98010,47.3602,-121.986,3350,175421,11,24,2014,N,60,3998
5249802085,9/2/2014,855000.0,4,2.0,2380,10800,2.0,0.0,2.0,3,8,2380,0,1925,0,98118,47.5682,-122.275,2112,6600,9,2,2014,UNK,268,4200
3528900060,6/26/2014,1150000.0,3,2.5,2490,4000,2.0,0.0,0.0,5,8,1670,820,1918,0,98109,47.6403,-122.35,2310,4000,6,26,2014,UNK,180,0
6056100295,5/30/2014,330000.0,2,2.5,1240,1546,2.0,0.0,0.0,3,7,1240,0,2007,0,98108,47.5634,-122.29799999999999,1520,2468,5,30,2014,N,-280,-922
9392200030,9/23/2014,290000.0,4,2.25,1900,10950,1.0,0.0,0.0,4,7,1400,500,1959,0,98032,47.3582,-122.28399999999999,1700,11850,9,23,2014,UNK,200,-900
936000055,11/19/2014,519500.0,3,3.0,2390,19454,1.5,0.0,0.0,3,8,2390,0,2008,0,98166,47.4545,-122.336,1540,26979,11,19,2014,N,850,-7525
3840700560,8/14/2014,450000.0,3,1.75,1810,12600,1.0,0.0,0.0,3,7,1400,410,1977,0,98034,47.7143,-122.23299999999999,1934,12600,8,14,2014,UNK,-124,0
333100295,11/24/2014,3120000.0,3,3.5,4490,56609,2.0,1.0,4.0,3,12,4490,0,1993,0,98034,47.6997,-122.24,2710,51330,11,24,2014,UNK,1780,5279
133000127,6/23/2014,265000.0,3,1.0,1620,9450,1.5,0.0,0.0,3,7,1620,0,1928,0,98168,47.5136,-122.31299999999999,2070,11970,6,23,2014,UNK,-450,-2520
4221970060,5/6/2015,359000.0,4,2.5,2640,7883,2.0,0.0,0.0,3,8,2640,0,1990,0,98092,47.3124,-122.18799999999999,2150,7683,5,6,2015,UNK,490,200
1732800310,3/2/2015,2000000.0,4,3.75,2870,4500,2.0,0.0,3.0,3,10,2510,360,2012,0,98119,47.6291,-122.363,2870,6354,3,2,2015,N,0,-1854
2025069037,2/10/2015,1050000.0,4,2.5,3250,48037,1.0,0.0,2.0,3,8,2030,1220,1985,0,98074,47.6326,-122.07,2970,48037,2,10,2015,UNK,280,0
2516000486,7/1/2014,402500.0,2,1.0,800,2280,1.0,0.0,0.0,5,6,800,0,1946,0,98107,47.6588,-122.36200000000001,1310,4200,7,1,2014,UNK,-510,-1920
4037400070,8/25/2014,450000.0,3,1.75,1360,5445,1.0,0.0,0.0,4,7,1360,0,1957,0,98008,47.6071,-122.12299999999999,1570,7840,8,25,2014,UNK,-210,-2395
3375300370,3/6/2015,262500.0,5,2.25,1950,8086,1.0,0.0,0.0,3,7,1130,820,1980,0,98003,47.3179,-122.331,1670,8550,3,6,2015,UNK,280,-464
1682500240,2/25/2015,285000.0,4,2.25,1970,7200,2.0,0.0,0.0,3,8,1970,0,1979,0,98092,47.3132,-122.182,1790,7500,2,25,2015,UNK,180,-300
6806100340,3/4/2015,290000.0,3,2.5,2020,4861,2.0,0.0,0.0,3,7,2020,0,2005,0,98058,47.4659,-122.14399999999999,2170,4600,3,4,2015,N,-150,261
8682281070,8/7/2014,752500.0,2,2.5,2280,6230,1.0,0.0,0.0,3,8,2280,0,2005,0,98053,47.7065,-122.01299999999999,1640,5931,8,7,2014,N,640,299
8691330260,12/8/2014,820000.0,4,2.75,3540,13515,2.0,0.0,0.0,3,10,3540,0,1998,0,98075,47.5945,-121.98200000000001,3540,11538,12,8,2014,UNK,0,1977
869700140,8/11/2014,292000.0,3,2.5,1560,2740,2.0,0.0,0.0,3,8,1560,0,1999,0,98059,47.4909,-122.154,1310,2698,8,11,2014,UNK,250,42
7221400320,10/3/2014,213000.0,2,1.0,750,6089,1.0,0.0,2.0,3,6,750,0,1937,0,98055,47.475,-122.199,1430,6451,10,3,2014,UNK,-680,-362
7454001125,11/17/2014,400000.0,4,3.0,2240,7035,2.0,0.0,0.0,3,7,2240,0,1942,1993,98146,47.5124,-122.374,1060,6300,11,17,2014,Y,1180,735
7129304375,7/14/2014,202000.0,1,0.75,590,5650,1.0,0.0,0.0,3,6,590,0,1944,0,98118,47.5181,-122.26700000000001,980,5650,7,14,2014,UNK,-390,0
6189200260,5/4/2015,617450.0,3,2.0,1580,14398,1.0,0.0,0.0,3,7,1080,500,1981,0,98005,47.6328,-122.17399999999999,1650,14407,5,4,2015,UNK,-70,-9
1430800162,1/14/2015,250000.0,3,1.0,1040,8000,1.0,0.0,0.0,4,7,1040,0,1956,0,98166,47.4711,-122.35,1170,9450,1,14,2015,UNK,-130,-1450
2570300240,5/29/2014,405000.0,5,1.75,1880,10000,1.0,0.0,0.0,3,7,960,920,1963,0,98034,47.7182,-122.20100000000001,1580,10000,5,29,2014,UNK,300,0
3294700320,3/31/2015,325000.0,2,1.0,1070,8750,1.0,0.0,0.0,3,7,1070,0,1951,0,98055,47.4734,-122.198,1300,9670,3,31,2015,UNK,-230,-920
2976800700,5/22/2014,301350.0,3,3.0,1860,7440,1.0,0.0,0.0,5,7,1040,820,1954,0,98178,47.5035,-122.255,1490,8160,5,22,2014,UNK,370,-720
7625704340,3/3/2015,425000.0,2,1.75,1550,7800,1.0,0.0,0.0,3,7,1050,500,1940,0,98136,47.5436,-122.39,1370,5000,3,3,2015,UNK,180,2800
9238900390,9/5/2014,460000.0,3,1.0,1860,6360,1.0,0.0,0.0,3,8,1470,390,1954,0,98136,47.5327,-122.39200000000001,1770,6175,9,5,2014,UNK,90,185
4139430310,4/19/2015,938000.0,3,2.5,3090,10940,2.0,0.0,2.0,3,10,3090,0,1992,0,98006,47.5492,-122.119,3410,12157,4,19,2015,UNK,-320,-1217
1402630270,7/29/2014,348000.0,3,1.75,1720,8867,1.0,0.0,0.0,3,8,1320,400,1985,0,98058,47.44,-122.13600000000001,2200,9170,7,29,2014,UNK,-480,-303
3735901600,6/6/2014,435000.0,2,1.0,1260,4080,1.5,0.0,0.0,5,7,1260,0,1926,0,98115,47.687,-122.32,1720,4080,6,6,2014,UNK,-460,0
739500270,11/13/2014,227950.0,3,1.5,1120,11430,1.0,0.0,0.0,4,7,1120,0,1963,0,98031,47.4105,-122.194,1790,8760,11,13,2014,UNK,-670,2670
3566800125,3/30/2015,425000.0,2,1.0,1250,5880,1.0,0.0,0.0,3,6,900,350,1948,0,98117,47.6908,-122.391,1520,5020,3,30,2015,UNK,-270,860
2886200070,6/2/2014,550000.0,3,2.0,1810,4064,1.5,0.0,0.0,3,7,1810,0,1925,0,98103,47.6859,-122.339,1518,2945,6,2,2014,UNK,292,1119
3529300060,7/21/2014,347500.0,3,2.5,1890,7053,2.0,0.0,0.0,4,8,1890,0,1992,0,98031,47.3967,-122.18299999999999,2000,7226,7,21,2014,UNK,-110,-173
3085001610,9/30/2014,397000.0,4,1.75,2020,6000,1.0,0.0,0.0,3,7,1620,400,1959,0,98144,47.577,-122.302,1870,4000,9,30,2014,UNK,150,2000
9414500200,6/2/2014,410000.0,4,1.75,1790,11875,1.0,0.0,0.0,4,7,1490,300,1969,0,98027,47.522,-122.04700000000001,1870,11760,6,2,2014,UNK,-80,115
8651611230,7/11/2014,780000.0,3,3.5,3190,6776,2.0,0.0,0.0,3,10,3190,0,1998,0,98074,47.6348,-122.064,3230,7189,7,11,2014,UNK,-40,-413
8712100350,9/9/2014,1350000.0,4,3.25,3030,5164,1.5,0.0,0.0,5,9,2700,330,1925,0,98112,47.6394,-122.29899999999999,1890,4415,9,9,2014,UNK,1140,749
7202350310,10/28/2014,476000.0,3,2.25,1630,3070,2.0,0.0,0.0,3,7,1630,0,2004,0,98053,47.6785,-122.03,1690,3200,10,28,2014,N,-60,-130
1326059070,7/8/2014,390000.0,3,1.75,1180,16552,1.0,0.0,0.0,4,7,1180,0,1967,0,98072,47.7426,-122.116,2780,45302,7,8,2014,UNK,-1600,-28750
1311900240,12/30/2014,226500.0,3,2.0,1560,7000,1.0,0.0,0.0,4,7,1560,0,1968,0,98001,47.3355,-122.28399999999999,1560,7200,12,30,2014,UNK,0,-200
7518503490,7/31/2014,495000.0,3,2.0,1340,2550,2.0,0.0,0.0,3,7,1340,0,1984,0,98117,47.6793,-122.38,1370,5100,7,31,2014,UNK,-30,-2550
6669200200,3/19/2015,1500000.0,5,3.25,2590,11500,1.0,0.0,2.0,4,9,2590,0,1968,0,98040,47.545,-122.229,2780,11989,3,19,2015,UNK,-190,-489
3438501860,4/22/2015,385000.0,3,1.0,1020,5950,1.0,0.0,0.0,3,6,880,140,1950,0,98106,47.5436,-122.35700000000001,1800,5950,4,22,2015,UNK,-780,0
7852170570,3/9/2015,535950.0,3,2.5,2370,5344,2.0,0.0,0.0,3,9,2370,0,2003,0,98065,47.54,-121.863,2990,5418,3,9,2015,UNK,-620,-74
9290850060,10/22/2014,910000.0,4,2.5,3170,32430,2.5,0.0,0.0,3,10,3170,0,1989,0,98053,47.6903,-122.056,3360,35610,10,22,2014,UNK,-190,-3180
4206901505,3/26/2015,465000.0,2,1.0,1120,4000,1.0,0.0,0.0,3,7,1120,0,1926,0,98105,47.6567,-122.32700000000001,1620,4000,3,26,2015,UNK,-500,0
6600220550,6/26/2014,495000.0,3,1.75,1440,11787,1.0,0.0,0.0,3,8,1440,0,1983,0,98074,47.6276,-122.03299999999999,2190,11787,6,26,2014,UNK,-750,0
8699100160,2/10/2015,250000.0,4,2.0,2170,5404,1.5,0.0,0.0,5,6,1470,700,1920,0,98002,47.3046,-122.22,1030,5477,2,10,2015,UNK,1140,-73
1068000520,5/6/2014,1230000.0,4,2.25,3490,6906,2.0,0.0,0.0,4,10,2280,1210,1928,0,98199,47.6424,-122.40700000000001,2540,6223,5,6,2014,UNK,950,683
2558610070,2/17/2015,400000.0,4,2.25,1970,8941,2.0,0.0,0.0,3,7,1970,0,1973,0,98034,47.7223,-122.17200000000001,1880,7793,2,17,2015,UNK,90,1148
1829300270,8/21/2014,715000.0,4,2.5,2780,13521,2.0,0.0,0.0,3,10,2780,0,1987,0,98074,47.6374,-122.042,2980,11454,8,21,2014,UNK,-200,2067
7212650240,2/23/2015,342000.0,3,2.0,2250,7757,1.0,0.0,0.0,3,8,2250,0,1992,0,98003,47.2684,-122.30799999999999,1970,6866,2,23,2015,UNK,280,891
3205200240,4/30/2015,420000.0,4,1.75,1340,8400,1.0,0.0,0.0,5,7,1340,0,1967,0,98056,47.5382,-122.17299999999999,1980,8400,4,30,2015,UNK,-640,0
1682000350,7/8/2014,148226.0,3,1.0,1400,7360,1.0,0.0,0.0,4,7,1400,0,1968,0,98092,47.3123,-122.186,1600,8030,7,8,2014,UNK,-200,-670
7229900885,11/3/2014,313000.0,3,1.0,1510,10369,1.0,0.0,0.0,4,7,1010,500,1968,0,98059,47.4808,-122.09899999999999,1510,16057,11,3,2014,UNK,0,-5688
7888000400,6/3/2014,150000.0,3,1.0,1320,8220,1.0,0.0,0.0,3,7,1320,0,1959,0,98198,47.3697,-122.309,1320,7920,6,3,2014,UNK,0,300
523049195,5/22/2014,150000.0,2,1.0,820,10270,1.0,0.0,0.0,3,7,820,0,1954,0,98168,47.5119,-122.329,1670,10086,5,22,2014,UNK,-850,184
1423400160,6/18/2014,230000.0,2,1.0,1080,9435,1.0,0.0,0.0,3,6,1080,0,1958,0,98058,47.458999999999996,-122.181,1200,9210,6,18,2014,UNK,-120,225
1766600075,9/2/2014,389100.0,2,1.0,840,5400,1.0,0.0,0.0,4,7,840,0,1948,0,98118,47.5489,-122.271,1340,5400,9,2,2014,UNK,-500,0
1088020070,12/16/2014,645000.0,4,2.25,2070,8720,1.0,0.0,0.0,5,8,1360,710,1974,0,98033,47.6678,-122.182,2180,8510,12,16,2014,UNK,-110,210
7893200486,3/2/2015,310000.0,3,1.0,1520,6500,1.0,0.0,0.0,3,7,990,530,1958,0,98198,47.4164,-122.33200000000001,1500,7500,3,2,2015,UNK,20,-1000
8929000060,10/4/2014,351358.0,2,1.75,1210,1189,2.0,0.0,0.0,3,8,1210,0,2014,0,98029,47.5526,-121.99799999999999,1540,1672,10,4,2014,N,-330,-483
8146200070,3/10/2015,1700000.0,5,2.75,3810,9360,2.0,0.0,0.0,3,10,3810,0,2014,0,98004,47.6039,-122.194,2110,9870,3,10,2015,N,1700,-510
624069050,4/7/2015,1570000.0,4,3.5,5370,323215,2.0,0.0,0.0,3,10,5370,0,2002,0,98075,47.6003,-122.07600000000001,3780,9891,4,7,2015,UNK,1590,313324
5318100935,10/20/2014,850000.0,3,2.0,1540,3600,2.0,0.0,0.0,3,8,1540,0,1900,1988,98112,47.6343,-122.28299999999999,2970,3600,10,20,2014,Y,-1430,0
1313300340,5/14/2014,470000.0,4,2.5,2310,14023,2.0,0.0,0.0,3,9,2310,0,1991,0,98019,47.7351,-121.964,2410,14007,5,14,2014,UNK,-100,16
8032700070,11/18/2014,770000.0,3,2.25,1870,1900,3.0,0.0,0.0,3,8,1870,0,2008,0,98103,47.6537,-122.34,1690,1694,11,18,2014,N,180,206
1072000240,6/24/2014,366000.0,3,1.75,1840,11440,1.0,0.0,0.0,4,8,1340,500,1977,0,98059,47.474,-122.14,1940,11440,6,24,2014,UNK,-100,0
3904920390,7/10/2014,545000.0,3,2.5,2060,7184,2.0,0.0,0.0,3,8,2060,0,1987,0,98029,47.567,-122.012,2230,7788,7,10,2014,UNK,-170,-604
7345200400,9/9/2014,205000.0,3,1.0,1010,8800,1.0,0.0,0.0,4,7,1010,0,1968,0,98002,47.2761,-122.208,1550,7700,9,9,2014,UNK,-540,1100
923000270,5/8/2014,405000.0,2,1.0,1020,8155,1.0,0.0,0.0,4,7,1020,0,1948,0,98177,47.7257,-122.361,1430,8157,5,8,2014,UNK,-410,-2
7016310270,4/10/2015,467000.0,4,2.5,2220,7210,1.0,0.0,0.0,3,7,1270,950,1973,0,98011,47.7428,-122.18299999999999,2220,7313,4,10,2015,UNK,0,-103
3650100105,9/26/2014,392500.0,2,1.0,1050,4125,1.0,0.0,0.0,4,7,1050,0,1909,0,98144,47.5736,-122.307,1650,4125,9,26,2014,UNK,-600,0
3761100240,10/27/2014,901000.0,4,2.75,3030,18400,1.5,0.0,3.0,3,9,2360,670,1973,0,98034,47.7019,-122.243,3030,12486,10,27,2014,UNK,0,5914
2126049277,12/3/2014,500000.0,3,1.75,1800,7199,1.0,0.0,0.0,3,7,1300,500,1972,0,98125,47.7264,-122.307,1800,8100,12,3,2014,UNK,0,-901
253600160,5/30/2014,384950.0,3,2.5,1860,3690,2.0,0.0,0.0,3,7,1860,0,2000,0,98028,47.776,-122.23899999999999,1870,4394,5,30,2014,UNK,-10,-704
1623069046,3/12/2015,1700000.0,4,3.5,4070,336283,2.0,0.0,0.0,3,11,4070,0,2006,0,98027,47.478,-122.038,3020,44613,3,12,2015,N,1050,291670
9235900030,7/17/2014,245000.0,2,1.0,860,6120,1.0,0.0,0.0,3,7,860,0,1948,0,98155,47.7503,-122.32799999999999,1100,6860,7,17,2014,UNK,-240,-740
5451200370,2/9/2015,1170000.0,4,2.25,3080,10487,2.0,0.0,0.0,4,9,3080,0,1968,0,98040,47.5344,-122.22399999999999,2480,10607,2,9,2015,UNK,600,-120
7338000270,4/21/2015,184500.0,3,1.5,1280,3640,2.0,0.0,0.0,3,6,1280,0,1983,0,98002,47.333999999999996,-122.214,1150,4105,4,21,2015,UNK,130,-465
2115720270,4/14/2015,269000.0,2,2.0,1540,5000,1.5,0.0,0.0,3,8,1540,0,1986,0,98023,47.318999999999996,-122.39399999999999,1590,5000,4,14,2015,UNK,-50,0
11200070,7/21/2014,570000.0,3,2.5,1530,3296,2.0,0.0,0.0,3,8,1530,0,1998,0,98007,47.6181,-122.13799999999999,1530,4099,7,21,2014,UNK,0,-803
8732300060,5/12/2014,850000.0,4,1.75,2350,11914,1.0,0.0,0.0,4,8,2350,0,1961,0,98040,47.5392,-122.228,2240,10706,5,12,2014,UNK,110,1208
8651410240,2/2/2015,209000.0,3,1.0,920,5200,1.0,0.0,0.0,4,6,920,0,1969,0,98042,47.3647,-122.08200000000001,920,4875,2,2,2015,UNK,0,325
3342102220,8/6/2014,327000.0,4,1.75,1840,5100,1.0,0.0,0.0,4,5,1840,0,1933,0,98056,47.5209,-122.205,2160,5400,8,6,2014,UNK,-320,-300
7663700783,6/13/2014,369500.0,3,1.5,1650,9957,1.0,0.0,0.0,4,7,1100,550,1961,0,98125,47.7303,-122.29799999999999,1650,7957,6,13,2014,UNK,0,2000
9477201370,2/26/2015,440000.0,3,1.75,1760,8025,1.0,0.0,0.0,4,7,1230,530,1976,0,98034,47.7287,-122.19200000000001,1590,7543,2,26,2015,UNK,170,482
1923000370,5/12/2014,947500.0,4,2.25,3290,12329,1.5,0.0,0.0,4,10,3290,0,1968,0,98040,47.5639,-122.21600000000001,3170,12329,5,12,2014,UNK,120,0
6841700070,3/17/2015,510000.0,2,1.0,1270,4500,1.5,0.0,0.0,4,7,1270,0,1919,0,98122,47.6059,-122.295,2140,4550,3,17,2015,UNK,-870,-50
3293700105,4/28/2015,385000.0,3,2.0,1600,10318,1.0,0.0,0.0,3,7,930,670,1941,0,98133,47.7466,-122.34700000000001,1590,7040,4,28,2015,UNK,10,3278
8001450060,8/20/2014,370000.0,5,3.0,2670,9920,1.0,0.0,0.0,3,8,1400,1270,1990,0,98001,47.3211,-122.277,1890,10341,8,20,2014,UNK,780,-421
2877104316,12/1/2014,660000.0,4,1.5,1960,4500,1.5,0.0,2.0,3,7,1960,0,1922,0,98117,47.6797,-122.359,1960,4500,12,1,2014,UNK,0,0
1522039105,1/15/2015,729000.0,3,4.25,3300,308080,2.0,0.0,2.0,4,9,2520,780,1976,0,98070,47.3979,-122.416,2130,90604,1,15,2015,UNK,1170,217476
924069190,8/19/2014,440000.0,3,1.75,2000,11880,2.0,0.0,0.0,3,8,2000,0,1979,0,98075,47.5882,-122.052,1820,15120,8,19,2014,UNK,180,-3240
2722059185,9/10/2014,445000.0,4,2.5,2360,81892,1.0,0.0,0.0,3,8,2360,0,2000,0,98042,47.369,-122.156,1730,18096,9,10,2014,UNK,630,63796
4073200575,12/1/2014,460000.0,2,1.0,1430,12092,1.0,0.0,0.0,4,7,1430,0,1938,0,98125,47.7023,-122.27600000000001,2320,10800,12,1,2014,UNK,-890,1292
9542600070,12/2/2014,516000.0,3,3.0,2330,7304,1.0,0.0,0.0,3,9,1300,1030,1971,0,98005,47.5982,-122.17200000000001,2330,9518,12,2,2014,UNK,0,-2214
2459960030,8/15/2014,343888.0,4,2.5,2060,5607,2.0,0.0,0.0,3,7,2060,0,2002,0,98058,47.4365,-122.14399999999999,2060,5367,8,15,2014,UNK,0,240
259800640,6/9/2014,500000.0,4,1.75,2240,9886,1.5,0.0,0.0,4,7,2240,0,1965,0,98008,47.6294,-122.116,1540,8040,6,9,2014,UNK,700,1846
1223039195,5/8/2015,465000.0,5,1.75,2330,6450,1.0,0.0,1.0,3,8,1330,1000,1958,0,98146,47.4959,-122.367,2330,8258,5,8,2015,UNK,0,-1808
1545804510,5/12/2014,302000.0,5,2.25,2180,7813,2.0,0.0,0.0,3,7,2180,0,1986,0,98038,47.3651,-122.051,1880,8649,5,12,2014,UNK,300,-836
1921059045,11/7/2014,195000.0,2,1.0,1280,7861,1.0,0.0,0.0,4,6,1280,0,1913,0,98002,47.3007,-122.228,1020,6480,11,7,2014,UNK,260,1381
8078460070,6/9/2014,640000.0,3,2.5,2140,8925,2.0,0.0,0.0,3,8,2140,0,1991,0,98074,47.6314,-122.027,2310,8956,6,9,2014,UNK,-170,-31
7525300260,6/23/2014,502000.0,6,2.5,2890,8122,1.0,0.0,0.0,3,8,1630,1260,1977,0,98008,47.5886,-122.113,2730,9915,6,23,2014,UNK,160,-1793
4249400270,4/17/2015,360000.0,3,2.5,1480,3851,2.0,0.0,0.0,3,8,1480,0,1998,0,98072,47.7732,-122.163,1650,4716,4,17,2015,UNK,-170,-865
179000240,3/25/2015,290500.0,4,2.5,1680,3000,2.0,0.0,0.0,3,7,1680,0,2003,0,98178,47.494,-122.279,1420,5500,3,25,2015,UNK,260,-2500
8856004327,5/9/2014,248000.0,4,3.0,2163,5883,2.0,0.0,0.0,3,7,2163,0,2006,0,98001,47.2734,-122.251,1700,10143,5,9,2014,N,463,-4260
8029550160,5/16/2014,433000.0,4,2.5,2280,7568,2.0,0.0,0.0,4,7,2280,0,2001,0,98056,47.5115,-122.194,2280,5312,5,16,2014,UNK,0,2256
5016001260,4/13/2015,480000.0,2,1.0,820,4200,1.0,0.0,0.0,3,7,820,0,1980,0,98112,47.6249,-122.29799999999999,1290,4000,4,13,2015,UNK,-470,200
1133000036,4/21/2015,410000.0,3,1.0,1330,5000,1.0,0.0,0.0,3,7,1120,210,1957,0,98125,47.7211,-122.30799999999999,1920,7790,4,21,2015,UNK,-590,-2790
5416510710,5/5/2014,309950.0,4,2.75,2310,5000,2.0,0.0,0.0,3,7,2310,0,2006,0,98038,47.3614,-122.035,1980,5000,5,5,2014,N,330,0
1796380060,12/1/2014,253000.0,3,2.0,1290,7372,1.0,0.0,0.0,5,7,1290,0,1990,0,98042,47.3658,-122.085,1290,7366,12,1,2014,UNK,0,6
1223089050,5/6/2014,280000.0,3,1.75,1630,11800,1.0,0.0,0.0,4,7,1630,0,1971,0,98045,47.4863,-121.73,2090,57428,5,6,2014,UNK,-460,-45628
7436900060,4/24/2015,440000.0,3,1.0,1410,8925,1.0,0.0,0.0,3,7,1410,0,1958,0,98052,47.6782,-122.162,1330,8925,4,24,2015,UNK,80,0
2202500135,11/18/2014,333000.0,5,1.75,1240,8936,1.0,0.0,0.0,3,7,1240,0,1954,0,98006,47.5738,-122.13600000000001,1600,9341,11,18,2014,UNK,-360,-405
224069195,6/16/2014,759950.0,3,2.5,3100,23790,2.0,0.0,0.0,3,9,3100,0,2002,0,98075,47.5882,-122.01100000000001,2250,40854,6,16,2014,UNK,850,-17064
9407101180,12/24/2014,345000.0,3,2.25,2020,9000,2.0,0.0,0.0,3,7,2020,0,1979,0,98045,47.4487,-121.775,1460,9680,12,24,2014,UNK,560,-680
6699950310,9/26/2014,350000.0,4,2.5,2500,5831,2.0,0.0,0.0,3,8,2500,0,2007,0,98038,47.3454,-122.039,2500,5188,9,26,2014,N,0,643
5379800810,8/7/2014,198000.0,2,1.0,790,14200,1.0,0.0,0.0,3,7,790,0,1951,0,98188,47.458999999999996,-122.285,1430,10000,8,7,2014,UNK,-640,4200
711000070,7/25/2014,730000.0,3,1.75,2040,11294,1.0,0.0,0.0,4,7,1340,700,1952,0,98004,47.5923,-122.197,2120,9587,7,25,2014,UNK,-80,1707
5127001170,5/28/2014,266200.0,3,1.5,1430,9600,1.0,0.0,0.0,4,7,1430,0,1966,0,98059,47.4737,-122.15,1590,10240,5,28,2014,UNK,-160,-640
191100140,3/16/2015,1060000.0,4,2.5,2250,10160,2.0,0.0,0.0,5,8,2250,0,1967,0,98040,47.5645,-122.219,2660,10125,3,16,2015,UNK,-410,35
6198400218,9/19/2014,95000.0,2,1.0,1070,20450,1.0,0.0,0.0,2,6,1070,0,1948,0,98058,47.4338,-122.18299999999999,1360,15581,9,19,2014,UNK,-290,4869
3578400270,6/23/2014,430000.0,3,1.75,1300,12731,1.0,0.0,0.0,3,8,1300,0,1981,0,98074,47.6236,-122.04,1700,13556,6,23,2014,UNK,-400,-825
9573120260,6/10/2014,650000.0,4,2.25,2560,9731,2.0,0.0,0.0,4,7,2560,0,1973,0,98034,47.7261,-122.24600000000001,1860,9731,6,10,2014,UNK,700,0
2310110070,3/17/2015,379900.0,3,2.5,2190,5071,2.0,0.0,0.0,3,8,2190,0,2004,0,98038,47.3506,-122.04,2300,5654,3,17,2015,N,-110,-583
6413600192,4/27/2015,325000.0,2,1.5,940,1222,2.0,0.0,0.0,3,7,860,80,2004,0,98125,47.7178,-122.318,1302,1840,4,27,2015,N,-362,-618
4037500335,6/6/2014,455000.0,4,2.25,1740,8449,1.0,0.0,0.0,4,7,1170,570,1958,0,98008,47.6079,-122.12299999999999,1980,11175,6,6,2014,UNK,-240,-2726
5141000510,9/15/2014,392000.0,4,3.75,2220,3797,1.5,0.0,0.0,4,6,1330,890,1917,0,98108,47.5574,-122.315,1490,4340,9,15,2014,UNK,730,-543
3876311180,9/4/2014,373000.0,3,1.75,1310,7811,1.0,0.0,0.0,3,7,1310,0,1976,0,98034,47.7319,-122.167,1530,7800,9,4,2014,UNK,-220,11
5036300575,10/16/2014,951250.0,5,3.0,2710,8227,1.0,0.0,2.0,3,8,1910,800,1953,0,98199,47.6505,-122.39,2060,5400,10,16,2014,UNK,650,2827
384000135,6/24/2014,502000.0,3,2.0,1300,14350,1.0,0.0,0.0,3,7,1300,0,1955,0,98006,47.5736,-122.152,1520,10670,6,24,2014,UNK,-220,3680
322059326,4/27/2015,362500.0,3,2.0,1940,40588,1.0,0.0,0.0,3,7,1940,0,2000,0,98058,47.4252,-122.15899999999999,1860,9657,4,27,2015,UNK,80,30931
9530101670,6/23/2014,525000.0,2,1.0,1080,3500,1.0,0.0,3.0,3,7,1080,0,1924,0,98103,47.6667,-122.35600000000001,1790,4000,6,23,2014,UNK,-710,-500
5490220030,2/25/2015,580000.0,4,2.5,2110,11680,1.0,0.0,0.0,4,7,1420,690,1977,0,98052,47.6964,-122.118,1890,9600,2,25,2015,UNK,220,2080
2459500070,12/22/2014,278000.0,3,2.25,1590,9425,1.0,0.0,0.0,3,7,1170,420,1985,0,98058,47.4291,-122.16,1590,9394,12,22,2014,UNK,0,31
7312400075,12/16/2014,422500.0,2,1.0,910,4800,1.0,0.0,0.0,4,7,910,0,1923,0,98126,47.5536,-122.37700000000001,1450,5000,12,16,2014,UNK,-540,-200
7011200830,9/9/2014,783200.0,4,2.0,1590,5400,1.0,0.0,2.0,3,7,990,600,1900,0,98119,47.637,-122.367,2190,4800,9,9,2014,UNK,-600,600
8691390860,6/20/2014,715000.0,4,2.5,3290,6628,2.0,0.0,0.0,3,9,3290,0,2003,0,98075,47.5994,-121.975,3240,5831,6,20,2014,UNK,50,797
8929000350,8/4/2014,472217.0,3,2.5,2010,2212,2.0,0.0,0.0,3,8,1390,0,2014,0,98029,47.5523,-121.99799999999999,1690,1619,8,4,2014,N,320,593
1322049335,5/28/2014,244615.0,3,2.5,2060,4030,2.0,0.0,0.0,3,7,2060,0,1999,0,98032,47.3909,-122.238,2060,4029,5,28,2014,UNK,0,1
7715600070,12/12/2014,385000.0,3,1.75,1560,14288,1.0,0.0,0.0,3,6,780,780,1944,0,98125,47.7183,-122.306,1320,8928,12,12,2014,UNK,240,5360
2985800070,7/25/2014,549995.0,3,1.0,1120,6600,1.0,0.0,0.0,3,7,1120,0,1943,0,98105,47.6712,-122.26700000000001,1300,6600,7,25,2014,UNK,-180,0
98000560,8/16/2014,959900.0,4,3.75,3550,15151,2.0,0.0,0.0,3,11,3550,0,2004,0,98075,47.5888,-121.971,4340,15151,8,16,2014,N,-790,0
125059179,7/23/2014,510000.0,6,4.5,3300,7200,2.0,0.0,0.0,3,8,3300,0,1980,0,98052,47.6798,-122.104,2470,7561,7,23,2014,UNK,830,-361
7558800570,8/13/2014,367000.0,3,1.75,2000,12669,1.0,0.0,3.0,4,7,1200,800,1965,0,98070,47.3579,-122.446,1580,12055,8,13,2014,UNK,420,614
9378700200,10/8/2014,375000.0,5,3.0,2680,8410,2.0,0.0,0.0,3,8,1810,870,1990,0,98058,47.4401,-122.126,1860,8410,10,8,2014,UNK,820,0
2767603612,5/12/2014,500000.0,2,2.25,1290,1334,3.0,0.0,0.0,3,8,1290,0,2007,0,98107,47.6719,-122.382,1350,1334,5,12,2014,N,-60,0
2767603612,1/13/2015,489000.0,2,2.25,1290,1334,3.0,0.0,0.0,3,8,1290,0,2007,0,98107,47.6719,-122.382,1350,1334,1,13,2015,N,-60,0
3259400024,4/27/2015,340000.0,3,2.0,1150,700,2.0,0.0,0.0,3,7,800,350,2000,0,98136,47.5552,-122.381,1060,1910,4,27,2015,UNK,90,-1210
7954000125,5/1/2015,562000.0,3,1.75,1880,5978,1.0,0.0,0.0,5,7,940,940,1957,0,98144,47.5793,-122.294,1930,4770,5,1,2015,UNK,-50,1208
5535600640,9/12/2014,489950.0,3,2.5,2400,7478,2.0,0.0,0.0,3,9,2400,0,2002,0,98019,47.7362,-121.97399999999999,2980,8182,9,12,2014,UNK,-580,-704
1313000710,10/3/2014,652000.0,3,2.25,1920,9600,1.0,0.0,0.0,4,8,1560,360,1968,0,98052,47.6341,-122.103,2040,9600,10,3,2014,UNK,-120,0
1786700240,10/24/2014,472000.0,4,3.25,4350,7090,2.0,0.0,0.0,3,8,2870,1480,1999,0,98042,47.3747,-122.156,2490,7266,10,24,2014,UNK,1860,-176
2739200160,6/12/2014,333000.0,4,2.5,1910,9244,1.0,0.0,0.0,4,6,1910,0,1963,0,98059,47.4918,-122.141,2590,9286,6,12,2014,UNK,-680,-42
2874600335,5/30/2014,560000.0,3,1.5,2000,7350,1.0,0.0,0.0,3,8,2000,0,1953,0,98177,47.7061,-122.368,1890,6960,5,30,2014,UNK,110,390
3222049159,12/1/2014,799000.0,4,3.5,3290,20107,2.0,0.0,4.0,3,10,2220,1070,1990,0,98198,47.355,-122.319,2990,16988,12,1,2014,UNK,300,3119
7856550240,7/10/2014,860000.0,5,2.25,3480,9200,2.0,0.0,0.0,3,8,3480,0,1979,0,98006,47.5585,-122.15299999999999,3130,9200,7,10,2014,UNK,350,0
2817910030,4/30/2015,449500.0,4,2.5,2410,55931,2.0,0.0,0.0,3,9,2410,0,1989,0,98092,47.3109,-122.09700000000001,2780,55931,4,30,2015,UNK,-370,0
8649900160,12/5/2014,692500.0,4,3.0,2820,11500,2.0,0.0,0.0,3,10,2820,0,1991,0,98075,47.5826,-122.02799999999999,2770,9694,12,5,2014,UNK,50,1806
7856610160,8/12/2014,925000.0,4,1.75,2710,11400,1.0,0.0,0.0,4,9,1430,1280,1976,0,98006,47.56100000000001,-122.15299999999999,2640,11000,8,12,2014,UNK,70,400
3705000070,10/21/2014,267500.0,3,2.25,2080,2856,1.5,0.0,0.0,3,7,1550,530,2003,0,98042,47.4198,-122.15799999999999,2080,2275,10,21,2014,UNK,0,581
2619950400,7/14/2014,396800.0,4,2.5,2200,6018,2.0,0.0,0.0,3,8,2200,0,2010,0,98019,47.7338,-121.96600000000001,2480,5899,7,14,2014,N,-280,119
7749500160,4/9/2015,220000.0,4,1.5,1180,8058,1.0,0.0,0.0,5,7,1180,0,1969,0,98092,47.2966,-122.19,1800,9348,4,9,2015,UNK,-620,-1290
3585300445,8/22/2014,892500.0,3,1.75,2120,56192,1.0,0.0,1.0,3,9,1720,400,1959,0,98177,47.7665,-122.37200000000001,2240,20500,8,22,2014,UNK,-120,35692
2909700070,5/27/2014,455500.0,3,2.0,1460,10311,1.0,0.0,0.0,4,7,1460,0,1975,0,98052,47.6771,-122.156,1690,9679,5,27,2014,UNK,-230,632
2581900036,6/12/2014,743000.0,3,1.75,2110,11250,1.0,0.0,0.0,4,8,2110,0,1961,0,98040,47.5402,-122.21600000000001,2560,10992,6,12,2014,UNK,-450,258
5589900400,12/5/2014,338000.0,4,1.5,1790,17925,1.0,0.0,0.0,4,6,1790,0,1951,0,98155,47.7501,-122.302,1660,15165,12,5,2014,UNK,130,2760
323089159,10/3/2014,332000.0,3,1.75,1340,13115,1.0,0.0,0.0,3,7,1340,0,1978,0,98045,47.5021,-121.77,1370,10800,10,3,2014,UNK,-30,2315
5015000700,1/23/2015,563225.0,3,1.0,2460,4000,1.5,0.0,0.0,4,7,1370,1090,1918,0,98112,47.6268,-122.29700000000001,1680,4000,1,23,2015,UNK,780,0
624110860,4/27/2015,1150000.0,4,3.5,3760,20609,2.0,0.0,0.0,3,11,3760,0,1990,0,98077,47.7255,-122.059,3360,15761,4,27,2015,UNK,400,4848
9521100465,10/13/2014,645000.0,2,1.0,1240,5000,1.0,0.0,0.0,3,7,1000,240,1920,0,98103,47.6634,-122.351,1480,3500,10,13,2014,UNK,-240,1500
3275790140,12/30/2014,739000.0,3,2.5,2750,16000,2.0,0.0,0.0,4,9,2560,190,1981,0,98033,47.69300000000001,-122.18700000000001,2370,11279,12,30,2014,UNK,380,4721
1313300400,7/1/2014,435000.0,3,2.5,2530,13446,2.0,0.0,0.0,3,9,2530,0,1993,0,98019,47.7345,-121.961,2450,13446,7,1,2014,UNK,80,0
8670900140,7/29/2014,995000.0,3,2.25,3200,3800,2.0,0.0,0.0,5,9,2650,550,1914,0,98102,47.63800000000001,-122.31700000000001,2400,3900,7,29,2014,UNK,800,-100
2540850070,3/20/2015,520000.0,4,2.75,2020,7357,1.0,0.0,0.0,3,7,1350,670,1986,0,98034,47.7145,-122.225,1690,7804,3,20,2015,UNK,330,-447
1921069068,4/29/2015,400000.0,4,2.5,3030,180263,2.0,0.0,0.0,3,7,2030,1000,1987,0,98092,47.2953,-122.09700000000001,2600,182509,4,29,2015,UNK,430,-2246
3574800860,10/7/2014,440000.0,3,1.75,2350,7641,1.0,0.0,0.0,3,7,1510,840,1978,0,98034,47.7307,-122.219,2190,7500,10,7,2014,UNK,160,141
5652600069,9/17/2014,440000.0,3,1.5,1690,6010,1.0,0.0,0.0,3,7,1230,460,1946,0,98115,47.6955,-122.291,1690,5418,9,17,2014,UNK,0,592
4083302625,3/24/2015,738000.0,3,1.0,1280,3900,1.0,0.0,0.0,4,7,1280,0,1921,0,98103,47.6545,-122.336,2020,4560,3,24,2015,UNK,-740,-660
114100791,4/3/2015,250000.0,3,1.5,1170,9848,1.0,0.0,0.0,3,7,1170,0,1963,0,98028,47.7612,-122.234,2220,5542,4,3,2015,UNK,-1050,4306
9432900070,9/2/2014,338150.0,4,2.25,2700,8580,2.0,0.0,0.0,3,8,2700,0,1992,0,98022,47.2087,-122.009,2420,8580,9,2,2014,UNK,280,0
7214820400,9/2/2014,425000.0,3,2.25,1800,7371,1.0,0.0,0.0,3,7,1280,520,1979,0,98072,47.7584,-122.145,1960,7675,9,2,2014,UNK,-160,-304
2725069157,6/13/2014,883000.0,4,2.5,3670,54450,2.0,0.0,0.0,3,10,3670,0,1999,0,98074,47.6211,-122.016,2900,49658,6,13,2014,UNK,770,4792
1025079074,12/2/2014,510000.0,3,2.0,2350,266151,1.5,0.0,0.0,3,7,2350,0,1983,0,98014,47.6609,-121.89200000000001,2270,222156,12,2,2014,UNK,80,43995
724069070,9/13/2014,950000.0,4,1.75,3100,21303,1.0,0.0,1.0,4,9,3100,0,1962,0,98075,47.5847,-122.081,3480,9697,9,13,2014,UNK,-380,11606
2206700070,10/13/2014,435000.0,3,1.0,1120,9656,1.0,0.0,0.0,5,7,1120,0,1955,0,98006,47.567,-122.139,1720,9908,10,13,2014,UNK,-600,-252
8564500240,5/27/2014,415000.0,5,1.5,1900,10226,1.0,0.0,0.0,3,7,1130,770,1961,0,98034,47.7226,-122.227,1690,10227,5,27,2014,UNK,210,-1
7579200765,10/6/2014,439000.0,2,2.5,1350,944,2.0,0.0,0.0,3,9,870,480,2004,0,98116,47.5591,-122.385,1440,1350,10,6,2014,N,-90,-406
7893205525,5/27/2014,295832.0,5,1.0,1410,6400,1.0,0.0,0.0,5,7,960,450,1955,0,98198,47.4207,-122.334,1400,6500,5,27,2014,UNK,10,-100
9320700400,10/31/2014,285000.0,3,1.75,1560,9514,1.0,0.0,0.0,4,7,1560,0,1967,0,98031,47.4088,-122.21,1550,9600,10,31,2014,UNK,10,-86
3226049045,4/30/2015,350000.0,3,1.5,1090,5003,1.0,0.0,0.0,3,7,1090,0,1962,0,98125,47.703,-122.321,1540,5279,4,30,2015,UNK,-450,-276
9828701741,10/21/2014,489000.0,2,2.75,1465,972,2.0,0.0,0.0,3,7,1050,415,2006,0,98112,47.621,-122.29799999999999,1480,1430,10,21,2014,N,-15,-458
7205510370,11/24/2014,304500.0,3,2.25,1790,6930,1.0,0.0,0.0,3,7,1390,400,1974,0,98003,47.3536,-122.31700000000001,1810,7420,11,24,2014,UNK,-20,-490
8899000310,3/17/2015,288000.0,3,1.5,1300,7313,1.0,0.0,0.0,4,7,1300,0,1968,0,98055,47.4568,-122.21,1770,8075,3,17,2015,UNK,-470,-762
6804600240,2/11/2015,417000.0,3,1.75,1920,9512,1.0,0.0,0.0,3,8,1440,480,1980,0,98011,47.7606,-122.167,1820,9512,2,11,2015,UNK,100,0
2902201126,4/1/2015,615000.0,3,3.0,1420,991,2.0,0.0,0.0,3,8,1040,380,2005,0,98102,47.6408,-122.32700000000001,1500,1301,4,1,2015,N,-80,-310
5536500200,9/18/2014,730000.0,5,3.5,3760,4857,2.0,0.0,3.0,3,9,2820,940,2004,0,98072,47.7398,-122.167,3000,5693,9,18,2014,N,760,-836
3530490160,8/21/2014,178500.0,2,1.0,930,3447,1.0,0.0,0.0,4,8,930,0,1978,0,98198,47.3822,-122.318,1160,3447,8,21,2014,UNK,-230,0
2008000550,8/15/2014,300000.0,4,2.0,1580,9600,1.0,0.0,0.0,5,7,1050,530,1965,0,98198,47.4091,-122.31299999999999,1710,9600,8,15,2014,UNK,-130,0
2045400075,6/23/2014,415000.0,4,2.5,2170,8518,1.0,0.0,3.0,3,7,1350,820,1955,0,98178,47.5073,-122.234,1880,7680,6,23,2014,UNK,290,838
616000200,8/22/2014,452500.0,3,1.75,2040,15695,1.0,0.0,0.0,4,8,2040,0,1959,0,98166,47.4155,-122.339,2280,14400,8,22,2014,UNK,-240,1295
7852160310,8/14/2014,1010000.0,4,2.75,3430,15877,1.0,0.0,4.0,3,11,3430,0,2005,0,98065,47.5364,-121.85600000000001,4080,14577,8,14,2014,N,-650,1300
8079100640,12/1/2014,653000.0,4,2.5,2160,7000,2.0,0.0,0.0,4,9,2160,0,1989,0,98029,47.5659,-122.01299999999999,2300,7440,12,1,2014,UNK,-140,-440
6662000070,5/14/2014,715000.0,4,2.25,2060,5649,1.0,0.0,0.0,5,8,1360,700,1941,0,98199,47.6496,-122.40700000000001,2060,5626,5,14,2014,UNK,0,23
1928300640,8/28/2014,541000.0,3,1.75,1410,4080,1.5,0.0,0.0,4,7,1410,0,1927,0,98105,47.6695,-122.32,1820,4080,8,28,2014,UNK,-410,0
7888100240,12/9/2014,245000.0,4,1.5,1850,7547,1.5,0.0,0.0,4,7,1850,0,1960,0,98198,47.3714,-122.309,1730,7577,12,9,2014,UNK,120,-30
3034200516,2/17/2015,547000.0,2,1.0,1370,10038,1.5,0.0,0.0,4,7,1370,0,1922,0,98133,47.718999999999994,-122.339,1610,8822,2,17,2015,UNK,-240,1216
7504000510,4/2/2015,750000.0,5,2.75,3330,12408,1.0,0.0,0.0,3,10,1740,1590,1976,0,98074,47.6318,-122.05799999999999,2780,12000,4,2,2015,UNK,550,408
9141100070,1/26/2015,575000.0,5,2.5,1970,12375,1.0,0.0,0.0,3,8,1570,400,1959,0,98133,47.7412,-122.354,1970,8941,1,26,2015,UNK,0,3434
921059200,8/13/2014,216000.0,3,1.75,1310,8670,1.0,0.0,0.0,4,6,1310,0,1984,0,98092,47.3156,-122.186,2622,7191,8,13,2014,UNK,-1312,1479
3645100240,9/22/2014,443000.0,3,1.75,1640,4579,1.0,0.0,0.0,4,6,1640,0,1916,0,98133,47.7061,-122.352,1580,5040,9,22,2014,UNK,60,-461
4123800260,11/3/2014,257700.0,4,2.25,1600,6202,2.0,0.0,0.0,4,7,1600,0,1986,0,98038,47.3784,-122.046,1530,6298,11,3,2014,UNK,70,-96
7334401000,4/14/2015,278000.0,3,1.0,1230,9440,1.0,0.0,0.0,3,7,1230,0,1978,0,98045,47.4657,-121.74700000000001,1230,10296,4,14,2015,UNK,0,-856
2111010890,11/5/2014,300000.0,3,2.5,2240,3691,2.0,0.0,0.0,3,7,2240,0,2003,0,98092,47.3364,-122.169,2619,3691,11,5,2014,UNK,-379,0
4137070830,2/13/2015,269100.0,3,2.5,2190,7904,2.0,0.0,0.0,3,8,2190,0,1995,0,98092,47.2617,-122.21,2190,7669,2,13,2015,UNK,0,235
7283900036,8/18/2014,402500.0,3,1.0,990,10752,1.5,0.0,0.0,4,7,990,0,1929,0,98133,47.7648,-122.35,1820,7600,8,18,2014,UNK,-830,3152
345700340,6/10/2014,306888.0,2,1.5,1010,7719,2.0,0.0,0.0,3,7,1010,0,1981,0,98056,47.5128,-122.189,1210,7719,6,10,2014,UNK,-200,0
4178300070,12/26/2014,795000.0,4,2.5,2920,14210,2.0,0.0,0.0,4,10,2920,0,1978,0,98007,47.6196,-122.15,2840,13702,12,26,2014,UNK,80,508
3342103228,8/4/2014,525000.0,4,2.5,2310,5573,2.0,0.0,0.0,4,9,2310,0,2003,0,98056,47.5197,-122.2,2310,6189,8,4,2014,UNK,0,-616
5451300105,7/20/2014,1050000.0,3,2.5,3470,12076,2.0,0.0,3.0,3,10,2560,910,1988,0,98040,47.5319,-122.238,3590,17677,7,20,2014,UNK,-120,-5601
5249803645,8/29/2014,452000.0,2,1.0,1220,6000,1.0,0.0,0.0,3,6,880,340,1938,0,98118,47.5647,-122.27,1220,6840,8,29,2014,UNK,0,-840
7326200030,4/13/2015,350000.0,3,2.25,1550,5401,2.0,0.0,0.0,3,7,1550,0,2000,0,98019,47.736999999999995,-121.96700000000001,1740,4485,4,13,2015,UNK,-190,916
7227502075,4/9/2015,410000.0,4,2.5,2070,6180,2.0,0.0,0.0,3,8,2070,0,2007,0,98056,47.4915,-122.18299999999999,1250,6018,4,9,2015,N,820,162
7011200160,11/13/2014,595000.0,3,1.75,2060,3600,1.5,0.0,0.0,3,7,1180,880,1905,1985,98119,47.6389,-122.37100000000001,1730,2475,11,13,2014,Y,330,1125
7202340390,4/7/2015,499000.0,3,2.5,1690,4851,2.0,0.0,0.0,3,7,1690,0,2004,0,98053,47.6795,-122.03399999999999,2330,4851,4,7,2015,N,-640,0
5412100240,10/22/2014,340000.0,4,2.5,2550,7555,2.0,0.0,0.0,3,8,2550,0,2001,0,98001,47.2614,-122.29,2550,6800,10,22,2014,UNK,0,755
1245000685,6/25/2014,1070000.0,5,3.25,3370,7947,2.0,0.0,0.0,3,10,3370,0,2001,0,98033,47.6906,-122.20200000000001,2040,7900,6,25,2014,UNK,1330,47
3222059187,5/28/2014,460000.0,4,3.0,2230,52983,2.0,0.0,0.0,3,8,2230,0,1991,0,98030,47.3577,-122.195,2060,8755,5,28,2014,UNK,170,44228
1822500270,8/19/2014,345000.0,4,2.5,2382,5899,2.0,0.0,0.0,3,8,2382,0,2011,0,98003,47.2793,-122.295,2382,5897,8,19,2014,N,0,2
2310010270,2/18/2015,280500.0,3,2.25,1620,7566,2.0,0.0,0.0,3,7,1620,0,1990,0,98038,47.3566,-122.039,1470,7566,2,18,2015,UNK,150,0
9547204930,2/25/2015,704000.0,3,1.0,1140,6120,1.5,0.0,0.0,3,7,1140,0,1926,0,98115,47.6822,-122.309,1800,4080,2,25,2015,UNK,-660,2040
8137500400,10/7/2014,545000.0,3,2.5,2140,40173,2.0,0.0,0.0,4,8,2140,0,1990,0,98027,47.4786,-122.066,2380,43016,10,7,2014,UNK,-240,-2843
3343901242,8/7/2014,335000.0,3,1.5,1900,7584,1.0,0.0,0.0,5,7,1900,0,1962,0,98056,47.5091,-122.19,1410,7584,8,7,2014,UNK,490,0
486000510,5/23/2014,1330000.0,4,3.0,3370,7920,1.0,0.0,3.0,3,10,1860,0,1988,0,98117,47.6773,-122.40299999999999,2730,7380,5,23,2014,UNK,640,540
537000075,8/11/2014,420000.0,3,2.75,2300,8000,1.0,0.0,0.0,3,7,1430,870,1965,0,98003,47.3293,-122.306,2070,10200,8,11,2014,UNK,230,-2200
3544400045,2/20/2015,705000.0,4,2.0,2040,5050,1.0,0.0,0.0,5,7,1160,880,1937,0,98115,47.6885,-122.324,2040,5050,2,20,2015,UNK,0,0
9211520400,11/4/2014,274900.0,4,1.75,1840,10528,1.0,0.0,0.0,3,7,1210,630,1990,0,98023,47.2987,-122.385,1620,9331,11,4,2014,UNK,220,1197
2738600140,5/2/2014,499950.0,4,2.5,2860,3345,2.0,0.0,0.0,3,8,2190,670,2004,0,98072,47.7735,-122.15799999999999,2860,3596,5,2,2014,N,0,-251
3073500111,3/18/2015,415250.0,3,1.5,1400,7550,1.0,0.0,0.0,4,7,1400,0,1953,0,98133,47.7566,-122.337,1730,7562,3,18,2015,UNK,-330,-12
7889000160,3/17/2015,222000.0,3,1.0,990,7520,1.0,0.0,0.0,4,7,990,0,1958,0,98002,47.285,-122.20700000000001,990,7440,3,17,2015,UNK,0,80
1422059129,8/14/2014,375000.0,3,2.0,3120,42247,1.0,0.0,0.0,4,7,2150,970,1980,0,98042,47.3925,-122.137,2100,43416,8,14,2014,UNK,1020,-1169
9430000070,4/30/2015,300000.0,3,2.5,1640,5707,2.0,0.0,0.0,3,7,1640,0,1995,0,98031,47.4016,-122.209,1850,5827,4,30,2015,UNK,-210,-120
2518400046,11/18/2014,456700.0,3,1.75,2820,8879,1.0,0.0,0.0,5,7,1540,1280,1920,1957,98146,47.5094,-122.376,1640,7850,11,18,2014,Y,1180,1029
1315300070,3/19/2015,925500.0,3,2.75,1970,5200,1.5,0.0,3.0,3,8,1970,0,1915,2002,98136,47.5374,-122.38799999999999,2140,5200,3,19,2015,Y,-170,0
1081330030,7/23/2014,375000.0,5,2.5,2840,15598,1.0,0.0,0.0,4,8,1470,1370,1975,0,98059,47.4693,-122.117,2570,14930,7,23,2014,UNK,270,668
4397010140,10/14/2014,420000.0,3,2.5,2370,15375,2.0,0.0,2.0,3,9,2370,0,1993,0,98042,47.3803,-122.147,2450,9800,10,14,2014,UNK,-80,5575
8564700240,10/17/2014,575000.0,3,2.5,2610,7301,2.0,0.0,0.0,3,8,2610,0,2004,0,98072,47.7614,-122.139,2460,7181,10,17,2014,N,150,120
597000566,4/28/2015,335000.0,3,2.0,1340,1951,1.0,0.0,0.0,3,6,670,670,1915,0,98144,47.5763,-122.309,1520,2248,4,28,2015,UNK,-180,-297
9828202030,2/18/2015,428000.0,4,2.0,1300,7200,1.0,0.0,0.0,3,7,1300,0,1958,0,98122,47.6169,-122.294,1540,6600,2,18,2015,UNK,-240,600
7214711260,10/1/2014,655000.0,4,2.5,3340,34238,1.0,0.0,0.0,4,8,2060,1280,1977,0,98077,47.7654,-122.07600000000001,2400,36590,10,1,2014,UNK,940,-2352
5569620550,6/27/2014,738000.0,3,3.0,2630,4896,2.0,0.0,0.0,3,9,2630,0,2006,0,98052,47.6932,-122.133,2880,4972,6,27,2014,N,-250,-76
6145601890,8/19/2014,415000.0,5,1.75,1960,3748,1.0,0.0,0.0,3,7,980,980,1965,0,98133,47.7027,-122.34899999999999,1410,3844,8,19,2014,UNK,550,-96
9269200831,8/25/2014,392000.0,3,1.0,1090,6125,1.0,0.0,0.0,4,6,790,300,1945,0,98126,47.5343,-122.37,1050,6125,8,25,2014,UNK,40,0
6021502470,11/6/2014,555000.0,2,1.0,1550,4600,1.0,0.0,0.0,4,7,1050,500,1941,0,98117,47.68600000000001,-122.384,1550,4600,11,6,2014,UNK,0,0
646910560,3/6/2015,260000.0,3,2.5,1770,2677,2.0,0.0,0.0,3,7,1770,0,2005,0,98055,47.4339,-122.194,1550,1798,3,6,2015,N,220,879
2475900565,3/9/2015,392500.0,3,1.0,1390,10500,1.5,0.0,0.0,3,6,1390,0,1940,0,98024,47.567,-121.89299999999999,1350,9800,3,9,2015,UNK,40,700
4139430810,8/1/2014,912000.0,3,2.5,2979,17313,2.0,0.0,2.0,3,11,2979,0,1993,0,98006,47.5503,-122.118,3890,14797,8,1,2014,UNK,-911,2516
2586800140,11/18/2014,135000.0,2,1.0,830,7609,1.0,0.0,0.0,3,6,830,0,1943,0,98146,47.5057,-122.348,1170,7609,11,18,2014,UNK,-340,0
226059121,8/13/2014,500000.0,3,2.75,1560,77536,1.0,0.0,0.0,3,7,1400,160,1978,0,98072,47.7695,-122.126,2210,41449,8,13,2014,UNK,-650,36087
7696610270,12/29/2014,238000.0,3,1.5,1360,7488,1.0,0.0,0.0,4,7,1050,310,1975,0,98001,47.3314,-122.275,1580,7508,12,29,2014,UNK,-220,-20
4279900140,10/1/2014,251000.0,4,2.0,1650,5974,1.0,0.0,0.0,5,7,860,790,1972,0,98178,47.5008,-122.257,1940,6001,10,1,2014,UNK,-290,-27
5422560810,7/14/2014,406500.0,2,1.75,1510,5319,2.0,0.0,0.0,4,8,1510,0,1978,0,98052,47.6647,-122.13,1740,6160,7,14,2014,UNK,-230,-841
1657300270,3/12/2015,433495.0,4,2.25,3010,10925,2.0,0.0,0.0,4,9,3010,0,1988,0,98092,47.3326,-122.20100000000001,2690,10925,3,12,2015,UNK,320,0
8648210140,12/24/2014,265000.0,3,2.25,1510,6071,1.0,0.0,0.0,4,7,1150,360,1985,0,98042,47.3619,-122.07700000000001,1510,7271,12,24,2014,UNK,0,-1200
3034200247,2/6/2015,360000.0,3,1.75,1950,7260,1.0,0.0,0.0,3,8,1520,430,1957,0,98133,47.7187,-122.33,1950,7548,2,6,2015,UNK,0,-288
2204500550,7/17/2014,425000.0,4,1.0,1800,12485,1.0,0.0,0.0,5,7,950,850,1955,0,98006,47.5729,-122.147,1290,9840,7,17,2014,UNK,510,2645
7390400069,3/27/2015,450000.0,2,2.75,2810,11205,1.0,0.0,0.0,3,7,1510,1300,1968,0,98178,47.4869,-122.243,2520,13000,3,27,2015,UNK,290,-1795
1077100070,3/16/2015,449900.0,3,1.75,1760,8266,1.0,0.0,0.0,5,7,1760,0,1954,0,98133,47.7708,-122.339,1400,8519,3,16,2015,UNK,360,-253
423059360,10/17/2014,345000.0,4,2.5,2040,5875,2.0,0.0,0.0,3,8,2040,0,2004,0,98056,47.5051,-122.17,2230,5459,10,17,2014,N,-190,416
3316500200,10/9/2014,612500.0,4,2.0,1690,35346,1.0,0.0,0.0,3,7,1690,0,1967,0,98008,47.6149,-122.124,2050,37846,10,9,2014,UNK,-360,-2500
1328300990,8/5/2014,317000.0,3,1.75,1530,7650,1.0,0.0,0.0,4,8,1530,0,1977,0,98058,47.4435,-122.12799999999999,1850,6804,8,5,2014,UNK,-320,846
4443800505,5/7/2015,585000.0,3,1.5,1810,3880,1.5,0.0,0.0,4,8,1310,500,1929,0,98117,47.6835,-122.39200000000001,1400,3880,5,7,2015,UNK,410,0
7327500200,6/18/2014,455000.0,3,1.75,1180,14292,1.0,0.0,0.0,3,7,1180,0,1981,0,98045,47.4818,-121.73299999999999,1480,14400,6,18,2014,UNK,-300,-108
4054510310,12/1/2014,1040000.0,4,4.0,4090,51908,2.0,0.0,0.0,3,11,4090,0,1991,0,98077,47.7226,-122.039,4290,41655,12,1,2014,UNK,-200,10253
7525100060,8/20/2014,497000.0,4,2.25,2250,3463,2.0,0.0,0.0,4,8,2250,0,1968,0,98052,47.6324,-122.10600000000001,1850,2811,8,20,2014,UNK,400,652
3065600270,4/22/2015,226750.0,3,1.75,1070,6315,1.0,0.0,0.0,3,7,1070,0,1992,0,98023,47.2803,-122.35600000000001,1520,5707,4,22,2015,UNK,-450,608
2881700273,8/19/2014,385000.0,4,2.0,1820,7102,1.0,0.0,0.0,3,7,1220,600,1950,0,98155,47.7447,-122.324,1650,8184,8,19,2014,UNK,170,-1082
7889600685,12/11/2014,205000.0,3,0.75,1080,5025,1.0,0.0,0.0,3,5,1080,0,1948,0,98146,47.4936,-122.335,1370,6000,12,11,2014,UNK,-290,-975
1137500070,9/29/2014,745000.0,4,2.5,2760,13093,2.0,0.0,0.0,4,9,2760,0,1989,0,98075,47.5845,-122.06,2810,13545,9,29,2014,UNK,-50,-452
5104530810,6/20/2014,371000.0,4,2.5,2550,4770,2.0,0.0,0.0,3,8,2550,0,2005,0,98038,47.3526,-122.0,2380,4590,6,20,2014,N,170,180
3905060070,8/29/2014,545000.0,4,2.5,2080,8504,2.0,0.0,0.0,3,8,2080,0,1991,0,98029,47.5703,-121.99799999999999,2000,6773,8,29,2014,UNK,80,1731
6450302545,5/8/2015,443000.0,3,1.0,1280,5460,1.5,0.0,0.0,4,7,1280,0,1931,0,98133,47.7321,-122.334,1390,5500,5,8,2015,UNK,-110,-40
7972602435,3/18/2015,287000.0,2,1.0,950,6350,1.0,0.0,0.0,3,7,950,0,1951,0,98106,47.528,-122.352,1080,7620,3,18,2015,UNK,-130,-1270
5423500240,6/24/2014,194000.0,3,1.0,1050,7577,1.0,0.0,0.0,3,7,1050,0,1983,0,98023,47.2891,-122.35700000000001,1430,7245,6,24,2014,UNK,-380,332
8074200160,6/29/2014,265000.0,3,1.0,1800,7650,1.0,0.0,0.0,5,7,1800,0,1957,0,98056,47.4922,-122.178,1230,7650,6,29,2014,UNK,570,0
3317500070,4/8/2015,1140000.0,4,2.75,3840,10004,1.0,0.0,2.0,4,9,2110,1730,1963,0,98040,47.5606,-122.225,3500,12118,4,8,2015,UNK,340,-2114
6119700030,5/8/2015,699950.0,4,3.25,3674,12793,2.0,0.0,1.0,3,9,3674,0,1987,0,98166,47.4357,-122.34299999999999,3220,13100,5,8,2015,UNK,454,-307
2568800160,10/15/2014,433000.0,4,1.0,1710,7000,1.5,0.0,0.0,3,7,1710,0,1950,0,98125,47.7037,-122.29299999999999,2030,7938,10,15,2014,UNK,-320,-938
2781250520,10/16/2014,200000.0,2,1.75,910,2693,1.0,0.0,0.0,3,6,910,0,2003,0,98038,47.3493,-122.025,1360,2693,10,16,2014,UNK,-450,0
7230200310,4/9/2015,289571.0,3,1.5,1340,25160,1.0,0.0,0.0,3,7,1340,0,1968,0,98059,47.475,-122.111,1440,23680,4,9,2015,UNK,-100,1480
4400900030,6/2/2014,440000.0,4,2.75,2340,11034,1.0,0.0,0.0,3,8,1720,620,1967,0,98155,47.7686,-122.27799999999999,2370,11941,6,2,2014,UNK,-30,-907
4038300070,11/13/2014,400000.0,3,1.5,1510,8360,1.0,0.0,0.0,3,7,1120,390,1960,0,98007,47.6119,-122.133,1700,8360,11,13,2014,UNK,-190,0
5706000070,10/14/2014,589000.0,4,2.5,2630,15000,2.0,0.0,0.0,5,8,2630,0,1962,0,98027,47.5262,-122.02799999999999,1770,8700,10,14,2014,UNK,860,6300
825069078,3/24/2015,850000.0,5,2.25,3100,97661,2.0,0.0,0.0,3,9,3100,0,1986,0,98053,47.6624,-122.06200000000001,2370,53993,3,24,2015,UNK,730,43668
363000045,1/2/2015,520000.0,3,1.0,940,3000,1.5,0.0,0.0,3,7,940,0,1903,0,98122,47.6033,-122.3,1210,3500,1,2,2015,UNK,-270,-500
1912100875,4/23/2015,555000.0,2,2.25,1370,1248,2.0,0.0,0.0,3,7,1200,170,2000,0,98102,47.6399,-122.32,1800,3360,4,23,2015,UNK,-430,-2112
7853230200,3/9/2015,470000.0,3,2.5,2480,5082,2.0,0.0,0.0,3,7,2480,0,2004,0,98065,47.5297,-121.846,2480,5874,3,9,2015,N,0,-792
9406500350,12/29/2014,207000.0,2,1.5,1068,1158,2.0,0.0,0.0,3,7,1068,0,1990,0,98028,47.753,-122.244,1078,1278,12,29,2014,UNK,-10,-120
5152960350,11/13/2014,379750.0,4,2.75,2390,9650,1.0,0.0,2.0,3,8,1620,770,1976,0,98003,47.3438,-122.322,2390,10000,11,13,2014,UNK,0,-350
6021500320,5/7/2015,709000.0,4,1.75,2170,4600,1.0,0.0,0.0,3,7,1270,900,1950,0,98117,47.6894,-122.384,1750,4000,5,7,2015,UNK,420,600
7137910140,9/23/2014,240000.0,3,2.5,1520,9864,1.0,0.0,0.0,3,7,1160,360,1993,0,98092,47.3186,-122.171,1580,7425,9,23,2014,UNK,-60,2439
6117500955,2/4/2015,445500.0,4,1.5,2210,10497,1.0,0.0,0.0,4,8,1650,560,1953,0,98166,47.4321,-122.34700000000001,1840,12697,2,4,2015,UNK,370,-2200
269001331,9/9/2014,1310000.0,5,2.5,3200,7863,1.0,0.0,3.0,5,8,1600,1600,1959,0,98199,47.6398,-122.39,2640,7680,9,9,2014,UNK,560,183
1023059190,3/24/2015,210000.0,3,1.5,1160,10125,1.0,0.0,0.0,4,7,1160,0,1959,0,98059,47.4919,-122.15100000000001,1440,10018,3,24,2015,UNK,-280,107
8961970560,8/11/2014,603000.0,4,2.5,2670,5895,2.0,0.0,0.0,3,8,2670,0,1999,0,98074,47.6066,-122.016,2820,6531,8,11,2014,UNK,-150,-636
3066400710,4/7/2015,720000.0,3,2.5,2520,10012,2.0,0.0,0.0,3,10,2520,0,1987,0,98074,47.6295,-122.051,2680,10071,4,7,2015,UNK,-160,-59
795000765,6/16/2014,92000.0,2,1.0,760,5500,1.5,0.0,0.0,3,5,760,0,1947,0,98168,47.5045,-122.329,1040,5515,6,16,2014,UNK,-280,-15
2767603535,1/26/2015,600000.0,3,1.75,1310,5000,2.0,0.0,0.0,4,7,1310,0,1901,0,98107,47.6722,-122.37899999999999,1270,4750,1,26,2015,UNK,40,250
7774200070,4/8/2015,725000.0,4,2.5,2750,13950,1.0,0.0,3.0,4,8,1380,1370,1948,0,98146,47.4938,-122.36399999999999,2460,13950,4,8,2015,UNK,290,0
4029400140,12/10/2014,409950.0,5,2.25,1790,10300,1.0,0.0,0.0,3,7,1270,520,1961,0,98155,47.7718,-122.292,1790,10300,12,10,2014,UNK,0,0
1954400060,5/6/2014,515000.0,3,2.5,1790,7167,2.0,0.0,0.0,3,8,1790,0,1989,0,98074,47.6176,-122.045,1680,7418,5,6,2014,UNK,110,-251
2473002650,5/12/2015,495000.0,4,2.5,2400,11640,1.0,0.0,0.0,5,8,1800,600,1968,0,98058,47.4485,-122.139,2440,10823,5,12,2015,UNK,-40,817
5451220200,6/24/2014,998000.0,4,2.25,2420,10200,2.0,0.0,0.0,4,9,2420,0,1973,0,98040,47.5336,-122.225,2390,10200,6,24,2014,UNK,30,0
1472700200,7/9/2014,630000.0,3,1.75,1710,8767,1.0,0.0,0.0,4,8,1710,0,1986,0,98033,47.6945,-122.18799999999999,2050,9200,7,9,2014,UNK,-340,-433
1661000060,8/1/2014,410000.0,3,1.75,2000,7480,1.0,0.0,0.0,3,8,1320,680,1972,0,98177,47.7734,-122.359,2000,8610,8,1,2014,UNK,0,-1130
2600110710,8/19/2014,602000.0,3,2.25,1580,11580,1.0,0.0,0.0,4,8,1580,0,1979,0,98006,47.5503,-122.155,2630,10009,8,19,2014,UNK,-1050,1571
2600110560,11/12/2014,750000.0,4,2.75,2310,10232,1.0,0.0,0.0,5,8,1310,1000,1980,0,98006,47.5515,-122.15299999999999,2820,9886,11,12,2014,UNK,-510,346
8617000060,7/8/2014,711600.0,4,3.0,3580,9316,2.5,0.0,0.0,3,10,2370,1210,1991,0,98007,47.595,-122.133,2580,9242,7,8,2014,UNK,1000,74
8562720390,8/25/2014,1050000.0,4,4.0,4320,8709,2.0,0.0,0.0,3,11,3190,1130,2006,0,98027,47.5369,-122.07,4010,8321,8,25,2014,N,310,388
1137300890,12/17/2014,700500.0,3,2.5,2560,35265,2.0,0.0,0.0,3,9,2560,0,1981,0,98072,47.7354,-122.095,2820,35496,12,17,2014,UNK,-260,-231
4104900340,2/4/2015,710000.0,4,2.5,3220,18618,2.0,0.0,1.0,3,10,3220,0,1991,0,98056,47.5326,-122.181,2650,11896,2,4,2015,UNK,570,6722
2616700560,12/4/2014,250000.0,3,2.0,1660,13085,1.0,0.0,0.0,3,7,1010,650,1985,0,98001,47.3298,-122.277,1660,7778,12,4,2014,UNK,0,5307
1061500510,10/15/2014,350000.0,4,1.75,2420,8400,1.0,0.0,0.0,5,7,1620,800,1964,0,98056,47.5017,-122.165,1660,8400,10,15,2014,UNK,760,0
6411600370,5/15/2014,475000.0,7,3.5,2870,29699,1.0,0.0,0.0,3,7,1520,1350,1961,0,98125,47.7153,-122.32700000000001,1380,7555,5,15,2014,UNK,1490,22144
4154302075,1/16/2015,200000.0,2,1.0,830,7200,1.0,0.0,0.0,2,6,830,0,1920,0,98118,47.5604,-122.275,1150,6600,1,16,2015,UNK,-320,600
1727500390,10/30/2014,450000.0,4,2.25,1710,7000,1.0,0.0,0.0,4,7,1040,670,1972,0,98034,47.718999999999994,-122.21700000000001,1780,6500,10,30,2014,UNK,-70,500
2538410260,8/1/2014,316000.0,5,2.5,2600,4641,2.0,0.0,0.0,3,7,2600,0,2005,0,98058,47.4325,-122.146,2330,4589,8,1,2014,N,270,52
9269200520,10/16/2014,310000.0,1,1.0,670,4920,1.0,0.0,0.0,3,5,670,0,1920,0,98126,47.5342,-122.37299999999999,1050,4920,10,16,2014,UNK,-380,0
7334400070,2/23/2015,392000.0,3,1.5,1500,11975,1.0,0.0,0.0,4,7,1500,0,1970,0,98045,47.4658,-121.758,1510,13875,2,23,2015,UNK,-10,-1900
1972200696,10/6/2014,521000.0,3,3.25,1460,1254,3.0,0.0,0.0,3,8,1460,0,2000,0,98103,47.6535,-122.353,1400,1255,10,6,2014,UNK,60,-1
2267000486,8/22/2014,495000.0,2,2.0,1540,7110,1.0,0.0,0.0,3,7,960,580,1949,0,98117,47.6932,-122.395,1860,7065,8,22,2014,UNK,-320,45
1311800560,11/21/2014,209000.0,3,1.75,1250,8084,1.0,0.0,0.0,4,7,1250,0,1967,0,98001,47.3364,-122.27600000000001,1340,7680,11,21,2014,UNK,-90,404
9542400075,6/6/2014,809950.0,4,2.0,2230,9900,1.5,0.0,0.0,5,9,2230,0,1959,0,98005,47.5979,-122.17299999999999,2510,11041,6,6,2014,UNK,-280,-1141
3223069065,9/17/2014,400000.0,2,1.75,1800,224769,1.0,0.0,0.0,3,7,1420,380,1950,2008,98038,47.4327,-122.06,1620,112384,9,17,2014,Y,180,112385
1724500030,3/12/2015,415000.0,4,2.5,2400,7292,1.0,0.0,0.0,3,8,1530,870,1980,0,98133,47.7749,-122.339,1710,7909,3,12,2015,UNK,690,-617
3751602797,7/2/2014,411000.0,4,2.0,2370,76665,2.0,0.0,0.0,4,8,2370,0,1978,0,98001,47.2831,-122.279,2110,19334,7,2,2014,UNK,260,57331
809002030,9/11/2014,825000.0,2,2.0,1830,3600,1.0,0.0,0.0,4,7,1230,600,1926,0,98109,47.6359,-122.351,2020,3600,9,11,2014,UNK,-190,0
993002127,2/23/2015,436000.0,3,2.25,1480,1384,3.0,0.0,0.0,3,8,1480,0,2008,0,98103,47.691,-122.34200000000001,1310,1329,2,23,2015,N,170,55
1473120140,7/8/2014,460000.0,4,2.5,2620,8331,2.0,0.0,0.0,3,9,2620,0,1991,0,98058,47.4357,-122.15899999999999,2760,8174,7,8,2014,UNK,-140,157
7849200861,7/14/2014,281000.0,3,1.0,1300,5782,1.0,0.0,0.0,4,6,1300,0,1959,0,98065,47.523999999999994,-121.821,1020,7200,7,14,2014,UNK,280,-1418
269000030,8/25/2014,976000.0,4,1.5,3120,7680,1.0,0.0,3.0,3,8,1660,1460,1956,0,98199,47.646,-122.39,2900,7680,8,25,2014,UNK,220,0
2607760700,4/20/2015,485000.0,4,2.5,2400,10364,2.0,0.0,0.0,3,8,2400,0,1995,0,98045,47.4832,-121.79899999999999,2390,9918,4,20,2015,UNK,10,446
7715801090,7/25/2014,429000.0,3,2.5,1430,9240,2.0,0.0,0.0,3,7,1430,0,1984,0,98074,47.6258,-122.05799999999999,1480,8125,7,25,2014,UNK,-50,1115
1999600320,3/4/2015,729000.0,3,2.5,2480,7428,2.0,0.0,0.0,3,9,2480,0,1990,0,98006,47.5489,-122.185,2600,8322,3,4,2015,UNK,-120,-894
4221250340,4/9/2015,625000.0,3,2.5,2280,4757,2.0,0.0,0.0,3,8,2280,0,2003,0,98075,47.5901,-122.01799999999999,2280,4534,4,9,2015,UNK,0,223
3668000810,1/16/2015,218500.0,3,1.75,1390,9328,1.0,0.0,0.0,4,7,1390,0,1987,0,98092,47.2766,-122.146,1550,8374,1,16,2015,UNK,-160,954
2337300370,2/6/2015,175000.0,3,1.0,1030,8395,1.0,0.0,0.0,4,7,1030,0,1960,0,98023,47.3322,-122.337,1370,9380,2,6,2015,UNK,-340,-985
1453602065,2/5/2015,442500.0,3,1.0,1120,8200,1.0,0.0,0.0,4,7,1120,0,1938,0,98125,47.7254,-122.29,1820,7205,2,5,2015,UNK,-700,995
3359500960,3/21/2015,480000.0,3,2.0,1300,3000,2.0,0.0,0.0,3,7,1300,0,1986,0,98115,47.6728,-122.325,1670,4500,3,21,2015,UNK,-370,-1500
6133100125,10/8/2014,715500.0,3,2.25,2410,9668,1.0,0.0,1.0,4,8,1540,870,1965,0,98117,47.6996,-122.391,2510,5250,10,8,2014,UNK,-100,4418
8562600260,11/20/2014,432500.0,3,1.75,1470,7350,1.0,0.0,0.0,3,8,1470,0,1963,0,98052,47.6687,-122.154,1470,7350,11,20,2014,UNK,0,0
2325069032,7/31/2014,875000.0,5,4.25,4720,18741,2.0,0.0,0.0,3,11,3210,1510,2005,0,98053,47.6347,-122.01299999999999,3880,37328,7,31,2014,N,840,-18587
1223039235,11/14/2014,605000.0,5,2.75,2910,13332,2.0,0.0,0.0,4,8,2910,0,1940,1991,98146,47.4977,-122.359,1760,8900,11,14,2014,Y,1150,4432
4139480350,1/13/2015,1690000.0,4,4.0,5000,12941,3.0,0.0,2.0,3,12,5000,0,2002,0,98006,47.55,-122.103,4560,12941,1,13,2015,UNK,440,0
3348401382,2/10/2015,318000.0,3,2.25,1690,12662,1.0,0.0,0.0,5,7,1090,600,1982,0,98178,47.4972,-122.264,1950,9642,2,10,2015,UNK,-260,3020
164000267,10/16/2014,311300.0,2,1.0,1000,7228,1.0,0.0,0.0,4,7,1000,0,1947,0,98133,47.7294,-122.352,1100,7228,10,16,2014,UNK,-100,0
1099900030,4/15/2015,325000.0,5,2.75,2400,7904,1.0,0.0,0.0,3,7,1450,950,1992,0,98188,47.4683,-122.26299999999999,2400,7475,4,15,2015,UNK,0,429
4139700260,11/17/2014,795000.0,5,3.5,3330,3705,2.0,0.0,0.0,3,9,2610,720,2008,0,98006,47.5567,-122.124,2810,3971,11,17,2014,N,520,-266
6071800310,6/19/2014,558000.0,4,2.25,2060,10358,1.0,0.0,0.0,4,8,1320,740,1962,0,98006,47.5478,-122.17399999999999,2060,9676,6,19,2014,UNK,0,682
1321720140,5/28/2014,370000.0,4,2.5,3090,18645,2.0,0.0,0.0,3,9,3090,0,1995,0,98023,47.2902,-122.34200000000001,3610,20114,5,28,2014,UNK,-520,-1469
8078460320,11/18/2014,598850.0,4,2.5,2350,7245,2.0,0.0,0.0,3,8,2350,0,1993,0,98074,47.6318,-122.023,2350,9419,11,18,2014,UNK,0,-2174
6388930570,10/23/2014,515700.0,3,2.5,2180,9722,2.0,0.0,0.0,3,8,2180,0,1994,0,98056,47.527,-122.17299999999999,2440,9722,10,23,2014,UNK,-260,0
3709500060,6/20/2014,458000.0,3,2.5,1870,5013,2.0,0.0,0.0,3,8,1870,0,2003,0,98011,47.7552,-122.221,2040,5555,6,20,2014,UNK,-170,-542
5469500640,2/24/2015,583500.0,3,2.25,3530,13000,2.5,0.0,0.0,4,10,3530,0,1985,0,98042,47.3823,-122.15899999999999,2960,13000,2,24,2015,UNK,570,0
293910070,7/23/2014,653750.0,4,2.5,2460,4166,2.0,0.0,0.0,3,9,2460,0,2003,0,98034,47.7072,-122.23200000000001,2460,4964,7,23,2014,UNK,0,-798
3158500340,7/11/2014,299000.0,3,2.5,1650,4725,2.0,0.0,0.0,3,8,1650,0,2011,0,98038,47.3548,-122.055,2000,4725,7,11,2014,N,-350,0
2617300200,5/9/2014,532000.0,5,3.0,3480,57499,1.0,0.0,0.0,4,8,2340,1140,1976,0,98027,47.4574,-122.024,2020,40946,5,9,2014,UNK,1460,16553
521049200,7/8/2014,819000.0,3,2.75,3176,13391,2.0,0.0,3.0,4,9,2726,450,1985,0,98198,47.3429,-122.33,3470,12779,7,8,2014,UNK,-294,612
7779200105,7/18/2014,945000.0,4,2.25,2420,9000,1.0,0.0,4.0,5,9,2000,420,1967,0,98146,47.4884,-122.363,2400,9035,7,18,2014,UNK,20,-35
8651500710,11/6/2014,608700.0,4,2.5,2260,9696,1.0,0.0,0.0,3,9,2260,0,1983,0,98074,47.643,-122.066,2400,12111,11,6,2014,UNK,-140,-2415
871000435,5/9/2015,812000.0,4,2.0,2380,6122,1.0,0.0,2.0,4,8,1310,1070,1949,0,98199,47.6506,-122.405,1810,5202,5,9,2015,UNK,570,920
217500140,5/13/2014,464000.0,5,2.5,3400,8970,1.0,0.0,0.0,4,8,1700,1700,1959,0,98133,47.7358,-122.335,1890,8475,5,13,2014,UNK,1510,495
9290850810,6/13/2014,950000.0,4,2.5,3770,35081,2.0,0.0,0.0,3,10,3770,0,1989,0,98053,47.6908,-122.051,4000,35492,6,13,2014,UNK,-230,-411
6844700510,12/3/2014,700000.0,4,2.5,2672,4297,2.0,0.0,0.0,3,8,2020,652,2005,0,98115,47.6955,-122.289,1720,6120,12,3,2014,N,952,-1823
1232001040,10/16/2014,435000.0,3,1.0,1180,4219,1.0,0.0,0.0,3,7,1060,120,1939,0,98117,47.6867,-122.37799999999999,1630,4219,10,16,2014,UNK,-450,0
3751601171,10/7/2014,229500.0,3,1.5,1810,14400,1.0,0.0,0.0,4,7,1810,0,1954,0,98001,47.2887,-122.26899999999999,1710,12000,10,7,2014,UNK,100,2400
6117502220,11/17/2014,1580000.0,3,3.0,2610,22672,1.5,1.0,4.0,4,8,2610,0,1952,0,98166,47.4414,-122.354,2810,22672,11,17,2014,UNK,-200,0
4322300140,11/3/2014,265000.0,3,2.25,1450,13439,1.0,0.0,0.0,4,7,1180,270,1963,0,98003,47.2811,-122.29899999999999,1520,12348,11,3,2014,UNK,-70,1091
1526059051,8/28/2014,995000.0,2,2.0,1600,64468,1.0,0.0,0.0,3,7,1600,0,1950,0,98072,47.7344,-122.14299999999999,1950,64468,8,28,2014,UNK,-350,0
3800000160,7/9/2014,590000.0,3,2.5,2650,9380,1.0,0.0,0.0,5,8,1680,970,1975,0,98155,47.7756,-122.273,2310,9600,7,9,2014,UNK,340,-220
1454600116,6/11/2014,740000.0,4,2.75,2490,17833,2.0,0.0,2.0,3,9,1490,1000,1979,0,98125,47.7206,-122.28399999999999,2640,16943,6,11,2014,UNK,-150,890
4174600055,5/21/2014,360000.0,2,0.75,850,7710,1.0,0.0,2.0,5,6,550,300,1909,0,98108,47.5588,-122.301,2500,6022,5,21,2014,UNK,-1650,1688
2594200566,4/6/2015,548500.0,4,2.0,1820,7200,1.0,0.0,0.0,3,7,1300,520,1976,0,98136,47.5161,-122.38799999999999,1770,8149,4,6,2015,UNK,50,-949
8825900465,5/7/2014,599000.0,3,1.75,1960,4788,1.0,0.0,0.0,4,7,1090,870,1920,0,98115,47.6746,-122.31200000000001,1960,3960,5,7,2014,UNK,0,828
8562900310,6/13/2014,615000.0,3,1.75,2350,20820,1.0,0.0,0.0,4,8,1800,550,1978,0,98074,47.6095,-122.059,2040,10800,6,13,2014,UNK,310,10020
1446401555,12/8/2014,292000.0,3,1.75,1320,6600,1.0,0.0,0.0,3,7,1320,0,1988,0,98168,47.4838,-122.33,1070,6594,12,8,2014,UNK,250,6
3528000140,10/23/2014,899000.0,4,2.5,3720,30649,2.0,0.0,0.0,3,10,3720,0,1988,0,98053,47.6651,-122.056,3220,29434,10,23,2014,UNK,500,1215
7625704500,12/8/2014,500000.0,3,1.5,2210,6500,1.0,0.0,0.0,4,7,1030,1180,1912,0,98136,47.5434,-122.38799999999999,1750,6370,12,8,2014,UNK,460,130
3575302397,11/13/2014,580000.0,3,2.5,1910,11550,1.5,0.0,0.0,3,8,1910,0,2003,0,98074,47.6213,-122.064,2230,11550,11,13,2014,UNK,-320,0
6190500340,5/9/2014,580000.0,4,2.5,2840,6268,2.0,0.0,0.0,3,9,2840,0,1998,0,98028,47.7386,-122.235,2790,6526,5,9,2014,UNK,50,-258
475000510,11/18/2014,594000.0,3,1.0,1320,5000,1.0,0.0,0.0,4,7,1090,230,1920,0,98107,47.6674,-122.365,1700,5000,11,18,2014,UNK,-380,0
7199340320,4/9/2015,500000.0,3,2.5,2440,7600,1.0,0.0,0.0,3,7,1420,1020,1981,0,98052,47.6966,-122.12700000000001,2060,7700,4,9,2015,UNK,380,-100
3904940140,10/6/2014,550000.0,4,2.5,2420,8056,1.0,0.0,0.0,3,8,1680,740,1988,0,98029,47.5748,-122.01299999999999,2160,6807,10,6,2014,UNK,260,1249
2310030390,4/29/2015,275000.0,3,1.75,1180,6260,1.0,0.0,0.0,4,8,1180,0,1993,0,98038,47.3531,-122.04799999999999,1580,7272,4,29,2015,UNK,-400,-1012
2591800340,4/30/2015,390000.0,3,2.25,1820,7420,2.0,0.0,0.0,4,8,1820,0,1983,0,98058,47.4368,-122.162,1900,7526,4,30,2015,UNK,-80,-106
3505100126,6/26/2014,1250000.0,3,3.0,3760,8500,2.5,0.0,3.0,4,10,3060,700,1910,0,98116,47.5815,-122.398,2610,5500,6,26,2014,UNK,1150,3000
3361401977,8/26/2014,250000.0,3,2.25,1560,15340,2.0,0.0,0.0,3,7,1560,0,1997,0,98168,47.4989,-122.322,1560,8260,8,26,2014,UNK,0,7080
5422570260,9/29/2014,405000.0,2,2.5,1790,5400,2.0,0.0,0.0,4,8,1790,0,1979,0,98052,47.6606,-122.12799999999999,1700,5760,9,29,2014,UNK,90,-360
100600320,8/13/2014,213950.0,3,1.0,1430,7000,1.0,0.0,0.0,3,6,1430,0,1968,0,98023,47.3018,-122.369,1050,7700,8,13,2014,UNK,380,-700
8099200030,12/22/2014,232000.0,3,1.5,1390,11340,1.0,0.0,0.0,4,7,1390,0,1963,0,98031,47.3984,-122.186,1740,11340,12,22,2014,UNK,-350,0
7140600055,4/11/2015,207000.0,3,1.0,990,10800,1.0,0.0,0.0,4,6,990,0,1959,0,98002,47.293,-122.215,1060,10364,4,11,2015,UNK,-70,436
3422049276,12/11/2014,310000.0,3,1.75,1880,30346,1.0,0.0,0.0,3,8,1880,0,1988,0,98001,47.3515,-122.291,2260,5883,12,11,2014,UNK,-380,24463
3157600240,9/3/2014,540000.0,3,2.5,2520,5000,3.0,0.0,0.0,3,9,2520,0,1990,0,98106,47.5664,-122.359,1130,5000,9,3,2014,UNK,1390,0
91000135,5/7/2015,750000.0,4,1.5,2060,4000,1.5,0.0,2.0,3,7,1580,480,1920,1990,98103,47.6857,-122.353,1160,4000,5,7,2015,Y,900,0
423059369,6/4/2014,392500.0,4,2.5,2150,7303,2.0,0.0,0.0,3,8,2150,0,2005,0,98056,47.5109,-122.18299999999999,1940,9569,6,4,2014,N,210,-2266
5152000030,2/4/2015,305000.0,5,2.5,2500,12220,1.0,0.0,0.0,3,8,1690,810,1962,0,98003,47.3335,-122.325,2130,12000,2,4,2015,UNK,370,220
7732300390,5/23/2014,735000.0,3,2.5,2390,9157,2.0,0.0,0.0,3,9,2390,0,1984,0,98052,47.6617,-122.15,2360,8250,5,23,2014,UNK,30,907
1954430390,7/7/2014,575000.0,4,2.5,2400,6137,2.0,0.0,0.0,3,8,2400,0,1990,0,98074,47.6187,-122.04,2120,7468,7,7,2014,UNK,280,-1331
7891600260,6/18/2014,175000.0,2,1.0,660,5000,1.0,0.0,0.0,3,6,660,0,1915,0,98106,47.5664,-122.36399999999999,1000,5000,6,18,2014,UNK,-340,0
2329800140,12/3/2014,291000.0,4,2.5,1580,6633,2.0,0.0,0.0,4,7,1580,0,1984,0,98042,47.3768,-122.118,1590,6633,12,3,2014,UNK,-10,0
8653900070,8/4/2014,791500.0,4,2.5,3250,8970,2.0,0.0,0.0,3,10,3250,0,1994,0,98075,47.5862,-122.037,3240,8449,8,4,2014,UNK,10,521
7740500070,7/10/2014,475000.0,3,2.0,1880,9659,1.0,0.0,0.0,3,8,1180,700,1951,0,98155,47.7497,-122.28399999999999,1780,9659,7,10,2014,UNK,100,0
3352401090,11/13/2014,238950.0,2,1.0,1190,11400,1.0,0.0,0.0,3,7,1190,0,1951,0,98178,47.5012,-122.265,1410,11400,11,13,2014,UNK,-220,0
2767704756,10/20/2014,470000.0,3,3.5,1280,1257,2.0,0.0,0.0,3,8,1040,240,2000,0,98107,47.6721,-122.374,1280,1249,10,20,2014,UNK,0,8
7504400710,4/27/2015,420000.0,4,1.75,2380,15324,1.0,0.0,0.0,3,8,1610,770,1978,0,98074,47.6262,-122.04899999999999,2540,12608,4,27,2015,UNK,-160,2716
7787100390,4/20/2015,440000.0,3,2.5,2040,7605,2.0,0.0,0.0,3,8,2040,0,1996,0,98045,47.4876,-121.779,2150,7545,4,20,2015,UNK,-110,60
4240400140,8/20/2014,656000.0,4,1.75,1440,4300,1.5,0.0,0.0,4,8,1290,150,1929,0,98117,47.6846,-122.37200000000001,1640,5000,8,20,2014,UNK,-200,-700
7202270570,7/14/2014,559950.0,3,2.5,2120,4310,2.0,0.0,0.0,3,7,2120,0,2001,0,98053,47.687,-122.037,2280,4380,7,14,2014,UNK,-160,-70
3037200045,11/13/2014,600000.0,2,2.0,990,5416,1.0,0.0,0.0,3,6,990,0,1935,0,98122,47.604,-122.311,1650,3360,11,13,2014,UNK,-660,2056
3750605247,8/4/2014,255000.0,3,1.0,1710,12000,1.0,0.0,0.0,4,7,1710,0,1972,0,98001,47.2616,-122.281,1310,9600,8,4,2014,UNK,400,2400
7972604425,4/1/2015,210750.0,4,1.5,1840,7076,1.5,0.0,0.0,3,7,1840,0,1957,0,98106,47.5185,-122.345,1510,7320,4,1,2015,UNK,330,-244
809002610,7/18/2014,485000.0,4,1.0,1150,2560,1.5,0.0,0.0,3,7,1150,0,1909,0,98109,47.6368,-122.355,1890,3000,7,18,2014,UNK,-740,-440
4123840570,10/20/2014,390000.0,3,2.5,2250,8076,2.0,0.0,0.0,3,8,2250,0,1995,0,98038,47.3667,-122.041,2180,7244,10,20,2014,UNK,70,832
1081200070,3/23/2015,405000.0,3,2.5,2460,12600,1.0,0.0,0.0,4,8,1810,650,1970,0,98059,47.473,-122.118,1820,11180,3,23,2015,UNK,640,1420
9274204100,9/10/2014,462500.0,4,1.0,1540,4500,1.5,0.0,0.0,2,7,1540,0,1905,0,98116,47.586999999999996,-122.384,1920,6000,9,10,2014,UNK,-380,-1500
1072010510,2/10/2015,435000.0,4,2.25,2210,14073,1.0,0.0,0.0,3,8,1630,580,1978,0,98059,47.4774,-122.14200000000001,2340,11340,2,10,2015,UNK,-130,2733
7202330160,11/19/2014,440000.0,3,2.5,1440,5434,2.0,0.0,0.0,3,7,1440,0,2003,0,98053,47.6818,-122.03399999999999,1560,3770,11,19,2014,UNK,-120,1664
8731990700,6/25/2014,299950.0,3,1.75,1790,7650,1.0,0.0,3.0,3,9,1790,0,1978,0,98023,47.3213,-122.385,2540,7600,6,25,2014,UNK,-750,50
9828200746,5/4/2015,440000.0,2,1.5,1120,1024,2.0,0.0,0.0,3,8,1120,0,1970,1998,98122,47.6175,-122.29799999999999,1120,1549,5,4,2015,Y,0,-525
9407100310,11/13/2014,312620.0,3,2.5,1260,11877,1.0,0.0,0.0,3,7,1260,0,1975,0,98045,47.4442,-121.762,1430,9790,11,13,2014,UNK,-170,2087
6817800510,6/5/2014,372500.0,3,1.5,1180,12324,1.0,0.0,0.0,3,7,800,380,1981,0,98074,47.6337,-122.03200000000001,1280,11371,6,5,2014,UNK,-100,953
7212680860,2/9/2015,297262.0,3,2.5,1730,8076,2.0,0.0,0.0,3,8,1730,0,1994,0,98003,47.2619,-122.30799999999999,1780,6930,2,9,2015,UNK,-50,1146
3260000570,2/10/2015,735000.0,4,3.0,2250,7245,1.0,0.0,0.0,4,7,1250,1000,1963,0,98005,47.6045,-122.169,1960,7245,2,10,2015,UNK,290,0
1139000400,8/26/2014,430000.0,3,1.5,1550,5034,2.0,0.0,0.0,4,7,1550,0,1922,0,98177,47.7072,-122.36,1820,7200,8,26,2014,UNK,-270,-2166
8649401000,10/22/2014,241000.0,2,1.75,1070,9750,1.5,0.0,0.0,3,7,1070,0,1995,0,98014,47.7131,-121.319,970,9750,10,22,2014,UNK,100,0
6600400260,5/12/2014,201000.0,3,1.0,1460,9750,1.0,0.0,0.0,4,7,1460,0,1969,0,98042,47.3242,-122.14399999999999,1270,9750,5,12,2014,UNK,190,0
1797500435,4/20/2015,570000.0,2,1.0,1060,4000,1.0,0.0,0.0,4,7,1060,0,1910,0,98115,47.6731,-122.315,1770,4000,4,20,2015,UNK,-710,0
2155000160,5/8/2014,538000.0,4,1.75,1840,9600,1.0,0.0,0.0,3,7,1220,620,1967,0,98052,47.6579,-122.125,1770,9720,5,8,2014,UNK,70,-120
9526600340,5/12/2015,729000.0,3,2.5,2440,4244,2.0,0.0,0.0,3,8,2440,0,2011,0,98052,47.7057,-122.11200000000001,2690,4556,5,12,2015,N,-250,-312
2205500030,1/8/2015,331500.0,4,1.75,1700,14756,1.0,0.0,0.0,3,7,850,850,1955,0,98006,47.5762,-122.14299999999999,1680,10250,1,8,2015,UNK,20,4506
2123049114,5/19/2014,110700.0,2,1.0,680,8064,1.0,0.0,0.0,3,6,680,0,1941,0,98188,47.468999999999994,-122.29799999999999,1340,10800,5,19,2014,UNK,-660,-2736
8078050140,10/2/2014,245000.0,3,2.0,1700,8448,1.0,0.0,0.0,3,7,1700,0,1996,0,98022,47.2077,-122.01100000000001,1350,8587,10,2,2014,UNK,350,-139
7617500075,7/21/2014,427000.0,3,1.75,2000,7111,1.0,0.0,0.0,4,7,1360,640,1956,0,98177,47.7676,-122.37299999999999,1830,9000,7,21,2014,UNK,170,-1889
381000240,8/6/2014,650500.0,4,1.75,2340,5940,1.0,0.0,0.0,3,8,1290,1050,1953,0,98115,47.6789,-122.281,1930,5940,8,6,2014,UNK,410,0
7568700260,8/14/2014,335900.0,2,1.0,1120,7440,1.0,0.0,0.0,4,7,1120,0,1939,0,98155,47.7405,-122.323,1170,7440,8,14,2014,UNK,-50,0
1370803925,9/3/2014,535000.0,2,2.0,1510,5133,1.5,0.0,0.0,3,7,1510,0,1939,0,98199,47.6415,-122.40100000000001,1470,6000,9,3,2014,UNK,40,-867
1250200786,1/22/2015,360000.0,5,2.0,2120,2400,1.0,0.0,0.0,4,6,1080,1040,1906,0,98144,47.5979,-122.29700000000001,1690,4400,1,22,2015,UNK,430,-2000
7399300510,2/4/2015,294900.0,3,2.25,1500,8100,1.0,0.0,0.0,3,7,1210,290,1968,0,98055,47.4632,-122.19,1600,7896,2,4,2015,UNK,-100,204
5430300106,3/11/2015,460000.0,2,1.0,1030,5934,1.0,0.0,0.0,4,7,1030,0,1928,0,98115,47.6828,-122.287,1420,5588,3,11,2015,UNK,-390,346
2954400310,9/15/2014,1770000.0,4,3.5,5440,38900,2.0,0.0,0.0,3,12,5440,0,1990,0,98053,47.6605,-122.069,4830,41313,9,15,2014,UNK,610,-2413
9209900335,5/9/2014,463000.0,2,1.0,1150,4400,1.0,0.0,0.0,4,7,1150,0,1905,0,98112,47.6226,-122.292,1240,4400,5,9,2014,UNK,-90,0
1920079062,12/22/2014,332000.0,5,1.5,2420,43560,1.0,0.0,2.0,3,8,1500,920,1962,0,98022,47.208,-121.963,1620,17331,12,22,2014,UNK,800,26229
7227800055,9/9/2014,199500.0,4,2.0,1750,8116,1.0,0.0,0.0,4,5,1750,0,1943,0,98056,47.5097,-122.181,1440,7865,9,9,2014,UNK,310,251
7227800055,11/24/2014,247000.0,4,2.0,1750,8116,1.0,0.0,0.0,4,5,1750,0,1943,0,98056,47.5097,-122.181,1440,7865,11,24,2014,UNK,310,251
3296900160,6/9/2014,442500.0,4,2.5,2170,14024,2.0,0.0,0.0,3,8,2170,0,1992,0,98019,47.7346,-121.97,2240,14029,6,9,2014,UNK,-70,-5
3421069053,6/19/2014,600000.0,3,2.0,2540,237402,1.0,0.0,0.0,3,9,2540,0,2007,0,98022,47.2688,-122.024,2200,229125,6,19,2014,N,340,8277
7202380340,9/3/2014,449000.0,3,2.5,1690,3827,2.0,0.0,0.0,3,7,1690,0,2005,0,98053,47.6768,-122.029,1690,3129,9,3,2014,N,0,698
6716700240,3/6/2015,725000.0,4,1.0,1600,4500,1.5,0.0,0.0,4,7,1600,0,1926,0,98115,47.6804,-122.316,1720,4500,3,6,2015,UNK,-120,0
1431400070,2/5/2015,215000.0,3,1.0,1060,7900,1.0,0.0,0.0,3,7,1060,0,1961,2001,98058,47.4604,-122.18,1310,7900,2,5,2015,Y,-250,0
9554200200,12/18/2014,582500.0,2,1.75,1990,6549,1.0,0.0,0.0,3,7,1170,820,1948,0,98115,47.7,-122.296,1640,7202,12,18,2014,UNK,350,-653
1310900140,6/24/2014,305000.0,4,2.25,2210,9371,2.0,0.0,0.0,4,8,2210,0,1968,0,98032,47.3634,-122.279,2300,11584,6,24,2014,UNK,-90,-2213
9454200030,9/23/2014,734000.0,4,2.75,3090,7650,2.0,0.0,2.0,3,8,2340,750,1959,1989,98042,47.3622,-122.15700000000001,2760,10370,9,23,2014,Y,330,-2720
1402810140,5/5/2014,300000.0,3,2.0,1050,10072,1.0,0.0,0.0,3,7,1050,0,1986,0,98019,47.7341,-121.976,1130,10087,5,5,2014,UNK,-80,-15
1823069155,5/5/2014,525888.0,5,1.75,2550,71874,1.0,0.0,0.0,5,7,1810,740,1960,0,98027,47.4845,-122.08,2170,51400,5,5,2014,UNK,380,20474
2530800070,9/11/2014,711000.0,4,2.5,2095,4400,1.5,0.0,0.0,5,8,1295,800,1910,0,98116,47.5838,-122.39,1980,4400,9,11,2014,UNK,115,0
4024100496,7/16/2014,360000.0,3,1.75,1520,12282,1.0,0.0,0.0,3,8,1220,300,1978,0,98155,47.7516,-122.29899999999999,1860,13500,7,16,2014,UNK,-340,-1218
5252000200,12/10/2014,357000.0,5,2.5,2750,12350,2.0,0.0,0.0,3,8,2750,0,1987,0,98031,47.419,-122.206,1650,9810,12,10,2014,UNK,1100,2540
7331900270,9/30/2014,235000.0,3,1.75,1200,9266,1.0,0.0,0.0,4,7,1200,0,1960,0,98002,47.31399999999999,-122.208,1200,9266,9,30,2014,UNK,0,0
1574700140,8/8/2014,550000.0,3,1.75,1830,9720,1.0,0.0,1.0,3,7,1150,680,1928,0,98040,47.5511,-122.23,3380,10854,8,8,2014,UNK,-1550,-1134
162500030,12/5/2014,324000.0,3,1.0,1160,7202,1.0,0.0,0.0,4,7,1160,0,1957,0,98133,47.7675,-122.334,1620,8598,12,5,2014,UNK,-460,-1396
3705900292,4/28/2015,420000.0,3,2.0,1750,9239,1.0,0.0,0.0,3,8,1410,340,1989,0,98133,47.7583,-122.339,1720,7874,4,28,2015,UNK,30,1365
2141500070,6/19/2014,450000.0,4,2.5,2400,7693,2.0,0.0,0.0,3,8,2400,0,2003,0,98059,47.4881,-122.14200000000001,2400,8038,6,19,2014,UNK,0,-345
8562750060,4/20/2015,825000.0,5,3.5,4140,6770,2.0,0.0,0.0,3,9,3030,1110,2004,0,98027,47.5381,-122.069,3960,5431,4,20,2015,N,180,1339
7349620030,7/22/2014,272000.0,4,2.25,2115,6234,2.0,0.0,0.0,3,7,2115,0,1998,0,98002,47.285,-122.20100000000001,2440,6366,7,22,2014,UNK,-325,-132
2523039315,10/22/2014,481000.0,3,2.0,2580,15653,1.5,0.0,0.0,3,9,2580,0,1990,0,98166,47.4561,-122.361,1920,9840,10,22,2014,UNK,660,5813
2877101821,8/5/2014,500000.0,3,1.0,1220,3400,1.0,0.0,0.0,3,7,1060,160,1927,0,98117,47.6775,-122.363,1350,3750,8,5,2014,UNK,-130,-350
1176000390,6/12/2014,448000.0,2,1.5,1630,3780,1.0,0.0,0.0,4,7,890,740,1940,0,98107,47.6711,-122.40299999999999,1770,6400,6,12,2014,UNK,-140,-2620
8682262190,3/19/2015,480000.0,2,2.0,1350,4220,1.0,0.0,0.0,3,8,1350,0,2004,0,98053,47.718,-122.03399999999999,1350,4409,3,19,2015,N,0,-189
7202350060,9/8/2014,475000.0,3,2.5,1690,2890,2.0,0.0,0.0,3,7,1690,0,2004,0,98053,47.6802,-122.031,1690,2730,9,8,2014,N,0,160
3630060070,10/21/2014,472500.0,2,2.25,1700,2383,2.0,0.0,0.0,3,8,1700,0,2005,0,98029,47.547,-121.99700000000001,1700,2700,10,21,2014,N,0,-317
2413300810,9/23/2014,291000.0,4,2.25,1890,7616,1.0,0.0,0.0,4,8,1260,630,1979,0,98003,47.3275,-122.329,1890,7420,9,23,2014,UNK,0,196
6450304260,7/22/2014,294000.0,2,1.0,850,5250,1.0,0.0,0.0,4,7,850,0,1950,0,98133,47.731,-122.34200000000001,1440,5250,7,22,2014,UNK,-590,0
2025059204,7/30/2014,1010000.0,4,2.5,2480,12688,1.0,0.0,0.0,4,9,1820,660,1967,0,98004,47.6344,-122.205,2910,11979,7,30,2014,UNK,-430,709
7202290240,10/17/2014,442500.0,3,2.5,1690,3129,2.0,0.0,0.0,3,7,1690,0,2002,0,98053,47.6875,-122.04299999999999,1690,3129,10,17,2014,UNK,0,0
1788700070,6/27/2014,170000.0,2,1.0,810,8424,1.0,0.0,0.0,4,6,810,0,1959,0,98023,47.3286,-122.346,820,8424,6,27,2014,UNK,-10,0
8085400055,4/28/2015,1580000.0,4,2.5,3980,16304,1.0,0.0,1.0,3,10,2480,1500,1968,0,98004,47.638999999999996,-122.21,3980,16304,4,28,2015,UNK,0,0
5700002025,2/18/2015,665000.0,3,2.25,2580,6000,2.0,0.0,0.0,3,8,1780,800,1925,0,98144,47.5778,-122.289,2300,5995,2,18,2015,UNK,280,5
853600310,8/28/2014,1610000.0,5,4.5,6085,142725,3.0,0.0,0.0,3,11,6085,0,2000,0,98014,47.6085,-121.95200000000001,4830,128457,8,28,2014,UNK,1255,14268
5332200320,7/14/2014,675000.0,2,1.75,2140,5000,1.0,0.0,0.0,3,7,1000,1140,1930,1991,98112,47.6284,-122.291,2250,4000,7,14,2014,Y,-110,1000
2130701535,2/4/2015,279900.0,2,1.75,1360,10000,1.0,0.0,0.0,3,6,1360,0,1957,1989,98019,47.7421,-121.98200000000001,1430,10000,2,4,2015,Y,-70,0
510002010,6/30/2014,875000.0,4,1.5,1800,3245,1.5,0.0,0.0,4,8,1800,0,1929,0,98103,47.6605,-122.331,1800,4275,6,30,2014,UNK,0,-1030
3630110510,8/4/2014,571000.0,3,2.5,1920,3867,2.0,0.0,0.0,3,8,1920,0,2005,0,98029,47.5538,-121.994,2190,3841,8,4,2014,N,-270,26
6300000400,6/17/2014,320000.0,3,1.0,860,5060,1.5,0.0,0.0,3,7,860,0,1927,0,98133,47.7062,-122.34100000000001,880,5060,6,17,2014,UNK,-20,0
1560920200,8/26/2014,525000.0,3,2.5,2340,35021,1.0,0.0,0.0,3,9,2340,0,1986,0,98038,47.3988,-122.02799999999999,2630,35190,8,26,2014,UNK,-290,-169
1652500060,7/11/2014,1650000.0,8,2.75,4040,20666,1.0,0.0,0.0,4,9,2020,2020,1962,0,98004,47.63399999999999,-122.221,3670,20500,7,11,2014,UNK,370,166
9368700270,4/1/2015,137900.0,3,1.75,1160,5082,1.0,0.0,0.0,3,6,580,580,1942,0,98178,47.503,-122.262,1730,6000,4,1,2015,UNK,-570,-918
2223089053,6/3/2014,440000.0,3,2.25,1680,57063,2.0,0.0,0.0,4,8,1680,0,1989,0,98045,47.4669,-121.765,1910,57063,6,3,2014,UNK,-230,0
9828201920,3/4/2015,360000.0,3,1.0,1280,3870,1.0,0.0,0.0,3,7,640,640,1945,0,98122,47.6163,-122.294,1280,4800,3,4,2015,UNK,0,-930
7334401040,2/5/2015,271000.0,4,1.5,1800,9576,1.0,0.0,0.0,4,7,1800,0,1977,0,98045,47.4664,-121.74700000000001,1370,9576,2,5,2015,UNK,430,0
5152700060,5/28/2014,465000.0,6,3.25,4250,23326,1.0,0.0,3.0,3,10,2150,2100,1967,0,98003,47.34,-122.32700000000001,3370,15983,5,28,2014,UNK,880,7343
1460900030,9/26/2014,280000.0,4,2.5,2400,4596,2.0,0.0,0.0,3,8,2400,0,2004,0,98001,47.3358,-122.265,2230,4763,9,26,2014,N,170,-167
3626039250,4/28/2015,283000.0,2,1.0,940,6350,1.0,0.0,0.0,4,5,940,0,1942,0,98103,47.698,-122.35700000000001,1490,6350,4,28,2015,UNK,-550,0
7199360320,2/13/2015,411500.0,3,1.0,1110,7208,1.0,0.0,0.0,3,7,1110,0,1980,0,98052,47.6979,-122.124,1440,7210,2,13,2015,UNK,-330,-2
8731901610,9/17/2014,282000.0,3,2.25,2420,7548,1.0,0.0,0.0,4,8,1370,1050,1967,0,98023,47.3112,-122.376,2150,8000,9,17,2014,UNK,270,-452
6821102317,12/9/2014,535000.0,3,2.5,1850,1499,2.5,0.0,0.0,3,9,1790,60,2005,0,98199,47.6475,-122.396,1770,1539,12,9,2014,N,80,-40
3271300955,7/3/2014,554729.0,4,2.5,2020,4350,2.0,0.0,0.0,5,9,1730,290,1943,0,98199,47.6503,-122.41,1620,5800,7,3,2014,UNK,400,-1450
3271300955,2/24/2015,868000.0,4,2.5,2020,4350,2.0,0.0,0.0,5,9,1730,290,1943,0,98199,47.6503,-122.41,1620,5800,2,24,2015,UNK,400,-1450
2623089135,6/16/2014,427000.0,3,2.5,1830,65340,1.0,0.0,0.0,3,8,1520,310,1991,0,98045,47.4553,-121.75,2100,84942,6,16,2014,UNK,-270,-19602
2044500152,11/17/2014,455000.0,4,1.75,1920,6000,1.0,0.0,0.0,4,7,960,960,1954,0,98125,47.7137,-122.315,1850,7200,11,17,2014,UNK,70,-1200
1725059187,10/29/2014,595000.0,2,1.75,1280,8500,1.0,0.0,0.0,3,7,1280,0,1953,2010,98033,47.6553,-122.19,1950,10356,10,29,2014,Y,-670,-1856
6699930260,3/20/2015,400000.0,4,2.5,3130,5240,2.0,0.0,0.0,3,8,3130,0,2004,0,98038,47.3446,-122.042,2470,5240,3,20,2015,N,660,0
3295610200,6/25/2014,770000.0,4,2.5,3920,12415,2.0,0.0,0.0,3,10,3920,0,1997,0,98075,47.5658,-122.03200000000001,3639,12805,6,25,2014,UNK,281,-390
1186000125,5/9/2014,742500.0,4,2.75,3100,3773,2.0,0.0,0.0,3,8,2000,1100,1919,1996,98122,47.6158,-122.291,2130,3777,5,9,2014,Y,970,-4
6065300570,6/24/2014,1250000.0,4,2.5,3220,15600,1.0,0.0,0.0,5,9,1680,1540,1973,0,98006,47.5697,-122.182,2990,15600,6,24,2014,UNK,230,0
8039900400,8/12/2014,375000.0,3,2.0,1670,13775,1.0,0.0,0.0,3,8,1670,0,1968,0,98045,47.4873,-121.78299999999999,2130,14500,8,12,2014,UNK,-460,-725
1925059200,4/7/2015,1560000.0,4,2.5,2700,17853,2.0,0.0,0.0,4,9,2700,0,1960,0,98004,47.6463,-122.219,3790,16672,4,7,2015,UNK,-1090,1181
5729000070,1/28/2015,545000.0,4,2.0,5461,22880,1.0,0.0,0.0,4,9,3265,2196,1964,0,98032,47.3557,-122.29,1940,10995,1,28,2015,UNK,3521,11885
98000960,5/13/2014,1050000.0,4,3.25,4400,16625,2.0,0.0,0.0,3,11,4400,0,2003,0,98075,47.5868,-121.96799999999999,4440,15523,5,13,2014,UNK,-40,1102
1330300451,12/17/2014,1570000.0,3,1.75,2190,8500,1.0,0.0,0.0,4,9,2190,0,1957,0,98112,47.64,-122.285,2850,8868,12,17,2014,UNK,-660,-368
4312700340,3/18/2015,178000.0,4,1.5,1200,11163,1.5,0.0,0.0,4,6,1200,0,1970,0,98092,47.3024,-122.10600000000001,1200,11163,3,18,2015,UNK,0,0
3797700030,10/9/2014,262500.0,3,1.75,1470,10390,1.0,0.0,0.0,3,7,1470,0,1989,0,98031,47.4192,-122.20100000000001,1770,7507,10,9,2014,UNK,-300,2883
452001890,4/15/2015,730000.0,3,1.75,1650,5000,1.5,0.0,0.0,4,8,1650,0,1900,0,98107,47.6743,-122.37100000000001,1630,5000,4,15,2015,UNK,20,0
2927600105,7/3/2014,395000.0,5,1.75,1840,10453,1.0,0.0,2.0,3,8,1360,480,1948,0,98166,47.4508,-122.368,2250,11250,7,3,2014,UNK,-410,-797
3298300140,10/24/2014,355000.0,3,1.0,1210,6650,1.0,0.0,0.0,3,6,1210,0,1959,0,98008,47.6214,-122.12,990,7590,10,24,2014,UNK,220,-940
1321700390,9/8/2014,299990.0,3,2.5,1870,8541,2.0,0.0,0.0,3,8,1870,0,1989,0,98023,47.2925,-122.346,2150,7789,9,8,2014,UNK,-280,752
1222069129,3/27/2015,1130000.0,4,3.25,3890,422096,1.5,0.0,0.0,3,9,3150,740,2001,0,98038,47.4125,-121.98200000000001,2180,229996,3,27,2015,UNK,1710,192100
1081800070,11/18/2014,425000.0,4,2.25,2660,11200,2.0,0.0,0.0,4,8,2660,0,1972,0,98059,47.4722,-122.131,2090,11120,11,18,2014,UNK,570,80
6414100732,1/7/2015,349000.0,2,1.0,1150,7552,1.0,0.0,0.0,3,7,1150,0,1951,0,98125,47.7215,-122.323,1150,7346,1,7,2015,UNK,0,206
513000445,11/11/2014,554950.0,4,1.75,1740,4816,1.0,0.0,0.0,5,7,870,870,1942,0,98116,47.5758,-122.382,1210,5074,11,11,2014,UNK,530,-258
6888900060,11/16/2014,326000.0,6,3.0,2580,8064,1.5,0.0,0.0,3,7,1880,700,1913,0,98118,47.5549,-122.287,1510,6084,11,16,2014,UNK,1070,1980
7309100270,6/26/2014,580000.0,4,1.75,1720,6975,1.0,0.0,0.0,3,8,1420,300,1975,0,98052,47.6506,-122.12100000000001,2210,7875,6,26,2014,UNK,-490,-900
2162000260,8/27/2014,699000.0,3,2.5,2740,18455,2.0,0.0,1.0,4,10,1510,1230,1977,0,98040,47.5585,-122.215,2840,16438,8,27,2014,UNK,-100,2017
7732000045,11/25/2014,757000.0,3,2.75,2610,11290,1.0,0.0,0.0,3,7,1630,980,1985,0,98033,47.6632,-122.20100000000001,2570,9125,11,25,2014,UNK,40,2165
3764800510,7/23/2014,335000.0,3,1.75,1400,7920,1.0,0.0,0.0,3,7,1400,0,1965,0,98034,47.7312,-122.20200000000001,1310,7876,7,23,2014,UNK,90,44
2481600030,7/1/2014,660000.0,3,2.0,2570,28500,1.0,0.0,0.0,3,9,1970,600,1983,0,98052,47.7318,-122.13799999999999,3070,32400,7,1,2014,UNK,-500,-3900
5126310060,4/17/2015,540000.0,4,2.75,2830,7334,2.0,0.0,0.0,3,8,2830,0,2005,0,98059,47.4868,-122.141,2830,7378,4,17,2015,N,0,-44
1310700390,10/10/2014,320000.0,5,2.25,2630,8625,2.0,0.0,0.0,3,8,2630,0,1966,0,98032,47.3619,-122.287,1880,8670,10,10,2014,UNK,750,-45
6402710070,4/21/2015,280000.0,3,2.5,1580,7918,2.0,0.0,0.0,3,7,1580,0,1994,0,98055,47.4431,-122.19,1650,7916,4,21,2015,UNK,-70,2
5702450260,7/23/2014,324000.0,3,2.0,1540,10931,1.0,0.0,3.0,3,7,1540,0,1989,0,98045,47.495,-121.77600000000001,1570,10485,7,23,2014,UNK,-30,446
3243200310,5/20/2014,300000.0,3,1.0,2120,7735,1.0,0.0,0.0,4,7,1060,1060,1967,0,98059,47.4869,-122.12299999999999,1010,8570,5,20,2014,UNK,1110,-835
2131200885,8/28/2014,360000.0,3,1.75,1830,10000,2.0,0.0,0.0,4,7,1830,0,1913,1964,98019,47.74100000000001,-121.979,1480,10000,8,28,2014,Y,350,0
8651480550,6/23/2014,600000.0,3,2.5,2260,10153,2.0,0.0,0.0,3,10,2260,0,1987,0,98074,47.64100000000001,-122.068,2740,10153,6,23,2014,UNK,-480,0
3024059036,5/30/2014,950000.0,4,1.75,2500,92347,1.0,0.0,0.0,4,8,1500,1000,1970,0,98040,47.5345,-122.21600000000001,3750,20267,5,30,2014,UNK,-1250,72080
6382500079,7/9/2014,599950.0,3,3.25,1830,1804,3.0,0.0,0.0,3,8,1830,0,2014,0,98117,47.6945,-122.37700000000001,1830,1804,7,9,2014,N,0,0
4363700200,3/25/2015,190000.0,4,1.0,1190,7920,1.0,0.0,0.0,3,6,890,300,1951,0,98126,47.5305,-122.37100000000001,1140,7920,3,25,2015,UNK,50,0
3876310860,3/30/2015,350000.0,4,1.75,2310,9002,1.0,0.0,0.0,3,7,1780,530,1970,0,98034,47.731,-122.166,2090,8814,3,30,2015,UNK,220,188
2391602650,4/10/2015,522000.0,3,1.0,1230,4600,1.5,0.0,0.0,3,7,1230,0,1929,0,98116,47.5616,-122.39200000000001,1230,4600,4,10,2015,UNK,0,0
2597530070,3/18/2015,850000.0,3,2.5,2940,10809,2.0,0.0,0.0,3,10,2940,0,1992,0,98006,47.5418,-122.13600000000001,3090,10348,3,18,2015,UNK,-150,461
1314300046,6/30/2014,308000.0,3,1.0,1010,8800,1.0,0.0,0.0,4,7,1010,0,1954,0,98118,47.5483,-122.27799999999999,1400,4095,6,30,2014,UNK,-390,4705
3693900885,12/2/2014,1020000.0,6,2.25,2550,5000,2.0,0.0,0.0,4,7,2550,0,1907,0,98117,47.6785,-122.396,1480,5000,12,2,2014,UNK,1070,0
6046400465,10/28/2014,397500.0,3,1.0,1480,5100,1.5,0.0,0.0,3,7,1480,0,1938,1959,98103,47.6915,-122.348,1300,5100,10,28,2014,Y,180,0
4388000070,1/27/2015,186000.0,3,1.75,1460,7967,1.0,0.0,0.0,3,7,1040,420,1977,0,98023,47.3199,-122.374,1460,6835,1,27,2015,UNK,0,1132
8854000370,6/20/2014,436500.0,5,3.0,3110,12429,1.0,0.0,0.0,3,8,1790,1320,1977,0,98011,47.7463,-122.213,3050,11902,6,20,2014,UNK,60,527
4459800075,6/3/2014,710000.0,3,2.0,2140,4923,1.0,0.0,0.0,4,8,1070,1070,1928,0,98103,47.6902,-122.339,1470,4923,6,3,2014,UNK,670,0
7153200160,1/14/2015,1380000.0,5,3.25,3450,6360,2.0,0.0,0.0,5,9,1860,1590,1905,0,98122,47.6133,-122.287,2310,5000,1,14,2015,UNK,1140,1360
7752400075,4/28/2015,450000.0,3,2.25,1960,10682,1.0,0.0,0.0,3,7,1960,0,1957,0,98008,47.6319,-122.124,1540,10682,4,28,2015,UNK,420,0
7604410030,1/21/2015,375000.0,4,2.75,1890,5240,1.0,0.0,0.0,3,7,980,910,1981,0,98106,47.5528,-122.35600000000001,1600,5240,1,21,2015,UNK,290,0
2144800311,11/13/2014,315000.0,2,1.0,2080,14659,1.0,0.0,0.0,3,7,1040,1040,1960,0,98178,47.4858,-122.23100000000001,1920,15208,11,13,2014,UNK,160,-549
1705400550,2/13/2015,467500.0,3,1.0,1700,4165,1.5,0.0,0.0,3,7,1700,0,1918,0,98118,47.5569,-122.277,1400,4165,2,13,2015,UNK,300,0
9485700136,2/27/2015,330000.0,3,1.0,1140,7316,1.0,0.0,0.0,3,6,1140,0,1959,0,98106,47.527,-122.36200000000001,1140,7440,2,27,2015,UNK,0,-124
1822039225,7/25/2014,665000.0,3,2.5,3136,54450,1.5,0.0,0.0,5,8,3136,0,1910,0,98070,47.3999,-122.47200000000001,2300,54450,7,25,2014,UNK,836,0
2625059301,3/24/2015,760000.0,4,3.25,2590,3889,3.0,0.0,0.0,3,9,2590,0,2013,0,98007,47.6259,-122.14200000000001,2590,4062,3,24,2015,N,0,-173
7625702440,12/30/2014,469000.0,3,1.75,1480,800,2.0,0.0,0.0,3,8,1000,480,2014,0,98136,47.5493,-122.387,1480,1143,12,30,2014,N,0,-343
9126100487,8/13/2014,408000.0,3,3.0,1500,1473,2.0,0.0,0.0,3,8,1120,380,2000,0,98122,47.6063,-122.305,1720,1976,8,13,2014,UNK,-220,-503
7922900030,10/3/2014,851000.0,3,2.75,2660,10350,1.0,0.0,4.0,4,8,1330,1330,1971,0,98008,47.5868,-122.116,2820,10043,10,3,2014,UNK,-160,307
8682292180,7/25/2014,410000.0,2,2.0,1350,3926,1.0,0.0,0.0,3,8,1350,0,2007,0,98053,47.7192,-122.024,1440,3926,7,25,2014,N,-90,0
6730700260,3/13/2015,235000.0,2,1.0,860,10500,1.0,0.0,0.0,3,6,860,0,1943,0,98024,47.5662,-121.88600000000001,950,10500,3,13,2015,UNK,-90,0
7225000045,8/28/2014,207100.0,2,1.0,1000,4500,1.0,0.0,0.0,3,6,1000,0,1916,0,98055,47.4896,-122.204,980,4837,8,28,2014,UNK,20,-337
4140500055,6/26/2014,560000.0,4,2.5,2480,16360,1.0,0.0,0.0,5,7,1510,970,1959,0,98028,47.7638,-122.265,1770,15205,6,26,2014,UNK,710,1155
2592210370,10/31/2014,903000.0,3,2.75,3860,12786,2.0,0.0,0.0,4,10,3860,0,1984,0,98006,47.549,-122.141,2820,14636,10,31,2014,UNK,1040,-1850
1337800830,1/7/2015,998500.0,3,1.75,2140,4800,2.0,0.0,0.0,3,8,1690,450,1905,0,98112,47.6311,-122.31200000000001,2440,4800,1,7,2015,UNK,-300,0
1951500055,7/30/2014,268500.0,4,1.75,1820,13600,1.5,0.0,0.0,3,7,1120,700,1959,0,98032,47.3743,-122.295,1810,11970,7,30,2014,UNK,10,1630
1136100045,10/15/2014,494950.0,2,1.75,2220,33000,1.0,0.0,0.0,4,8,2220,0,1970,0,98072,47.7403,-122.12899999999999,2220,33000,10,15,2014,UNK,0,0
3860400060,8/1/2014,1130000.0,4,2.5,2660,11200,2.0,0.0,0.0,3,9,2660,0,1999,0,98004,47.5894,-122.197,3290,11275,8,1,2014,UNK,-630,-75
1657000070,11/18/2014,250000.0,3,2.0,1470,12096,1.0,0.0,0.0,4,6,1470,0,1942,0,98030,47.3734,-122.193,1470,10966,11,18,2014,UNK,0,1130
1423069129,3/20/2015,449000.0,4,1.75,2350,54450,1.0,0.0,0.0,4,7,1250,1100,1971,0,98027,47.4816,-122.005,2180,50529,3,20,2015,UNK,170,3921
1118001631,1/12/2015,1230000.0,3,2.25,2980,7700,1.0,0.0,0.0,3,9,2530,450,1964,0,98112,47.6336,-122.29,3020,8234,1,12,2015,UNK,-40,-534
7399200240,3/17/2015,325000.0,4,2.0,1870,7700,1.0,0.0,0.0,3,8,1870,0,1966,0,98055,47.4619,-122.196,2270,8580,3,17,2015,UNK,-400,-880
4037000160,6/15/2014,506000.0,5,3.0,2430,8000,1.0,0.0,0.0,4,7,1370,1060,1957,0,98008,47.603,-122.12,1770,8000,6,15,2014,UNK,660,0
8562740370,3/25/2015,751000.0,4,2.5,2790,6538,2.0,0.0,0.0,3,9,2790,0,2003,0,98027,47.5349,-122.066,2990,6538,3,25,2015,UNK,-200,0
9407001620,8/12/2014,280000.0,3,2.5,1370,22326,2.0,0.0,0.0,3,7,1370,0,1993,0,98045,47.4469,-121.775,1580,10920,8,12,2014,UNK,-210,11406
2481620310,5/14/2014,1120000.0,4,2.25,4470,60373,2.0,0.0,0.0,3,11,4470,0,1988,0,98072,47.7289,-122.12700000000001,3210,40450,5,14,2014,UNK,1260,19923
7511200350,9/19/2014,580000.0,3,1.75,2040,81021,1.0,0.0,0.0,3,8,2040,0,1980,0,98053,47.6536,-122.045,2260,39280,9,19,2014,UNK,-220,41741
4039100350,4/23/2015,665000.0,4,2.25,2340,5300,1.0,0.0,0.0,5,8,1700,640,1963,0,98008,47.6202,-122.11200000000001,1890,8250,4,23,2015,UNK,450,-2950
808300270,5/27/2014,450000.0,4,2.5,2520,8515,2.0,0.0,0.0,3,7,2520,0,1999,0,98019,47.7233,-121.959,2130,6930,5,27,2014,UNK,390,1585
3023059012,9/10/2014,389900.0,4,1.0,1710,117176,1.5,0.0,0.0,4,6,1710,0,1942,0,98055,47.4497,-122.212,1940,12223,9,10,2014,UNK,-230,104953
4039300810,11/17/2014,427000.0,3,1.0,1200,5252,1.0,0.0,0.0,3,7,1200,0,1962,0,98007,47.6075,-122.134,1800,7920,11,17,2014,UNK,-600,-2668
8849300320,4/16/2015,265000.0,3,1.75,1330,12618,1.0,0.0,3.0,3,7,1330,0,1983,0,98188,47.4403,-122.271,1870,8429,4,16,2015,UNK,-540,4189
272000320,11/5/2014,398000.0,3,1.5,1310,2996,2.0,0.0,0.0,3,7,1310,0,1998,0,98144,47.5879,-122.29899999999999,1310,2997,11,5,2014,UNK,0,-1
1180002470,11/4/2014,354000.0,6,3.5,3020,4500,2.0,0.0,0.0,3,7,3020,0,1941,1992,98178,47.49800000000001,-122.225,900,6000,11,4,2014,Y,2120,-1500
1330290160,4/13/2015,339950.0,4,2.5,2260,6086,2.0,0.0,0.0,3,8,2260,0,1999,0,98030,47.3642,-122.17399999999999,2260,6218,4,13,2015,UNK,0,-132
6392000570,11/12/2014,399000.0,2,1.0,790,4000,1.0,0.0,0.0,3,6,790,0,1948,0,98115,47.6844,-122.289,990,5000,11,12,2014,UNK,-200,-1000
8835200160,10/10/2014,325000.0,2,2.0,970,5000,1.0,0.0,0.0,3,7,970,0,1983,0,98034,47.7223,-122.16,1540,5000,10,10,2014,UNK,-570,0
868000575,8/19/2014,998800.0,3,2.0,2250,8000,1.0,0.0,2.0,4,9,2250,0,1955,0,98177,47.7077,-122.37799999999999,2880,10960,8,19,2014,UNK,-630,-2960
597000550,9/19/2014,350000.0,4,2.5,1530,2248,1.5,0.0,0.0,3,7,1530,0,1914,0,98144,47.5766,-122.309,1340,3700,9,19,2014,UNK,190,-1452
6669000070,8/5/2014,1000000.0,4,1.75,1780,11436,1.0,0.0,0.0,5,9,1780,0,1967,0,98004,47.6273,-122.194,2100,12052,8,5,2014,UNK,-320,-616
7202340860,3/18/2015,561000.0,3,2.5,2120,5277,2.0,0.0,0.0,3,7,2120,0,2005,0,98053,47.6811,-122.03399999999999,2370,5257,3,18,2015,N,-250,20
6141100320,7/7/2014,245000.0,2,1.0,1500,6685,1.0,0.0,0.0,3,7,1190,310,1926,0,98133,47.7186,-122.354,1420,6561,7,7,2014,UNK,80,124
6141100320,2/13/2015,570000.0,2,1.0,1500,6685,1.0,0.0,0.0,3,7,1190,310,1926,0,98133,47.7186,-122.354,1420,6561,2,13,2015,UNK,80,124
6815100370,10/30/2014,845000.0,4,3.0,2390,4000,1.5,0.0,0.0,5,8,1460,930,1931,0,98103,47.6857,-122.331,1670,4000,10,30,2014,UNK,720,0
5636010560,9/29/2014,314500.0,4,2.5,2390,9600,2.0,0.0,0.0,3,7,2390,0,1996,0,98010,47.3289,-122.001,1900,9603,9,29,2014,UNK,490,-3
2592200030,6/18/2014,650000.0,3,1.75,2920,9370,1.0,0.0,0.0,4,8,1620,1300,1981,0,98006,47.5491,-122.15100000000001,2890,9609,6,18,2014,UNK,30,-239
1823059159,5/6/2015,298000.0,2,1.0,850,5000,1.0,0.0,0.0,3,5,850,0,1907,0,98055,47.4874,-122.20700000000001,910,4815,5,6,2015,UNK,-60,185
2254501620,4/9/2015,500000.0,2,1.0,930,3200,1.0,0.0,0.0,3,7,930,0,1904,0,98122,47.608999999999995,-122.314,1690,3840,4,9,2015,UNK,-760,-640
9275700765,6/10/2014,870000.0,4,2.5,3340,12248,2.0,0.0,1.0,3,9,2470,870,1998,0,98126,47.5858,-122.37899999999999,2110,5679,6,10,2014,UNK,1230,6569
7454000875,4/6/2015,299000.0,2,1.0,710,6732,1.0,0.0,0.0,5,6,710,0,1942,0,98126,47.5151,-122.37200000000001,710,6720,4,6,2015,UNK,0,12
7434500127,8/12/2014,527000.0,3,2.25,2240,6450,1.0,0.0,0.0,3,7,1440,800,1979,0,98125,47.7034,-122.315,1390,6450,8,12,2014,UNK,850,0
646500070,11/6/2014,420000.0,3,1.0,1060,7638,1.0,0.0,0.0,5,7,1060,0,1966,0,98007,47.5941,-122.14200000000001,1470,8097,11,6,2014,UNK,-410,-459
9432900560,2/12/2015,290000.0,3,2.5,2360,8764,2.0,0.0,0.0,3,8,2360,0,1991,0,98022,47.2114,-122.009,2360,8746,2,12,2015,UNK,0,18
5154700060,10/15/2014,1660000.0,4,2.75,3520,19200,1.0,1.0,4.0,4,9,1950,1570,1951,0,98136,47.525,-122.39299999999999,2450,7000,10,15,2014,UNK,1070,12200
3395300260,8/15/2014,499990.0,3,1.75,1730,9334,1.0,0.0,0.0,3,8,1220,510,1977,0,98052,47.6478,-122.113,2020,10000,8,15,2014,UNK,-290,-666
2113700510,10/27/2014,315000.0,3,1.75,1170,4000,1.0,0.0,0.0,3,6,720,450,1943,2013,98106,47.5306,-122.354,1130,4000,10,27,2014,Y,40,0
4053200566,10/20/2014,425000.0,4,2.25,3680,26266,2.0,0.0,0.0,4,9,3680,0,1981,0,98042,47.3219,-122.085,2340,19939,10,20,2014,UNK,1340,6327
7214720400,2/17/2015,630000.0,3,2.5,2900,46609,2.0,0.0,0.0,3,9,2900,0,1987,0,98077,47.7731,-122.086,2570,42188,2,17,2015,UNK,330,4421
3211210200,11/18/2014,365000.0,3,1.75,1290,7205,1.5,0.0,0.0,3,7,1290,0,1971,0,98034,47.7329,-122.23700000000001,1340,7214,11,18,2014,UNK,-50,-9
7010700810,11/6/2014,774000.0,4,2.75,2010,7000,2.0,0.0,0.0,5,8,2010,0,1901,0,98199,47.6607,-122.396,1420,4400,11,6,2014,UNK,590,2600
3971700390,4/6/2015,368888.0,3,1.5,1490,12186,1.0,0.0,0.0,4,7,1490,0,1950,0,98155,47.7739,-122.322,1180,14285,4,6,2015,UNK,310,-2099
9406550060,10/2/2014,339500.0,4,2.5,1930,7862,2.0,0.0,0.0,3,7,1930,0,1994,0,98038,47.3644,-122.04,1640,9145,10,2,2014,UNK,290,-1283
414100045,9/23/2014,344950.0,4,1.75,2240,7500,1.0,0.0,0.0,4,7,1120,1120,1956,0,98133,47.7466,-122.34,1440,7500,9,23,2014,UNK,800,0
4276400030,11/12/2014,450000.0,3,2.0,2320,17688,1.0,0.0,0.0,3,8,2320,0,1952,1994,98166,47.4519,-122.363,1610,14482,11,12,2014,Y,710,3206
9433000060,11/18/2014,814950.0,4,2.75,2990,6626,2.0,0.0,0.0,3,9,2990,0,2014,0,98052,47.7107,-122.11,2910,5533,11,18,2014,N,80,1093
7885800160,9/5/2014,299900.0,4,2.5,2200,5730,2.0,0.0,0.0,3,8,2200,0,2003,0,98042,47.3482,-122.15299999999999,2200,5772,9,5,2014,UNK,0,-42
2473101070,2/27/2015,315000.0,3,2.0,1500,7828,1.0,0.0,0.0,4,7,1500,0,1967,0,98058,47.4484,-122.15799999999999,1500,7700,2,27,2015,UNK,0,128
3701000060,12/16/2014,880000.0,3,1.75,3860,9000,1.0,0.0,2.0,3,9,1930,1930,1970,0,98155,47.7431,-122.29,2960,9000,12,16,2014,UNK,900,0
8651441290,12/29/2014,195000.0,3,1.5,1430,5200,1.0,0.0,0.0,4,7,1030,400,1977,0,98042,47.3644,-122.094,1190,5200,12,29,2014,UNK,240,0
255400060,12/8/2014,910000.0,5,2.75,3750,8279,2.0,0.0,0.0,3,9,3750,0,2001,0,98074,47.6039,-122.06,3450,8279,12,8,2014,UNK,300,0
8567450140,8/27/2014,540000.0,5,2.5,3100,10189,2.0,0.0,0.0,3,8,3100,0,2002,0,98019,47.738,-121.965,2840,10189,8,27,2014,UNK,260,0
2517000140,5/16/2014,306000.0,3,2.5,1870,5874,2.0,0.0,0.0,3,7,1870,0,2005,0,98042,47.3992,-122.163,2090,4060,5,16,2014,N,-220,1814
1938400520,10/16/2014,272000.0,4,2.25,2040,7600,1.0,0.0,0.0,4,8,1580,460,1978,0,98023,47.3169,-122.365,2130,7200,10,16,2014,UNK,-90,400
3179100055,12/9/2014,1300000.0,5,3.5,3700,8504,2.0,0.0,0.0,3,8,2750,950,1950,2014,98105,47.669,-122.275,2370,6246,12,9,2014,Y,1330,2258
1924069105,10/17/2014,450000.0,3,1.75,3150,9258,1.0,0.0,1.0,3,8,2370,780,1970,0,98027,47.5571,-122.08,2740,10274,10,17,2014,UNK,410,-1016
704450070,7/7/2014,450000.0,3,2.5,1990,12793,2.0,0.0,0.0,3,8,1990,0,1993,0,98028,47.7347,-122.226,2290,9035,7,7,2014,UNK,-300,3758
2881700046,6/10/2014,310000.0,4,1.0,1740,11075,1.5,0.0,0.0,3,7,1740,0,1965,0,98133,47.7458,-122.334,1580,7684,6,10,2014,UNK,160,3391
8955800045,5/12/2015,530000.0,2,2.25,2080,11285,1.0,0.0,0.0,4,8,1180,900,1954,0,98042,47.3628,-122.147,2590,13048,5,12,2015,UNK,-510,-1763
3816300105,1/12/2015,435000.0,4,2.5,2060,10125,2.0,0.0,0.0,4,7,1560,500,1979,0,98028,47.763999999999996,-122.262,1760,9876,1,12,2015,UNK,300,249
6649900030,5/5/2015,485000.0,3,2.0,1590,11222,1.0,0.0,0.0,4,7,1590,0,1948,0,98177,47.7762,-122.367,2160,16300,5,5,2015,UNK,-570,-5078
1912100885,7/2/2014,690000.0,3,1.5,1760,4000,2.0,0.0,0.0,3,8,1760,0,1922,0,98102,47.6401,-122.32,1760,4000,7,2,2014,UNK,0,0
9542840570,4/1/2015,305000.0,4,2.5,1620,4000,2.0,0.0,0.0,3,7,1620,0,2008,0,98038,47.3661,-122.02,1580,3780,4,1,2015,N,40,220
2473381070,11/5/2014,300000.0,3,1.75,1210,7000,1.0,0.0,0.0,3,7,1210,0,1975,0,98058,47.4572,-122.169,1670,7000,11,5,2014,UNK,-460,0
7137950350,1/22/2015,289950.0,4,3.0,2040,5050,1.0,0.0,0.0,3,8,1490,550,1993,0,98092,47.3266,-122.175,2020,6118,1,22,2015,UNK,20,-1068
1088800060,11/5/2014,575000.0,3,2.5,2270,9600,2.0,0.0,0.0,3,9,2270,0,1990,0,98011,47.7388,-122.206,2580,9617,11,5,2014,UNK,-310,-17
4054530260,6/27/2014,1820000.0,4,4.5,6640,53330,2.0,0.0,0.0,3,12,6640,0,1993,0,98077,47.7283,-122.046,4620,68625,6,27,2014,UNK,2020,-15295
248000240,7/15/2014,219000.0,3,1.5,1060,9600,1.0,0.0,0.0,4,7,1060,0,1962,0,98023,47.3229,-122.348,1440,9600,7,15,2014,UNK,-380,0
3995700435,7/2/2014,265000.0,4,3.0,1940,8170,1.0,0.0,0.0,4,7,1940,0,1948,0,98155,47.7381,-122.302,1310,8169,7,2,2014,UNK,630,1
9287800135,7/14/2014,1110000.0,5,3.25,3070,5000,2.0,0.0,0.0,3,9,2050,1020,2006,0,98103,47.6742,-122.35600000000001,2070,5000,7,14,2014,N,1000,0
4337000070,3/9/2015,200000.0,3,1.0,930,7590,1.0,0.0,0.0,3,6,820,110,1943,0,98166,47.4802,-122.335,1220,7590,3,9,2015,UNK,-290,0
8859000045,4/24/2015,545000.0,4,2.75,2180,8480,1.0,0.0,3.0,4,7,1210,970,1959,0,98146,47.4961,-122.366,2240,8497,4,24,2015,UNK,-60,-17
8856920550,3/19/2015,378000.0,3,2.5,2130,8404,2.0,0.0,0.0,3,8,2130,0,1991,0,98058,47.4623,-122.13,2130,8404,3,19,2015,UNK,0,0
5705500075,3/26/2015,388000.0,2,1.75,800,4800,1.0,0.0,0.0,4,6,800,0,1922,0,98136,47.5559,-122.396,1090,5000,3,26,2015,UNK,-290,-200
6163901433,11/26/2014,425000.0,4,2.25,2200,8384,1.0,0.0,0.0,3,7,1250,950,1959,0,98155,47.753,-122.31700000000001,1750,8384,11,26,2014,UNK,450,0
475000004,7/7/2014,536000.0,2,1.5,1130,746,2.0,0.0,0.0,3,8,1030,100,2009,0,98107,47.6684,-122.363,1520,1519,7,7,2014,N,-390,-773
7936500172,5/28/2014,1180000.0,3,2.5,1970,23180,1.0,1.0,4.0,3,8,1100,870,1937,1998,98136,47.5495,-122.398,3030,34689,5,28,2014,Y,-1060,-11509
2770604080,3/24/2015,629950.0,3,2.5,1680,1620,2.0,0.0,0.0,3,9,1120,560,2014,0,98119,47.6425,-122.374,1610,1618,3,24,2015,N,70,2
5101408599,6/11/2014,465000.0,4,1.75,1470,5350,1.0,0.0,0.0,3,7,980,490,1955,0,98125,47.7048,-122.315,1970,6138,6,11,2014,UNK,-500,-788
1226059105,8/27/2014,545000.0,4,2.25,2390,40510,1.0,0.0,0.0,4,8,2390,0,1969,0,98072,47.7566,-122.113,3200,36989,8,27,2014,UNK,-810,3521
3211700045,1/28/2015,592000.0,4,2.5,2300,11165,2.0,0.0,0.0,4,8,2300,0,1979,0,98008,47.5794,-122.118,2170,11165,1,28,2015,UNK,130,0
8567300270,8/18/2014,446000.0,4,2.0,2280,43692,1.0,0.0,0.0,3,7,1140,1140,1957,1984,98038,47.4067,-122.03,2580,37938,8,18,2014,Y,-300,5754
6021503655,7/16/2014,375000.0,3,2.5,1330,816,3.0,0.0,0.0,3,8,1330,0,2004,0,98117,47.6836,-122.387,1330,1113,7,16,2014,N,0,-297
7202331160,6/16/2014,632500.0,5,2.5,2640,7096,2.0,0.0,0.0,3,7,2640,0,2003,0,98053,47.6827,-122.038,2640,4850,6,16,2014,UNK,0,2246
2763710060,8/8/2014,459950.0,4,1.75,2430,9747,1.0,0.0,0.0,3,8,1780,650,1974,0,98155,47.7687,-122.27600000000001,2340,10296,8,8,2014,UNK,90,-549
3211270160,6/12/2014,485000.0,4,2.5,2470,35073,2.0,0.0,0.0,3,9,2470,0,1989,0,98092,47.3064,-122.10799999999999,2990,35259,6,12,2014,UNK,-520,-186
3365900106,1/15/2015,255000.0,3,1.0,1440,11330,1.0,0.0,0.0,3,7,1440,0,1965,0,98168,47.4742,-122.265,1580,10100,1,15,2015,UNK,-140,1230
1761300340,6/10/2014,251750.0,3,2.0,1320,7200,1.0,0.0,0.0,5,7,1320,0,1975,0,98031,47.3947,-122.17399999999999,1540,7200,6,10,2014,UNK,-220,0
2909300240,5/1/2015,725000.0,3,2.5,2810,6300,2.0,0.0,0.0,3,8,2810,0,2001,0,98074,47.6077,-122.02,2860,6630,5,1,2015,UNK,-50,-330
476000324,10/16/2014,460000.0,3,3.25,1370,1194,3.0,0.0,0.0,3,8,1370,0,2005,0,98107,47.6704,-122.391,1320,1217,10,16,2014,N,50,-23
2141200030,8/28/2014,625000.0,3,2.5,2000,6341,1.0,0.0,0.0,5,8,1040,960,1981,0,98116,47.5639,-122.40100000000001,2030,6341,8,28,2014,UNK,-30,0
9557300560,5/8/2014,530000.0,3,1.75,1980,6760,1.0,0.0,0.0,4,8,1980,0,1973,0,98008,47.6398,-122.113,2120,7280,5,8,2014,UNK,-140,-520
2612000200,4/27/2015,394950.0,3,2.5,2050,8172,2.0,0.0,0.0,3,8,2050,0,2002,0,98168,47.4808,-122.28,2140,5664,4,27,2015,UNK,-90,2508
6002400030,8/14/2014,324950.0,4,1.75,2320,9240,1.0,0.0,0.0,3,7,1160,1160,1959,2014,98178,47.4909,-122.257,2130,7320,8,14,2014,Y,190,1920
6064800060,5/6/2015,330000.0,3,2.25,1960,1985,2.0,0.0,0.0,3,7,1750,210,2003,0,98118,47.5417,-122.289,1760,1985,5,6,2015,UNK,200,0
8091410390,2/17/2015,220000.0,4,1.75,1910,8171,1.0,0.0,0.0,3,7,1910,0,1986,0,98030,47.35,-122.16799999999999,1910,7542,2,17,2015,UNK,0,629
1786830060,7/7/2014,685000.0,3,3.25,2030,11070,2.0,0.0,0.0,4,8,2030,0,1980,0,98052,47.6478,-122.117,2450,11070,7,7,2014,UNK,-420,0
7277100055,2/24/2015,500000.0,3,2.25,2210,7680,1.0,0.0,2.0,3,8,1730,480,1972,0,98177,47.7729,-122.389,2390,7680,2,24,2015,UNK,-180,0
3392500060,9/4/2014,368000.0,4,2.75,2610,9426,1.0,0.0,0.0,3,7,1360,1250,1965,0,98188,47.4435,-122.279,1600,9426,9,4,2014,UNK,1010,0
3897100640,11/3/2014,825000.0,3,2.25,2520,7975,2.0,0.0,0.0,4,9,1550,970,1990,0,98033,47.6704,-122.18299999999999,2520,9900,11,3,2014,UNK,0,-1925
7942602080,6/16/2014,660000.0,6,1.75,1840,2774,1.0,0.0,0.0,3,7,1060,780,1900,0,98122,47.6041,-122.31,1680,4292,6,16,2014,UNK,160,-1518
2787311480,9/29/2014,253000.0,3,1.75,1570,7416,1.0,0.0,0.0,4,7,1570,0,1971,0,98031,47.4117,-122.17399999999999,1900,7416,9,29,2014,UNK,-330,0
5467200055,3/7/2015,392500.0,4,2.75,2400,19923,1.0,0.0,0.0,5,7,1320,1080,1953,0,98042,47.3616,-122.14399999999999,2470,10736,3,7,2015,UNK,-70,9187
7277100510,2/14/2015,605000.0,3,1.75,1930,5400,2.0,0.0,2.0,3,9,1930,0,1978,0,98177,47.77,-122.391,2100,6840,2,14,2015,UNK,-170,-1440
2525300200,5/15/2014,215000.0,3,1.0,1160,10384,1.0,0.0,0.0,4,6,1160,0,1969,0,98038,47.3634,-122.027,1200,9880,5,15,2014,UNK,-40,504
7732500270,9/25/2014,650000.0,4,2.5,2820,15000,2.0,0.0,0.0,4,9,2820,0,1985,0,98052,47.7255,-122.101,2440,15000,9,25,2014,UNK,380,0
5700001920,2/19/2015,877500.0,4,2.0,3060,8000,2.0,0.0,0.0,4,8,2040,1020,1922,0,98144,47.5795,-122.29,2730,5800,2,19,2015,UNK,330,2200
5560000640,6/19/2014,232500.0,3,1.0,1320,8450,1.0,0.0,0.0,3,6,880,440,1961,0,98023,47.3278,-122.337,1320,8450,6,19,2014,UNK,0,0
2781250560,12/2/2014,234000.0,2,2.0,1200,3624,2.0,0.0,0.0,3,6,1200,0,2003,0,98038,47.349,-122.025,1360,2693,12,2,2014,UNK,-160,931
1122059037,4/13/2015,380000.0,3,1.75,1560,104108,1.0,0.0,0.0,3,7,1250,310,1970,0,98042,47.4016,-122.131,2000,110957,4,13,2015,UNK,-440,-6849
5515600163,9/16/2014,420000.0,5,2.25,3070,64033,1.0,0.0,0.0,3,9,2730,340,1983,0,98001,47.3238,-122.292,1560,28260,9,16,2014,UNK,1510,35773
8807300570,12/29/2014,399950.0,3,1.0,1040,9600,1.0,0.0,0.0,3,7,1040,0,1978,0,98053,47.6738,-122.06299999999999,1370,10889,12,29,2014,UNK,-330,-1289
9412700550,5/21/2014,256750.0,3,2.5,1990,8991,1.0,0.0,0.0,3,7,1570,420,1969,0,98042,47.3939,-122.164,1920,8991,5,21,2014,UNK,70,0
9202600060,6/2/2014,535000.0,3,2.5,1690,9626,2.0,0.0,0.0,3,8,1690,0,1984,0,98027,47.5647,-122.09200000000001,1860,8958,6,2,2014,UNK,-170,668
8857320030,11/7/2014,515000.0,3,2.0,1810,2738,2.0,0.0,0.0,4,9,1810,0,1979,0,98008,47.6112,-122.115,1760,2754,11,7,2014,UNK,50,-16
685000160,2/12/2015,770000.0,4,1.75,2520,8442,1.0,0.0,0.0,4,7,1640,880,1953,0,98004,47.6317,-122.205,2110,8442,2,12,2015,UNK,410,0
8001100030,1/2/2015,256000.0,3,2.5,1570,5113,1.0,0.0,0.0,3,7,1090,480,1996,0,98001,47.3327,-122.29,1570,5150,1,2,2015,UNK,0,-37
9144100126,8/21/2014,489900.0,3,1.0,1680,8910,1.0,0.0,0.0,4,7,1680,0,1940,0,98117,47.7011,-122.375,1620,7182,8,21,2014,UNK,60,1728
7149410060,8/20/2014,165000.0,3,1.5,1250,7200,1.0,0.0,0.0,4,7,1250,0,1978,0,98032,47.3678,-122.28200000000001,1250,7560,8,20,2014,UNK,0,-360
3388000640,3/18/2015,220000.0,3,1.5,1280,7742,1.0,0.0,0.0,4,7,1280,0,1962,0,98031,47.3947,-122.197,1450,8316,3,18,2015,UNK,-170,-574
1321700030,6/24/2014,575000.0,4,2.5,4620,20793,2.0,0.0,0.0,4,11,4620,0,1991,0,98023,47.2929,-122.34200000000001,3640,20793,6,24,2014,UNK,980,0
6662400105,10/30/2014,375000.0,3,2.5,1580,5725,2.0,0.0,0.0,3,7,1580,0,2004,0,98072,47.7611,-122.161,1510,5725,10,30,2014,N,70,0
3971700903,1/22/2015,422250.0,3,1.75,1650,7145,2.0,0.0,0.0,5,8,1300,350,1977,0,98155,47.7733,-122.324,1760,7206,1,22,2015,UNK,-110,-61
6804600260,6/3/2014,420000.0,3,1.75,1660,9600,1.0,0.0,0.0,3,8,1380,0,1981,0,98011,47.7601,-122.167,2030,9500,6,3,2014,UNK,-370,100
8078460520,9/23/2014,608000.0,4,2.5,2410,7140,2.0,0.0,0.0,3,8,2410,0,1993,0,98074,47.6329,-122.021,2350,7140,9,23,2014,UNK,60,0
2436700800,5/16/2014,620000.0,3,2.25,1720,4000,1.5,0.0,0.0,4,7,1450,270,1921,0,98105,47.6683,-122.286,1410,4000,5,16,2014,UNK,310,0
2592210510,2/17/2015,850000.0,3,2.5,3120,12406,2.0,0.0,2.0,3,9,1940,1180,1983,0,98006,47.5507,-122.141,3240,13141,2,17,2015,UNK,-120,-735
9414610320,1/16/2015,463000.0,4,2.5,2680,9928,1.0,0.0,0.0,4,8,1340,1340,1974,0,98027,47.5219,-122.052,2180,10478,1,16,2015,UNK,500,-550
7567600030,1/27/2015,750000.0,5,1.75,2640,13290,1.0,1.0,4.0,4,8,1400,1240,1954,0,98178,47.5022,-122.223,2400,11942,1,27,2015,UNK,240,1348
624110810,3/25/2015,1070000.0,3,3.25,3730,13264,2.0,0.0,0.0,3,9,3730,0,1989,0,98077,47.7246,-122.059,3730,14933,3,25,2015,UNK,0,-1669
4123800400,9/9/2014,290000.0,3,2.0,1700,6498,1.0,0.0,0.0,3,7,1700,0,1986,0,98038,47.3781,-122.044,1700,6654,9,9,2014,UNK,0,-156
9424400105,7/10/2014,525000.0,4,1.75,2280,5959,1.0,0.0,0.0,3,7,1250,1030,1947,0,98116,47.5655,-122.395,1640,5911,7,10,2014,UNK,640,48
7941130140,2/17/2015,319000.0,3,2.25,1220,2980,2.0,0.0,0.0,3,7,1220,0,1986,0,98034,47.7151,-122.20299999999999,1220,2140,2,17,2015,UNK,0,840
1568100295,2/2/2015,592500.0,6,4.5,3500,8504,2.0,0.0,0.0,3,7,3500,0,1980,0,98155,47.7349,-122.295,1550,8460,2,2,2015,UNK,1950,44
6683000295,5/13/2014,350000.0,3,2.5,2010,14298,2.0,0.0,0.0,3,7,2010,0,1977,0,98070,47.5069,-122.47200000000001,2010,14298,5,13,2014,UNK,0,0
5710610520,2/26/2015,454900.0,3,1.75,2130,9775,1.0,0.0,0.0,4,8,1430,700,1973,0,98027,47.5326,-122.04899999999999,2130,11250,2,26,2015,UNK,0,-1475
1565900390,4/15/2015,272000.0,4,2.25,1800,9018,2.0,0.0,0.0,3,7,1800,0,1992,0,98022,47.2126,-121.984,1670,9380,4,15,2015,UNK,130,-362
6608500260,7/16/2014,357500.0,3,1.0,1070,10125,1.0,0.0,0.0,3,7,1070,0,1961,0,98033,47.7012,-122.167,1540,10200,7,16,2014,UNK,-470,-75
7338401230,8/28/2014,285000.0,3,1.75,1020,5000,1.0,0.0,0.0,5,6,1020,0,1954,0,98118,47.5332,-122.29,1360,5000,8,28,2014,UNK,-340,0
7212660520,3/26/2015,280000.0,4,2.0,1600,6861,1.0,0.0,0.0,3,7,1600,0,1994,0,98003,47.2701,-122.31299999999999,1870,7455,3,26,2015,UNK,-270,-594
8901001290,9/3/2014,477000.0,4,1.5,1380,7800,1.0,0.0,0.0,3,7,1080,300,1928,0,98125,47.7093,-122.306,1770,7503,9,3,2014,UNK,-390,297
3345100030,7/22/2014,750000.0,3,2.25,3270,168000,2.0,0.0,0.0,4,10,3270,0,1982,0,98056,47.5197,-122.191,3220,7963,7,22,2014,UNK,50,160037
7986401275,11/19/2014,595000.0,4,2.5,2100,3125,2.0,0.0,2.0,3,7,1400,700,1907,0,98107,47.6634,-122.35799999999999,2060,5040,11,19,2014,UNK,40,-1915
3047700045,7/17/2014,525000.0,3,2.25,2110,2850,3.0,0.0,0.0,3,8,2110,0,2001,0,98103,47.6915,-122.339,1340,5001,7,17,2014,UNK,770,-2151
1422029117,7/11/2014,319000.0,3,1.75,1640,53400,1.0,0.0,0.0,4,7,1640,0,1966,0,98070,47.3944,-122.506,1850,380279,7,11,2014,UNK,-210,-326879
104530240,8/27/2014,225000.0,3,2.0,1320,5665,1.0,0.0,0.0,3,7,1320,0,1986,0,98023,47.3096,-122.35700000000001,1336,7080,8,27,2014,UNK,-16,-1415
8718500260,7/23/2014,485000.0,4,2.5,2420,10603,1.0,0.0,0.0,5,7,1210,1210,1958,0,98028,47.7397,-122.259,1750,10800,7,23,2014,UNK,670,-197
3735901040,7/3/2014,341000.0,3,1.0,1390,4814,1.5,0.0,0.0,3,6,1390,0,1908,0,98115,47.6881,-122.32,1730,3990,7,3,2014,UNK,-340,824
3448002180,1/16/2015,674000.0,3,3.25,2320,6744,2.0,0.0,0.0,3,9,1930,390,2014,0,98125,47.7132,-122.29299999999999,1700,6744,1,16,2015,N,620,0
5126300960,1/27/2015,442250.0,3,2.5,2170,8169,2.0,0.0,0.0,3,8,2170,0,2003,0,98059,47.4833,-122.139,2240,6733,1,27,2015,UNK,-70,1436
1774220400,5/13/2014,591000.0,4,2.25,2710,38180,2.0,0.0,0.0,4,8,2710,0,1977,0,98077,47.77,-122.09700000000001,2590,38180,5,13,2014,UNK,120,0
8648100030,11/13/2014,276000.0,3,2.0,1450,8928,1.0,0.0,0.0,3,7,1450,0,1998,0,98042,47.3637,-122.075,2050,8523,11,13,2014,UNK,-600,405
7940710070,8/22/2014,394000.0,3,2.5,1370,4400,1.0,0.0,0.0,3,8,1370,0,1988,0,98034,47.7139,-122.20299999999999,1630,4400,8,22,2014,UNK,-260,0
1518000070,11/19/2014,355000.0,3,2.5,1810,3192,1.0,0.0,0.0,3,7,1070,740,2001,0,98019,47.7364,-121.969,1740,3720,11,19,2014,UNK,70,-528
3832500260,5/9/2014,260000.0,3,2.5,1420,14850,1.0,0.0,0.0,4,7,1020,400,1963,0,98032,47.3661,-122.29,2060,8800,5,9,2014,UNK,-640,6050
1139600270,7/1/2014,300000.0,3,2.75,2090,9620,1.0,0.0,0.0,3,8,1340,750,1987,0,98023,47.2741,-122.337,2150,9660,7,1,2014,UNK,-60,-40
1139600270,3/24/2015,310000.0,3,2.75,2090,9620,1.0,0.0,0.0,3,8,1340,750,1987,0,98023,47.2741,-122.337,2150,9660,3,24,2015,UNK,-60,-40
1099610830,12/2/2014,209000.0,3,1.0,1330,6900,1.0,0.0,0.0,3,7,1330,0,1976,0,98023,47.3033,-122.381,1530,7000,12,2,2014,UNK,-200,-100
5647000060,12/11/2014,344950.0,3,2.0,1330,7419,1.0,0.0,0.0,3,7,1330,0,1985,0,98034,47.7322,-122.236,1330,7297,12,11,2014,UNK,0,122
3352402272,6/11/2014,230000.0,5,2.0,1910,7200,1.0,0.0,0.0,4,6,1110,800,1951,0,98178,47.4975,-122.26100000000001,1150,5948,6,11,2014,UNK,760,1252
6669020640,4/24/2015,336950.0,3,1.75,2310,7680,1.0,0.0,0.0,4,8,1410,900,1978,0,98032,47.3743,-122.285,2080,7680,4,24,2015,UNK,230,0
6154900070,6/11/2014,700000.0,3,2.75,2500,7378,1.0,0.0,0.0,5,7,1390,1110,1948,0,98177,47.7032,-122.37,2040,7140,6,11,2014,UNK,460,238
1545802080,9/4/2014,230000.0,3,2.0,1310,7332,1.0,0.0,0.0,3,7,1310,0,1987,0,98038,47.3597,-122.051,1530,7362,9,4,2014,UNK,-220,-30
8161020060,6/20/2014,443500.0,4,2.5,2040,21781,2.0,0.0,0.0,3,8,2040,0,1994,0,98014,47.6458,-121.904,2410,21781,6,20,2014,UNK,-370,0
8161020060,4/14/2015,471000.0,4,2.5,2040,21781,2.0,0.0,0.0,3,8,2040,0,1994,0,98014,47.6458,-121.904,2410,21781,4,14,2015,UNK,-370,0
443000060,12/10/2014,595000.0,3,2.25,2400,16301,1.0,0.0,0.0,3,8,1400,1000,1962,0,98115,47.6901,-122.28200000000001,1720,9828,12,10,2014,UNK,680,6473
4172100200,11/21/2014,470000.0,3,1.0,1400,4914,1.5,0.0,0.0,3,7,1400,0,1929,0,98117,47.681000000000004,-122.36399999999999,1400,3744,11,21,2014,UNK,0,1170
7309100070,12/12/2014,600000.0,4,1.75,1700,7800,1.0,0.0,0.0,4,8,1700,0,1975,0,98052,47.651,-122.119,2430,8342,12,12,2014,UNK,-730,-542
191100672,5/27/2014,1380000.0,4,3.75,3160,9525,2.5,0.0,0.0,3,10,3160,0,1997,0,98040,47.5623,-122.221,2400,9525,5,27,2014,UNK,760,0
2125400160,11/14/2014,427800.0,3,1.75,1340,13241,1.0,0.0,2.0,3,7,1340,0,1985,0,98034,47.7268,-122.213,2090,9704,11,14,2014,UNK,-750,3537
259800060,6/6/2014,445000.0,4,2.0,1470,8395,1.0,0.0,0.0,4,7,1470,0,1965,0,98008,47.631,-122.117,1760,7976,6,6,2014,UNK,-290,419
4402700125,7/16/2014,382000.0,3,1.75,1790,7679,1.0,0.0,0.0,4,7,1790,0,1953,0,98133,47.7442,-122.338,1560,7680,7,16,2014,UNK,230,-1
7504180070,11/11/2014,577000.0,3,1.5,1560,20251,1.0,0.0,0.0,5,7,1200,360,1989,0,98074,47.619,-122.054,1560,19119,11,11,2014,UNK,0,1132
2723069129,5/6/2015,427000.0,3,2.5,2620,108464,2.0,0.0,0.0,4,8,2620,0,1990,0,98038,47.4583,-122.036,3190,105850,5,6,2015,UNK,-570,2614
3210400060,12/24/2014,255000.0,3,1.0,1580,8206,1.0,0.0,0.0,3,7,1100,0,1962,0,98198,47.3676,-122.31200000000001,1600,8196,12,24,2014,UNK,-20,10
8658301535,7/21/2014,240000.0,3,1.0,1090,10000,1.0,0.0,0.0,3,6,1090,0,1961,0,98014,47.6503,-121.911,1040,7500,7,21,2014,UNK,50,2500
8923100125,6/20/2014,1230000.0,5,3.25,3240,6551,1.5,0.0,4.0,4,9,2500,740,1939,0,98115,47.6792,-122.273,2740,9300,6,20,2014,UNK,500,-2749
5592900105,2/13/2015,435000.0,4,1.75,2520,7200,1.0,0.0,2.0,5,7,1260,1260,1955,0,98056,47.4835,-122.19200000000001,2360,7300,2,13,2015,UNK,160,-100
8964800695,3/27/2015,1450000.0,3,1.75,2230,13529,1.0,0.0,0.0,3,9,2230,0,1949,0,98004,47.6204,-122.21700000000001,2230,11900,3,27,2015,UNK,0,1629
5104510860,5/6/2015,425000.0,4,3.0,2430,5502,2.0,0.0,0.0,3,8,2430,0,2002,0,98038,47.356,-122.014,2000,5702,5,6,2015,UNK,430,-200
1090000075,12/16/2014,393000.0,2,1.0,1020,4200,1.0,0.0,0.0,5,6,1020,0,1923,0,98136,47.5319,-122.391,1660,4200,12,16,2014,UNK,-640,0
1446800181,6/20/2014,264950.0,4,1.0,1810,7500,1.0,0.0,0.0,2,7,1410,400,1959,0,98168,47.4935,-122.333,1250,6255,6,20,2014,UNK,560,1245
1829300520,4/12/2015,746500.0,4,2.5,3460,9699,2.0,0.0,0.0,3,10,3460,0,1987,0,98074,47.637,-122.04,3140,10631,4,12,2015,UNK,320,-932
3992700070,11/24/2014,450000.0,3,1.0,2020,8100,1.0,0.0,0.0,3,7,1170,850,1956,0,98125,47.7136,-122.288,1480,7620,11,24,2014,UNK,540,480
2472950160,6/17/2014,229950.0,3,2.0,1410,7466,1.0,0.0,0.0,3,7,1410,0,1983,0,98058,47.427,-122.147,1410,7610,6,17,2014,UNK,0,-144
3468800310,1/13/2015,425000.0,2,1.0,750,4000,1.0,0.0,0.0,2,6,750,0,1933,0,98108,47.54,-122.32,1160,4000,1,13,2015,UNK,-410,0
6613000935,5/13/2014,2560000.0,4,2.5,5300,26211,2.0,1.0,2.0,2,10,4570,730,1923,0,98105,47.661,-122.26899999999999,3890,19281,5,13,2014,UNK,1410,6930
4054530240,4/27/2015,1400000.0,4,3.5,4380,66613,1.5,0.0,0.0,3,11,4380,0,1993,0,98077,47.7279,-122.04799999999999,4010,70109,4,27,2015,UNK,370,-3496
2600040160,10/31/2014,753000.0,3,2.25,2290,9047,2.0,0.0,0.0,4,8,2290,0,1984,0,98006,47.5545,-122.163,2120,9275,10,31,2014,UNK,170,-228
4229900140,10/6/2014,310000.0,2,1.0,720,5750,1.0,0.0,0.0,2,6,720,0,1943,0,98136,47.5535,-122.39299999999999,980,6125,10,6,2014,UNK,-260,-375
1005000240,12/19/2014,395000.0,2,1.0,1200,6014,1.0,0.0,0.0,4,6,600,600,1949,0,98118,47.5357,-122.28,1270,4652,12,19,2014,UNK,-70,1362
4188000240,12/11/2014,725000.0,3,2.5,2620,28703,1.0,0.0,0.0,3,10,2620,0,1985,0,98052,47.7238,-122.11399999999999,2950,30290,12,11,2014,UNK,-330,-1587
1562100340,8/28/2014,295000.0,4,3.0,2120,7650,2.0,0.0,0.0,3,8,2120,0,1964,0,98007,47.6214,-122.14,2260,7885,8,28,2014,UNK,-140,-235
7941600390,6/23/2014,225000.0,3,1.75,1580,8820,1.0,0.0,0.0,4,7,1580,0,1967,0,98003,47.317,-122.325,1280,8500,6,23,2014,UNK,300,320
2655500241,8/14/2014,1700000.0,3,3.25,4160,35153,3.0,0.0,2.0,3,12,3690,470,2001,0,98040,47.5749,-122.214,3290,11533,8,14,2014,UNK,870,23620
8651720060,2/2/2015,431000.0,3,2.25,1830,8831,1.0,0.0,0.0,3,7,1460,370,1979,0,98034,47.7286,-122.215,2330,8064,2,2,2015,UNK,-500,767
2621750350,3/26/2015,358500.0,3,2.5,2000,8057,1.0,0.0,0.0,3,8,1360,640,1998,0,98042,47.3724,-122.10700000000001,2530,8964,3,26,2015,UNK,-530,-907
2397101375,4/28/2015,595000.0,2,1.0,980,3600,1.0,0.0,0.0,3,6,980,0,1907,0,98119,47.6366,-122.365,1690,3600,4,28,2015,UNK,-710,0
808300200,3/19/2015,468000.0,4,2.5,3040,20682,2.0,0.0,0.0,3,7,3040,0,2000,0,98019,47.7245,-121.959,2670,9742,3,19,2015,UNK,370,10940
8645500370,12/3/2014,260000.0,4,1.0,1740,8100,1.0,0.0,0.0,4,7,1020,720,1962,0,98058,47.467,-122.185,1600,8949,12,3,2014,UNK,140,-849
5668500045,9/17/2014,375000.0,3,2.0,1450,7300,1.5,0.0,0.0,5,7,1450,0,1955,0,98133,47.7517,-122.34200000000001,1660,9069,9,17,2014,UNK,-210,-1769
6679000370,5/25/2014,295000.0,3,2.5,1560,4200,2.0,0.0,0.0,3,7,1560,0,2003,0,98038,47.3838,-122.02600000000001,1560,4200,5,25,2014,UNK,0,0
8699800070,7/31/2014,403900.0,4,2.5,2050,8909,1.0,0.0,2.0,4,8,1690,360,1986,0,98198,47.398,-122.31,2190,8912,7,31,2014,UNK,-140,-3
9500900060,7/22/2014,269950.0,3,1.75,1760,12823,1.0,0.0,0.0,4,7,1460,300,1956,0,98002,47.2868,-122.21,1450,10800,7,22,2014,UNK,310,2023
2255500060,2/18/2015,640000.0,3,3.5,1740,1975,2.0,0.0,3.0,3,8,1310,430,1998,0,98122,47.6085,-122.311,1740,1975,2,18,2015,UNK,0,0
5071500140,6/27/2014,221000.0,3,1.0,910,8789,1.0,0.0,0.0,3,7,910,0,1966,0,98148,47.4345,-122.32600000000001,1160,8789,6,27,2014,UNK,-250,0
3546000070,6/17/2014,255000.0,3,1.75,1700,7532,1.0,0.0,0.0,3,7,1700,0,1987,0,98030,47.355,-122.176,1690,7405,6,17,2014,UNK,10,127
9478500570,6/23/2014,300000.0,4,2.5,2620,4469,2.0,0.0,0.0,3,7,2620,0,2008,0,98042,47.3663,-122.115,2250,4500,6,23,2014,N,370,-31
2473440070,3/20/2015,270000.0,3,2.25,1500,7410,1.0,0.0,0.0,4,7,1500,0,1973,0,98058,47.4597,-122.162,1750,7990,3,20,2015,UNK,-250,-580
952001710,3/3/2015,575000.0,4,1.75,1630,5750,1.0,0.0,0.0,3,7,1160,470,1947,0,98116,47.5674,-122.384,1640,5750,3,3,2015,UNK,-10,0
7905400160,2/11/2015,246900.0,3,1.5,1370,9800,1.0,0.0,0.0,5,7,1370,0,1968,0,98001,47.3068,-122.27,1370,9800,2,11,2015,UNK,0,0
6852700520,4/6/2015,635000.0,2,2.5,1390,1132,2.0,0.0,0.0,3,8,1130,260,2006,0,98102,47.6228,-122.319,1400,1237,4,6,2015,N,-10,-105
625100004,3/17/2015,450000.0,3,2.0,1540,67756,1.0,0.0,0.0,3,7,1540,0,1900,1973,98077,47.721000000000004,-122.07799999999999,2060,67756,3,17,2015,Y,-520,0
6600400370,9/10/2014,215000.0,3,1.0,1190,7500,1.0,0.0,0.0,5,7,1190,0,1968,0,98042,47.3248,-122.14200000000001,1200,9750,9,10,2014,UNK,-10,-2250
2025770310,6/11/2014,785000.0,3,3.5,4500,21870,2.0,0.0,0.0,3,10,4500,0,2004,0,98092,47.3043,-122.15899999999999,4670,23058,6,11,2014,N,-170,-1188
2126049290,2/20/2015,522500.0,4,3.0,2370,8154,1.0,0.0,0.0,3,7,1380,990,1977,0,98125,47.7258,-122.306,2100,8148,2,20,2015,UNK,270,6
1843200350,7/22/2014,150000.0,2,1.5,1360,1934,2.0,0.0,0.0,4,7,1360,0,1978,0,98092,47.2857,-122.189,1360,1898,7,22,2014,UNK,0,36
3750600566,12/15/2014,199950.0,2,1.75,870,18537,1.0,0.0,0.0,4,6,870,0,1946,0,98001,47.275,-122.27799999999999,1300,22800,12,15,2014,UNK,-430,-4263
3761100045,6/18/2014,3000000.0,4,4.25,4850,12445,2.0,1.0,4.0,5,10,3850,1000,1989,0,98034,47.7011,-122.244,3350,12210,6,18,2014,UNK,1500,235
7937600262,7/10/2014,379900.0,3,2.0,3110,44967,2.0,0.0,0.0,3,9,3020,90,1999,0,98058,47.4343,-122.08200000000001,2150,44967,7,10,2014,UNK,960,0
3629921000,11/21/2014,950000.0,4,2.5,3700,7051,2.0,0.0,0.0,3,11,3700,0,2006,0,98029,47.5427,-121.995,3580,6175,11,21,2014,N,120,876
7519000335,12/3/2014,865000.0,6,2.75,3500,5150,2.0,0.0,0.0,5,8,2430,1070,1909,0,98117,47.6842,-122.363,1430,3860,12,3,2014,UNK,2070,1290
5459000240,6/4/2014,785000.0,3,1.75,1670,9600,1.0,0.0,0.0,5,8,1670,0,1961,0,98040,47.5754,-122.23299999999999,1900,9600,6,4,2014,UNK,-230,0
9835801000,6/25/2014,245700.0,3,2.25,1640,8400,1.0,0.0,0.0,3,8,1180,460,1968,0,98032,47.3733,-122.289,1600,8120,6,25,2014,UNK,40,280
1102001274,4/15/2015,951000.0,3,2.25,3400,12825,1.0,0.0,1.0,3,9,3400,0,1961,0,98118,47.5435,-122.26,2510,11574,4,15,2015,UNK,890,1251
7950303290,4/2/2015,499950.0,3,1.75,2060,3500,1.0,0.0,0.0,5,7,1030,1030,1951,0,98118,47.5635,-122.28200000000001,1110,6000,4,2,2015,UNK,950,-2500
7968460240,2/11/2015,257000.0,3,1.75,1330,36537,1.0,0.0,0.0,4,7,1330,0,1989,0,98092,47.3126,-122.12899999999999,1650,35100,2,11,2015,UNK,-320,1437
9827700105,9/17/2014,549000.0,3,2.0,2330,3600,1.5,0.0,0.0,4,7,1580,750,1900,0,98122,47.6025,-122.303,1750,3600,9,17,2014,UNK,580,0
3536900030,2/9/2015,1600000.0,3,2.75,3040,21052,2.0,0.0,0.0,4,10,3040,0,1980,0,98004,47.63800000000001,-122.225,2950,21052,2,9,2015,UNK,90,0
328000160,12/11/2014,1400000.0,5,3.75,3700,7920,3.0,0.0,4.0,3,9,2900,800,1983,0,98115,47.6865,-122.266,2860,6360,12,11,2014,UNK,840,1560
6909700340,8/20/2014,619000.0,3,2.0,1990,3000,1.5,0.0,2.0,5,8,1430,560,1927,0,98144,47.5891,-122.29299999999999,1780,5000,8,20,2014,UNK,210,-2000
829000160,10/9/2014,311000.0,5,3.0,2020,5917,1.0,0.0,0.0,3,7,1220,800,1993,0,98108,47.5482,-122.294,2130,5529,10,9,2014,UNK,-110,388
4077800376,7/1/2014,600000.0,5,2.25,2980,7781,1.0,0.0,0.0,3,9,1580,1400,1960,0,98125,47.7048,-122.279,2310,7781,7,1,2014,UNK,670,0
6154500030,6/26/2014,1080000.0,4,3.5,3990,5267,2.0,0.0,0.0,3,10,3990,0,2008,0,98006,47.5641,-122.124,3230,6481,6,26,2014,N,760,-1214
9828202325,6/19/2014,436000.0,2,1.0,790,6600,1.0,0.0,0.0,3,6,790,0,1949,0,98122,47.6149,-122.29299999999999,1520,4400,6,19,2014,UNK,-730,2200
795002190,7/15/2014,205000.0,2,1.0,1060,8000,1.0,0.0,0.0,3,6,1060,0,1941,0,98168,47.5088,-122.333,1390,8000,7,15,2014,UNK,-330,0
226059065,9/3/2014,514000.0,3,2.25,2260,54014,1.0,0.0,0.0,3,7,1450,810,1962,0,98072,47.7657,-122.131,2140,44431,9,3,2014,UNK,120,9583
8682280270,9/3/2014,530000.0,2,2.5,1900,2983,2.0,0.0,0.0,3,8,1900,0,2006,0,98053,47.7029,-122.015,1510,3876,9,3,2014,N,390,-893
7695370160,8/11/2014,511000.0,5,2.5,3361,6983,2.0,0.0,0.0,3,10,3361,0,2006,0,98092,47.3427,-122.169,3112,6920,8,11,2014,N,249,63
3025300226,5/15/2014,2100000.0,4,1.75,3550,19865,2.0,0.0,0.0,3,9,3550,0,1962,2002,98039,47.6236,-122.235,3000,19862,5,15,2014,Y,550,3
241900160,3/10/2015,370000.0,5,2.5,2740,5460,2.0,0.0,0.0,3,8,2740,0,2005,0,98031,47.4042,-122.204,2900,5971,3,10,2015,N,-160,-511
2461900550,12/16/2014,500000.0,4,1.75,2040,6000,1.0,0.0,0.0,5,7,1020,1020,1943,0,98136,47.5507,-122.383,1440,6000,12,16,2014,UNK,600,0
9206700060,11/5/2014,710000.0,4,2.5,4070,129808,2.0,0.0,0.0,3,10,4070,0,1998,0,98038,47.4433,-122.016,4070,102366,11,5,2014,UNK,0,27442
1997200060,9/8/2014,270000.0,1,1.0,720,5196,1.0,0.0,0.0,3,7,720,0,1911,0,98103,47.6928,-122.337,1580,5762,9,8,2014,UNK,-860,-566
5468700105,8/5/2014,415000.0,3,1.75,2000,8400,1.5,0.0,0.0,4,8,2000,0,1959,0,98133,47.7535,-122.334,2000,8400,8,5,2014,UNK,0,0
5078400160,6/5/2014,1800000.0,5,4.5,4400,15580,2.0,0.0,0.0,3,11,3390,1010,2003,0,98004,47.6232,-122.20700000000001,2150,14249,6,5,2014,UNK,2250,1331
6603000030,12/17/2014,236000.0,3,1.75,1300,8976,1.0,0.0,0.0,3,7,1300,0,1967,0,98003,47.3357,-122.305,1430,9750,12,17,2014,UNK,-130,-774
8598200070,12/8/2014,278000.0,2,2.5,1420,2229,2.0,0.0,0.0,3,7,1420,0,2004,0,98059,47.4871,-122.165,1500,2230,12,8,2014,N,-80,-1
5101402435,6/3/2014,312000.0,3,2.25,1540,5338,1.0,0.0,0.0,5,7,770,770,1954,0,98115,47.6942,-122.304,1680,6525,6,3,2014,UNK,-140,-1187
5101402435,3/4/2015,539000.0,3,2.25,1540,5338,1.0,0.0,0.0,5,7,770,770,1954,0,98115,47.6942,-122.304,1680,6525,3,4,2015,UNK,-140,-1187
8820902400,9/10/2014,498000.0,3,3.0,2360,2750,2.0,0.0,1.0,3,7,1780,580,1983,0,98125,47.7142,-122.281,1970,5800,9,10,2014,UNK,390,-3050
1246700251,5/27/2014,857000.0,4,3.0,3720,29043,2.0,0.0,0.0,3,9,3720,0,1991,0,98033,47.6907,-122.161,1610,23000,5,27,2014,UNK,2110,6043
5315101716,2/25/2015,780000.0,3,1.75,1690,13500,1.0,0.0,0.0,4,7,1690,0,1978,0,98040,47.5897,-122.23299999999999,1950,10500,2,25,2015,UNK,-260,3000
5035300570,9/23/2014,650000.0,3,2.0,2300,5000,1.0,0.0,0.0,4,8,1150,1150,1938,0,98199,47.6521,-122.413,2300,5000,9,23,2014,UNK,0,0
4123400310,4/9/2015,559500.0,4,1.75,1650,7088,1.0,0.0,0.0,3,8,1650,0,1973,0,98027,47.5688,-122.087,1850,7523,4,9,2015,UNK,-200,-435
4058802255,7/24/2014,219950.0,2,1.0,990,6448,1.0,0.0,0.0,3,7,990,0,1948,0,98178,47.5031,-122.245,1130,7200,7,24,2014,UNK,-140,-752
2141330560,7/25/2014,671500.0,4,2.25,2130,8410,2.0,0.0,0.0,4,8,2130,0,1977,0,98006,47.5589,-122.12799999999999,2170,8400,7,25,2014,UNK,-40,10
2725069121,9/3/2014,813000.0,4,2.5,3320,52707,2.0,0.0,0.0,3,10,3320,0,1999,0,98074,47.6247,-122.016,3040,54450,9,3,2014,UNK,280,-1743
7682200340,7/28/2014,182000.0,3,2.25,1960,8875,1.0,0.0,0.0,3,7,1290,670,1965,0,98003,47.3344,-122.301,1890,8700,7,28,2014,UNK,70,175
9518100059,8/22/2014,203700.0,2,1.0,770,2500,1.0,0.0,0.0,3,6,770,0,1913,1960,98072,47.7534,-122.17200000000001,1500,8286,8,22,2014,Y,-730,-5786
1861400060,5/5/2014,740000.0,4,1.75,2010,3600,1.5,0.0,0.0,3,7,2010,0,1902,0,98119,47.6337,-122.37100000000001,2010,3600,5,5,2014,UNK,0,0
2223059053,3/11/2015,230000.0,2,1.0,800,17965,1.0,0.0,0.0,4,5,800,0,1942,0,98058,47.4693,-122.161,1500,8925,3,11,2015,UNK,-700,9040
421049114,10/9/2014,128000.0,3,1.0,910,11117,1.0,0.0,0.0,3,7,910,0,1955,0,98003,47.3432,-122.309,1490,8416,10,9,2014,UNK,-580,2701
6703100140,8/22/2014,345000.0,3,1.0,1200,6628,1.0,0.0,0.0,4,7,1200,0,1952,0,98155,47.7367,-122.319,1330,6768,8,22,2014,UNK,-130,-140
6127010890,4/27/2015,663000.0,4,2.5,3570,6246,2.0,0.0,0.0,3,7,3570,0,2005,0,98075,47.5927,-122.006,2260,5231,4,27,2015,N,1310,1015
8898700960,6/20/2014,329950.0,3,2.5,1820,8085,2.0,0.0,0.0,3,7,1820,0,1983,0,98055,47.4575,-122.204,1860,8625,6,20,2014,UNK,-40,-540
486000597,8/11/2014,1050000.0,3,2.25,2930,7005,3.0,0.0,2.0,3,9,2670,260,1999,0,98117,47.6763,-122.404,2450,6460,8,11,2014,UNK,480,545
7175300045,11/12/2014,402300.0,3,1.75,1480,4050,1.0,0.0,0.0,3,7,870,610,1926,0,98115,47.681000000000004,-122.304,1350,4500,11,12,2014,UNK,130,-450
3073500045,5/7/2014,492000.0,4,2.5,3305,16164,1.5,0.0,0.0,5,7,2245,1060,1922,1956,98133,47.7563,-122.338,1620,8883,5,7,2014,Y,1685,7281
2407900550,5/7/2015,448000.0,4,2.5,2230,5000,1.0,0.0,0.0,3,7,1650,580,2006,0,98059,47.4799,-122.12899999999999,2090,4637,5,7,2015,N,140,363
5379802650,2/25/2015,273000.0,3,1.0,1560,7800,1.0,0.0,0.0,3,7,1560,0,1955,0,98188,47.4549,-122.287,1468,9375,2,25,2015,UNK,92,-1575
4364700990,10/3/2014,335000.0,3,1.0,1030,7200,1.0,0.0,0.0,3,6,880,150,1948,0,98126,47.5255,-122.376,1030,7200,10,3,2014,UNK,0,0
2158900140,9/5/2014,695000.0,3,3.75,2380,3600,1.5,0.0,0.0,3,7,1690,690,1927,0,98112,47.6374,-122.307,1990,3520,9,5,2014,UNK,390,80
3235100075,5/3/2015,279000.0,3,1.0,1010,7903,1.0,0.0,0.0,3,6,1010,0,1948,0,98155,47.76600000000001,-122.32,1010,7903,5,3,2015,UNK,0,0
2887701940,12/5/2014,485000.0,2,1.75,2060,2700,1.0,0.0,0.0,3,7,1030,1030,1929,0,98115,47.6856,-122.31200000000001,1390,2700,12,5,2014,UNK,670,0
7399200510,8/12/2014,383000.0,4,2.5,2370,10580,2.0,0.0,0.0,3,8,2370,0,1966,0,98055,47.464,-122.19200000000001,1590,8584,8,12,2014,UNK,780,1996
3578600045,12/16/2014,490000.0,4,2.5,2242,37451,2.0,0.0,0.0,3,8,2242,0,1995,0,98028,47.7443,-122.228,2242,13125,12,16,2014,UNK,0,24326
9406500310,11/19/2014,240000.0,2,1.5,1078,1263,2.0,0.0,0.0,3,7,1078,0,1990,0,98028,47.7532,-122.244,1078,1263,11,19,2014,UNK,0,0
1560100135,2/24/2015,285000.0,2,1.0,890,7250,1.0,0.0,0.0,3,7,890,0,1943,0,98125,47.7118,-122.314,900,7000,2,24,2015,UNK,-10,250
1326069094,2/25/2015,524950.0,3,1.5,2700,24539,2.0,0.0,0.0,3,7,2120,580,1977,2014,98019,47.7348,-121.984,1830,11000,2,25,2015,Y,870,13539
3396830310,4/7/2015,729000.0,4,2.5,2450,27081,2.0,0.0,0.0,3,8,2450,0,1985,0,98052,47.7177,-122.104,2630,12025,4,7,2015,UNK,-180,15056
4040400340,9/5/2014,460000.0,3,1.75,1420,8250,1.0,0.0,0.0,4,7,1420,0,1960,0,98007,47.6112,-122.133,2020,8250,9,5,2014,UNK,-600,0
7234601221,10/14/2014,687500.0,3,1.5,1280,2114,1.5,0.0,0.0,3,8,1280,0,1904,0,98122,47.6174,-122.30799999999999,1540,1456,10,14,2014,UNK,-260,658
6065301040,8/14/2014,1170000.0,5,2.75,2910,15118,1.0,0.0,0.0,5,9,1780,1130,1972,0,98006,47.5696,-122.18299999999999,2880,15253,8,14,2014,UNK,30,-135
2600010390,10/15/2014,825000.0,4,2.25,2430,10050,2.0,0.0,0.0,4,8,2430,0,1979,0,98006,47.5563,-122.163,2390,10250,10,15,2014,UNK,40,-200
6679000560,7/29/2014,314950.0,2,2.5,1860,6359,2.0,0.0,0.0,3,7,1860,0,2003,0,98038,47.3847,-122.029,1860,6359,7,29,2014,UNK,0,0
6743700335,6/4/2014,470000.0,3,2.0,1800,12669,1.0,0.0,0.0,3,7,1800,0,1956,1990,98033,47.6935,-122.17299999999999,1970,9775,6,4,2014,Y,-170,2894
2207000060,8/18/2014,500000.0,3,1.5,1960,8815,1.0,0.0,0.0,4,7,1020,940,1958,0,98006,47.5765,-122.15899999999999,1760,9534,8,18,2014,UNK,200,-719
1900000060,11/17/2014,313000.0,3,1.5,1550,7260,1.5,0.0,0.0,2,6,1550,0,1925,0,98166,47.4693,-122.34899999999999,1190,7620,11,17,2014,UNK,360,-360
1232001480,7/10/2014,445000.0,2,1.0,840,3840,1.0,0.0,0.0,4,7,840,0,1926,0,98117,47.684,-122.37799999999999,1310,3840,7,10,2014,UNK,-470,0
9835800320,8/28/2014,300000.0,4,1.75,2080,8750,1.0,0.0,0.0,4,8,1330,750,1967,0,98032,47.3749,-122.291,1790,8750,8,28,2014,UNK,290,0
9285800055,10/14/2014,619500.0,4,2.5,2210,5077,1.5,0.0,0.0,4,8,1480,730,1912,0,98126,47.5719,-122.37700000000001,1740,5000,10,14,2014,UNK,470,77
3438500677,6/13/2014,305000.0,3,1.5,1210,5240,1.0,0.0,0.0,4,7,610,0,1983,0,98106,47.5524,-122.35600000000001,1560,5240,6,13,2014,UNK,-350,0
3879901290,4/1/2015,874000.0,3,2.5,1350,941,3.0,0.0,0.0,3,9,1350,0,2007,0,98119,47.6265,-122.36399999999999,1640,1369,4,1,2015,N,-290,-428
3905040060,3/13/2015,477500.0,3,2.0,1860,5146,2.0,0.0,0.0,3,8,1860,0,1991,0,98029,47.5706,-121.999,1950,5146,3,13,2015,UNK,-90,0
9530101290,11/10/2014,700000.0,3,2.0,1940,4500,1.0,0.0,3.0,3,7,1090,850,1926,0,98107,47.6659,-122.359,1700,4500,11,10,2014,UNK,240,0
5104532030,3/6/2015,515000.0,4,3.5,3400,5222,2.0,0.0,0.0,3,9,3400,0,2005,0,98038,47.3559,-122.0,3190,5326,3,6,2015,N,210,-104
6411600045,10/16/2014,590000.0,4,2.5,2240,9385,2.0,0.0,0.0,3,8,2240,0,1991,0,98133,47.7125,-122.33200000000001,2010,9000,10,16,2014,UNK,230,385
1796360990,7/1/2014,205000.0,3,1.75,1170,8239,1.0,0.0,0.0,3,7,1170,0,1981,0,98042,47.3679,-122.088,1180,7866,7,1,2014,UNK,-10,373
9264911550,10/22/2014,310000.0,3,3.25,3130,9302,2.0,0.0,0.0,3,8,2190,940,1987,0,98023,47.3078,-122.338,2350,7949,10,22,2014,UNK,780,1353
7715800310,8/21/2014,442500.0,2,2.25,1510,7280,2.0,0.0,0.0,3,7,1510,0,1987,0,98074,47.6264,-122.05799999999999,1510,8120,8,21,2014,UNK,0,-840
3407700012,11/6/2014,1080000.0,4,3.5,3740,41458,2.0,0.0,2.0,3,11,3740,0,2000,0,98072,47.7375,-122.139,3750,38325,11,6,2014,UNK,-10,3133
2322069116,8/25/2014,530000.0,4,2.5,2690,46609,2.0,0.0,0.0,3,8,2690,0,1980,0,98038,47.3843,-122.006,1500,34800,8,25,2014,UNK,1190,11809
4058800875,6/24/2014,343500.0,4,1.75,1760,6204,1.0,0.0,2.0,4,7,1180,580,1950,0,98178,47.5045,-122.24,1990,6240,6,24,2014,UNK,-230,-36
8113101070,4/23/2015,334900.0,4,1.75,2180,4066,1.5,0.0,0.0,3,6,1270,910,1911,0,98118,47.5487,-122.277,1400,1343,4,23,2015,UNK,780,2723
9512501370,11/5/2014,544300.0,4,1.75,1560,9000,1.0,0.0,0.0,5,7,1560,0,1969,0,98052,47.6707,-122.149,1510,8848,11,5,2014,UNK,50,152
3670500465,5/26/2014,370000.0,3,2.5,1780,4050,2.0,0.0,0.0,3,7,1780,0,2001,0,98155,47.7346,-122.30799999999999,1571,4976,5,26,2014,UNK,209,-926
8856950310,5/24/2014,245000.0,3,1.75,1260,6908,1.0,0.0,0.0,3,7,1260,0,1994,0,98038,47.385,-122.031,1810,7159,5,24,2014,UNK,-550,-251
4315700505,2/10/2015,535000.0,4,1.75,1570,3250,1.5,0.0,0.0,5,8,1570,0,1928,0,98136,47.5405,-122.39299999999999,1570,5720,2,10,2015,UNK,0,-2470
3046200125,4/6/2015,202000.0,2,1.0,740,6550,1.0,0.0,0.0,4,5,740,0,1946,0,98168,47.4807,-122.33200000000001,1080,8515,4,6,2015,UNK,-340,-1965
2922701420,11/18/2014,490000.0,4,2.25,2020,4960,2.0,0.0,0.0,3,7,1710,310,1938,0,98117,47.6867,-122.369,1590,4550,11,18,2014,UNK,430,410
6430500238,12/16/2014,651500.0,4,1.5,1500,3075,2.0,0.0,0.0,5,7,1420,80,1929,0,98103,47.6893,-122.35,1480,3774,12,16,2014,UNK,20,-699
6031400071,1/14/2015,270000.0,4,2.5,1670,8056,1.0,0.0,0.0,3,7,1170,500,1961,0,98168,47.4884,-122.319,1360,8056,1,14,2015,UNK,310,0
1854750030,4/7/2015,1160000.0,3,3.5,3620,8072,2.0,0.0,0.0,3,10,2920,700,1999,0,98006,47.5646,-122.12700000000001,3680,9624,4,7,2015,UNK,-60,-1552
7950302121,7/16/2014,289000.0,2,1.5,1010,1309,2.0,0.0,0.0,3,7,860,150,2007,0,98118,47.5659,-122.286,1190,3060,7,16,2014,N,-180,-1751
1421069117,4/17/2015,240000.0,3,1.5,1460,13503,1.0,0.0,0.0,4,6,1460,0,1977,0,98010,47.3119,-122.015,1460,13394,4,17,2015,UNK,0,109
1370803510,5/15/2014,790000.0,3,1.75,1790,6117,1.0,0.0,2.0,3,8,1350,440,1940,0,98199,47.6366,-122.40100000000001,1960,5554,5,15,2014,UNK,-170,563
1559900140,12/22/2014,350000.0,3,2.25,1760,9621,2.0,0.0,0.0,3,7,1760,0,1995,0,98019,47.7466,-121.979,1810,6589,12,22,2014,UNK,-50,3032
2734100738,10/29/2014,246950.0,3,3.5,1790,1682,2.0,0.0,0.0,3,7,1480,310,2006,0,98108,47.542,-122.321,1150,4000,10,29,2014,N,640,-2318
7007700030,1/5/2015,400000.0,3,1.0,1050,6000,1.0,0.0,0.0,3,7,1050,0,1952,0,98116,47.5709,-122.40100000000001,1720,6000,1,5,2015,UNK,-670,0
7702020030,2/25/2015,533000.0,4,2.5,2590,6394,2.0,0.0,0.0,3,8,2590,0,2003,0,98028,47.7599,-122.23299999999999,2500,5328,2,25,2015,UNK,90,1066
1795500060,10/21/2014,198400.0,3,1.0,1040,8645,1.0,0.0,0.0,4,7,1040,0,1962,0,98042,47.3631,-122.116,1290,8645,10,21,2014,UNK,-250,0
3303860030,10/29/2014,495000.0,4,2.5,4060,8547,2.0,0.0,0.0,3,9,2790,1270,2007,0,98038,47.3694,-122.056,2810,8313,10,29,2014,N,1250,234
7701960990,6/16/2014,862000.0,4,2.5,3190,14565,2.0,0.0,0.0,3,11,3190,0,1990,0,98077,47.713,-122.072,3420,20475,6,16,2014,UNK,-230,-5910
7701960990,8/19/2014,870000.0,4,2.5,3190,14565,2.0,0.0,0.0,3,11,3190,0,1990,0,98077,47.713,-122.072,3420,20475,8,19,2014,UNK,-230,-5910
5453700060,2/24/2015,875000.0,4,1.75,2180,9726,1.0,0.0,0.0,4,9,2180,0,1966,0,98040,47.5359,-122.23299999999999,2560,10244,2,24,2015,UNK,-380,-518
2143700935,9/3/2014,317000.0,6,3.5,2120,5840,2.0,0.0,0.0,5,7,2120,0,1979,0,98055,47.4788,-122.227,1860,8000,9,3,2014,UNK,260,-2160
9485300560,7/25/2014,325000.0,4,2.75,2110,6838,2.0,0.0,0.0,4,8,2110,0,1991,0,98031,47.3877,-122.171,2100,7280,7,25,2014,UNK,10,-442
3693900135,9/20/2014,615000.0,2,1.5,1210,5000,1.5,0.0,0.0,5,6,1210,0,1907,0,98117,47.6793,-122.397,1570,5000,9,20,2014,UNK,-360,0
7212650990,7/21/2014,334950.0,4,2.5,2410,7846,2.0,0.0,0.0,3,8,2410,0,1992,0,98003,47.2641,-122.31200000000001,2380,7914,7,21,2014,UNK,30,-68
1245001659,8/21/2014,775000.0,3,2.5,1980,7807,2.0,0.0,0.0,4,9,1980,0,1989,0,98033,47.6884,-122.204,1590,7579,8,21,2014,UNK,390,228
6071300550,8/22/2014,600000.0,4,2.5,2370,9135,1.0,0.0,0.0,4,8,1600,770,1967,0,98006,47.5564,-122.177,2050,9468,8,22,2014,UNK,320,-333
4083306620,7/28/2014,565000.0,3,1.75,1720,2218,1.5,0.0,0.0,3,7,1270,450,1931,2003,98103,47.648999999999994,-122.335,1130,1600,7,28,2014,Y,590,618
8122100392,10/28/2014,292500.0,2,1.0,750,5026,1.0,0.0,0.0,4,6,750,0,1942,0,98126,47.5368,-122.374,1260,5040,10,28,2014,UNK,-510,-14
5418500800,4/29/2015,825000.0,3,2.25,2510,10418,1.0,0.0,0.0,3,8,1810,700,1968,0,98115,47.7003,-122.285,2510,9435,4,29,2015,UNK,0,983
2421059036,4/15/2015,495000.0,3,2.5,2577,156816,2.0,0.0,0.0,3,8,2577,0,2000,0,98092,47.2935,-122.10799999999999,2090,156816,4,15,2015,UNK,487,0
952000310,5/20/2014,525000.0,3,1.5,1540,4773,2.0,0.0,0.0,3,8,1540,0,1941,2009,98126,47.5678,-122.37799999999999,1540,5750,5,20,2014,Y,0,-977
5694501195,5/11/2015,438600.0,1,1.0,720,2500,1.0,0.0,0.0,3,7,720,0,1910,0,98103,47.6597,-122.345,1520,3750,5,11,2015,UNK,-800,-1250
2872900390,8/14/2014,507000.0,3,2.25,1810,8158,1.0,0.0,0.0,3,8,1450,360,1984,0,98074,47.6258,-122.038,1740,9532,8,14,2014,UNK,70,-1374
1502400140,4/29/2015,275900.0,3,1.75,1380,8400,1.0,0.0,0.0,3,7,1380,0,1967,0,98003,47.3117,-122.321,1540,8400,4,29,2015,UNK,-160,0
3860900003,6/17/2014,1170000.0,4,2.5,2570,6251,2.0,0.0,0.0,3,9,2570,0,2000,0,98004,47.593,-122.197,2570,9588,6,17,2014,UNK,0,-3337
1180003435,12/9/2014,275000.0,4,1.75,1690,6000,1.0,0.0,0.0,3,7,1690,0,1957,0,98178,47.497,-122.227,1350,6000,12,9,2014,UNK,340,0
6430000070,10/27/2014,355000.0,3,0.75,1420,3060,1.0,0.0,0.0,4,7,860,560,1923,0,98103,47.6872,-122.346,1350,4000,10,27,2014,UNK,70,-940
5530000030,1/26/2015,233000.0,4,2.0,2130,9579,1.0,0.0,0.0,4,7,1250,880,1968,0,98001,47.3069,-122.271,1590,9800,1,26,2015,UNK,540,-221
5700000465,9/4/2014,666000.0,3,2.5,3000,5000,1.5,0.0,0.0,4,7,2110,0,1918,0,98144,47.5781,-122.29299999999999,1970,5000,9,4,2014,UNK,1030,0
3211100570,8/11/2014,317500.0,4,2.5,2150,9000,1.0,0.0,0.0,4,7,1360,790,1979,0,98059,47.4785,-122.16,1620,8400,8,11,2014,UNK,530,600
9536601331,7/22/2014,420000.0,4,2.0,2280,10319,1.0,0.0,3.0,4,8,1270,1010,1989,0,98198,47.3594,-122.322,2280,9767,7,22,2014,UNK,0,552
985000955,3/12/2015,290000.0,4,2.0,1560,8800,2.0,0.0,0.0,5,6,1560,0,1942,1967,98168,47.4927,-122.31200000000001,1480,10000,3,12,2015,Y,80,-1200
323059208,6/3/2014,320000.0,3,2.0,1880,10758,1.0,0.0,0.0,5,6,940,940,1952,0,98059,47.5091,-122.14399999999999,2060,21000,6,3,2014,UNK,-180,-10242
4221270350,3/23/2015,650000.0,3,2.5,2320,5284,2.0,0.0,0.0,3,8,2320,0,2004,0,98075,47.591,-122.01700000000001,2320,4383,3,23,2015,N,0,901
3768000030,7/14/2014,325000.0,3,1.75,1010,7171,1.0,0.0,0.0,4,7,1010,0,1967,0,98034,47.7317,-122.23100000000001,1250,7560,7,14,2014,UNK,-240,-389
7211401610,8/20/2014,165000.0,3,1.0,1120,5000,1.0,0.0,0.0,3,6,1120,0,1917,0,98146,47.5109,-122.35700000000001,1050,5000,8,20,2014,UNK,70,0
9542000340,8/7/2014,500000.0,3,1.75,1560,16194,1.0,0.0,0.0,3,8,1560,0,1961,0,98005,47.5966,-122.175,2430,16193,8,7,2014,UNK,-870,1
2426049078,7/16/2014,443000.0,4,1.5,1860,12197,1.0,0.0,0.0,3,7,1860,0,1964,0,98034,47.729,-122.235,1510,11761,7,16,2014,UNK,350,436
5438000160,6/9/2014,213400.0,3,1.5,1150,8686,1.0,0.0,0.0,4,7,1150,0,1963,0,98055,47.4417,-122.194,1760,8798,6,9,2014,UNK,-610,-112
259600890,10/2/2014,480000.0,4,1.75,1920,9380,1.0,0.0,0.0,3,7,1920,0,1964,0,98008,47.6344,-122.118,1580,8580,10,2,2014,UNK,340,800
8732190200,1/15/2015,275000.0,4,2.25,2490,7233,1.0,0.0,0.0,3,8,1460,1030,1978,0,98023,47.3115,-122.396,2000,8000,1,15,2015,UNK,490,-767
3395040200,7/9/2014,299880.0,3,2.5,1460,3044,2.0,0.0,0.0,3,7,1460,0,2000,0,98108,47.544,-122.296,1490,3044,7,9,2014,UNK,-30,0
6362900171,5/27/2014,499950.0,3,3.5,1820,1501,2.0,0.0,0.0,3,8,1430,390,2014,0,98144,47.596000000000004,-122.29799999999999,1550,1501,5,27,2014,N,270,0
2154500060,12/3/2014,1710000.0,5,3.0,4290,17100,1.0,0.0,3.0,3,9,2480,1810,1972,2007,98040,47.5473,-122.211,3550,16988,12,3,2014,Y,740,112
5706200370,8/6/2014,550000.0,4,2.75,2230,9460,1.0,0.0,0.0,5,7,1480,750,1960,0,98027,47.5246,-122.044,1760,10878,8,6,2014,UNK,470,-1418
1402950240,6/2/2014,300000.0,4,2.5,2070,7476,2.0,0.0,0.0,3,8,2070,0,2003,0,98092,47.3352,-122.189,2430,5500,6,2,2014,UNK,-360,1976
4141800030,10/14/2014,920000.0,3,1.75,2480,4000,1.0,0.0,0.0,3,8,1240,1240,1948,2014,98122,47.615,-122.288,2450,4000,10,14,2014,Y,30,0
3426049284,8/19/2014,2300000.0,4,3.25,4110,15929,2.0,1.0,4.0,3,12,2720,1390,2001,0,98115,47.6934,-122.271,2640,15929,8,19,2014,UNK,1470,0
3658700510,7/24/2014,620000.0,4,2.75,2290,3060,1.5,0.0,0.0,5,7,1550,740,1928,0,98115,47.6793,-122.316,1460,3060,7,24,2014,UNK,830,0
2220069196,8/11/2014,253500.0,3,1.0,1220,20400,1.0,0.0,0.0,5,6,1220,0,1959,0,98022,47.2063,-122.023,1640,53578,8,11,2014,UNK,-420,-33178
5700004485,5/20/2014,978000.0,4,2.75,2620,13777,1.5,0.0,2.0,4,9,1720,900,1926,0,98144,47.58,-122.285,3530,9287,5,20,2014,UNK,-910,4490
1328320350,12/2/2014,387500.0,4,2.5,3190,9856,2.0,0.0,0.0,3,8,3190,0,1979,0,98058,47.4445,-122.126,2260,7996,12,2,2014,UNK,930,1860
3432500310,6/24/2014,325000.0,3,1.0,850,6906,1.0,0.0,0.0,3,6,850,0,1948,0,98155,47.7441,-122.314,1150,6907,6,24,2014,UNK,-300,-1
9274200318,4/10/2015,568000.0,3,2.5,1740,1308,3.0,0.0,0.0,3,8,1740,0,2008,0,98116,47.5892,-122.387,1740,1280,4,10,2015,N,0,28
3034200550,9/22/2014,525000.0,4,2.5,2140,7754,2.0,0.0,0.0,3,8,2140,0,1996,0,98133,47.7173,-122.338,1690,7775,9,22,2014,UNK,450,-21
2078500350,6/4/2014,560000.0,3,2.5,2070,12708,2.0,0.0,0.0,3,8,2070,0,1996,0,98056,47.5295,-122.18,2620,9617,6,4,2014,UNK,-550,3091
7203101290,10/20/2014,394000.0,3,2.5,1680,4075,2.0,0.0,0.0,3,7,1680,0,2008,0,98053,47.6964,-122.024,1710,4075,10,20,2014,N,-30,0
9287801455,10/28/2014,484950.0,2,1.0,1000,4956,1.0,0.0,2.0,4,7,1000,0,1916,0,98107,47.6753,-122.36,1830,4959,10,28,2014,UNK,-830,-3
9472200060,11/5/2014,1300000.0,3,2.75,3340,12690,1.0,0.0,0.0,3,10,2550,790,1956,1988,98105,47.6665,-122.27,3340,9480,11,5,2014,Y,0,3210
869700060,7/29/2014,315000.0,3,2.5,1260,2767,2.0,0.0,0.0,3,8,1260,0,1999,0,98059,47.4914,-122.155,1310,2767,7,29,2014,UNK,-50,0
4298100060,5/9/2014,590000.0,4,2.25,2430,32496,1.0,0.0,0.0,3,9,2430,0,1993,0,98077,47.7642,-122.04799999999999,2750,35506,5,9,2014,UNK,-320,-3010
7211402105,11/26/2014,106000.0,1,1.0,560,5700,1.0,0.0,0.0,3,5,560,0,1947,0,98146,47.511,-122.359,1120,5000,11,26,2014,UNK,-560,700
7135520260,11/18/2014,751000.0,3,2.5,3380,9528,2.0,0.0,0.0,3,10,3380,0,1994,0,98059,47.5275,-122.148,3630,14089,11,18,2014,UNK,-250,-4561
9222400565,10/17/2014,474000.0,2,1.0,1100,3500,1.0,0.0,0.0,5,7,1100,0,1908,0,98115,47.6741,-122.323,2050,4000,10,17,2014,UNK,-950,-500
7116500125,5/28/2014,189000.0,2,2.0,1700,3171,1.0,0.0,0.0,5,5,850,850,1927,0,98002,47.3025,-122.22399999999999,1380,5906,5,28,2014,UNK,320,-2735
7202290320,10/24/2014,440500.0,3,2.5,1600,3172,2.0,0.0,0.0,3,7,1600,0,2002,0,98053,47.6868,-122.042,1690,3698,10,24,2014,UNK,-90,-526
9808630260,3/18/2015,1020000.0,3,2.5,2605,2216,2.0,0.0,2.0,4,9,2090,515,1979,0,98033,47.6529,-122.20200000000001,2605,1979,3,18,2015,UNK,0,237
8682310310,5/11/2015,589000.0,2,2.0,1850,4667,1.0,0.0,0.0,3,8,1850,0,2010,0,98053,47.7101,-122.014,1860,6008,5,11,2015,N,-10,-1341
4137000700,8/29/2014,273000.0,3,2.25,1830,7651,2.0,0.0,0.0,3,8,1830,0,1986,0,98092,47.2642,-122.219,2160,8442,8,29,2014,UNK,-330,-791
5119400075,6/20/2014,950000.0,3,3.25,3050,18892,1.0,1.0,4.0,4,8,1650,1400,1962,0,98198,47.3881,-122.32600000000001,1170,70973,6,20,2014,UNK,1880,-52081
8857100060,11/10/2014,277700.0,2,1.5,1240,1055,2.0,0.0,0.0,3,8,1200,40,1967,0,98008,47.6104,-122.11200000000001,1410,1340,11,10,2014,UNK,-170,-285
3329510200,11/24/2014,299900.0,3,2.25,2100,8163,2.0,0.0,0.0,3,7,2100,0,1984,0,98001,47.3336,-122.26899999999999,1410,7515,11,24,2014,UNK,690,648
7789200070,6/3/2014,235000.0,3,1.0,1250,15603,1.0,0.0,0.0,4,7,1250,0,1959,0,98056,47.5093,-122.17200000000001,1720,10220,6,3,2014,UNK,-470,5383
6140600049,5/6/2015,464000.0,2,2.0,1230,4800,2.0,0.0,0.0,3,7,1230,0,1952,2004,98133,47.7145,-122.35,1560,7200,5,6,2015,Y,-330,-2400
9324320030,3/17/2015,281000.0,3,1.75,1690,9826,1.0,0.0,0.0,4,7,1690,0,1988,0,98023,47.31399999999999,-122.365,1980,9826,3,17,2015,UNK,-290,0
2555900030,11/7/2014,320000.0,3,1.0,1520,8870,1.5,0.0,0.0,4,7,1520,0,1951,0,98155,47.7638,-122.31700000000001,1520,7800,11,7,2014,UNK,0,1070
8662500350,6/20/2014,282000.0,4,2.0,1890,6302,2.0,0.0,0.0,3,7,1890,0,1997,0,98030,47.3846,-122.205,1690,5369,6,20,2014,UNK,200,933
7856601040,2/20/2015,745000.0,4,1.75,1990,8900,1.0,0.0,0.0,4,8,1990,0,1972,0,98006,47.5639,-122.149,2620,8925,2,20,2015,UNK,-630,-25
109200390,8/20/2014,245000.0,3,1.75,1480,3900,1.0,0.0,0.0,4,7,1480,0,1980,0,98023,47.2977,-122.367,1830,6956,8,20,2014,UNK,-350,-3056
109200390,10/20/2014,250000.0,3,1.75,1480,3900,1.0,0.0,0.0,4,7,1480,0,1980,0,98023,47.2977,-122.367,1830,6956,10,20,2014,UNK,-350,-3056
6870300060,9/22/2014,470000.0,3,2.5,2120,2374,2.0,0.0,0.0,3,8,1770,350,2005,0,98052,47.674,-122.14200000000001,2480,3043,9,22,2014,N,-360,-669
2734100732,10/15/2014,216650.0,3,3.5,1480,1077,2.0,0.0,0.0,3,7,1300,180,2007,0,98109,47.5421,-122.322,1140,2003,10,15,2014,N,340,-926
7201900370,5/5/2015,440000.0,3,1.0,1250,8412,1.0,0.0,0.0,4,7,1250,0,1975,0,98052,47.7012,-122.131,1840,8976,5,5,2015,UNK,-590,-564
3904960700,6/13/2014,590000.0,4,2.5,2010,7972,2.0,0.0,0.0,4,8,2010,0,1989,0,98029,47.5782,-122.01799999999999,2100,8511,6,13,2014,UNK,-90,-539
2225059240,10/28/2014,935000.0,5,2.5,3150,35283,1.0,0.0,0.0,3,10,1800,1350,1975,0,98005,47.6368,-122.15700000000001,3280,35283,10,28,2014,UNK,-130,0
4397650160,9/22/2014,848000.0,3,3.5,3010,5717,2.0,0.0,0.0,3,10,3010,0,2000,0,98007,47.5943,-122.15,2780,5138,9,22,2014,UNK,230,579
3629860060,3/12/2015,827500.0,5,4.25,3920,5823,2.0,0.0,0.0,3,9,3000,920,2000,0,98029,47.5492,-122.008,3000,5297,3,12,2015,UNK,920,526
4083305085,5/20/2014,1130000.0,6,3.0,2880,3192,2.0,0.0,0.0,4,8,2180,700,1919,0,98103,47.6506,-122.33200000000001,1870,4533,5,20,2014,UNK,1010,-1341
518500700,5/7/2014,630000.0,2,2.25,2550,5663,1.0,0.0,0.0,3,10,1720,830,2011,0,98056,47.5304,-122.20200000000001,2560,3828,5,7,2014,N,-10,1835
3580900260,5/5/2014,340000.0,5,1.0,1120,9022,1.5,0.0,0.0,4,7,1120,0,1962,0,98034,47.7296,-122.24,1310,7500,5,5,2014,UNK,-190,1522
1974300060,9/23/2014,570000.0,4,2.75,3140,10918,1.0,0.0,0.0,3,8,1900,1240,1968,1986,98034,47.7086,-122.243,3170,10918,9,23,2014,Y,-30,0
624069035,12/9/2014,2750000.0,4,4.0,4130,5575,2.0,1.0,4.0,4,10,2860,1270,1993,0,98075,47.5968,-122.083,2980,5575,12,9,2014,UNK,1150,0
5152980070,1/2/2015,514500.0,4,2.5,2990,9614,1.0,0.0,2.0,4,9,1740,1250,1976,0,98003,47.3424,-122.329,3370,12085,1,2,2015,UNK,-380,-2471
2624039114,4/13/2015,360000.0,2,1.0,1120,12625,1.0,0.0,3.0,3,7,1120,0,1940,0,98136,47.5397,-122.385,1880,6828,4,13,2015,UNK,-760,5797
4337000200,12/17/2014,228900.0,4,1.5,1570,8775,1.0,0.0,0.0,3,7,1570,0,1943,0,98166,47.4789,-122.335,980,8775,12,17,2014,UNK,590,0
7203100550,6/25/2014,660000.0,3,2.75,2210,4000,2.0,0.0,0.0,3,8,2210,0,2008,0,98053,47.6954,-122.01700000000001,2230,4674,6,25,2014,N,-20,-674
2782100260,3/3/2015,647000.0,4,2.5,2390,5800,2.0,0.0,0.0,3,9,2390,0,2000,0,98075,47.5965,-122.038,2590,6507,3,3,2015,UNK,-200,-707
1737320060,6/10/2014,366000.0,3,1.75,1520,8625,1.0,0.0,0.0,3,8,1520,0,1976,0,98011,47.7687,-122.223,2080,9200,6,10,2014,UNK,-560,-575
7972604001,7/18/2014,354000.0,5,1.75,1830,7986,1.0,0.0,0.0,4,7,1060,770,1962,0,98106,47.5208,-122.35,1410,7260,7,18,2014,UNK,420,726
2719100240,5/19/2014,850000.0,4,3.5,2640,5900,2.0,0.0,2.0,3,8,2640,0,1937,1998,98136,47.5421,-122.383,1700,5900,5,19,2014,Y,940,0
3904990570,5/24/2014,496700.0,3,2.5,1740,5782,2.0,0.0,0.0,4,8,1740,0,1989,0,98029,47.5783,-122.001,2080,5782,5,24,2014,UNK,-340,0
7399000350,11/4/2014,300000.0,3,2.0,1550,8300,1.0,0.0,0.0,4,8,1550,0,1965,0,98055,47.4654,-122.195,1860,8000,11,4,2014,UNK,-310,300
6400700189,10/17/2014,390000.0,3,1.0,1040,8075,1.0,0.0,0.0,4,7,1040,0,1961,0,98033,47.6701,-122.176,1450,8075,10,17,2014,UNK,-410,0
4305200070,5/19/2014,350000.0,3,2.25,1640,7200,2.0,0.0,0.0,4,8,1640,0,1985,0,98007,47.5948,-122.15299999999999,1830,8372,5,19,2014,UNK,-190,-1172
4305200070,9/22/2014,561000.0,3,2.25,1640,7200,2.0,0.0,0.0,4,8,1640,0,1985,0,98007,47.5948,-122.15299999999999,1830,8372,9,22,2014,UNK,-190,-1172
2201500240,7/30/2014,475000.0,3,1.75,1260,10065,1.0,0.0,0.0,3,7,1260,0,1954,2014,98006,47.5727,-122.13799999999999,1320,10278,7,30,2014,Y,-60,-213
3277800729,10/16/2014,275000.0,3,1.5,1170,1174,2.0,0.0,0.0,3,7,840,330,2007,0,98126,47.5459,-122.376,1170,2537,10,16,2014,N,0,-1363
2525310320,10/28/2014,290000.0,3,1.75,1590,13500,1.0,0.0,0.0,4,7,1090,500,1980,0,98038,47.3621,-122.031,1540,10375,10,28,2014,UNK,50,3125
2215901840,2/11/2015,199000.0,3,2.5,1750,6725,1.0,0.0,0.0,3,7,1330,420,1993,0,98038,47.352,-122.05799999999999,1670,7744,2,11,2015,UNK,80,-1019
1796700160,3/24/2015,279900.0,4,2.5,1770,4338,2.0,0.0,0.0,3,7,1770,0,2001,0,98042,47.3672,-122.09899999999999,1770,6606,3,24,2015,UNK,0,-2268
4218400671,5/5/2015,1660000.0,4,2.25,3530,5500,2.0,0.0,0.0,3,8,2860,670,1940,0,98105,47.6618,-122.273,2840,5500,5,5,2015,UNK,690,0
6415100350,4/13/2015,405000.0,3,2.5,2160,10200,1.0,0.0,0.0,3,7,1360,800,1978,0,98133,47.7295,-122.331,2010,7850,4,13,2015,UNK,150,2350
7504020400,1/27/2015,615000.0,4,2.25,2360,15860,1.0,0.0,0.0,3,9,2360,0,1977,0,98074,47.6307,-122.051,2650,11798,1,27,2015,UNK,-290,4062
8732190070,10/2/2014,268000.0,3,1.75,1980,12543,1.0,0.0,0.0,3,8,1180,800,1978,0,98023,47.3104,-122.39399999999999,2090,8539,10,2,2014,UNK,-110,4004
2826049200,8/25/2014,451000.0,4,1.5,1620,5444,1.5,0.0,0.0,3,8,1620,0,1955,0,98125,47.7065,-122.29700000000001,1620,6912,8,25,2014,UNK,0,-1468
8682292190,12/15/2014,850000.0,2,2.75,2700,9854,1.0,0.0,0.0,3,9,2700,0,2012,0,98053,47.7187,-122.024,1440,4168,12,15,2014,N,1260,5686
2524049250,9/21/2014,1180000.0,5,2.25,3270,16553,2.0,0.0,2.0,5,9,2470,800,1968,0,98040,47.5428,-122.236,3690,17916,9,21,2014,UNK,-420,-1363
7972603385,5/16/2014,245000.0,2,1.0,870,6150,1.0,0.0,0.0,3,6,870,0,1941,0,98106,47.5256,-122.34700000000001,1120,6150,5,16,2014,UNK,-250,0
4454800060,6/26/2014,450000.0,2,1.75,840,3340,1.0,0.0,0.0,3,6,700,140,1912,0,98107,47.6692,-122.359,1700,3980,6,26,2014,UNK,-860,-640
8910500226,4/9/2015,370350.0,3,3.5,1340,1168,2.0,0.0,2.0,3,8,1080,260,2002,0,98133,47.71100000000001,-122.35600000000001,1650,1378,4,9,2015,UNK,-310,-210
1972202505,7/29/2014,543000.0,3,2.5,1540,1256,3.0,0.0,0.0,3,8,1540,0,2004,0,98103,47.6498,-122.346,1500,1350,7,29,2014,N,40,-94
6303400520,1/27/2015,265000.0,2,2.0,1650,8975,1.0,0.0,0.0,5,6,1650,0,1942,0,98146,47.5073,-122.36,1260,8668,1,27,2015,UNK,390,307
7852020340,3/25/2015,497000.0,3,2.5,2630,4611,2.0,0.0,0.0,3,8,2630,0,2001,0,98065,47.5322,-121.868,2220,5250,3,25,2015,UNK,410,-639
3824100041,4/12/2015,419000.0,4,2.25,1880,9727,1.0,0.0,0.0,3,7,1100,780,1979,0,98028,47.7731,-122.257,1790,10274,4,12,2015,UNK,90,-547
3904990260,7/24/2014,545800.0,4,2.5,1980,4500,2.0,0.0,0.0,3,8,1980,0,1989,0,98029,47.57899999999999,-122.001,1770,4595,7,24,2014,UNK,210,-95
204000140,4/3/2015,403000.0,3,1.0,1500,10730,1.0,0.0,0.0,3,7,1000,500,1977,0,98053,47.6385,-121.96600000000001,1570,12210,4,3,2015,UNK,-70,-1480
6083000071,11/10/2014,195000.0,3,2.0,1230,8235,1.5,0.0,0.0,3,6,1230,0,1959,0,98168,47.4853,-122.304,1080,10281,11,10,2014,UNK,150,-2046
6819100111,12/11/2014,1130000.0,4,2.5,2520,2600,2.0,0.0,0.0,5,8,1670,850,1925,0,98119,47.6434,-122.35799999999999,2290,3600,12,11,2014,UNK,230,-1000
7806210400,9/29/2014,255000.0,5,1.75,1970,8925,1.0,0.0,0.0,5,7,1170,800,1977,0,98002,47.2925,-122.196,1910,8025,9,29,2014,UNK,60,900
4375700055,6/27/2014,500000.0,2,1.5,1520,8040,1.0,0.0,0.0,5,7,1520,0,1951,0,98125,47.7131,-122.306,1440,8040,6,27,2014,UNK,80,0
207500012,5/5/2014,855000.0,4,2.75,2600,5390,1.0,0.0,0.0,4,8,1300,1300,1960,0,98199,47.6382,-122.397,2550,5600,5,5,2014,UNK,50,-210
2731600045,1/7/2015,390000.0,4,2.0,2290,9200,1.5,0.0,0.0,3,7,2290,0,1920,0,98166,47.4678,-122.363,2140,9200,1,7,2015,UNK,150,0
1953400570,3/24/2015,339000.0,3,2.0,1979,8470,1.0,0.0,2.0,4,7,1329,650,1956,0,98198,47.3912,-122.301,1650,8591,3,24,2015,UNK,329,-121
2883200139,3/6/2015,1330000.0,4,3.5,2170,3672,2.0,0.0,0.0,3,9,2170,0,1905,1989,98115,47.6828,-122.329,1950,3450,3,6,2015,Y,220,222
3345100251,2/17/2015,429900.0,4,1.5,1820,17918,1.0,0.0,0.0,4,8,1190,0,1962,0,98056,47.521,-122.179,1890,15241,2,17,2015,UNK,-70,2677
1387301740,9/25/2014,370900.0,3,1.5,1200,8560,1.0,0.0,0.0,4,7,1200,0,1975,0,98011,47.7392,-122.194,1550,7800,9,25,2014,UNK,-350,760
3214200070,4/29/2015,457500.0,3,1.0,1210,7636,1.0,0.0,0.0,4,7,1210,0,1952,0,98118,47.5377,-122.266,1530,5900,4,29,2015,UNK,-320,1736
1937300193,2/27/2015,499000.0,4,2.5,1970,2601,2.0,0.0,0.0,3,7,1440,530,1999,0,98144,47.5949,-122.30799999999999,1760,3025,2,27,2015,UNK,210,-424
2821049082,2/12/2015,225000.0,2,1.0,1040,11500,1.0,0.0,0.0,5,7,1040,0,1947,0,98003,47.2791,-122.3,1300,11954,2,12,2015,UNK,-260,-454
2207500200,9/15/2014,615000.0,3,1.75,1920,4000,1.0,0.0,0.0,3,7,1070,850,1950,0,98102,47.6392,-122.318,2280,4000,9,15,2014,UNK,-360,0
9528104286,1/13/2015,455000.0,2,1.5,1020,1146,3.0,0.0,0.0,3,7,1020,0,2001,0,98115,47.6774,-122.325,1138,1156,1,13,2015,UNK,-118,-10
8901001170,5/14/2014,458000.0,3,1.0,1660,7500,1.0,0.0,0.0,4,7,1060,600,1940,0,98125,47.7105,-122.306,1450,7500,5,14,2014,UNK,210,0
3260200200,10/30/2014,580000.0,3,2.25,1670,7416,1.0,0.0,0.0,4,7,1220,450,1974,0,98005,47.6028,-122.17200000000001,1710,7416,10,30,2014,UNK,-40,0
1853080640,5/14/2014,966000.0,5,4.5,3810,8019,2.0,0.0,0.0,3,10,3810,0,2008,0,98074,47.5915,-122.05799999999999,3390,7713,5,14,2014,N,420,306
986000045,10/7/2014,240000.0,4,1.75,2020,10332,1.0,0.0,0.0,3,7,1010,1010,1954,0,98168,47.5059,-122.303,2240,8379,10,7,2014,UNK,-220,1953
4322200105,3/31/2015,229050.0,1,1.0,420,3298,1.0,0.0,0.0,4,4,420,0,1949,0,98136,47.5375,-122.391,1460,4975,3,31,2015,UNK,-1040,-1677
1453600681,2/23/2015,328500.0,3,2.25,1390,1407,3.0,0.0,0.0,3,7,1390,0,2004,0,98125,47.7227,-122.296,1390,1628,2,23,2015,N,0,-221
3365900041,1/21/2015,319000.0,3,1.5,2010,10100,1.0,0.0,0.0,4,7,1110,900,1964,0,98168,47.4738,-122.266,1900,10100,1,21,2015,UNK,110,0
9294300070,5/2/2014,650000.0,4,2.0,1820,5000,1.5,0.0,1.0,3,7,1640,180,1945,0,98115,47.6815,-122.26899999999999,2060,5000,5,2,2014,UNK,-240,0
5096300140,2/17/2015,398500.0,3,2.5,1630,1971,2.0,0.0,0.0,3,8,1630,0,1996,0,98177,47.7753,-122.375,1630,3451,2,17,2015,UNK,0,-1480
985001275,6/20/2014,250000.0,1,1.0,800,16306,1.0,0.0,0.0,2,6,680,120,1931,0,98168,47.4916,-122.30799999999999,1270,8666,6,20,2014,UNK,-470,7640
6669200370,6/26/2014,815000.0,3,2.0,2270,11989,1.0,0.0,0.0,4,9,2270,0,1968,0,98040,47.5434,-122.229,2880,12439,6,26,2014,UNK,-610,-450
3885806840,3/16/2015,1070000.0,3,2.75,2290,5002,2.0,0.0,0.0,4,9,1950,340,1995,0,98033,47.6811,-122.20700000000001,2290,5100,3,16,2015,UNK,0,-98
2025079037,10/1/2014,510000.0,3,2.25,2750,219542,2.0,0.0,0.0,3,7,1870,880,1981,0,98014,47.6367,-121.948,2430,219542,10,1,2014,UNK,320,0
3812400202,11/14/2014,156000.0,2,1.75,590,6138,1.0,0.0,0.0,2,5,590,0,1947,0,98118,47.545,-122.27799999999999,1360,7112,11,14,2014,UNK,-770,-974
4136880140,5/22/2014,254500.0,4,2.75,2570,7264,2.0,0.0,0.0,3,8,1720,850,1998,0,98092,47.258,-122.208,2420,7911,5,22,2014,UNK,150,-647
258500059,7/21/2014,760000.0,3,2.5,2050,15020,1.0,0.0,2.0,3,9,1600,450,1960,0,98177,47.75899999999999,-122.37100000000001,2930,15050,7,21,2014,UNK,-880,-30
8016250140,5/6/2015,210000.0,3,2.5,1610,6732,2.0,0.0,0.0,3,7,1610,0,1994,0,98030,47.3658,-122.17200000000001,1680,7414,5,6,2015,UNK,-70,-682
5153100030,8/25/2014,349950.0,3,2.5,2140,7715,2.0,0.0,0.0,3,7,2140,0,1991,0,98198,47.38399999999999,-122.322,1990,7628,8,25,2014,UNK,150,87
1377800135,4/2/2015,676000.0,3,2.0,1730,6784,2.5,0.0,0.0,4,7,1730,0,1942,0,98199,47.6462,-122.40299999999999,1210,6784,4,2,2015,UNK,520,0
7549800045,1/2/2015,475000.0,4,3.5,2440,3052,2.0,0.0,0.0,3,8,1940,500,2006,0,98108,47.555,-122.309,2390,4600,1,2,2015,N,50,-1548
3179101070,6/30/2014,880000.0,4,2.75,3220,4392,1.5,0.0,0.0,4,9,2320,900,1931,0,98105,47.6713,-122.27600000000001,2310,5795,6,30,2014,UNK,910,-1403
629800520,9/3/2014,1210000.0,4,3.25,4330,26162,2.0,0.0,0.0,3,11,4330,0,1997,0,98074,47.6009,-122.01100000000001,5110,26319,9,3,2014,UNK,-780,-157
7129302800,12/12/2014,420000.0,3,1.5,1780,5000,1.0,0.0,4.0,4,7,1030,750,1958,0,98118,47.5168,-122.256,1780,7500,12,12,2014,UNK,0,-2500
2450000320,5/23/2014,607000.0,3,1.0,1230,8114,1.0,0.0,0.0,4,7,1230,0,1951,0,98004,47.5822,-122.196,2220,8114,5,23,2014,UNK,-990,0
6804600990,11/24/2014,475000.0,4,1.75,2160,19283,2.0,0.0,0.0,3,8,2160,0,1981,0,98011,47.7603,-122.169,1990,9744,11,24,2014,UNK,170,9539
3389900800,10/22/2014,395000.0,2,1.75,1400,2500,1.0,0.0,0.0,5,7,710,690,1916,0,98116,47.5628,-122.391,1250,5700,10,22,2014,UNK,150,-3200
524059208,2/20/2015,650000.0,4,1.75,1900,10454,1.0,0.0,0.0,4,7,1180,720,1954,0,98004,47.5933,-122.195,2060,11325,2,20,2015,UNK,-160,-871
1523069128,3/31/2015,625000.0,5,2.75,2910,85377,1.0,0.0,0.0,4,8,1510,1400,1966,0,98027,47.48,-122.03,2160,66120,3,31,2015,UNK,750,19257
5701700640,7/29/2014,849000.0,3,3.0,2960,42159,2.0,0.0,0.0,3,10,2960,0,1995,0,98052,47.7183,-122.1,2640,25209,7,29,2014,UNK,320,16950
4077800247,6/10/2014,429950.0,3,1.5,2010,9480,1.0,0.0,0.0,3,8,1570,440,1951,0,98125,47.7102,-122.281,1920,8791,6,10,2014,UNK,90,689
3629860160,10/28/2014,825000.0,3,2.5,3760,5260,2.0,0.0,0.0,3,9,3230,530,2002,0,98029,47.5489,-122.007,3080,5312,10,28,2014,UNK,680,-52
2877102180,8/29/2014,505000.0,2,1.0,1020,5000,1.0,0.0,0.0,4,7,1020,0,1916,0,98117,47.6781,-122.363,1480,5000,8,29,2014,UNK,-460,0
7203101610,5/12/2014,265000.0,2,1.0,1290,2828,2.0,0.0,0.0,3,7,1290,0,2008,0,98053,47.6968,-122.025,1290,2628,5,12,2014,N,0,200
3342100685,6/25/2014,283000.0,3,1.0,890,8400,1.0,0.0,0.0,4,6,890,0,1954,0,98056,47.5168,-122.204,1850,5565,6,25,2014,UNK,-960,2835
3575301550,4/7/2015,560000.0,3,2.75,1620,7500,1.0,0.0,0.0,5,7,1140,480,1979,0,98074,47.6175,-122.065,1900,7500,4,7,2015,UNK,-280,0
1829300260,11/13/2014,765000.0,4,2.5,3360,13636,2.0,0.0,0.0,3,10,3360,0,1987,0,98074,47.6373,-122.042,2980,10615,11,13,2014,UNK,380,3021
6071000030,7/22/2014,610000.0,5,2.75,2930,31411,1.0,0.0,0.0,4,9,1520,1410,1975,0,98006,47.5576,-122.186,3070,12378,7,22,2014,UNK,-140,19033
4099100260,9/3/2014,589000.0,3,2.5,2940,4799,1.0,0.0,0.0,3,9,1710,1230,1996,0,98033,47.6681,-122.184,2540,4616,9,3,2014,UNK,400,183
3365900520,6/18/2014,192500.0,3,1.0,1080,8580,1.5,0.0,0.0,3,6,1080,0,1900,0,98168,47.4716,-122.262,1800,12672,6,18,2014,UNK,-720,-4092
8964800890,1/9/2015,3200000.0,3,3.25,4560,13363,1.0,0.0,4.0,3,11,2760,1800,1995,0,98004,47.6205,-122.214,4060,13362,1,9,2015,UNK,500,1
7977200055,2/13/2015,550000.0,3,1.0,1010,6120,1.0,0.0,0.0,3,7,860,150,1940,0,98115,47.6861,-122.296,1930,6120,2,13,2015,UNK,-920,0
7589700106,10/14/2014,460000.0,2,1.5,1790,3760,1.5,0.0,0.0,4,8,1280,510,1928,0,98117,47.6871,-122.37299999999999,1540,5080,10,14,2014,UNK,250,-1320
9324300030,7/3/2014,264500.0,4,2.25,2060,11385,1.0,0.0,0.0,4,7,1200,860,1962,0,98023,47.31399999999999,-122.363,2110,11385,7,3,2014,UNK,-50,0
5347200070,4/27/2015,339000.0,3,1.0,1150,2496,1.0,0.0,0.0,3,6,1010,140,1947,0,98126,47.5194,-122.376,1340,1203,4,27,2015,UNK,-190,1293
2771600550,11/12/2014,950000.0,4,3.5,4030,4200,3.0,0.0,0.0,3,9,4030,0,1992,0,98199,47.6416,-122.38600000000001,2130,5000,11,12,2014,UNK,1900,-800
5456000135,8/22/2014,677500.0,3,1.75,2020,9718,1.0,0.0,0.0,3,8,2020,0,1956,0,98040,47.574,-122.21,2370,8604,8,22,2014,UNK,-350,1114
629811360,12/5/2014,690000.0,4,2.5,2740,8120,2.0,0.0,0.0,3,9,2740,0,1999,0,98074,47.6123,-122.006,2780,8344,12,5,2014,UNK,-40,-224
1354600160,5/9/2014,312000.0,4,2.25,1930,7452,1.0,0.0,0.0,3,7,1430,500,1984,0,98031,47.4098,-122.189,1714,7200,5,9,2014,UNK,216,252
8566100160,10/22/2014,840000.0,5,1.75,2500,11617,1.0,0.0,0.0,4,9,1560,940,1966,0,98040,47.5361,-122.21700000000001,3370,11617,10,22,2014,UNK,-870,0
5104520550,7/1/2014,357500.0,3,3.5,2080,5100,2.0,0.0,0.0,3,8,2080,0,2004,0,98038,47.35,-122.005,2080,5100,7,1,2014,N,0,0
2819100140,4/27/2015,675000.0,3,1.5,1460,6480,1.0,0.0,2.0,4,7,980,480,1940,0,98117,47.6962,-122.397,2180,6912,4,27,2015,UNK,-720,-432
7298020140,10/21/2014,515000.0,3,2.75,3290,11441,2.0,0.0,0.0,4,10,3290,0,1988,0,98023,47.3052,-122.34,2600,12070,10,21,2014,UNK,690,-629
8929000140,6/23/2014,491234.0,4,2.5,1540,1860,2.0,0.0,0.0,3,8,1540,0,2014,0,98029,47.5521,-121.999,1210,1090,6,23,2014,N,330,770
9407600070,3/19/2015,290000.0,3,2.0,1310,6265,1.0,0.0,0.0,3,7,1310,0,1988,0,98038,47.3893,-122.051,1100,6360,3,19,2015,UNK,210,-95
2896000510,8/21/2014,490000.0,4,2.5,2120,7820,1.0,0.0,0.0,3,8,1280,840,1975,0,98052,47.6743,-122.145,2350,8605,8,21,2014,UNK,-230,-785
1938000140,4/28/2015,810000.0,4,2.0,2920,10424,1.0,0.0,0.0,5,8,1520,1400,1964,0,98005,47.5876,-122.17200000000001,2360,10696,4,28,2015,UNK,560,-272
4331000400,2/20/2015,252000.0,3,1.5,1150,13200,1.0,0.0,0.0,3,7,1150,0,1956,0,98166,47.4752,-122.345,1220,13066,2,20,2015,UNK,-70,134
4031700030,4/10/2015,299999.0,3,2.5,2380,9719,2.0,0.0,0.0,3,8,2380,0,2001,0,98001,47.2932,-122.28299999999999,2830,11505,4,10,2015,UNK,-450,-1786
1722800860,3/9/2015,400000.0,3,2.75,2220,5000,2.0,0.0,0.0,3,7,2220,0,1993,0,98108,47.5515,-122.324,960,5000,3,9,2015,UNK,1260,0
2491200955,12/29/2014,530000.0,5,2.0,3020,6000,1.5,0.0,0.0,5,7,1860,1160,1925,0,98126,47.5207,-122.37799999999999,1380,6000,12,29,2014,UNK,1640,0
2013802030,9/11/2014,357000.0,3,2.0,2460,53882,1.0,1.0,4.0,3,7,2460,0,1955,0,98198,47.3811,-122.325,2660,32625,9,11,2014,UNK,-200,21257
1923300135,3/10/2015,365000.0,3,1.75,1820,5555,1.0,0.0,0.0,4,7,1030,790,1939,0,98103,47.6867,-122.352,1420,4000,3,10,2015,UNK,400,1555
2391600335,2/3/2015,804000.0,4,2.5,2620,5060,2.0,0.0,0.0,3,9,2620,0,2005,0,98116,47.5634,-122.39399999999999,900,5060,2,3,2015,N,1720,0
2425039017,9/4/2014,808250.0,3,2.0,1750,2640,1.0,0.0,0.0,3,8,1010,740,1914,2005,98119,47.6419,-122.368,1750,4560,9,4,2014,Y,0,-1920
6752600320,5/14/2015,360000.0,4,2.5,2020,7289,2.0,0.0,0.0,3,7,2020,0,1994,0,98031,47.401,-122.171,2090,7259,5,14,2015,UNK,-70,30
193300140,10/23/2014,240000.0,3,1.75,1240,10956,1.0,0.0,0.0,3,6,1240,0,1987,0,98042,47.3705,-122.15,1240,8137,10,23,2014,UNK,0,2819
5651010320,7/22/2014,335000.0,2,2.0,1380,5840,1.0,0.0,0.0,3,7,1380,0,1988,0,98011,47.7732,-122.17200000000001,1810,5035,7,22,2014,UNK,-430,805
243000045,8/29/2014,380000.0,3,1.75,1920,8775,1.0,0.0,0.0,3,7,1920,0,1953,0,98166,47.4544,-122.351,1560,8100,8,29,2014,UNK,360,675
1558100398,5/15/2014,350000.0,3,1.75,1680,250470,1.0,0.0,0.0,4,7,1070,610,1940,0,98019,47.7624,-121.93,1680,360000,5,15,2014,UNK,0,-109530
4204400339,9/25/2014,194000.0,3,1.0,1400,7955,1.0,0.0,0.0,3,7,1400,0,1964,0,98055,47.4848,-122.221,1160,14959,9,25,2014,UNK,240,-7004
9567800140,3/25/2015,310000.0,3,1.0,1240,7194,1.0,0.0,0.0,3,6,1090,150,1936,0,98011,47.7636,-122.20200000000001,2090,8514,3,25,2015,UNK,-850,-1320
4046500140,2/9/2015,315000.0,3,1.75,1410,15134,1.0,0.0,0.0,3,7,1410,0,1980,0,98014,47.6931,-121.921,1770,15337,2,9,2015,UNK,-360,-203
2115510160,12/8/2014,258950.0,3,1.75,1440,8050,1.0,0.0,0.0,3,8,1440,0,1985,0,98023,47.3187,-122.39,1790,7488,12,8,2014,UNK,-350,562
9828702518,6/17/2014,479000.0,2,2.25,1230,932,2.0,0.0,0.0,3,8,1020,210,2004,0,98112,47.6192,-122.301,1230,1064,6,17,2014,N,0,-132
3888100117,11/10/2014,510000.0,5,1.5,1550,9750,1.0,0.0,0.0,4,7,1550,0,1966,0,98033,47.6811,-122.169,1970,9750,11,10,2014,UNK,-420,0
1775900140,7/9/2014,400000.0,3,2.0,1760,6875,1.0,0.0,0.0,4,8,1760,0,1967,0,98072,47.74,-122.09299999999999,1670,13650,7,9,2014,UNK,90,-6775
6645950070,4/1/2015,1450000.0,4,3.5,5000,38012,2.0,0.0,0.0,3,11,3610,1390,2004,0,98029,47.553999999999995,-122.036,3850,18054,4,1,2015,N,1150,19958
6840701160,10/29/2014,680000.0,5,2.0,2140,5000,1.5,0.0,0.0,4,7,2020,120,1913,0,98122,47.6044,-122.29899999999999,1810,4400,10,29,2014,UNK,330,600
1336800240,5/8/2014,1750000.0,6,3.0,3510,5760,2.5,0.0,0.0,4,10,3510,0,1906,0,98112,47.6263,-122.31200000000001,3450,5760,5,8,2014,UNK,60,0
3830200140,8/4/2014,335000.0,3,1.75,2010,9417,1.0,0.0,0.0,4,8,1500,510,1967,0,98030,47.37300000000001,-122.185,1200,8250,8,4,2014,UNK,810,1167
2473510260,6/23/2014,460000.0,5,2.5,3390,9760,1.0,0.0,0.0,5,8,1750,0,1978,0,98058,47.4462,-122.137,2360,9600,6,23,2014,UNK,1030,160
5056500260,5/2/2014,440000.0,4,2.25,2160,8119,1.0,0.0,0.0,3,8,1080,1080,1966,0,98006,47.5443,-122.177,1850,9000,5,2,2014,UNK,310,-881
8682280260,3/26/2015,412250.0,2,2.0,1300,2983,1.0,0.0,0.0,3,8,1300,0,2006,0,98053,47.703,-122.015,1510,3876,3,26,2015,N,-210,-893
7338000800,11/20/2014,185000.0,3,1.5,1280,4031,2.0,0.0,0.0,4,6,1280,0,1985,0,98002,47.3342,-122.215,1150,4500,11,20,2014,UNK,130,-469
3260701160,4/7/2015,286500.0,3,2.0,1840,8140,1.0,0.0,0.0,4,7,1040,800,1975,0,98003,47.3106,-122.325,1600,6720,4,7,2015,UNK,240,1420
3793500510,5/2/2015,422000.0,4,2.5,3200,6691,2.0,0.0,0.0,3,7,3200,0,2002,0,98038,47.367,-122.031,2610,6510,5,2,2015,UNK,590,181
9485950340,3/19/2015,408000.0,3,2.25,2800,35362,2.0,0.0,0.0,3,9,2800,0,1985,0,98042,47.3507,-122.089,2800,37058,3,19,2015,UNK,0,-1696
2011400662,10/27/2014,306500.0,2,1.0,1390,19988,1.0,0.0,2.0,4,7,1390,0,1949,0,98198,47.3985,-122.321,2580,10490,10,27,2014,UNK,-1190,9498
6699940320,4/13/2015,359900.0,4,2.5,2600,5188,2.0,0.0,0.0,3,8,2600,0,2005,0,98038,47.3451,-122.04,2610,5188,4,13,2015,N,-10,0
6134500070,7/9/2014,560000.0,3,2.5,1960,6058,2.0,0.0,0.0,3,8,1960,0,2002,0,98053,47.6319,-122.007,2480,6656,7,9,2014,UNK,-520,-598
8807810890,8/27/2014,259875.0,3,1.0,1250,21303,1.0,0.0,0.0,3,6,1250,0,1970,0,98053,47.6625,-122.059,1250,17920,8,27,2014,UNK,0,3383
8807810890,11/5/2014,385000.0,3,1.0,1250,21303,1.0,0.0,0.0,3,6,1250,0,1970,0,98053,47.6625,-122.059,1250,17920,11,5,2014,UNK,0,3383
6453300055,10/7/2014,188000.0,1,1.0,550,16345,1.0,0.0,0.0,3,4,550,0,1945,0,98106,47.5181,-122.339,1100,9240,10,7,2014,UNK,-550,7105
1118001820,6/15/2014,1140000.0,4,3.25,2500,5801,1.5,0.0,0.0,3,8,1960,540,1926,0,98112,47.632,-122.29,3670,7350,6,15,2014,UNK,-1170,-1549
8570900023,10/10/2014,255000.0,3,1.0,1250,10094,1.0,0.0,0.0,4,6,1250,0,1927,0,98045,47.4987,-121.781,1300,10094,10,10,2014,UNK,-50,0
629000510,7/30/2014,1190000.0,4,2.75,3020,8622,2.0,0.0,0.0,3,9,3020,0,1976,2003,98004,47.5866,-122.20100000000001,3060,14303,7,30,2014,Y,-40,-5681
2028701000,5/29/2014,635200.0,4,1.75,1640,4240,1.0,0.0,0.0,5,7,920,720,1921,0,98117,47.6766,-122.368,1300,4240,5,29,2014,UNK,340,0
7147400045,4/28/2015,355000.0,3,1.75,1870,8250,2.0,0.0,0.0,3,7,1870,0,1956,1979,98188,47.445,-122.285,1350,8714,4,28,2015,Y,520,-464
3180100023,1/30/2015,544000.0,3,2.5,1760,1755,3.5,0.0,0.0,3,8,1760,0,1998,0,98105,47.6688,-122.279,1700,1721,1,30,2015,UNK,60,34
1032000079,4/22/2015,402000.0,3,1.5,1320,3145,2.0,0.0,0.0,3,7,1320,0,1998,0,98144,47.5909,-122.29700000000001,1320,3002,4,22,2015,UNK,0,143
7010700860,12/26/2014,575000.0,4,1.5,1430,4163,1.5,0.0,0.0,3,7,1430,0,1910,0,98199,47.6606,-122.397,1500,4000,12,26,2014,UNK,-70,163
5547500070,7/24/2014,216000.0,3,1.75,1580,9705,1.0,0.0,0.0,4,7,1580,0,1977,0,98042,47.3819,-122.09,1580,9942,7,24,2014,UNK,0,-237
7237501040,6/17/2014,1200000.0,4,3.5,4170,9748,2.0,0.0,0.0,3,11,4170,0,2004,0,98059,47.528,-122.132,4560,10589,6,17,2014,N,-390,-841
7284900030,5/22/2014,850000.0,4,3.25,3090,6744,2.0,0.0,4.0,3,9,3090,0,1923,2015,98177,47.768,-122.38799999999999,2020,6656,5,22,2014,Y,1070,88
3277801646,5/16/2014,238000.0,3,2.0,1020,1204,2.0,0.0,0.0,3,7,720,300,2004,0,98126,47.5445,-122.376,1360,1506,5,16,2014,N,-340,-302
8722101370,4/13/2015,625000.0,4,1.75,2180,4431,1.5,0.0,0.0,3,8,2020,160,1912,0,98112,47.636,-122.302,1890,4400,4,13,2015,UNK,290,31
2436200200,7/1/2014,1110000.0,5,3.25,3350,4000,2.0,0.0,0.0,4,8,2510,840,1997,0,98105,47.6645,-122.291,1620,4000,7,1,2014,UNK,1730,0
2716600273,5/28/2014,820000.0,3,2.5,2510,5503,2.0,0.0,2.0,3,9,2510,0,1995,0,98136,47.5419,-122.383,1790,6099,5,28,2014,UNK,720,-596
1795700030,12/1/2014,355000.0,3,2.5,1880,5290,1.0,0.0,0.0,3,8,1250,630,1974,0,98108,47.5401,-122.3,2030,5092,12,1,2014,UNK,-150,198
9421500160,3/3/2015,495000.0,4,1.5,1810,7998,1.0,0.0,0.0,3,8,1210,600,1960,0,98125,47.726000000000006,-122.29700000000001,1830,7763,3,3,2015,UNK,-20,235
4139910030,3/2/2015,1300000.0,5,2.5,4170,33310,2.0,0.0,0.0,4,11,4170,0,1991,0,98006,47.5455,-122.126,4670,37960,3,2,2015,UNK,-500,-4650
3080000030,5/5/2014,398750.0,3,2.5,2230,4000,2.0,0.0,0.0,3,7,2230,0,1954,0,98144,47.5801,-122.306,1310,4000,5,5,2014,UNK,920,0
2568200070,7/16/2014,835000.0,4,2.5,3650,7784,2.0,0.0,0.0,3,9,3650,0,2006,0,98052,47.7066,-122.101,3150,6442,7,16,2014,N,500,1342
1546600565,10/2/2014,705000.0,6,2.75,2830,10579,1.0,0.0,0.0,4,8,1430,1400,1967,0,98005,47.636,-122.171,2060,10745,10,2,2014,UNK,770,-166
9187200045,5/4/2015,625000.0,4,1.5,2120,5000,2.0,0.0,0.0,4,8,2120,0,1900,0,98122,47.6024,-122.296,1830,5000,5,4,2015,UNK,290,0
8078450340,2/11/2015,550000.0,4,2.5,2090,6926,2.0,0.0,0.0,3,8,2090,0,1990,0,98074,47.6339,-122.022,2000,7151,2,11,2015,UNK,90,-225
9297301535,5/29/2014,540000.0,3,1.5,2600,5085,1.0,0.0,0.0,4,7,1400,1200,1940,0,98126,47.5659,-122.376,1320,4000,5,29,2014,UNK,1280,1085
6431000196,6/4/2014,519000.0,2,1.0,830,2820,1.0,0.0,0.0,4,7,830,0,1920,0,98103,47.68899999999999,-122.34700000000001,1460,3150,6,4,2014,UNK,-630,-330
9406520260,1/28/2015,311000.0,4,2.5,1975,8734,2.0,0.0,0.0,3,7,1975,0,1996,0,98038,47.363,-122.03399999999999,1975,8538,1,28,2015,UNK,0,196
9510900140,4/6/2015,305000.0,4,2.5,1900,7000,1.0,0.0,0.0,2,7,1420,480,1968,0,98023,47.3092,-122.376,1600,7600,4,6,2015,UNK,300,-600
7932600140,7/3/2014,395000.0,4,2.75,2640,35070,1.5,0.0,0.0,3,8,2640,0,1963,0,98058,47.4242,-122.181,2520,34986,7,3,2014,UNK,120,84
7864500140,11/7/2014,275000.0,4,1.5,1610,6923,1.0,0.0,0.0,3,6,1010,600,1969,0,98198,47.3747,-122.306,1320,7684,11,7,2014,UNK,290,-761
3629960550,8/7/2014,450000.0,3,3.25,1770,1863,2.0,0.0,0.0,3,8,1430,340,2003,0,98029,47.5478,-122.005,1410,1375,8,7,2014,UNK,360,488
2239000016,9/11/2014,324000.0,2,1.0,1070,6000,1.0,0.0,0.0,3,7,1070,0,1955,0,98133,47.7307,-122.33200000000001,1490,7622,9,11,2014,UNK,-420,-1622
1069000070,4/15/2015,2800000.0,5,3.25,4590,12793,2.0,0.0,2.0,5,11,3590,1000,1928,0,98199,47.6453,-122.41,2920,8609,4,15,2015,UNK,1670,4184
1972201550,7/16/2014,565000.0,4,1.0,1540,2452,1.5,0.0,0.0,4,7,1540,0,1906,0,98103,47.6522,-122.348,1290,3360,7,16,2014,UNK,250,-908
5469000140,7/7/2014,373000.0,4,1.75,1590,7920,2.0,0.0,0.0,4,7,1590,0,1960,0,98133,47.7456,-122.336,1720,7998,7,7,2014,UNK,-130,-78
7871500685,7/8/2014,613000.0,2,2.0,1170,1890,1.5,0.0,1.0,4,8,1170,0,1927,0,98119,47.6402,-122.37100000000001,2160,4000,7,8,2014,UNK,-990,-2110
7214820200,11/7/2014,614000.0,4,2.25,2880,9996,1.0,0.0,0.0,4,8,1920,960,1981,0,98072,47.7584,-122.14299999999999,2410,10584,11,7,2014,UNK,470,-588
6072300800,5/5/2015,595000.0,4,1.75,2510,8989,1.0,0.0,0.0,4,8,1680,830,1964,0,98006,47.5569,-122.17200000000001,2510,8931,5,5,2015,UNK,0,58
6817801040,8/21/2014,440000.0,2,1.0,1280,12086,1.0,0.0,0.0,3,7,850,430,1983,0,98074,47.63399999999999,-122.03299999999999,1280,10452,8,21,2014,UNK,0,1634
6117500160,3/17/2015,425000.0,3,1.5,1570,12412,1.0,0.0,3.0,3,8,1570,0,1954,0,98166,47.438,-122.34899999999999,2130,12412,3,17,2015,UNK,-560,0
5100401516,9/25/2014,407000.0,2,1.0,740,6380,1.0,0.0,0.0,3,6,740,0,1912,0,98115,47.6929,-122.318,1800,6380,9,25,2014,UNK,-1060,0
6751100125,8/25/2014,472000.0,3,1.5,1740,9038,1.0,0.0,0.0,4,7,1740,0,1955,0,98007,47.5897,-122.13600000000001,1390,9770,8,25,2014,UNK,350,-732
2771602420,6/17/2014,472000.0,3,2.5,1180,1262,3.0,0.0,0.0,3,8,1180,0,2010,0,98119,47.6381,-122.375,1180,2632,6,17,2014,N,0,-1370
3585900045,10/22/2014,1250000.0,5,2.75,2960,28300,1.0,0.0,3.0,4,9,2160,800,1959,0,98177,47.7606,-122.37,2940,23250,10,22,2014,UNK,20,5050
2492200055,7/8/2014,412000.0,3,1.75,1880,5752,1.0,0.0,0.0,4,7,940,940,1945,0,98126,47.5354,-122.37799999999999,1110,5201,7,8,2014,UNK,770,551
461004730,4/6/2015,717000.0,3,1.0,1150,5000,1.0,0.0,0.0,3,8,1150,0,1959,2015,98117,47.6805,-122.369,1160,5000,4,6,2015,Y,-10,0
4038000055,8/12/2014,425000.0,3,1.0,1320,7076,1.0,0.0,0.0,4,7,1320,0,1959,0,98008,47.6131,-122.12299999999999,1510,9000,8,12,2014,UNK,-190,-1924
4338800685,8/19/2014,299999.0,4,2.0,1640,7200,1.0,0.0,0.0,5,6,820,820,1944,0,98166,47.4791,-122.34700000000001,1640,8200,8,19,2014,UNK,0,-1000
2215901230,5/7/2015,254000.0,3,2.0,1470,7694,1.0,0.0,0.0,4,7,1470,0,1992,0,98038,47.3539,-122.054,1580,7480,5,7,2015,UNK,-110,214
2730000270,2/12/2015,178500.0,3,1.0,900,10511,1.0,0.0,0.0,4,6,900,0,1961,0,98001,47.2883,-122.272,1460,10643,2,12,2015,UNK,-560,-132
2397100560,11/21/2014,800000.0,3,1.75,1510,3600,1.0,0.0,0.0,5,8,1230,280,1910,0,98119,47.6387,-122.363,1300,3600,11,21,2014,UNK,210,0
5100403754,9/11/2014,420000.0,3,1.0,1440,5623,1.0,0.0,0.0,4,6,720,720,1922,0,98115,47.69600000000001,-122.319,1280,5623,9,11,2014,UNK,160,0
5634500891,3/12/2015,319900.0,2,1.0,1380,9251,1.0,0.0,0.0,3,7,1380,0,1940,0,98028,47.7486,-122.249,1870,12158,3,12,2015,UNK,-490,-2907
3834000004,3/2/2015,350000.0,2,1.5,1150,7552,1.0,0.0,1.0,3,7,1150,0,1944,0,98125,47.7298,-122.286,1910,8145,3,2,2015,UNK,-760,-593
5569700075,5/28/2014,968000.0,6,2.75,3610,17580,1.0,0.0,4.0,5,9,2070,1540,1959,0,98075,47.5739,-122.069,2890,14060,5,28,2014,UNK,720,3520
476000338,2/25/2015,491000.0,3,2.0,1250,1306,3.0,0.0,0.0,3,7,1250,0,2000,0,98107,47.6705,-122.39,1320,1306,2,25,2015,UNK,-70,0
3299610260,4/21/2015,948000.0,3,2.5,3510,9824,2.0,0.0,0.0,3,9,3510,0,2002,0,98075,47.5635,-122.03200000000001,3510,10588,4,21,2015,UNK,0,-764
4441300075,9/24/2014,900000.0,3,2.5,2260,9577,2.0,0.0,0.0,3,8,1700,560,1925,2004,98117,47.6928,-122.399,1740,10240,9,24,2014,Y,520,-663
1796200140,3/9/2015,270000.0,3,1.75,2840,9800,1.0,0.0,0.0,4,7,1420,1420,1977,0,98042,47.3516,-122.119,1650,9590,3,9,2015,UNK,1190,210
5029451230,6/17/2014,198000.0,3,1.5,1430,7347,1.0,0.0,0.0,3,7,820,610,1980,0,98023,47.2927,-122.369,1430,8723,6,17,2014,UNK,0,-1376
2523039282,11/21/2014,250000.0,2,1.0,1420,21158,1.0,0.0,0.0,3,7,1420,0,1953,0,98166,47.4594,-122.359,1220,8625,11,21,2014,UNK,200,12533
3629971290,7/30/2014,615000.0,4,2.5,2120,3720,2.0,0.0,0.0,3,8,2120,0,2004,0,98029,47.5526,-121.994,2170,3720,7,30,2014,N,-50,0
8078350520,9/16/2014,550000.0,3,2.5,2080,7749,2.0,0.0,0.0,3,8,2080,0,1988,0,98029,47.5723,-122.021,2210,7471,9,16,2014,UNK,-130,278
3395380200,10/17/2014,190000.0,2,2.5,1370,3438,2.0,0.0,0.0,3,7,1370,0,1987,0,98188,47.4606,-122.28299999999999,1370,2308,10,17,2014,UNK,0,1130
1687910200,10/7/2014,629000.0,4,2.25,1900,11171,1.0,0.0,0.0,3,8,1280,620,1984,0,98006,47.56100000000001,-122.126,2330,9934,10,7,2014,UNK,-430,1237
3818700016,10/7/2014,434000.0,3,1.75,1660,8301,1.0,0.0,0.0,5,7,1660,0,1955,0,98028,47.7647,-122.26299999999999,1660,9489,10,7,2014,UNK,0,-1188
9842300036,10/8/2014,415885.0,3,1.0,1310,4163,1.0,0.0,0.0,4,7,1310,0,1964,0,98126,47.5301,-122.381,1120,4166,10,8,2014,UNK,190,-3
4206901550,6/2/2014,550000.0,3,2.5,1840,3035,1.0,0.0,0.0,3,7,920,0,1926,0,98105,47.6557,-122.32700000000001,1780,4000,6,2,2014,UNK,60,-965
3878900681,1/21/2015,272000.0,1,0.75,1040,6034,1.0,0.0,1.0,3,7,580,460,1991,0,98178,47.5078,-122.251,1560,5650,1,21,2015,UNK,-520,384
2195700270,6/27/2014,665000.0,3,2.5,2610,35000,2.0,0.0,0.0,3,10,2610,0,1988,0,98072,47.7377,-122.101,3060,35427,6,27,2014,UNK,-450,-427
2824059128,10/9/2014,510000.0,3,2.0,1990,7405,1.0,0.0,0.0,5,7,1990,0,1971,0,98006,47.5421,-122.17200000000001,2120,6462,10,9,2014,UNK,-130,943
7635801370,9/4/2014,530000.0,3,2.0,3080,17700,1.0,0.0,0.0,4,8,1740,1340,1965,0,98166,47.4695,-122.366,2100,15100,9,4,2014,UNK,980,2600
1775910270,10/20/2014,355000.0,3,1.0,1200,16000,1.0,0.0,0.0,3,7,1200,0,1970,0,98072,47.7452,-122.101,1960,15500,10,20,2014,UNK,-760,500
5245400030,2/23/2015,255000.0,4,1.0,1250,9102,1.0,0.0,0.0,3,7,1250,0,1955,0,98148,47.4258,-122.32700000000001,1260,9180,2,23,2015,UNK,-10,-78
2600400030,7/24/2014,790000.0,4,2.75,2640,9000,2.0,0.0,0.0,3,10,2640,0,1990,0,98052,47.6481,-122.125,2980,9137,7,24,2014,UNK,-340,-137
3860900111,12/2/2014,695000.0,5,1.75,1790,9335,2.0,0.0,0.0,5,8,1790,0,1952,0,98004,47.5945,-122.20100000000001,1840,9612,12,2,2014,UNK,-50,-277
9558800030,11/7/2014,255000.0,2,2.0,1140,8400,1.0,0.0,0.0,2,7,1140,0,1954,0,98148,47.4351,-122.335,1130,9375,11,7,2014,UNK,10,-975
255000270,7/23/2014,410000.0,3,2.25,1790,5794,1.5,0.0,0.0,3,7,1380,410,1985,0,98072,47.7477,-122.171,2140,7769,7,23,2014,UNK,-350,-1975
3526039074,6/25/2014,650000.0,4,2.75,1910,16532,1.0,0.0,0.0,4,7,1420,490,1940,0,98117,47.6952,-122.39,2300,8250,6,25,2014,UNK,-390,8282
4083304355,3/18/2015,675000.0,4,1.75,1530,3615,1.5,0.0,0.0,4,7,1530,0,1913,0,98103,47.6529,-122.334,1650,4200,3,18,2015,UNK,-120,-585
6840701610,7/1/2014,332888.0,2,2.5,1050,1029,2.0,0.0,0.0,3,8,950,100,2007,0,98122,47.6018,-122.29899999999999,1350,3600,7,1,2014,N,-300,-2571
2212200270,2/20/2015,300000.0,3,1.75,1730,6900,1.0,0.0,0.0,4,7,1130,600,1976,0,98031,47.3915,-122.18799999999999,1950,7200,2,20,2015,UNK,-220,-300
2203500140,8/1/2014,320000.0,4,1.5,1100,11824,1.0,0.0,0.0,4,7,1100,0,1954,0,98006,47.5704,-122.141,1380,11796,8,1,2014,UNK,-280,28
9353301070,5/8/2015,342500.0,5,2.25,2100,10726,1.0,0.0,0.0,4,7,1050,1050,1963,0,98059,47.4922,-122.134,2100,10726,5,8,2015,UNK,0,0
1326059185,3/20/2015,752875.0,4,2.5,2800,72309,2.0,0.0,0.0,3,9,2800,0,1992,0,98072,47.7432,-122.11200000000001,2280,36420,3,20,2015,UNK,520,35889
46100350,6/30/2014,1730000.0,5,3.5,5000,26540,2.0,0.0,3.0,3,10,3410,1590,2008,0,98040,47.5665,-122.21,3360,17398,6,30,2014,N,1640,9142
7987400316,8/14/2014,255000.0,1,0.5,880,1642,1.0,0.0,0.0,3,6,500,380,1910,0,98126,47.5732,-122.37200000000001,1410,2992,8,14,2014,UNK,-530,-1350
3971702325,11/3/2014,244000.0,3,2.5,1470,9337,2.0,0.0,0.0,3,7,1470,0,1991,0,98155,47.7651,-122.323,1360,8684,11,3,2014,UNK,110,653
7419500200,4/1/2015,1420000.0,5,3.25,3950,11438,2.0,0.0,2.0,3,10,3430,520,2006,0,98033,47.6898,-122.189,2070,10751,4,1,2015,N,1880,687
923049468,11/10/2014,218000.0,3,1.0,980,12812,1.0,0.0,0.0,3,7,980,0,1956,0,98168,47.4892,-122.306,1430,8986,11,10,2014,UNK,-450,3826
5589300435,12/3/2014,359000.0,4,1.0,2180,10617,1.5,0.0,0.0,3,7,2180,0,1950,0,98155,47.7522,-122.307,1360,9519,12,3,2014,UNK,820,1098
3303990030,10/27/2014,840000.0,4,2.75,3040,13559,2.0,0.0,0.0,3,11,3040,0,2003,0,98059,47.522,-122.149,3830,12202,10,27,2014,UNK,-790,1357
2926069083,5/7/2014,900000.0,5,3.75,4130,226076,2.0,0.0,0.0,3,9,3170,960,1985,0,98077,47.715,-122.065,4130,55321,5,7,2014,UNK,0,170755
3622059157,10/9/2014,205000.0,4,1.75,1850,65340,1.5,0.0,0.0,4,7,1850,0,1972,0,98042,47.3468,-122.11,1750,40946,10,9,2014,UNK,100,24394
5466350160,1/21/2015,205000.0,3,2.5,1600,7295,2.0,0.0,0.0,2,7,1600,0,1993,0,98042,47.3904,-122.165,1410,9000,1,21,2015,UNK,190,-1705
4174600262,4/8/2015,500000.0,2,1.5,2070,5432,2.0,0.0,0.0,3,7,1370,700,1951,0,98108,47.5571,-122.29899999999999,2070,5505,4,8,2015,UNK,0,-73
9477940390,1/9/2015,510000.0,4,2.5,3180,5405,2.0,0.0,0.0,3,7,3180,0,2001,0,98059,47.4905,-122.14,2610,5403,1,9,2015,UNK,570,2
1126069045,6/20/2014,1140000.0,6,4.25,6900,244716,2.0,0.0,0.0,4,9,4820,2080,2002,0,98077,47.7506,-122.012,4170,266587,6,20,2014,UNK,2730,-21871
6096500105,4/30/2015,1550000.0,4,2.25,2640,3000,2.0,0.0,0.0,3,7,2080,560,1908,0,98109,47.6313,-122.344,1910,3000,4,30,2015,UNK,730,0
2923069037,7/21/2014,210000.0,3,1.5,1920,61014,1.0,0.0,0.0,3,6,1920,0,1953,0,98038,47.4446,-122.074,1616,61014,7,21,2014,UNK,304,0
5649300160,12/9/2014,597500.0,3,1.75,2030,32565,1.0,0.0,0.0,3,8,1600,430,1981,0,98052,47.7112,-122.098,2910,34190,12,9,2014,UNK,-880,-1625
3121059036,10/29/2014,400000.0,2,1.0,1140,101529,1.5,0.0,0.0,3,6,1140,0,1932,0,98092,47.2592,-122.228,1580,101529,10,29,2014,UNK,-440,0
6136900045,8/21/2014,412000.0,3,1.0,1660,6992,1.0,0.0,0.0,5,7,1260,400,1952,0,98155,47.7576,-122.318,1390,7359,8,21,2014,UNK,270,-367
2426039247,3/25/2015,299950.0,2,1.5,1390,1756,3.0,0.0,0.0,3,7,1390,0,2005,0,98133,47.7274,-122.35700000000001,1340,1756,3,25,2015,N,50,0
8818400340,4/23/2015,1080000.0,4,3.0,2490,4325,1.5,0.0,0.0,3,8,1690,800,1922,2003,98105,47.6628,-122.32600000000001,1960,4284,4,23,2015,Y,530,41
7429000240,11/18/2014,422500.0,4,2.5,2550,8824,2.0,0.0,0.0,3,9,2550,0,1990,0,98031,47.3979,-122.212,2630,11237,11,18,2014,UNK,-80,-2413
3888100030,7/14/2014,410000.0,3,2.0,1270,10227,1.0,0.0,0.0,4,6,1270,0,1968,0,98033,47.6876,-122.16799999999999,1470,9750,7,14,2014,UNK,-200,477
5699000070,5/28/2014,1400000.0,4,3.25,2980,7000,2.0,0.0,3.0,3,10,2140,840,1900,2014,98144,47.5933,-122.292,2200,4800,5,28,2014,Y,780,2200
8731982470,7/15/2014,245000.0,3,2.0,1470,8000,1.0,0.0,0.0,4,8,1470,0,1974,0,98023,47.3191,-122.385,1980,8000,7,15,2014,UNK,-510,0
6899990200,7/2/2014,720000.0,4,3.0,3550,12327,1.5,0.0,0.0,4,10,2180,1370,1990,0,98011,47.7533,-122.205,3170,12937,7,2,2014,UNK,380,-610
4154300505,10/24/2014,315000.0,2,1.0,780,7200,1.0,0.0,0.0,2,6,780,0,1935,0,98118,47.5609,-122.279,1750,7200,10,24,2014,UNK,-970,0
9268710140,2/24/2015,191950.0,2,2.5,1390,1302,2.0,0.0,0.0,3,7,1390,0,1987,0,98003,47.3081,-122.329,1390,2052,2,24,2015,UNK,0,-750
9290860140,9/23/2014,455000.0,4,2.5,2440,5001,2.0,0.0,0.0,3,8,2440,0,2005,0,98056,47.5108,-122.193,2260,5001,9,23,2014,N,180,0
5708500270,5/16/2014,523000.0,3,1.5,1260,3135,1.5,0.0,0.0,3,8,1260,0,1931,0,98116,47.5755,-122.38799999999999,1700,4180,5,16,2014,UNK,-440,-1045
16000200,10/24/2014,250000.0,3,2.25,1640,4420,2.0,0.0,0.0,4,7,1640,0,1918,0,98002,47.31100000000001,-122.21,1230,6632,10,24,2014,UNK,410,-2212
1352300520,1/13/2015,294000.0,3,3.0,1670,4120,1.5,0.0,0.0,3,7,1140,530,1929,2012,98055,47.4881,-122.199,1010,4120,1,13,2015,Y,660,0
5207200160,10/10/2014,490000.0,3,2.25,2380,6000,1.0,0.0,0.0,3,8,2040,340,1961,0,98115,47.6955,-122.275,1680,7200,10,10,2014,UNK,700,-1200
9284800844,9/16/2014,310000.0,4,1.0,1030,5750,1.0,0.0,0.0,3,7,1030,0,1971,0,98126,47.553000000000004,-122.37,1250,5750,9,16,2014,UNK,-220,0
5602000105,7/21/2014,265000.0,3,1.5,1560,10489,1.0,0.0,0.0,5,7,1560,0,1961,0,98022,47.2048,-121.999,1400,10489,7,21,2014,UNK,160,0
3585220340,8/11/2014,402000.0,4,1.75,1640,10500,1.0,0.0,0.0,4,7,1010,630,1968,0,98052,47.6933,-122.116,1680,7650,8,11,2014,UNK,-40,2850
220069083,5/9/2014,705000.0,2,2.5,2200,188200,1.0,0.0,3.0,3,8,2200,0,2007,0,98022,47.2458,-122.00200000000001,2700,84942,5,9,2014,N,-500,103258
5104531290,11/24/2014,589450.0,4,2.5,3190,7941,2.0,0.0,0.0,3,10,3190,0,2005,0,98038,47.353,-122.00200000000001,3190,7255,11,24,2014,N,0,686
8125200273,12/23/2014,219950.0,3,1.5,1200,8404,1.0,0.0,0.0,3,7,1200,0,1964,0,98188,47.4482,-122.26899999999999,2120,12000,12,23,2014,UNK,-920,-3596
3176600105,8/13/2014,750000.0,3,2.25,2250,5301,2.0,0.0,0.0,4,8,1510,740,1975,0,98115,47.6741,-122.271,2240,7200,8,13,2014,UNK,10,-1899
6821101275,8/21/2014,478000.0,2,1.75,1960,6000,1.0,0.0,0.0,4,7,980,980,1904,0,98199,47.6531,-122.40100000000001,1650,6000,8,21,2014,UNK,310,0
5379802090,7/14/2014,170000.0,3,1.0,1250,7015,1.0,0.0,0.0,3,7,1250,0,1958,0,98188,47.4548,-122.29,1510,11460,7,14,2014,UNK,-260,-4445
3211240320,6/12/2014,489950.0,4,2.25,2640,31941,1.0,0.0,0.0,4,9,2640,0,1986,0,98092,47.3099,-122.116,2780,35365,6,12,2014,UNK,-140,-3424
486000520,6/6/2014,1370000.0,2,2.25,2460,16940,1.5,0.0,4.0,4,9,1930,530,1936,0,98117,47.6792,-122.404,2260,6851,6,6,2014,UNK,200,10089
705710640,3/2/2015,319950.0,3,2.5,1700,7000,2.0,0.0,0.0,3,7,1700,0,1996,0,98038,47.3798,-122.025,1950,7000,3,2,2015,UNK,-250,0
2185000685,11/24/2014,208417.0,2,1.0,840,4200,1.0,0.0,0.0,3,5,840,0,1938,0,98108,47.5292,-122.316,830,5000,11,24,2014,UNK,10,-800
7518502030,11/17/2014,410000.0,4,2.0,1900,5100,1.0,0.0,0.0,3,6,950,950,1914,1973,98117,47.6767,-122.38,1230,5100,11,17,2014,Y,670,0
4078300024,7/25/2014,590000.0,4,2.75,2160,4205,1.0,0.0,3.0,3,7,1080,1080,1969,0,98125,47.7081,-122.27600000000001,2450,6014,7,25,2014,UNK,-290,-1809
6071400710,4/29/2015,648000.0,3,1.75,1610,10229,1.0,0.0,0.0,5,8,1610,0,1961,0,98006,47.553000000000004,-122.17399999999999,2270,8800,4,29,2015,UNK,-660,1429
4136950200,6/27/2014,255000.0,3,2.5,1720,6194,2.0,0.0,0.0,3,8,1720,0,1998,0,98092,47.2624,-122.221,1720,6211,6,27,2014,UNK,0,-17
9527300200,8/25/2014,465000.0,4,2.75,2190,3267,2.0,0.0,0.0,3,8,2190,0,2004,0,98072,47.7751,-122.16799999999999,2190,3619,8,25,2014,N,0,-352
6071000310,1/28/2015,622000.0,4,1.75,3020,10714,1.0,0.0,0.0,5,8,1510,1510,1958,0,98006,47.56,-122.181,2230,14400,1,28,2015,UNK,790,-3686
9183702220,9/15/2014,306000.0,3,1.75,1980,9800,1.0,0.0,0.0,3,7,1980,0,1991,0,98030,47.3745,-122.22399999999999,1630,7650,9,15,2014,UNK,350,2150
369000045,10/10/2014,617000.0,3,2.5,1880,5500,2.0,0.0,0.0,4,7,1880,0,1947,2007,98199,47.657,-122.39299999999999,1230,5500,10,10,2014,Y,650,0
2826049117,5/28/2014,438750.0,3,1.75,1610,6480,1.0,0.0,0.0,4,7,1610,0,1947,0,98125,47.7137,-122.307,1230,8040,5,28,2014,UNK,380,-1560
811000055,9/25/2014,1280000.0,4,3.0,3260,4500,2.0,0.0,0.0,3,9,2300,960,1930,2014,98109,47.6314,-122.353,2410,4995,9,25,2014,Y,850,-495
7154200070,11/24/2014,995000.0,5,3.25,3970,8029,2.0,0.0,2.0,3,9,2970,1000,1979,0,98177,47.7764,-122.385,2520,8214,11,24,2014,UNK,1450,-185
2303900045,6/23/2014,1580000.0,4,2.5,4570,74487,2.0,0.0,4.0,5,12,4570,0,1948,1985,98177,47.7282,-122.37200000000001,3810,74487,6,23,2014,Y,760,0
1254200045,4/22/2015,635000.0,5,2.75,2620,5500,1.5,0.0,0.0,3,7,1710,910,1911,0,98117,47.6806,-122.38799999999999,1790,5500,4,22,2015,UNK,830,0
8731730710,7/28/2014,215000.0,3,1.0,1180,9000,1.0,0.0,0.0,4,7,1180,0,1970,0,98031,47.39,-122.166,1290,8316,7,28,2014,UNK,-110,684
9528104109,10/27/2014,530000.0,3,2.5,1365,1090,3.0,0.0,0.0,3,7,1315,50,2003,0,98115,47.6776,-122.324,1360,1124,10,27,2014,UNK,5,-34
3298700012,3/20/2015,295000.0,2,1.0,720,4125,1.0,0.0,0.0,4,6,720,0,1943,0,98106,47.5245,-122.354,1000,6100,3,20,2015,UNK,-280,-1975
7967700570,3/2/2015,245000.0,3,2.25,1350,6775,1.0,0.0,0.0,3,7,930,420,1981,0,98032,47.3593,-122.289,1460,7210,3,2,2015,UNK,-110,-435
1402200140,1/5/2015,400000.0,6,2.5,3060,17112,1.0,0.0,0.0,4,8,1530,0,1967,0,98058,47.4379,-122.146,2690,16038,1,5,2015,UNK,370,1074
3797300140,7/21/2014,303000.0,3,2.75,1850,8820,2.0,0.0,0.0,4,8,1850,0,1993,0,98022,47.1928,-122.01,1850,8651,7,21,2014,UNK,0,169
2481200140,10/15/2014,330000.0,3,1.75,1320,9675,1.5,0.0,0.0,4,7,1320,0,1970,0,98024,47.5695,-121.902,1160,9675,10,15,2014,UNK,160,0
3582900310,3/4/2015,700000.0,3,1.75,1990,13000,2.0,0.0,3.0,3,9,1990,0,1980,0,98028,47.7439,-122.262,2880,11340,3,4,2015,UNK,-890,1660
1352300990,8/26/2014,126000.0,1,1.0,610,4400,1.0,0.0,0.0,3,5,610,0,1922,0,98055,47.4865,-122.197,1090,4930,8,26,2014,UNK,-480,-530
1525059074,7/23/2014,850000.0,4,1.0,2500,35802,1.5,0.0,0.0,3,7,2500,0,1955,0,98005,47.6488,-122.15299999999999,2880,40510,7,23,2014,UNK,-380,-4708
3876000710,12/18/2014,405000.0,3,2.0,1440,7425,1.0,0.0,0.0,4,7,1440,0,1965,0,98034,47.7243,-122.185,1800,8344,12,18,2014,UNK,-360,-919
1994200260,8/19/2014,869900.0,6,4.5,2750,4400,2.0,0.0,0.0,3,8,1770,980,1987,0,98103,47.6883,-122.335,1860,4400,8,19,2014,UNK,890,0
1121000058,3/31/2015,485000.0,3,1.75,1790,6775,1.0,0.0,2.0,3,8,1790,0,1951,0,98126,47.5412,-122.37700000000001,1310,6028,3,31,2015,UNK,480,747
1407300012,1/28/2015,400000.0,2,2.0,1050,1173,2.0,0.0,0.0,3,8,720,330,2004,0,98122,47.6181,-122.302,1340,1317,1,28,2015,N,-290,-144
1565930070,9/11/2014,299950.0,3,2.5,1780,4650,2.0,0.0,0.0,3,7,1780,0,2011,0,98038,47.386,-122.04700000000001,3050,3848,9,11,2014,N,-1270,802
3574900030,3/27/2015,585000.0,4,2.5,2200,9099,2.0,0.0,0.0,3,8,2200,0,1994,0,98034,47.733000000000004,-122.225,2270,8900,3,27,2015,UNK,-70,199
5100401441,5/6/2015,495000.0,4,2.0,1720,5413,2.0,0.0,0.0,3,7,1470,250,1938,1980,98115,47.6929,-122.321,1510,5413,5,6,2015,Y,210,0
3629940160,3/11/2015,2200000.0,5,4.5,5840,17168,2.0,0.0,0.0,3,12,4570,1270,2006,0,98029,47.5457,-121.991,4850,15017,3,11,2015,N,990,2151
7715800390,11/10/2014,447000.0,3,2.25,1520,14080,2.0,0.0,0.0,3,7,1520,0,1984,0,98074,47.6273,-122.059,1530,9758,11,10,2014,UNK,-10,4322
1682000160,4/17/2015,206000.0,3,1.0,1320,9239,1.0,0.0,0.0,4,7,1320,0,1968,0,98092,47.312,-122.18299999999999,1320,8415,4,17,2015,UNK,0,824
952007055,10/21/2014,500000.0,3,1.0,1070,4600,1.0,0.0,0.0,3,7,950,120,1930,0,98116,47.5627,-122.383,1090,4600,10,21,2014,UNK,-20,0
3790700070,11/21/2014,302500.0,4,2.5,1990,5511,2.0,0.0,0.0,3,8,1990,0,1994,0,98030,47.3585,-122.191,1850,6031,11,21,2014,UNK,140,-520
3134100023,11/25/2014,1250000.0,4,4.25,4980,13000,2.0,0.0,3.0,3,9,3080,1900,1982,0,98052,47.6406,-122.101,2840,11308,11,25,2014,UNK,2140,1692
1862400292,7/23/2014,391000.0,2,1.0,890,5423,1.0,0.0,0.0,3,6,890,0,1946,0,98117,47.6966,-122.368,1690,5993,7,23,2014,UNK,-800,-570
4123800270,7/10/2014,250000.0,3,2.0,1440,5457,2.0,0.0,0.0,3,7,1440,0,1986,0,98038,47.3784,-122.046,1480,6286,7,10,2014,UNK,-40,-829
3448700070,7/23/2014,435000.0,4,2.5,2440,5350,2.0,0.0,0.0,3,7,2440,0,2003,0,98059,47.4891,-122.149,2440,5090,7,23,2014,UNK,0,260
9133600135,2/11/2015,160000.0,4,2.25,1800,14722,1.0,0.0,0.0,3,7,1440,360,1962,0,98055,47.4874,-122.223,2400,10000,2,11,2015,UNK,-600,4722
6163901913,7/22/2014,451000.0,5,3.0,2260,6508,1.0,0.0,0.0,3,7,1330,930,2003,0,98155,47.7508,-122.322,1940,9450,7,22,2014,UNK,320,-2942
1446403305,5/5/2014,206000.0,2,1.0,810,7158,1.0,0.0,0.0,5,6,810,0,1944,0,98168,47.4882,-122.325,1090,7158,5,5,2014,UNK,-280,0
59000445,9/23/2014,590000.0,4,2.75,2240,5400,2.0,0.0,0.0,4,7,1540,700,1940,0,98116,47.5785,-122.402,1830,5000,9,23,2014,UNK,410,400
7510700030,5/15/2014,695000.0,3,2.5,4560,17622,2.0,0.0,0.0,4,9,3800,0,1986,0,98074,47.621,-122.03,2360,15000,5,15,2014,UNK,2200,2622
1722059222,11/20/2014,350000.0,3,1.5,1550,40752,1.0,0.0,0.0,5,7,1550,0,1954,0,98031,47.394,-122.20200000000001,1550,8000,11,20,2014,UNK,0,32752
8127700132,3/26/2015,1240000.0,5,3.5,3180,4628,2.0,0.0,0.0,3,10,2420,760,2001,0,98199,47.6423,-122.39399999999999,2060,4640,3,26,2015,UNK,1120,-12
1774000030,3/30/2015,395000.0,6,2.25,2950,11200,1.0,0.0,0.0,4,7,1700,1250,1970,0,98072,47.7476,-122.087,1790,11200,3,30,2015,UNK,1160,0
4058800135,4/5/2015,419000.0,5,3.0,2190,9652,2.0,0.0,0.0,3,7,2190,0,1999,0,98178,47.5049,-122.23899999999999,1440,6710,4,5,2015,UNK,750,2942
8682281600,7/8/2014,592350.0,2,2.0,1570,4665,1.0,0.0,0.0,3,8,1570,0,2006,0,98053,47.708999999999996,-122.01700000000001,2165,6262,7,8,2014,N,-595,-1597
8562740520,8/6/2014,855000.0,5,3.25,3420,5669,2.0,0.0,0.0,3,9,2620,800,2003,0,98027,47.5366,-122.06700000000001,3310,6006,8,6,2014,UNK,110,-337
3982700125,12/30/2014,771000.0,4,2.5,2420,7200,2.0,0.0,0.0,3,9,2420,0,1991,0,98033,47.6893,-122.197,2650,7800,12,30,2014,UNK,-230,-600
1120069036,12/18/2014,325000.0,3,2.25,1570,43350,1.0,0.0,3.0,4,7,1570,0,1967,0,98022,47.2377,-122.016,1570,220849,12,18,2014,UNK,0,-177499
3592500800,10/18/2014,1850000.0,5,3.25,3680,6060,2.0,0.0,0.0,5,9,2630,1050,1925,0,98112,47.6341,-122.304,3050,5850,10,18,2014,UNK,630,210
7905200310,7/29/2014,545000.0,4,1.75,1910,6731,1.0,0.0,0.0,4,7,1210,700,1953,0,98116,47.5693,-122.391,1780,6350,7,29,2014,UNK,130,381
7577700136,2/26/2015,615000.0,3,1.75,1780,5175,1.0,0.0,0.0,4,7,990,790,1927,0,98116,47.5696,-122.38600000000001,1780,5175,2,26,2015,UNK,0,0
2629600016,4/10/2015,625500.0,2,1.0,2160,7439,1.0,0.0,0.0,4,6,1300,860,1953,0,98115,47.6981,-122.286,1680,7439,4,10,2015,UNK,480,0
9262800002,7/8/2014,232000.0,3,1.5,1460,15000,1.0,0.0,0.0,3,7,1460,0,1966,0,98001,47.3182,-122.271,1510,15000,7,8,2014,UNK,-50,0
2892700041,7/14/2014,168000.0,3,1.5,1370,7439,1.0,0.0,0.0,4,6,1370,0,1963,0,98055,47.4499,-122.189,2350,3370,7,14,2014,UNK,-980,4069
2892700041,1/28/2015,238000.0,3,1.5,1370,7439,1.0,0.0,0.0,4,6,1370,0,1963,0,98055,47.4499,-122.189,2350,3370,1,28,2015,UNK,-980,4069
4136950070,4/14/2015,260000.0,3,2.5,1500,7401,2.0,0.0,0.0,3,8,1500,0,1998,0,98092,47.2625,-122.221,1720,7171,4,14,2015,UNK,-220,230
2354300550,3/2/2015,460000.0,3,1.75,1210,7500,1.0,0.0,0.0,3,7,1210,0,1951,0,98027,47.5294,-122.03299999999999,1250,6000,3,2,2015,UNK,-40,1500
7740100260,8/25/2014,900000.0,3,2.5,2850,11535,1.0,0.0,1.0,3,8,1680,1170,1952,2008,98155,47.74800000000001,-122.288,2670,9942,8,25,2014,Y,180,1593
6163901352,10/21/2014,289950.0,3,1.0,1090,8280,1.0,0.0,0.0,3,6,1090,0,1947,2006,98155,47.7562,-122.318,1060,7609,10,21,2014,Y,30,671
2025700200,2/20/2015,265000.0,3,1.75,1450,5858,1.0,0.0,0.0,4,7,1450,0,1991,0,98038,47.3482,-122.037,1520,6573,2,20,2015,UNK,-70,-715
1775801090,5/30/2014,465000.0,4,2.25,1820,20349,1.0,0.0,0.0,5,8,1340,480,1977,0,98072,47.7415,-122.096,1270,12800,5,30,2014,UNK,550,7549
1138000070,11/13/2014,370000.0,3,1.5,1320,7201,1.0,0.0,0.0,3,7,1320,0,1971,0,98034,47.7126,-122.211,1380,7201,11,13,2014,UNK,-60,0
1823049046,8/6/2014,240000.0,2,1.5,1670,9880,1.0,0.0,0.0,4,7,1670,0,1941,1963,98146,47.4864,-122.348,1670,9807,8,6,2014,Y,0,73
7227801580,9/17/2014,232000.0,4,2.0,1440,5911,1.0,0.0,0.0,5,5,1440,0,1943,0,98056,47.5072,-122.181,1500,11089,9,17,2014,UNK,-60,-5178
4364700875,7/29/2014,237502.0,3,1.0,980,7560,1.0,0.0,0.0,3,7,980,0,1951,0,98126,47.5256,-122.375,1300,7560,7,29,2014,UNK,-320,0
8127700390,12/15/2014,1280000.0,4,3.5,4340,5500,2.0,0.0,0.0,3,10,2850,1490,2008,0,98199,47.6427,-122.397,1290,5500,12,15,2014,N,3050,0
9560500105,4/24/2015,957000.0,4,2.25,2860,11545,1.0,0.0,0.0,4,8,1430,1430,1966,0,98005,47.588,-122.16799999999999,2190,11396,4,24,2015,UNK,670,149
8651411420,3/5/2015,218000.0,3,1.5,1140,4875,1.0,0.0,0.0,5,6,1140,0,1970,0,98042,47.3684,-122.08,980,5070,3,5,2015,UNK,160,-195
1274500240,8/20/2014,205000.0,3,1.5,1120,8366,1.0,0.0,0.0,3,7,1120,0,1968,0,98042,47.3632,-122.11,1260,9000,8,20,2014,UNK,-140,-634
3278602190,6/11/2014,350000.0,3,3.25,1460,1592,2.0,0.0,0.0,3,8,1130,330,2006,0,98126,47.5481,-122.374,1560,1701,6,11,2014,N,-100,-109
873900240,7/2/2014,256000.0,4,2.5,2050,5787,2.0,0.0,0.0,3,7,2050,0,2002,0,98198,47.3527,-122.315,2030,6615,7,2,2014,UNK,20,-828
3834000520,7/30/2014,275000.0,3,1.0,1250,7654,1.0,0.0,0.0,3,7,1000,250,1952,0,98125,47.7289,-122.291,1310,7350,7,30,2014,UNK,-60,304
4224100030,4/3/2015,372000.0,4,2.5,2520,9604,2.0,0.0,0.0,3,9,2520,0,1990,0,98031,47.3893,-122.21600000000001,2540,9793,4,3,2015,UNK,-20,-189
5710500060,3/19/2015,688888.0,3,3.25,2580,9825,1.5,0.0,1.0,4,9,1760,820,1978,0,98027,47.5314,-122.054,2140,10270,3,19,2015,UNK,440,-445
203101370,6/30/2014,170000.0,2,1.0,1200,24792,2.0,0.0,0.0,2,7,1200,0,1976,0,98053,47.6337,-121.961,2150,24792,6,30,2014,UNK,-950,0
4039300140,6/25/2014,530000.0,5,2.25,2140,7910,1.0,0.0,0.0,3,7,1070,1070,1962,0,98007,47.6071,-122.137,1680,8700,6,25,2014,UNK,460,-790
3629920990,6/23/2014,905000.0,4,3.25,3440,7661,2.0,0.0,0.0,3,11,3440,0,2006,0,98029,47.5429,-121.995,3580,6478,6,23,2014,N,-140,1183
6882510060,8/25/2014,365000.0,4,2.5,1800,5070,1.0,0.0,0.0,5,7,1080,720,1979,0,98118,47.5303,-122.28,1870,5365,8,25,2014,UNK,-70,-295
2597150270,4/6/2015,312000.0,4,2.5,1790,10584,1.0,0.0,0.0,4,7,1290,500,1981,0,98031,47.4061,-122.18799999999999,1730,9120,4,6,2015,UNK,60,1464
4365200445,8/22/2014,400000.0,2,1.75,1250,7680,1.0,0.0,0.0,3,7,1250,0,1922,1968,98126,47.5242,-122.37100000000001,1250,7680,8,22,2014,Y,0,0
6145601819,9/12/2014,278750.0,2,2.0,800,5765,1.0,0.0,0.0,4,6,800,0,1936,0,98133,47.7024,-122.346,1160,3844,9,12,2014,UNK,-360,1921
3447000030,4/1/2015,510000.0,3,2.0,1410,11995,1.0,0.0,0.0,4,8,1410,0,1965,0,98006,47.5718,-122.12700000000001,2690,12650,4,1,2015,UNK,-1280,-655
4442800162,4/14/2015,527700.0,2,2.25,1330,806,3.0,0.0,0.0,3,8,1330,0,2009,0,98117,47.6904,-122.395,1320,1389,4,14,2015,N,10,-583
1698900075,4/15/2015,740000.0,4,2.75,2890,4000,1.5,0.0,0.0,4,9,2190,700,1931,0,98109,47.6419,-122.351,2280,4000,4,15,2015,UNK,610,0
9432750070,8/8/2014,512000.0,4,2.5,2550,17209,2.0,0.0,0.0,3,9,2550,0,1996,0,98059,47.4836,-122.13600000000001,2840,12560,8,8,2014,UNK,-290,4649
3204850140,11/12/2014,362000.0,5,2.5,2880,8216,2.0,0.0,0.0,3,8,2880,0,2001,0,98030,47.3747,-122.185,1960,7200,11,12,2014,UNK,920,1016
1446401550,2/6/2015,225000.0,3,1.0,660,6600,1.0,0.0,0.0,4,5,660,0,1940,0,98168,47.4842,-122.33,1320,6600,2,6,2015,UNK,-660,0
3904901840,6/30/2014,491500.0,3,2.25,1470,4322,2.0,0.0,0.0,3,7,1470,0,1985,0,98029,47.5672,-122.01799999999999,1610,4322,6,30,2014,UNK,-140,0
3299200075,2/4/2015,429950.0,4,1.75,1700,10230,1.0,0.0,0.0,3,8,1320,380,1959,0,98133,47.7453,-122.351,2000,8006,2,4,2015,UNK,-300,2224
2206500550,11/17/2014,375000.0,3,1.0,1040,9800,1.0,0.0,0.0,4,7,1040,0,1955,0,98006,47.5765,-122.155,1280,8880,11,17,2014,UNK,-240,920
2112700370,8/13/2014,199400.0,2,1.0,880,4000,1.0,0.0,0.0,4,6,880,0,1916,0,98106,47.5331,-122.352,1430,4000,8,13,2014,UNK,-550,0
4397010350,1/26/2015,364900.0,4,2.5,2490,9346,2.0,0.0,2.0,3,9,2490,0,1996,0,98042,47.3831,-122.147,2650,9454,1,26,2015,UNK,-160,-108
4364700885,9/12/2014,324950.0,3,1.5,1210,7560,1.0,0.0,0.0,3,7,1210,0,1941,0,98126,47.5255,-122.374,980,7560,9,12,2014,UNK,230,0
1498301672,3/30/2015,467000.0,5,2.0,2080,4000,1.0,0.0,0.0,4,6,1040,1040,1909,0,98144,47.5858,-122.30799999999999,1940,6000,3,30,2015,UNK,140,-2000
3992700326,8/22/2014,380000.0,3,1.0,1380,5400,1.0,0.0,0.0,4,7,1380,0,1954,0,98125,47.7134,-122.288,1190,6075,8,22,2014,UNK,190,-675
5438000060,11/3/2014,250000.0,3,2.25,1620,10850,1.0,0.0,0.0,3,7,1620,0,1966,0,98055,47.4437,-122.194,1910,10568,11,3,2014,UNK,-290,282
9550200370,5/20/2014,700000.0,4,1.0,1680,4021,1.5,0.0,0.0,3,7,1680,0,1921,0,98103,47.6663,-122.33200000000001,1710,4021,5,20,2014,UNK,-30,0
3977630270,11/13/2014,206990.0,3,1.0,1330,9620,1.0,0.0,0.0,5,6,1330,0,1976,0,98092,47.3174,-122.12700000000001,1300,10360,11,13,2014,UNK,30,-740
475001000,4/6/2015,670000.0,3,1.75,1730,3400,1.0,0.0,0.0,5,7,970,760,1928,0,98107,47.6662,-122.36399999999999,1640,5000,4,6,2015,UNK,90,-1600
3426059050,5/20/2014,315000.0,2,1.0,790,6969,1.0,0.0,0.0,3,6,790,0,1955,1984,98052,47.6978,-122.164,1380,12196,5,20,2014,Y,-590,-5227
4137000070,4/10/2015,319950.0,3,2.5,2240,7500,2.0,0.0,0.0,3,8,2240,0,1985,0,98092,47.265,-122.22,2190,7506,4,10,2015,UNK,50,-6
2759500105,7/30/2014,419000.0,3,1.5,1500,8272,1.0,0.0,0.0,4,7,1500,0,1958,0,98177,47.7741,-122.38,1630,8270,7,30,2014,UNK,-130,2
4137010310,8/22/2014,205000.0,3,2.0,1800,11419,1.0,0.0,0.0,3,8,1800,0,1989,0,98092,47.2623,-122.21700000000001,2220,11406,8,22,2014,UNK,-420,13
5616000030,10/23/2014,335000.0,4,2.5,1980,4745,2.0,0.0,0.0,3,7,1980,0,2004,0,98038,47.3495,-122.04,1980,4878,10,23,2014,N,0,-133
9266700295,10/24/2014,397000.0,3,1.75,1340,5100,1.0,0.0,0.0,3,7,1340,0,1953,0,98103,47.693999999999996,-122.348,1550,5100,10,24,2014,UNK,-210,0
9828200187,4/29/2015,370000.0,2,1.0,750,2020,1.0,0.0,0.0,3,7,750,0,1908,0,98122,47.6175,-122.301,1630,2383,4,29,2015,UNK,-880,-363
6061400160,9/18/2014,330000.0,4,2.25,1790,9920,1.0,0.0,0.0,4,7,1170,620,1969,0,98059,47.5126,-122.149,1990,9648,9,18,2014,UNK,-200,272
4139420640,10/30/2014,1790000.0,4,3.5,5490,14300,1.0,0.0,4.0,3,12,2910,2580,1996,0,98006,47.5511,-122.11399999999999,4290,13822,10,30,2014,UNK,1200,478
4022900197,8/8/2014,399000.0,3,2.0,1940,16300,1.0,0.0,0.0,3,7,1140,800,1978,0,98155,47.773999999999994,-122.28299999999999,1940,11250,8,8,2014,UNK,0,5050
3221069035,6/20/2014,400000.0,4,1.75,2670,189486,2.0,0.0,4.0,3,8,2670,0,1972,0,98092,47.2585,-122.061,2190,218610,6,20,2014,UNK,480,-29124
2591730200,7/17/2014,249900.0,3,2.0,1220,6404,1.0,0.0,0.0,3,7,1220,0,1994,0,98038,47.3523,-122.059,1570,7000,7,17,2014,UNK,-350,-596
9165100260,5/13/2014,717000.0,3,1.5,1310,3880,1.0,0.0,0.0,3,7,1090,220,1956,0,98117,47.6821,-122.39200000000001,1570,3880,5,13,2014,UNK,-260,0
5201810060,8/7/2014,319000.0,4,2.5,1930,8336,2.0,0.0,0.0,3,8,1930,0,1995,0,98031,47.4016,-122.166,2280,7959,8,7,2014,UNK,-350,377
5499200060,4/3/2015,635000.0,4,3.0,2100,3800,2.0,0.0,0.0,3,8,2100,0,1972,0,98115,47.6807,-122.291,1320,3800,4,3,2015,UNK,780,0
1568100060,9/10/2014,355000.0,3,1.0,1180,7573,1.0,0.0,0.0,4,7,1180,0,1977,0,98155,47.7372,-122.294,1320,7573,9,10,2014,UNK,-140,0
4139910160,4/1/2015,1600000.0,5,3.25,4320,32840,2.0,0.0,0.0,3,12,4320,0,1990,0,98006,47.5461,-122.12200000000001,4410,33210,4,1,2015,UNK,-90,-370
6743700060,7/14/2014,585000.0,4,1.75,3140,12519,1.0,0.0,0.0,3,7,2320,820,1951,0,98033,47.6941,-122.17299999999999,2240,7308,7,14,2014,UNK,900,5211
7258200060,12/29/2014,320000.0,3,2.0,2320,7800,1.0,0.0,0.0,4,7,1160,1160,1960,0,98168,47.5141,-122.316,1380,7800,12,29,2014,UNK,940,0
5127000810,5/14/2014,305495.0,3,1.75,2110,10200,2.0,0.0,0.0,4,7,2110,0,1966,0,98059,47.4744,-122.154,1800,10200,5,14,2014,UNK,310,0
2011400520,6/19/2014,240000.0,4,2.0,1790,14690,1.0,0.0,1.0,4,7,1670,120,1960,0,98198,47.3965,-122.321,2440,10664,6,19,2014,UNK,-650,4026
1953400510,6/23/2014,199950.0,5,2.5,1740,8750,1.0,0.0,0.0,4,7,1740,0,1959,0,98198,47.3904,-122.29899999999999,1740,8750,6,23,2014,UNK,0,0
2450500060,8/26/2014,1620000.0,4,3.25,3820,8114,2.0,0.0,0.0,3,10,3820,0,2005,0,98004,47.5837,-122.194,2440,9195,8,26,2014,N,1380,-1081
2623039082,2/18/2015,770000.0,3,3.5,2050,21744,2.0,1.0,4.0,4,9,1750,300,1930,0,98166,47.4536,-122.376,2300,12200,2,18,2015,UNK,-250,9544
3204400030,7/2/2014,255000.0,4,2.25,1680,3179,2.0,0.0,0.0,3,8,1680,0,2002,0,98092,47.3258,-122.186,1678,3590,7,2,2014,UNK,2,-411
2473370890,9/15/2014,289000.0,4,2.25,1930,8925,1.0,0.0,0.0,4,8,1930,0,1974,0,98058,47.4501,-122.12799999999999,1930,8400,9,15,2014,UNK,0,525
3343901401,7/18/2014,494500.0,4,3.0,3760,8804,2.0,0.0,0.0,3,8,2470,1290,2002,0,98056,47.5161,-122.191,1960,7225,7,18,2014,UNK,1800,1579
4376700030,6/4/2014,746000.0,3,2.25,2370,9619,1.0,0.0,0.0,4,8,1650,720,1973,0,98052,47.6366,-122.09899999999999,1960,9712,6,4,2014,UNK,410,-93
1072000400,10/23/2014,385000.0,4,3.0,2120,13000,2.0,0.0,0.0,4,8,2120,0,1978,0,98059,47.4745,-122.141,2180,11440,10,23,2014,UNK,-60,1560
2193330030,11/18/2014,688100.0,4,2.5,2370,10513,2.0,0.0,0.0,4,8,2370,0,1987,0,98052,47.6915,-122.09899999999999,2110,9540,11,18,2014,UNK,260,973
4083300070,5/12/2014,870300.0,4,2.5,2350,3150,1.5,0.0,0.0,4,8,1690,660,1910,0,98103,47.6605,-122.335,1750,3150,5,12,2014,UNK,600,0
2241700075,10/22/2014,310000.0,3,1.0,1180,8474,1.5,0.0,0.0,3,7,1180,0,1956,0,98155,47.7416,-122.32700000000001,1180,7200,10,22,2014,UNK,0,1274
9250900111,3/12/2015,500000.0,3,2.5,2270,5654,2.0,0.0,0.0,3,8,2270,0,1999,0,98133,47.7733,-122.351,1770,7840,3,12,2015,UNK,500,-2186
9412700160,8/14/2014,255000.0,3,2.25,1830,7770,1.0,0.0,0.0,4,7,1400,430,1977,0,98042,47.3925,-122.161,1960,7272,8,14,2014,UNK,-130,498
1118001360,2/18/2015,1480000.0,3,2.75,3910,7080,1.0,0.0,0.0,5,9,1970,1940,1949,0,98112,47.6324,-122.289,3480,7370,2,18,2015,UNK,430,-290
4383500030,9/24/2014,154500.0,3,1.0,890,9465,1.0,0.0,0.0,3,6,890,0,1957,0,98148,47.4388,-122.32799999999999,1590,9147,9,24,2014,UNK,-700,318
2558630060,5/30/2014,425000.0,3,2.25,1820,8058,1.0,0.0,0.0,3,7,1260,560,1974,0,98034,47.7241,-122.16799999999999,1850,7384,5,30,2014,UNK,-30,674
1150000400,7/21/2014,700000.0,4,2.5,2440,7491,2.0,0.0,0.0,4,10,2440,0,1988,0,98029,47.56100000000001,-122.01899999999999,2490,8580,7,21,2014,UNK,-50,-1089
5244801275,11/21/2014,410500.0,2,1.0,1110,3943,1.0,0.0,0.0,5,6,740,370,1916,0,98109,47.6436,-122.352,1590,4311,11,21,2014,UNK,-480,-368
1839920160,7/14/2014,432000.0,3,2.0,1870,7080,1.0,0.0,0.0,4,7,1210,660,1969,0,98034,47.7244,-122.179,1620,8000,7,14,2014,UNK,250,-920
9834200030,4/14/2015,530000.0,3,1.5,1240,4080,1.5,0.0,0.0,3,8,1240,0,1914,0,98144,47.5745,-122.291,1420,4080,4,14,2015,UNK,-180,0
3288200710,5/27/2014,465000.0,3,2.0,1560,8640,1.0,0.0,0.0,5,7,1560,0,1967,0,98034,47.7294,-122.186,1970,8625,5,27,2014,UNK,-410,15
3904980320,9/23/2014,498688.0,3,2.5,1910,5600,2.0,0.0,0.0,3,8,1910,0,1989,0,98029,47.5752,-122.009,1800,4928,9,23,2014,UNK,110,672
2927600435,4/2/2015,573500.0,3,1.0,2200,21450,1.0,0.0,0.0,4,9,1600,600,1952,0,98166,47.4527,-122.37200000000001,1880,11250,4,2,2015,UNK,320,10200
1321740260,10/15/2014,349900.0,4,2.75,2530,13474,2.0,0.0,0.0,4,8,2530,0,1994,0,98023,47.288999999999994,-122.344,2490,13140,10,15,2014,UNK,40,334
7809200055,6/18/2014,220000.0,3,1.0,1130,12519,1.0,0.0,0.0,3,7,1130,0,1958,0,98056,47.4965,-122.176,1460,12507,6,18,2014,UNK,-330,12
3298700671,7/31/2014,260000.0,2,1.0,820,6771,1.0,0.0,0.0,4,6,820,0,1918,0,98106,47.52,-122.354,1000,4440,7,31,2014,UNK,-180,2331
1231000640,9/11/2014,290000.0,2,1.0,960,4000,1.0,0.0,0.0,3,6,960,0,1918,0,98118,47.5554,-122.26700000000001,1210,4000,9,11,2014,UNK,-250,0
1498303905,4/2/2015,615000.0,4,1.5,1980,3240,1.5,0.0,0.0,4,8,1780,200,1930,0,98144,47.583999999999996,-122.294,2250,4000,4,2,2015,UNK,-270,-760
7491010060,10/22/2014,730000.0,4,3.5,3370,5638,2.0,0.0,0.0,3,10,2250,1120,2001,0,98034,47.7196,-122.223,3080,7200,10,22,2014,UNK,290,-1562
8835800350,1/12/2015,1950000.0,4,3.25,7420,167869,2.0,0.0,3.0,3,12,7420,0,2002,0,98045,47.4548,-121.764,5610,169549,1,12,2015,UNK,1810,-1680
8856960260,5/21/2014,332500.0,3,2.25,1800,10500,2.0,0.0,0.0,3,7,1800,0,1995,0,98038,47.3879,-122.03200000000001,1870,8555,5,21,2014,UNK,-70,1945
1088810160,12/24/2014,650000.0,5,3.5,3990,10120,2.0,0.0,0.0,3,9,2820,1170,1990,0,98011,47.74100000000001,-122.208,2750,9622,12,24,2014,UNK,1240,498
3931900510,8/29/2014,1400000.0,4,2.5,4070,7800,3.0,0.0,0.0,4,8,3390,680,2002,0,98115,47.6838,-122.32700000000001,2020,6760,8,29,2014,UNK,2050,1040
9567800435,5/13/2015,465000.0,4,1.75,1640,7194,1.5,0.0,0.0,4,7,1480,160,1915,0,98011,47.7649,-122.205,1440,9405,5,13,2015,UNK,200,-2211
2806000560,7/22/2014,690000.0,4,3.25,3730,11820,2.0,0.0,0.0,3,10,2460,1270,1990,0,98029,47.5775,-122.01899999999999,3680,10667,7,22,2014,UNK,50,1153
2473101360,7/11/2014,289900.0,3,1.75,1220,7004,1.0,0.0,0.0,5,7,1220,0,1966,0,98058,47.4492,-122.15700000000001,1640,7210,7,11,2014,UNK,-420,-206
2288900140,12/18/2014,1620000.0,3,3.5,3490,4000,2.0,0.0,0.0,3,9,2570,920,2009,0,98112,47.6385,-122.281,1880,4000,12,18,2014,N,1610,0
9320990140,4/22/2015,339950.0,3,2.5,1730,4286,2.0,0.0,0.0,3,7,1730,0,1999,0,98148,47.431999999999995,-122.329,1780,4343,4,22,2015,UNK,-50,-57
8731982050,4/23/2015,367999.0,4,2.75,3430,8000,1.5,0.0,0.0,4,8,3430,0,1972,0,98023,47.3183,-122.382,2090,8000,4,23,2015,UNK,1340,0
705700240,2/18/2015,380000.0,4,2.5,2320,10079,2.0,0.0,0.0,3,7,2320,0,1994,0,98038,47.3828,-122.02600000000001,2010,7438,2,18,2015,UNK,310,2641
4335000030,6/25/2014,440000.0,3,1.75,2030,17100,1.0,0.0,0.0,4,7,2030,0,1953,0,98166,47.451,-122.365,1950,14400,6,25,2014,UNK,80,2700
2806300070,5/21/2014,975000.0,5,4.0,4850,36450,2.0,0.0,0.0,3,10,4850,0,1977,0,98005,47.6426,-122.15799999999999,3850,35325,5,21,2014,UNK,1000,1125
5631501323,8/5/2014,309500.0,3,1.5,1340,13560,1.0,0.0,0.0,3,7,1340,0,1968,0,98028,47.74100000000001,-122.234,1540,15000,8,5,2014,UNK,-200,-1440
3738900105,7/23/2014,350000.0,3,1.0,1130,8201,1.0,0.0,0.0,5,6,1130,0,1948,0,98155,47.7359,-122.306,1180,8203,7,23,2014,UNK,-50,-2
2781270400,3/16/2015,215000.0,2,2.0,1180,2521,2.0,0.0,0.0,3,6,1180,0,2005,0,98038,47.3487,-122.021,1310,3003,3,16,2015,N,-130,-482
3336001360,8/26/2014,254000.0,2,1.0,910,6000,1.0,0.0,0.0,3,6,910,0,1943,0,98118,47.5253,-122.266,1460,5800,8,26,2014,UNK,-550,200
2464400435,4/20/2015,567000.0,3,1.75,1630,4275,1.5,0.0,3.0,3,7,1630,0,1908,0,98115,47.6851,-122.322,1800,4275,4,20,2015,UNK,-170,0
2025049114,5/29/2014,402000.0,2,1.0,710,1173,2.0,0.0,0.0,4,7,710,0,1943,0,98102,47.6412,-122.329,1370,1173,5,29,2014,UNK,-660,0
1523089012,11/20/2014,365000.0,4,1.0,1520,80150,1.0,0.0,0.0,2,5,1520,0,1948,0,98045,47.4742,-121.76899999999999,1740,84506,11,20,2014,UNK,-220,-4356
7305300695,5/2/2014,625000.0,4,2.5,2820,8408,2.0,0.0,0.0,3,9,2820,0,2014,0,98155,47.7538,-122.325,1300,8408,5,2,2014,N,1520,0
9269200340,4/23/2015,432000.0,4,1.75,1970,5160,1.5,0.0,0.0,3,7,1970,0,1942,0,98126,47.534,-122.37299999999999,1230,4920,4,23,2015,UNK,740,240
1402100070,8/1/2014,335500.0,5,3.0,2240,19090,1.0,0.0,0.0,4,8,1700,540,1968,0,98058,47.4416,-122.149,2280,20000,8,1,2014,UNK,-40,-910
2998300060,8/6/2014,672500.0,2,1.75,1860,5940,1.0,0.0,2.0,5,8,1020,840,1956,0,98116,47.5751,-122.40700000000001,2130,5940,8,6,2014,UNK,-270,0
8113101000,7/22/2014,336000.0,4,1.0,1780,4310,1.5,0.0,0.0,5,6,1780,0,1919,0,98118,47.5486,-122.27799999999999,1460,4310,7,22,2014,UNK,320,0
1388600070,11/24/2014,294400.0,4,2.5,1788,10183,2.0,0.0,0.0,4,7,1788,0,1990,0,98002,47.2883,-122.21799999999999,1700,6600,11,24,2014,UNK,88,3583
8944600060,4/20/2015,541900.0,3,2.5,1880,3054,2.0,0.0,0.0,3,8,1880,0,1988,0,98007,47.6091,-122.147,1840,3815,4,20,2015,UNK,40,-761
8860310240,12/17/2014,505000.0,3,1.75,2300,11400,1.0,0.0,0.0,4,8,1520,780,1977,0,98052,47.6884,-122.12799999999999,2300,10140,12,17,2014,UNK,0,1260
8016250060,6/5/2014,255000.0,3,2.5,1610,6176,2.0,0.0,0.0,3,7,1610,0,1994,0,98030,47.3657,-122.17299999999999,1680,7414,6,5,2014,UNK,-70,-1238
2061800045,1/22/2015,435000.0,6,2.5,2270,11970,1.0,0.0,0.0,3,7,1470,800,1964,0,98011,47.7722,-122.204,2270,10640,1,22,2015,UNK,0,1330
2652500070,5/8/2014,636000.0,2,1.75,1230,3600,1.5,0.0,0.0,5,7,1230,0,1925,0,98119,47.6423,-122.361,1210,4500,5,8,2014,UNK,20,-900
3622069114,9/9/2014,655000.0,4,3.5,3420,33106,2.0,0.0,0.0,3,9,3420,0,2004,0,98010,47.3554,-121.986,3420,36590,9,9,2014,N,0,-3484
4438000075,3/18/2015,280500.0,3,1.5,1670,6988,1.0,0.0,0.0,3,7,1370,300,1953,0,98148,47.4283,-122.323,1090,7753,3,18,2015,UNK,580,-765
2776600002,4/22/2015,520000.0,2,1.0,1120,6141,1.0,0.0,0.0,3,7,900,220,1946,0,98117,47.6924,-122.37200000000001,1500,7529,4,22,2015,UNK,-380,-1388
241900060,6/26/2014,354000.0,4,2.5,2580,5476,2.0,0.0,0.0,3,8,2580,0,2005,0,98031,47.4042,-122.205,2900,5476,6,26,2014,N,-320,0
5151800045,8/22/2014,810000.0,5,2.75,3847,17654,1.0,0.0,2.0,5,9,2299,1548,1975,0,98003,47.3379,-122.322,2690,15344,8,22,2014,UNK,1157,2310
3221059036,5/2/2014,400000.0,4,2.5,3630,42884,1.5,0.0,0.0,3,9,2300,1330,1979,0,98092,47.2617,-122.19,2830,80148,5,2,2014,UNK,800,-37264
7504020960,1/7/2015,879900.0,4,2.75,3580,12000,1.0,0.0,0.0,3,10,1840,1740,1979,0,98074,47.6319,-122.05,2910,12428,1,7,2015,UNK,670,-428
1924059319,3/20/2015,1290000.0,5,4.0,4050,11358,2.0,0.0,0.0,4,10,2780,1270,1980,0,98040,47.56,-122.225,3120,13555,3,20,2015,UNK,930,-2197
4067600160,4/2/2015,902500.0,3,3.5,3240,23522,2.0,0.0,0.0,3,10,2130,1110,1992,0,98010,47.3388,-122.03299999999999,3180,23273,4,2,2015,UNK,60,249
9828700685,5/13/2015,900000.0,3,1.75,1540,8400,1.5,0.0,0.0,3,7,1540,0,1902,0,98122,47.6187,-122.295,1330,4800,5,13,2015,UNK,210,3600
4307330070,7/17/2014,419500.0,4,2.5,2550,7200,2.0,0.0,2.0,3,7,2550,0,2003,0,98056,47.4793,-122.18,2560,5715,7,17,2014,UNK,-10,1485
6822100310,11/3/2014,685000.0,4,2.0,2340,6000,1.0,0.0,0.0,5,8,1270,1070,1953,0,98199,47.6495,-122.40100000000001,1600,6000,11,3,2014,UNK,740,0
3295900520,11/7/2014,429950.0,4,2.5,2320,4524,2.0,0.0,0.0,3,8,2320,0,2004,0,98059,47.4798,-122.13600000000001,2330,4524,11,7,2014,N,-10,0
1773100310,4/23/2015,464950.0,4,2.5,1640,6000,2.0,0.0,0.0,3,7,1640,0,2011,0,98106,47.559,-122.365,1640,4800,4,23,2015,N,0,1200
9407000990,10/10/2014,239900.0,2,1.0,910,9000,1.0,0.0,0.0,4,6,910,0,1983,0,98045,47.4463,-121.771,1410,9440,10,10,2014,UNK,-500,-440
1472800160,2/18/2015,406250.0,4,3.25,2550,11524,2.0,0.0,0.0,3,8,2550,0,1990,0,98019,47.7324,-121.963,2370,14001,2,18,2015,UNK,180,-2477
7787110370,10/27/2014,447000.0,4,2.5,2660,8027,2.0,0.0,0.0,3,8,2660,0,1997,0,98045,47.4831,-121.781,2480,8095,10,27,2014,UNK,180,-68
3041700570,6/5/2014,466800.0,3,2.5,1480,14250,2.0,0.0,0.0,3,7,1480,0,1996,0,98033,47.6595,-122.186,1660,14250,6,5,2014,UNK,-180,0
3999200310,9/17/2014,674000.0,4,2.5,2810,11560,1.0,0.0,0.0,5,7,1740,1070,1962,0,98008,47.5846,-122.12,1970,11560,9,17,2014,UNK,840,0
1931300955,11/26/2014,525000.0,1,1.0,830,3200,1.0,0.0,0.0,3,7,830,0,1924,0,98103,47.6557,-122.348,1350,2512,11,26,2014,UNK,-520,688
2591720160,5/1/2015,674950.0,3,2.75,3510,92347,2.0,0.0,0.0,3,10,3510,0,1990,0,98038,47.3735,-122.01799999999999,2970,37070,5,1,2015,UNK,540,55277
8691510310,4/29/2015,374900.0,3,2.5,2480,4950,2.0,0.0,0.0,3,7,2480,0,2004,0,98058,47.4389,-122.116,2230,5298,4,29,2015,N,250,-348
9831200520,10/6/2014,1440000.0,4,3.0,3720,5000,2.5,0.0,0.0,5,9,2720,1000,1905,0,98102,47.6282,-122.322,2610,5000,10,6,2014,UNK,1110,0
8123710070,12/5/2014,559500.0,3,2.25,2150,9250,2.0,0.0,0.0,3,8,2150,0,1984,0,98052,47.7179,-122.113,2240,9266,12,5,2014,UNK,-90,-16
7852170370,5/16/2014,522500.0,3,2.5,2370,7875,2.0,0.0,0.0,3,9,2370,0,2003,0,98065,47.5427,-121.863,2660,7752,5,16,2014,UNK,-290,123
3528000310,4/27/2015,1130000.0,5,2.5,4310,28008,2.0,0.0,0.0,3,10,4310,0,1988,0,98053,47.6662,-122.056,3170,28559,4,27,2015,UNK,1140,-551
6403500570,6/12/2014,498500.0,5,2.75,2990,7420,2.0,0.0,0.0,3,8,2990,0,1996,0,98059,47.4944,-122.162,2290,7678,6,12,2014,UNK,700,-258
6021501420,8/25/2014,571000.0,4,1.0,1350,4000,1.5,0.0,0.0,3,8,1350,0,1930,0,98117,47.6885,-122.38600000000001,1520,4000,8,25,2014,UNK,-170,0
723069128,5/14/2014,543000.0,2,2.0,2370,217800,1.5,0.0,0.0,3,7,1600,770,1992,0,98027,47.5007,-122.088,2370,157687,5,14,2014,UNK,0,60113
3329530030,3/4/2015,271920.0,3,2.0,1410,10248,1.0,0.0,0.0,3,7,1410,0,1985,0,98001,47.3315,-122.265,2090,9414,3,4,2015,UNK,-680,834
723049326,12/8/2014,104950.0,2,1.0,1170,8254,1.0,0.0,0.0,2,6,1170,0,1949,0,98146,47.497,-122.346,1820,8922,12,8,2014,UNK,-650,-668
7215721070,9/29/2014,485500.0,4,2.5,1800,4500,2.0,0.0,0.0,3,8,1800,0,1999,0,98075,47.5998,-122.014,1800,4500,9,29,2014,UNK,0,0
3179101580,5/28/2014,1210000.0,4,2.75,3650,6982,2.0,0.0,2.0,4,9,2530,1120,1951,2003,98115,47.6756,-122.275,3140,7894,5,28,2014,Y,510,-912
2025700270,1/22/2015,260250.0,3,1.75,1490,8357,1.0,0.0,0.0,4,7,1490,0,1993,0,98038,47.3473,-122.037,1490,7376,1,22,2015,UNK,0,981
8691300260,4/13/2015,875909.0,4,2.5,3610,13292,2.0,0.0,0.0,3,10,3610,0,1996,0,98075,47.5868,-121.97399999999999,3000,10776,4,13,2015,UNK,610,2516
5112800060,6/6/2014,455000.0,4,1.75,2050,94525,1.0,0.0,0.0,4,7,1250,800,1959,0,98058,47.4492,-122.084,2270,47480,6,6,2014,UNK,-220,47045
2112700240,5/20/2014,309000.0,3,1.0,1092,7500,1.5,0.0,0.0,3,6,1092,0,1918,0,98106,47.5321,-122.354,930,4000,5,20,2014,UNK,162,3500
8732190990,7/9/2014,229000.0,4,2.25,2010,7688,1.0,0.0,0.0,3,8,1170,840,1979,0,98023,47.3086,-122.396,1990,7688,7,9,2014,UNK,20,0
537000416,4/29/2015,250000.0,3,2.0,1680,7900,2.0,0.0,0.0,4,7,1680,0,1953,0,98003,47.3255,-122.305,1250,15600,4,29,2015,UNK,430,-7700
3761700251,5/28/2014,600000.0,4,2.0,2510,38141,1.0,0.0,0.0,3,9,2510,0,1960,0,98034,47.7219,-122.258,3180,11760,5,28,2014,UNK,-670,26381
625100181,5/8/2014,535000.0,4,2.5,2280,65836,2.0,0.0,0.0,3,8,2280,0,2004,0,98077,47.7237,-122.07600000000001,2300,97574,5,8,2014,N,-20,-31738
7202261260,11/17/2014,571000.0,3,2.5,2510,5186,2.0,0.0,0.0,3,7,2510,0,2001,0,98053,47.6895,-122.041,2530,5186,11,17,2014,UNK,-20,0
7856410030,5/5/2014,1030000.0,5,2.75,3190,16920,1.0,0.0,3.0,3,9,1690,1500,1976,0,98006,47.5641,-122.16,3100,13100,5,5,2014,UNK,90,3820
8128600060,6/24/2014,600000.0,4,3.25,4690,14930,2.0,0.0,2.0,3,10,3680,1010,1995,0,98155,47.7718,-122.28299999999999,2910,13320,6,24,2014,UNK,1780,1610
1775800860,4/28/2015,469500.0,3,2.25,1850,12000,1.0,0.0,0.0,4,7,1300,550,1977,0,98072,47.7408,-122.101,1580,12616,4,28,2015,UNK,270,-616
3303980140,4/2/2015,1150000.0,4,3.0,4160,13170,2.0,0.0,0.0,3,11,3040,1120,2001,0,98059,47.5182,-122.149,3780,13148,4,2,2015,UNK,380,22
4206901200,8/25/2014,785000.0,4,1.5,2220,4000,1.5,0.0,0.0,3,8,1970,250,1925,0,98105,47.6564,-122.325,1984,4000,8,25,2014,UNK,236,0
11500240,4/28/2015,872750.0,3,2.5,2870,13695,2.0,0.0,0.0,3,10,2870,0,1991,0,98052,47.6944,-122.102,2840,8472,4,28,2015,UNK,30,5223
6383500295,8/15/2014,900000.0,4,2.75,3950,10214,1.0,0.0,3.0,3,10,2050,1900,1955,0,98117,47.6969,-122.384,3130,8608,8,15,2014,UNK,820,1606
7849202220,7/17/2014,350000.0,2,1.75,1740,6620,1.5,0.0,0.0,3,8,1740,0,2002,0,98065,47.526,-121.82799999999999,1560,5400,7,17,2014,UNK,180,1220
2260300060,4/10/2015,2580000.0,5,3.0,4780,20440,1.0,0.0,0.0,4,10,3660,1120,1975,0,98039,47.6242,-122.23899999999999,4660,20440,4,10,2015,UNK,120,0
7701950060,7/29/2014,940000.0,4,2.5,3160,39960,1.0,0.0,0.0,3,10,3160,0,1980,0,98005,47.6418,-122.15700000000001,3900,36444,7,29,2014,UNK,-740,3516
5153200486,7/15/2014,185000.0,5,1.75,1990,27810,1.0,0.0,0.0,3,7,1990,0,1955,0,98023,47.3325,-122.35,2240,20000,7,15,2014,UNK,-250,7810
205000310,6/24/2014,850000.0,4,3.5,3920,37122,2.0,0.0,0.0,3,10,3920,0,1996,0,98053,47.6316,-121.988,2550,32647,6,24,2014,UNK,1370,4475
920069053,9/17/2014,201000.0,3,1.0,960,15273,1.0,0.0,0.0,4,7,960,0,1963,0,98022,47.238,-122.039,1930,51400,9,17,2014,UNK,-970,-36127
6141100445,1/7/2015,499000.0,2,1.5,1540,6549,2.0,0.0,0.0,3,7,1540,0,1980,0,98133,47.7189,-122.353,1470,6552,1,7,2015,UNK,70,-3
8809200070,4/8/2015,315000.0,4,2.5,1970,5190,2.0,0.0,0.0,3,7,1970,0,2002,0,98059,47.515,-122.164,1840,5564,4,8,2015,UNK,130,-374
3905080310,8/6/2014,509950.0,3,2.5,1880,4668,2.0,0.0,0.0,3,8,1880,0,1993,0,98029,47.5666,-121.999,2060,4668,8,6,2014,UNK,-180,0
393000311,2/25/2015,286300.0,3,2.75,2000,6405,1.0,0.0,0.0,3,8,1260,740,1964,0,98178,47.5066,-122.259,2130,6510,2,25,2015,UNK,-130,-105
3127200036,7/28/2014,590000.0,3,2.5,1990,8325,2.0,0.0,0.0,4,8,1310,680,1997,0,98034,47.705,-122.20100000000001,2450,10606,7,28,2014,UNK,-460,-2281
123039128,9/4/2014,325000.0,4,1.0,1400,9384,1.5,0.0,0.0,4,6,1400,0,1948,0,98106,47.5166,-122.361,1600,8432,9,4,2014,UNK,-200,952
2896310160,8/22/2014,625000.0,4,2.5,3190,27806,2.0,0.0,0.0,3,9,3190,0,1997,0,98010,47.3425,-122.03,2810,28619,8,22,2014,UNK,380,-813
5272200045,11/13/2014,378000.0,3,1.5,1000,6914,1.0,0.0,0.0,3,7,1000,0,1947,0,98125,47.7144,-122.319,1000,6947,11,13,2014,UNK,0,-33
9211500520,6/18/2014,239950.0,3,1.75,1670,6900,1.0,0.0,0.0,3,7,1170,500,1978,0,98023,47.2975,-122.38,1740,7000,6,18,2014,UNK,-70,-100
3589500260,11/11/2014,550000.0,4,2.0,2100,4500,1.0,0.0,0.0,5,7,1060,1040,1924,0,98105,47.6699,-122.31700000000001,1920,3900,11,11,2014,UNK,180,600
3330500335,4/22/2015,325000.0,2,1.0,1010,6180,1.0,0.0,0.0,3,6,1010,0,1903,0,98118,47.5532,-122.28,1560,6180,4,22,2015,UNK,-550,0
9445300045,6/9/2014,831000.0,4,2.5,2030,3905,1.5,0.0,0.0,4,7,1630,400,1926,0,98103,47.6547,-122.34,2000,3905,6,9,2014,UNK,30,0
114100354,12/12/2014,249000.0,3,1.0,1090,10296,1.0,0.0,0.0,4,6,1090,0,1950,0,98028,47.7743,-122.26,1910,10296,12,12,2014,UNK,-820,0
1775920340,1/26/2015,484000.0,4,1.75,2440,16730,1.0,0.0,0.0,3,7,1390,1050,1976,0,98072,47.7406,-122.11,1390,11600,1,26,2015,UNK,1050,5130
8946700140,11/21/2014,395000.0,4,3.0,2500,6278,2.0,0.0,0.0,3,9,2500,0,2002,0,98092,47.3325,-122.16799999999999,2700,7200,11,21,2014,UNK,-200,-922
8651610240,11/19/2014,839900.0,4,2.5,3420,7462,2.0,0.0,0.0,3,9,3420,0,2002,0,98074,47.6388,-122.064,3080,8031,11,19,2014,UNK,340,-569
1237500105,11/13/2014,760000.0,4,2.5,2850,11000,2.0,0.0,0.0,3,8,2850,0,1998,0,98052,47.6759,-122.161,1720,11000,11,13,2014,UNK,1130,0
9151600106,5/12/2015,750000.0,4,1.5,2030,3300,1.5,0.0,0.0,4,8,1530,500,1927,0,98116,47.5855,-122.383,2610,5400,5,12,2015,UNK,-580,-2100
1118000340,4/8/2015,3000000.0,5,3.75,4590,11265,2.0,0.0,0.0,4,11,3450,1140,1927,0,98112,47.6389,-122.288,3870,8996,4,8,2015,UNK,720,2269
7853230570,9/15/2014,440000.0,3,2.5,2230,5800,2.0,0.0,0.0,3,7,2230,0,2004,0,98065,47.5308,-121.84700000000001,2230,6088,9,15,2014,N,0,-288
4353700200,12/3/2014,501000.0,2,1.75,1810,7523,1.0,0.0,0.0,3,8,1170,640,1962,0,98027,47.5695,-122.087,2090,7523,12,3,2014,UNK,-280,0
7228501805,9/24/2014,739000.0,6,4.5,4000,7500,2.0,0.0,0.0,3,7,4000,0,1978,0,98122,47.6146,-122.306,1380,6298,9,24,2014,UNK,2620,1202
9541800075,9/8/2014,685650.0,3,1.75,1490,16200,1.0,0.0,0.0,5,8,1490,0,1958,0,98005,47.5919,-122.175,2070,16200,9,8,2014,UNK,-580,0
3425069083,6/25/2014,1010000.0,4,4.5,4225,284011,2.0,0.0,0.0,4,11,4225,0,1985,0,98074,47.6118,-122.024,2870,14576,6,25,2014,UNK,1355,269435
7613700270,9/16/2014,980000.0,4,1.75,2120,4000,1.5,0.0,0.0,4,8,1920,200,1929,0,98105,47.6601,-122.275,2300,4000,9,16,2014,UNK,-180,0
6882200140,9/30/2014,275000.0,3,1.5,1030,7184,1.0,0.0,0.0,4,7,1030,0,1968,0,98056,47.5069,-122.189,1330,7262,9,30,2014,UNK,-300,-78
2473380400,5/19/2014,319950.0,4,1.75,2310,8045,1.0,0.0,0.0,4,7,1650,660,1976,0,98058,47.4569,-122.165,1790,8086,5,19,2014,UNK,520,-41
3579000370,3/20/2015,448500.0,3,2.25,1830,7943,2.0,0.0,0.0,3,8,1830,0,1985,0,98028,47.7466,-122.249,2100,8070,3,20,2015,UNK,-270,-127
2623029078,6/3/2014,437000.0,5,2.0,2120,137565,1.5,0.0,0.0,3,7,2120,0,1913,0,98070,47.4558,-122.507,2120,157123,6,3,2014,UNK,0,-19558
3124049196,11/7/2014,330000.0,4,1.5,2500,9448,1.0,0.0,0.0,4,7,1250,1250,1966,0,98106,47.5212,-122.339,1640,9490,11,7,2014,UNK,860,-42
3374500240,12/17/2014,365000.0,3,2.5,2470,7700,2.0,0.0,0.0,4,8,2470,0,1990,0,98031,47.4096,-122.17,2400,7700,12,17,2014,UNK,70,0
8911000445,11/12/2014,329000.0,2,1.0,940,7700,1.0,0.0,0.0,4,6,940,0,1916,0,98133,47.7067,-122.354,1290,7375,11,12,2014,UNK,-350,325
1066100260,6/20/2014,681500.0,5,2.75,3260,11700,1.0,0.0,0.0,3,8,1630,1630,1964,0,98008,47.6169,-122.104,2860,11700,6,20,2014,UNK,400,0
7205850030,5/9/2014,566000.0,3,2.25,1660,10140,1.0,0.0,0.0,4,8,1370,290,1980,0,98052,47.6889,-122.12799999999999,2100,10125,5,9,2014,UNK,-440,15
1330910370,10/20/2014,897500.0,4,3.0,4370,217882,2.0,0.0,0.0,3,10,4370,0,1984,0,98053,47.6573,-122.03399999999999,2430,35096,10,20,2014,UNK,1940,182786
11520370,12/29/2014,738000.0,3,2.5,2620,9112,2.0,0.0,0.0,3,9,2620,0,1995,0,98052,47.6972,-122.116,2620,9067,12,29,2014,UNK,0,45
3327000070,4/20/2015,185000.0,3,1.75,1500,7800,1.0,0.0,0.0,3,7,1500,0,1968,0,98092,47.3141,-122.19200000000001,1490,7800,4,20,2015,UNK,10,0
2594200350,3/4/2015,445000.0,2,1.0,910,7200,1.0,0.0,1.0,4,7,830,80,1936,0,98136,47.5145,-122.39,1700,7200,3,4,2015,UNK,-790,0
2724049185,3/25/2015,175000.0,3,1.75,1430,4920,1.0,0.0,0.0,2,6,1430,0,1957,0,98118,47.5388,-122.275,1550,5646,3,25,2015,UNK,-120,-726
3123800125,11/21/2014,315000.0,2,1.0,900,8556,1.0,0.0,0.0,3,6,760,140,1941,0,98136,47.5148,-122.38600000000001,1500,8556,11,21,2014,UNK,-600,0
3298200320,6/24/2014,445000.0,4,1.75,1250,7400,1.0,0.0,0.0,5,6,1250,0,1959,0,98008,47.62,-122.12,990,7600,6,24,2014,UNK,260,-200
2068000270,8/5/2014,1400000.0,5,3.0,3850,14990,1.0,0.0,0.0,4,9,2290,1560,1964,0,98004,47.6425,-122.21799999999999,3010,15001,8,5,2014,UNK,840,-11
7732500700,11/26/2014,832500.0,4,2.5,3450,35100,2.0,0.0,0.0,3,10,3450,0,1987,0,98052,47.7302,-122.10600000000001,3110,35894,11,26,2014,UNK,340,-794
7851990240,7/17/2014,771150.0,4,3.5,3950,12320,2.0,0.0,0.0,3,10,3950,0,2001,0,98065,47.5414,-121.869,3920,11086,7,17,2014,UNK,30,1234
3423049269,5/13/2014,225000.0,4,1.5,1950,12559,1.5,0.0,0.0,3,6,1950,0,1939,0,98188,47.4364,-122.28200000000001,1950,9178,5,13,2014,UNK,0,3381
7852150200,9/23/2014,389950.0,3,2.5,1700,6396,2.0,0.0,0.0,3,7,1700,0,2003,0,98065,47.5333,-121.87,1700,4444,9,23,2014,UNK,0,1952
7853230270,8/4/2014,435000.0,3,2.5,2370,6082,2.0,0.0,0.0,3,7,2370,0,2004,0,98065,47.5288,-121.846,2690,6152,8,4,2014,N,-320,-70
1965200075,3/16/2015,845000.0,3,1.75,1600,2538,2.0,0.0,0.0,3,7,1600,0,1929,0,98102,47.6447,-122.32700000000001,1660,1750,3,16,2015,UNK,-60,788
1959700445,7/25/2014,1300000.0,4,1.75,4060,5500,2.0,0.0,0.0,5,9,2660,1400,1924,0,98102,47.6437,-122.321,3320,5500,7,25,2014,UNK,740,0
1250200765,7/14/2014,350000.0,3,2.25,1322,1796,2.0,0.0,0.0,3,8,1087,235,2005,0,98144,47.5976,-122.29799999999999,1690,2025,7,14,2014,N,-368,-229
3275300270,7/8/2014,250000.0,3,1.75,1140,10400,1.0,0.0,0.0,4,7,1140,0,1983,0,98003,47.2598,-122.311,1280,9800,7,8,2014,UNK,-140,600
7548300751,4/30/2015,370000.0,2,1.5,1280,2096,2.0,0.0,0.0,3,7,1080,200,2007,0,98144,47.5872,-122.30799999999999,1340,7452,4,30,2015,N,-60,-5356
9526600260,7/29/2014,750000.0,4,2.5,3080,4553,2.5,0.0,0.0,3,8,3080,0,2008,0,98052,47.7066,-122.11200000000001,2750,4929,7,29,2014,N,330,-376
2880100240,8/25/2014,439950.0,2,1.75,1210,3000,1.0,0.0,0.0,5,7,910,300,1906,0,98117,47.6789,-122.365,1260,3000,8,25,2014,UNK,-50,0
5253300320,11/3/2014,395000.0,4,1.75,1950,10219,1.0,0.0,0.0,3,7,1950,0,1962,0,98133,47.7492,-122.336,1500,9099,11,3,2014,UNK,450,1120
2291400566,8/7/2014,375000.0,4,1.0,1450,6820,1.5,0.0,0.0,3,6,1450,0,1947,0,98133,47.7061,-122.34700000000001,1450,6820,8,7,2014,UNK,0,0
103400160,5/15/2014,263000.0,3,2.25,1590,7748,2.0,0.0,0.0,4,7,1590,0,1991,0,98003,47.2857,-122.3,1590,7606,5,15,2014,UNK,0,142
1951600240,12/8/2014,185000.0,3,1.0,1240,9198,1.5,0.0,0.0,4,7,1240,0,1959,0,98032,47.37,-122.29700000000001,1170,8970,12,8,2014,UNK,70,228
224069129,2/25/2015,500000.0,3,1.0,1440,54315,1.0,0.0,0.0,3,7,790,650,1974,0,98075,47.591,-122.01,2690,40518,2,25,2015,UNK,-1250,13797
5608000860,9/26/2014,920000.0,4,2.5,3470,10045,2.0,0.0,0.0,3,10,3470,0,1993,0,98027,47.553999999999995,-122.095,4370,12359,9,26,2014,UNK,-900,-2314
424069271,10/24/2014,936000.0,7,3.75,5100,21802,2.0,0.0,0.0,3,10,3640,1460,2001,0,98075,47.595,-122.04,3350,10005,10,24,2014,UNK,1750,11797
8964800390,5/8/2014,1500000.0,3,1.75,2430,12757,1.0,0.0,2.0,4,8,1340,1090,1952,0,98004,47.6201,-122.209,2930,12450,5,8,2014,UNK,-500,307
7533800885,10/27/2014,1100000.0,3,2.25,2420,7200,1.0,0.0,0.0,3,8,1420,1000,1948,0,98115,47.6867,-122.275,2500,7200,10,27,2014,UNK,-80,0
2312400200,1/2/2015,247000.0,3,2.5,1510,10875,1.0,0.0,0.0,3,7,1150,360,1990,0,98003,47.3482,-122.3,1810,9916,1,2,2015,UNK,-300,959
3226049267,4/25/2015,289500.0,3,1.0,1200,5525,1.0,0.0,0.0,2,7,1200,0,1947,0,98115,47.6981,-122.325,1580,7200,4,25,2015,UNK,-380,-1675
7852130640,6/2/2014,432500.0,3,2.5,2240,6396,2.0,0.0,0.0,3,7,2240,0,2002,0,98065,47.5356,-121.881,2610,5128,6,2,2014,UNK,-370,1268
9530101535,3/27/2015,680000.0,3,1.75,1870,4320,1.0,0.0,0.0,4,7,970,900,1920,0,98103,47.6663,-122.35700000000001,1810,3900,3,27,2015,UNK,60,420
6822100030,5/28/2014,589000.0,3,1.0,1110,6000,1.5,0.0,0.0,5,7,1110,0,1932,0,98199,47.6496,-122.40299999999999,1420,6000,5,28,2014,UNK,-310,0
1090000036,12/23/2014,756450.0,4,2.0,3210,8400,1.5,0.0,0.0,5,7,2040,1170,1914,0,98136,47.5322,-122.391,2540,6458,12,23,2014,UNK,670,1942
6619910260,4/7/2015,536650.0,3,1.75,2090,8910,1.0,0.0,0.0,3,8,1230,860,1975,0,98034,47.7149,-122.22200000000001,2310,10695,4,7,2015,UNK,-220,-1785
342000036,7/2/2014,540000.0,3,2.25,1320,1800,2.0,0.0,0.0,3,7,1320,0,1994,0,98122,47.6081,-122.289,2010,4500,7,2,2014,UNK,-690,-2700
3448002267,4/28/2015,385000.0,3,1.75,1340,3850,1.0,0.0,0.0,4,7,1340,0,1960,0,98125,47.7134,-122.292,1540,7645,4,28,2015,UNK,-200,-3795
7974200765,9/2/2014,485000.0,3,1.0,1020,6120,1.0,0.0,0.0,3,7,1020,0,1941,0,98115,47.6787,-122.285,2370,6695,9,2,2014,UNK,-1350,-575
7230400400,9/26/2014,240000.0,3,2.0,1220,17652,1.0,0.0,0.0,4,7,1220,0,1980,0,98059,47.4712,-122.1,1990,17652,9,26,2014,UNK,-770,0
7230400400,3/26/2015,415500.0,3,2.0,1220,17652,1.0,0.0,0.0,4,7,1220,0,1980,0,98059,47.4712,-122.1,1990,17652,3,26,2015,UNK,-770,0
2028700575,11/13/2014,550000.0,3,2.0,1390,2688,1.5,0.0,0.0,5,7,1390,0,1915,0,98117,47.6783,-122.366,1440,2900,11,13,2014,UNK,-50,-212
4232400400,9/29/2014,1260000.0,4,2.0,2970,5400,2.5,0.0,0.0,4,9,2970,0,1900,0,98112,47.6235,-122.309,2500,5040,9,29,2014,UNK,470,360
792500260,7/15/2014,430000.0,2,2.0,1440,213008,2.0,0.0,0.0,4,7,1440,0,1990,0,98070,47.3604,-122.45700000000001,1630,161172,7,15,2014,UNK,-190,51836
2493200370,11/12/2014,415000.0,2,1.75,1550,4257,1.0,0.0,3.0,3,7,830,720,1953,0,98136,47.5274,-122.384,1920,5100,11,12,2014,UNK,-370,-843
844001052,1/28/2015,365000.0,4,2.5,1904,8200,2.0,0.0,0.0,5,7,1904,0,1999,0,98010,47.3107,-122.001,1560,12426,1,28,2015,UNK,344,-4226
7696610240,12/10/2014,257000.0,4,1.5,1400,8500,2.0,0.0,0.0,3,7,1400,0,1975,0,98001,47.3314,-122.275,1580,7650,12,10,2014,UNK,-180,850
3630110370,6/24/2014,420000.0,3,2.5,2140,3821,2.0,0.0,0.0,3,8,2140,0,2005,0,98029,47.5541,-121.995,2860,3841,6,24,2014,N,-720,-20
1217000270,9/16/2014,338995.0,3,1.75,1320,9450,1.0,0.0,0.0,5,7,1320,0,1943,0,98166,47.4557,-122.348,1320,8315,9,16,2014,UNK,0,1135
9441300030,4/10/2015,615000.0,3,1.75,2620,8280,1.0,0.0,0.0,4,7,1330,1290,1948,0,98177,47.7235,-122.359,1530,8160,4,10,2015,UNK,1090,120
2991000160,12/12/2014,312500.0,4,0.5,2300,5570,2.0,0.0,0.0,3,8,2300,0,1996,0,98092,47.3285,-122.16799999999999,1820,6371,12,12,2014,UNK,480,-801
6641020160,5/6/2014,513000.0,4,2.5,2000,5684,2.0,0.0,0.0,3,8,2000,0,1996,0,98028,47.7443,-122.22,2210,7066,5,6,2014,UNK,-210,-1382
2998300075,1/27/2015,857500.0,4,2.75,2960,5040,2.0,0.0,3.0,3,9,2210,750,1952,0,98116,47.5747,-122.40799999999999,2270,5500,1,27,2015,UNK,690,-460
5456000570,12/30/2014,1060000.0,3,2.75,2700,22343,1.5,0.0,1.0,4,10,2700,0,1977,0,98040,47.5706,-122.209,3390,15682,12,30,2014,UNK,-690,6661
7784400070,7/22/2014,585000.0,3,1.75,1740,9500,1.0,0.0,3.0,4,8,1150,590,1958,0,98146,47.4919,-122.365,2110,9450,7,22,2014,UNK,-370,50
2781250400,10/8/2014,350500.0,2,2.5,1770,4950,1.0,0.0,0.0,3,7,1770,0,2003,0,98038,47.3497,-122.025,1770,4500,10,8,2014,UNK,0,450
3821400200,10/6/2014,215000.0,3,2.0,1290,9312,1.0,0.0,0.0,3,7,1290,0,1947,0,98168,47.4811,-122.325,1650,7300,10,6,2014,UNK,-360,2012
3580900200,6/17/2014,440000.0,4,2.0,1450,8400,1.5,0.0,0.0,4,7,1450,0,1962,0,98034,47.7285,-122.24,1450,7440,6,17,2014,UNK,0,960
5466750140,4/27/2015,270000.0,3,2.25,1420,7800,1.0,0.0,0.0,4,7,1130,290,1985,0,98042,47.3598,-122.15700000000001,1460,7800,4,27,2015,UNK,-40,0
8122100160,10/23/2014,385000.0,3,0.75,1330,7020,1.0,0.0,0.0,5,7,1330,0,1924,0,98126,47.5377,-122.376,1410,5802,10,23,2014,UNK,-80,1218
9523102447,11/17/2014,688500.0,3,1.75,1760,4125,1.5,0.0,3.0,4,7,1760,0,1927,0,98103,47.6748,-122.352,1760,4000,11,17,2014,UNK,0,125
7234601525,5/19/2014,700000.0,3,1.75,2010,4905,1.0,0.0,0.0,5,7,1230,780,1912,0,98122,47.6105,-122.309,2210,1834,5,19,2014,UNK,-200,3071
6071300160,8/22/2014,585000.0,5,2.0,2560,14467,1.0,0.0,0.0,3,8,1280,1280,1960,0,98006,47.5547,-122.178,2200,10267,8,22,2014,UNK,360,4200
8044200200,2/26/2015,401000.0,2,1.5,1260,2625,2.0,0.0,0.0,4,7,1260,0,1983,0,98052,47.6747,-122.15100000000001,1260,2625,2,26,2015,UNK,0,0
8563050350,3/6/2015,655000.0,4,2.25,2420,7725,1.0,0.0,0.0,4,8,1890,530,1972,0,98052,47.6287,-122.09299999999999,1740,7944,3,6,2015,UNK,680,-219
1282300105,6/4/2014,317000.0,3,1.0,1010,5400,1.0,0.0,0.0,3,6,1010,0,1959,0,98144,47.5746,-122.29299999999999,960,5400,6,4,2014,UNK,50,0
3374300030,5/5/2015,500000.0,4,2.5,1770,8155,1.5,0.0,0.0,4,6,1770,0,1970,0,98034,47.718999999999994,-122.17299999999999,1460,7360,5,5,2015,UNK,310,795
9232900075,10/21/2014,314963.0,2,1.0,890,6350,1.0,0.0,0.0,3,6,890,0,1943,0,98103,47.6975,-122.35700000000001,1490,6350,10,21,2014,UNK,-600,0
952000640,10/27/2014,715000.0,3,1.5,1670,5060,2.0,0.0,2.0,5,7,1670,0,1925,0,98126,47.5671,-122.37899999999999,1670,5118,10,27,2014,UNK,0,-58
7334600030,10/14/2014,280000.0,3,2.25,1360,9600,2.0,0.0,0.0,3,7,1360,0,1992,0,98045,47.4687,-121.749,1200,10400,10,14,2014,UNK,160,-800
200500700,6/12/2014,531000.0,3,2.5,2120,9736,2.0,0.0,0.0,3,9,2120,0,1988,0,98011,47.7374,-122.219,2490,8763,6,12,2014,UNK,-370,973
11200400,9/23/2014,617000.0,3,2.5,1910,4488,2.0,0.0,0.0,3,8,1910,0,1998,0,98007,47.6176,-122.14,1530,3696,9,23,2014,UNK,380,792
1139000135,10/9/2014,440000.0,4,1.0,1480,7560,1.5,0.0,0.0,3,7,1480,0,1940,0,98177,47.7079,-122.35799999999999,1480,7560,10,9,2014,UNK,0,0
7468900270,7/29/2014,140000.0,3,1.0,1090,10114,1.0,0.0,0.0,4,7,1090,0,1955,0,98002,47.2975,-122.223,1380,7800,7,29,2014,UNK,-290,2314
1036400200,2/13/2015,661000.0,4,1.75,1670,13125,1.0,0.0,0.0,5,8,1670,0,1973,0,98052,47.6315,-122.101,2360,12500,2,13,2015,UNK,-690,625
1036400200,4/29/2015,697000.0,4,1.75,1670,13125,1.0,0.0,0.0,5,8,1670,0,1973,0,98052,47.6315,-122.101,2360,12500,4,29,2015,UNK,-690,625
3622900200,6/27/2014,1200000.0,5,2.75,3650,13297,2.0,0.0,0.0,5,9,2750,900,1969,0,98040,47.5497,-122.228,2900,11568,6,27,2014,UNK,750,1729
6884800262,9/20/2014,535000.0,4,2.0,1970,3515,1.0,0.0,0.0,5,8,1030,940,1969,0,98115,47.6873,-122.314,1650,4275,9,20,2014,UNK,320,-760
7950302255,3/24/2015,404500.0,2,2.0,1320,3060,1.5,0.0,0.0,4,6,1320,0,1910,0,98118,47.5643,-122.28399999999999,1410,3264,3,24,2015,UNK,-90,-204
3524039196,11/12/2014,396500.0,3,1.0,1710,5110,1.0,0.0,0.0,3,7,1100,610,1954,0,98126,47.5256,-122.37899999999999,1310,5110,11,12,2014,UNK,400,0
2064800830,3/20/2015,450000.0,3,2.25,1740,9488,1.0,0.0,0.0,4,8,1180,560,1977,0,98056,47.5339,-122.17399999999999,1880,8615,3,20,2015,UNK,-140,873
1861400116,1/16/2015,605000.0,3,3.25,2200,2400,2.0,0.0,0.0,3,8,1740,460,1988,0,98119,47.6325,-122.37100000000001,2200,3600,1,16,2015,UNK,0,-1200
7129302685,9/11/2014,699000.0,3,2.0,2010,4320,2.0,0.0,2.0,3,9,2010,0,1999,0,98118,47.5153,-122.256,1640,5225,9,11,2014,UNK,370,-905
4046600070,6/19/2014,805000.0,3,3.0,3910,19023,2.0,0.0,0.0,3,11,3910,0,1985,0,98014,47.6953,-121.914,1860,15001,6,19,2014,UNK,2050,4022
8655900162,2/19/2015,156000.0,1,0.75,470,15000,1.0,0.0,0.0,3,4,470,0,1947,0,98014,47.6554,-121.90799999999999,1730,22500,2,19,2015,UNK,-1260,-7500
2193310320,3/6/2015,595000.0,4,2.5,2330,7064,1.0,0.0,0.0,4,8,1780,550,1984,0,98052,47.6955,-122.09700000000001,1740,8075,3,6,2015,UNK,590,-1011
5417600200,7/28/2014,285000.0,3,1.75,1930,7200,1.5,0.0,0.0,3,6,1930,0,1929,0,98065,47.5263,-121.809,1350,9000,7,28,2014,UNK,580,-1800
4178900070,3/25/2015,725000.0,4,2.5,3270,6055,2.0,0.0,0.0,3,9,3270,0,2007,0,98056,47.5374,-122.19200000000001,2740,7367,3,25,2015,N,530,-1312
2115720070,11/25/2014,216300.0,3,2.5,1650,5000,2.0,0.0,0.0,3,8,1650,0,1985,0,98023,47.3206,-122.39399999999999,1720,5000,11,25,2014,UNK,-70,0
3211100990,10/20/2014,410000.0,4,2.75,2220,8450,1.0,0.0,0.0,4,7,1260,960,1983,0,98059,47.4804,-122.15700000000001,1580,8450,10,20,2014,UNK,640,0
5288200260,9/3/2014,597000.0,2,1.75,2470,4600,1.0,0.0,3.0,4,7,1140,1330,1916,0,98126,47.5599,-122.37799999999999,1790,5175,9,3,2014,UNK,680,-575
1771110070,2/18/2015,325000.0,3,1.0,1300,9300,1.0,0.0,0.0,4,7,1300,0,1977,0,98077,47.7562,-122.073,1300,10064,2,18,2015,UNK,0,-764
274000070,4/1/2015,355000.0,5,2.75,2530,9375,1.0,0.0,0.0,5,7,1530,1000,1966,0,98030,47.3738,-122.214,2250,8200,4,1,2015,UNK,280,1175
2816900030,12/18/2014,338000.0,3,1.5,2400,8215,1.0,0.0,0.0,3,7,1200,1200,1961,0,98146,47.5001,-122.338,1460,8217,12,18,2014,UNK,940,-2
304100070,11/18/2014,210000.0,4,2.25,1500,5393,2.0,0.0,0.0,3,7,1500,0,1999,0,98001,47.3378,-122.26299999999999,1700,5917,11,18,2014,UNK,-200,-524
3876200350,8/14/2014,423000.0,4,1.75,1700,9000,1.0,0.0,0.0,3,7,1700,0,1967,0,98034,47.7308,-122.18,1930,7818,8,14,2014,UNK,-230,1182
7806210070,2/11/2015,249500.0,4,1.5,2120,8554,1.0,0.0,0.0,4,7,1170,950,1977,0,98002,47.2933,-122.195,1790,8554,2,11,2015,UNK,330,0
5437600140,1/10/2015,325000.0,4,2.5,2240,5105,2.0,0.0,0.0,4,8,2240,0,2002,0,98042,47.3922,-122.165,1920,5288,1,10,2015,UNK,320,-183
1796360370,3/25/2015,257000.0,3,1.75,1540,8223,1.0,0.0,0.0,4,7,1070,470,1987,0,98042,47.3666,-122.089,1240,8113,3,25,2015,UNK,300,110
1428001160,4/20/2015,550000.0,3,1.75,1890,100623,1.0,0.0,3.0,3,8,1890,0,1978,0,98053,47.6454,-121.978,2110,50529,4,20,2015,UNK,-220,50094
1233100260,11/14/2014,490000.0,3,1.0,1260,9638,2.0,0.0,0.0,4,7,1260,0,1920,0,98033,47.6773,-122.178,1760,7822,11,14,2014,UNK,-500,1816
8835220200,2/2/2015,299000.0,2,1.5,1160,3838,2.0,0.0,0.0,3,7,1160,0,1983,0,98034,47.7255,-122.164,1410,3780,2,2,2015,UNK,-250,58
2023039045,11/3/2014,295000.0,2,1.0,1300,39639,1.0,0.0,0.0,4,6,1300,0,1960,0,98070,47.466,-122.45200000000001,1880,98881,11,3,2014,UNK,-580,-59242
7504400400,10/29/2014,630000.0,4,2.5,3220,14463,2.0,0.0,0.0,3,8,3220,0,1978,0,98074,47.6261,-122.04700000000001,2550,12109,10,29,2014,UNK,670,2354
1432900310,4/24/2015,320000.0,4,1.5,2020,8474,1.0,0.0,0.0,5,7,1010,1010,1962,0,98058,47.4579,-122.17,1720,8166,4,24,2015,UNK,300,308
9541600295,4/24/2015,1110000.0,4,2.5,2990,8640,1.0,0.0,0.0,5,8,2100,890,1959,0,98005,47.5932,-122.17200000000001,2270,8800,4,24,2015,UNK,720,-160
2914700310,9/22/2014,398000.0,4,1.0,1420,6458,1.0,0.0,0.0,4,7,1420,0,1953,0,98117,47.6988,-122.35799999999999,1670,6350,9,22,2014,UNK,-250,108
7972604355,5/21/2014,218000.0,3,1.0,1020,7874,1.0,0.0,0.0,3,7,1020,0,1956,0,98106,47.5175,-122.346,1290,7320,5,21,2014,UNK,-270,554
2423069084,3/3/2015,590000.0,4,2.75,2400,104108,2.0,0.0,0.0,3,8,2400,0,1988,0,98027,47.4686,-121.98899999999999,2270,54450,3,3,2015,UNK,130,49658
8655000070,6/1/2014,1600000.0,5,3.0,3640,8239,2.0,0.0,3.0,3,10,2540,1100,1982,0,98008,47.5842,-122.111,3330,10643,6,1,2014,UNK,310,-2404
8165501620,12/18/2014,348500.0,2,2.25,1550,1824,2.0,0.0,0.0,3,8,1550,0,2007,0,98106,47.5396,-122.368,1460,1826,12,18,2014,N,90,-2
8682281480,7/25/2014,592500.0,2,2.0,1870,4751,1.0,0.0,0.0,3,8,1870,0,2006,0,98053,47.7082,-122.015,2170,5580,7,25,2014,N,-300,-829
1137610140,6/10/2014,505000.0,3,2.5,2340,5957,2.0,0.0,0.0,3,8,2340,0,1995,0,98028,47.7347,-122.236,2340,6604,6,10,2014,UNK,0,-647
4232900310,10/29/2014,1430000.0,5,4.25,3350,3600,2.0,0.0,0.0,3,10,2260,1090,2014,0,98119,47.6351,-122.36399999999999,1810,3600,10,29,2014,N,1540,0
324000370,7/21/2014,502000.0,3,1.0,1710,5000,1.0,0.0,0.0,5,7,1140,570,1921,0,98116,47.5719,-122.385,1670,4000,7,21,2014,UNK,40,1000
3822200036,6/24/2014,257500.0,2,2.0,1180,9265,1.0,0.0,0.0,3,7,1180,0,1940,0,98125,47.7252,-122.29700000000001,460,18000,6,24,2014,UNK,720,-8735
3876100310,7/11/2014,405000.0,3,1.5,1600,7500,1.0,0.0,0.0,3,7,1600,0,1966,0,98034,47.721000000000004,-122.182,1700,7500,7,11,2014,UNK,-100,0
8024201525,3/17/2015,427000.0,3,1.75,1300,5111,1.0,0.0,0.0,4,7,1300,0,1959,0,98115,47.7005,-122.314,1370,5111,3,17,2015,UNK,-70,0
4024101670,12/4/2014,290000.0,3,1.5,1040,9997,1.0,0.0,0.0,4,7,1040,0,1955,0,98155,47.7583,-122.302,1040,8699,12,4,2014,UNK,0,1298
3124049171,3/24/2015,222000.0,3,1.0,1220,7695,1.0,0.0,0.0,3,7,1220,0,1954,0,98106,47.5191,-122.339,1210,7412,3,24,2015,UNK,10,283
2310100240,12/18/2014,315000.0,3,2.5,2240,6097,2.0,0.0,0.0,3,8,2240,0,2002,0,98038,47.3503,-122.042,2240,5574,12,18,2014,UNK,0,523
8021700030,6/4/2014,371000.0,3,1.5,1420,4500,1.0,0.0,0.0,3,7,1420,0,1959,0,98103,47.693999999999996,-122.33200000000001,1540,6375,6,4,2014,UNK,-120,-1875
3861500340,6/26/2014,279900.0,3,1.75,1580,6620,1.0,0.0,0.0,3,7,1580,0,1988,0,98003,47.2798,-122.303,1580,8137,6,26,2014,UNK,0,-1517
1823069046,4/20/2015,250000.0,3,1.5,2390,23522,1.0,0.0,0.0,2,7,1890,500,1938,1968,98059,47.4754,-122.09,2430,23958,4,20,2015,Y,-40,-436
6070500055,5/6/2014,599000.0,4,2.25,2260,29930,2.0,0.0,0.0,4,8,1400,860,1977,0,98006,47.5689,-122.126,2770,29930,5,6,2014,UNK,-510,0
520069032,7/16/2014,267300.0,3,1.75,1890,93218,1.0,0.0,0.0,4,7,1890,0,1964,0,98092,47.2568,-122.07,1690,172062,7,16,2014,UNK,200,-78844
4154303655,12/11/2014,585000.0,2,1.75,1830,7200,1.0,0.0,2.0,4,7,1070,760,1949,0,98118,47.5592,-122.273,1570,6000,12,11,2014,UNK,260,1200
3876800710,4/14/2015,350000.0,3,1.75,1000,8268,1.0,0.0,0.0,3,6,1000,0,1969,0,98072,47.7417,-122.17200000000001,1220,7800,4,14,2015,UNK,-220,468
259000240,6/17/2014,506000.0,3,1.75,2180,7700,1.0,0.0,0.0,3,8,1480,700,1961,0,98177,47.7594,-122.361,2180,7604,6,17,2014,UNK,0,96
1822069041,11/13/2014,400000.0,6,2.0,2320,210830,2.0,0.0,0.0,4,8,2320,0,1962,0,98058,47.398,-122.081,2540,217800,11,13,2014,UNK,-220,-6970
7520000695,11/4/2014,151100.0,3,1.0,840,4495,1.0,0.0,0.0,3,6,840,0,1921,0,98146,47.496,-122.34899999999999,1260,7434,11,4,2014,UNK,-420,-2939
7520000695,4/21/2015,251000.0,3,1.0,840,4495,1.0,0.0,0.0,3,6,840,0,1921,0,98146,47.496,-122.34899999999999,1260,7434,4,21,2015,UNK,-420,-2939
2141330700,5/22/2014,555000.0,4,2.25,2350,8140,1.0,0.0,0.0,4,8,1430,920,1977,0,98006,47.5579,-122.12899999999999,2640,8700,5,22,2014,UNK,-290,-560
3123039082,10/6/2014,467500.0,3,1.75,2040,273556,1.0,0.0,0.0,3,7,2040,0,1997,0,98070,47.4361,-122.469,1790,273556,10,6,2014,UNK,250,0
7215420370,4/7/2015,479000.0,4,2.5,2370,30378,2.0,0.0,0.0,3,8,2370,0,1996,0,98042,47.3389,-122.066,2870,34834,4,7,2015,UNK,-500,-4456
1311000270,4/16/2015,247000.0,5,2.0,1590,9350,1.0,0.0,0.0,5,7,1060,530,1962,0,98001,47.3398,-122.286,1460,8210,4,16,2015,UNK,130,1140
7334500800,1/23/2015,299500.0,3,1.0,1380,10875,1.0,0.0,0.0,3,7,1380,0,1977,0,98045,47.4653,-121.745,1040,10875,1,23,2015,UNK,340,0
2832100270,5/7/2015,306888.0,4,1.5,1940,8970,1.5,0.0,0.0,3,7,1270,670,1980,0,98125,47.7297,-122.32600000000001,1960,8470,5,7,2015,UNK,-20,500
3022079094,10/6/2014,675000.0,4,2.5,3320,244807,2.0,0.0,0.0,3,9,3320,0,2001,0,98010,47.3637,-121.955,2530,217800,10,6,2014,UNK,790,27007
2436200320,4/21/2015,577000.0,2,1.0,1090,5265,1.5,0.0,0.0,4,7,1090,0,1947,0,98105,47.6638,-122.292,2080,4000,4,21,2015,UNK,-990,1265
1042500013,5/20/2014,219950.0,3,1.5,1650,9936,1.0,0.0,0.0,3,7,1090,560,1967,0,98003,47.3285,-122.32799999999999,1560,9890,5,20,2014,UNK,90,46
3897100060,7/23/2014,375000.0,3,1.5,1110,5500,1.0,0.0,0.0,3,6,1110,0,1940,0,98033,47.6717,-122.184,1670,6600,7,23,2014,UNK,-560,-1100
3188100105,11/7/2014,650000.0,4,2.5,2110,6820,1.0,0.0,0.0,5,7,1530,580,1942,0,98115,47.6882,-122.306,1420,6431,11,7,2014,UNK,690,389
2767604170,4/6/2015,975000.0,3,3.0,1850,5000,1.5,0.0,0.0,2,6,1850,0,1900,0,98107,47.6711,-122.38600000000001,1360,2500,4,6,2015,UNK,490,2500
1773100765,4/29/2015,229000.0,1,1.0,600,3720,1.0,0.0,0.0,3,6,600,0,1920,0,98106,47.5558,-122.363,1480,4800,4,29,2015,UNK,-880,-1080
1211000070,9/21/2014,575000.0,5,2.5,2760,4000,1.5,0.0,0.0,3,8,1730,1030,1926,2014,98122,47.6074,-122.29899999999999,1680,4000,9,21,2014,Y,1080,0
8920100041,4/28/2015,815000.0,4,1.75,2970,14880,1.0,0.0,4.0,5,9,1560,1410,1962,0,98075,47.5907,-122.086,3310,13388,4,28,2015,UNK,-340,1492
126059225,8/6/2014,525000.0,3,1.75,2300,43560,1.0,0.0,0.0,4,7,1350,950,1979,0,98077,47.7716,-122.101,2320,57000,8,6,2014,UNK,-20,-13440
9286100320,6/6/2014,471000.0,3,2.5,2030,2805,2.0,0.0,0.0,3,8,1720,310,2001,0,98027,47.5305,-122.04700000000001,1670,2898,6,6,2014,UNK,360,-93
4449800681,6/23/2014,450000.0,4,1.75,2160,4333,1.0,0.0,0.0,4,8,1260,900,1942,0,98117,47.6893,-122.38799999999999,1670,4426,6,23,2014,UNK,490,-93
5505700030,5/28/2014,590000.0,3,2.0,1650,6150,2.0,0.0,0.0,4,7,1650,0,1926,1993,98116,47.5713,-122.39399999999999,1280,6150,5,28,2014,Y,370,0
3260590070,8/1/2014,744000.0,4,2.5,3140,7260,2.0,0.0,0.0,3,8,2200,940,2004,0,98006,47.5664,-122.124,2860,8186,8,1,2014,N,280,-926
3211240370,12/1/2014,460000.0,4,2.25,2690,36114,2.0,0.0,0.0,4,9,2690,0,1986,0,98092,47.3106,-122.116,2570,35091,12,1,2014,UNK,120,1023
8142000060,3/13/2015,299000.0,5,2.5,1940,9389,1.0,0.0,0.0,4,7,1290,650,1960,0,98155,47.7438,-122.32799999999999,1810,9390,3,13,2015,UNK,130,-1
5595900316,1/29/2015,231000.0,4,1.0,1220,5120,1.5,0.0,0.0,5,6,1220,0,1940,0,98022,47.205,-121.99600000000001,1540,7670,1,29,2015,UNK,-320,-2550
4312700200,8/20/2014,195000.0,3,1.0,1300,9600,1.0,0.0,0.0,4,6,1300,0,1975,0,98092,47.3037,-122.10700000000001,1150,10222,8,20,2014,UNK,150,-622
9407001600,4/23/2015,305000.0,3,1.75,1660,11500,1.0,0.0,0.0,3,7,1130,530,1979,0,98045,47.4473,-121.774,1250,11000,4,23,2015,UNK,410,500
5700001895,3/2/2015,895000.0,4,1.5,3390,6200,2.0,0.0,0.0,4,8,2530,860,1916,0,98144,47.58,-122.29,3080,6000,3,2,2015,UNK,310,200
1424200070,5/7/2014,1110000.0,4,1.5,2310,13300,1.0,0.0,0.0,3,7,1890,420,1950,0,98004,47.6232,-122.21,2840,12744,5,7,2014,UNK,-530,556
1708400370,6/26/2014,339000.0,2,1.0,950,7954,1.0,0.0,0.0,4,7,950,0,1941,0,98108,47.556999999999995,-122.306,1180,6828,6,26,2014,UNK,-230,1126
5457801925,4/11/2015,885000.0,4,3.75,2400,3520,1.0,0.0,0.0,3,7,1370,1030,1924,0,98109,47.6295,-122.346,2230,1419,4,11,2015,UNK,170,2101
2895600350,11/3/2014,375000.0,3,1.0,1780,5236,1.5,0.0,0.0,5,6,1050,730,1944,0,98146,47.5119,-122.38600000000001,1260,5320,11,3,2014,UNK,520,-84
4036801070,8/4/2014,367400.0,4,1.5,1280,7400,1.0,0.0,0.0,3,7,1280,0,1958,0,98008,47.6023,-122.12299999999999,1310,7400,8,4,2014,UNK,-30,0
976000879,4/24/2015,700000.0,4,2.0,1930,5398,1.0,0.0,0.0,3,7,1430,500,1953,0,98119,47.646,-122.363,1910,4902,4,24,2015,UNK,20,496
7923100400,1/30/2015,667000.0,5,2.25,2560,10360,1.0,0.0,0.0,4,8,1870,690,1966,0,98008,47.5819,-122.126,2070,7875,1,30,2015,UNK,490,2485
7129304200,12/22/2014,200000.0,2,1.0,920,5250,1.0,0.0,0.0,4,6,920,0,1906,0,98118,47.5177,-122.266,1210,5250,12,22,2014,UNK,-290,0
2225069062,4/15/2015,552775.0,3,2.5,1900,18414,2.0,0.0,0.0,3,8,1900,0,1971,2007,98074,47.6326,-122.015,2900,39921,4,15,2015,Y,-1000,-21507
3343903240,7/22/2014,452000.0,3,2.0,2270,148975,1.0,0.0,0.0,4,6,1270,1000,1900,1980,98056,47.5092,-122.195,2210,17388,7,22,2014,Y,60,131587
5095401360,11/21/2014,418000.0,3,2.5,2080,16050,1.0,0.0,0.0,5,8,1360,720,1978,0,98059,47.4694,-122.069,1790,14550,11,21,2014,UNK,290,1500
2547200160,2/12/2015,601500.0,3,1.75,1460,10128,1.0,0.0,0.0,3,8,1460,0,1968,2000,98033,47.6709,-122.167,2240,10154,2,12,2015,Y,-780,-26
124069032,5/5/2014,600000.0,3,1.75,1670,39639,1.0,0.0,0.0,4,8,1670,0,1976,1992,98075,47.5929,-121.98899999999999,2330,30492,5,5,2014,Y,-660,9147
7300400320,4/24/2015,340000.0,4,2.5,2810,6481,2.0,0.0,0.0,3,9,2810,0,1998,0,98092,47.333,-122.17200000000001,2660,6958,4,24,2015,UNK,150,-477
7212660560,8/26/2014,310000.0,3,2.5,2370,6752,2.0,0.0,0.0,3,8,2370,0,1994,0,98003,47.2703,-122.31200000000001,1870,7455,8,26,2014,UNK,500,-703
3343902650,12/17/2014,290000.0,2,1.75,1700,18000,1.0,0.0,0.0,3,8,1700,0,1972,0,98056,47.5066,-122.194,1700,8225,12,17,2014,UNK,0,9775
3034200036,4/24/2015,438000.0,2,1.0,1630,9255,1.0,0.0,0.0,3,7,1630,0,1941,0,98133,47.7222,-122.33200000000001,1800,8000,4,24,2015,UNK,-170,1255
1498303855,2/24/2015,718000.0,4,2.75,2930,4408,1.0,0.0,0.0,5,8,1660,1270,1939,0,98144,47.5841,-122.295,2200,4000,2,24,2015,UNK,730,408
1446404015,6/20/2014,200000.0,2,1.0,860,6600,1.0,0.0,0.0,5,6,860,0,1949,0,98168,47.4878,-122.324,1030,6732,6,20,2014,UNK,-170,-132
5467910140,5/28/2014,479900.0,3,2.0,1980,12150,1.0,0.0,0.0,3,9,1980,0,1994,0,98042,47.3657,-122.152,2200,12150,5,28,2014,UNK,-220,0
2472920800,4/23/2015,400000.0,3,2.5,2080,7877,2.0,0.0,0.0,3,9,2080,0,1987,0,98058,47.4395,-122.15100000000001,2550,7660,4,23,2015,UNK,-470,217
7147600070,3/23/2015,219950.0,3,1.0,1060,10042,1.0,0.0,0.0,4,7,1060,0,1957,0,98188,47.4434,-122.28299999999999,1130,10925,3,23,2015,UNK,-70,-883
3820350140,8/27/2014,300000.0,3,2.5,1590,3381,2.0,0.0,0.0,3,7,1590,0,2000,0,98019,47.7344,-121.986,1820,3383,8,27,2014,UNK,-230,-2
520700125,8/5/2014,437000.0,3,2.25,1980,8775,1.0,0.0,0.0,3,7,1290,690,1959,0,98177,47.7753,-122.359,1550,9240,8,5,2014,UNK,430,-465
3211200140,7/10/2014,350000.0,4,2.0,1720,7210,1.0,0.0,0.0,3,7,860,0,1971,0,98034,47.7307,-122.23899999999999,1250,7210,7,10,2014,UNK,470,0
250000320,9/29/2014,626000.0,4,1.75,1350,9293,1.0,0.0,0.0,4,7,1350,0,1954,0,98004,47.6335,-122.196,1890,9293,9,29,2014,UNK,-540,0
6139800640,2/24/2015,490000.0,3,2.5,2080,12032,2.0,0.0,0.0,3,8,2080,0,1978,0,98077,47.7455,-122.073,2320,9900,2,24,2015,UNK,-240,2132
6699000710,5/20/2014,289000.0,3,2.5,2090,4700,2.0,0.0,0.0,3,8,2090,0,2002,0,98042,47.3724,-122.104,2740,5040,5,20,2014,UNK,-650,-340
7010700550,11/14/2014,595000.0,3,2.5,2030,5100,2.0,0.0,0.0,3,7,2030,0,2008,0,98199,47.6594,-122.397,1790,4380,11,14,2014,N,240,720
5506500070,12/11/2014,676000.0,3,2.25,2680,41804,1.0,0.0,0.0,3,9,2680,0,1989,0,98045,47.4828,-121.73,2680,40866,12,11,2014,UNK,0,938
3293700521,4/14/2015,389000.0,3,1.75,1820,8028,1.0,0.0,0.0,3,7,1220,600,1980,0,98133,47.7466,-122.355,1940,11100,4,14,2015,UNK,-120,-3072
6929604005,9/15/2014,240000.0,3,2.0,1300,5000,1.0,0.0,0.0,4,7,1300,0,1983,0,98198,47.3837,-122.304,1630,7500,9,15,2014,UNK,-330,-2500
3216900070,6/17/2014,382500.0,4,2.5,2210,7079,2.0,0.0,0.0,3,8,2210,0,1993,0,98031,47.4206,-122.18299999999999,1970,7000,6,17,2014,UNK,240,79
7922800160,5/9/2014,511555.0,3,2.0,1400,7293,1.0,0.0,0.0,4,7,1400,0,1963,0,98008,47.58600000000001,-122.12,1600,7960,5,9,2014,UNK,-200,-667
6610000320,9/10/2014,710500.0,3,1.75,2040,4125,1.5,0.0,0.0,4,8,1540,500,1917,0,98107,47.6608,-122.359,1620,4400,9,10,2014,UNK,420,-275
5561400140,5/21/2014,429000.0,3,2.5,2420,49928,2.0,0.0,0.0,3,8,1860,560,1985,0,98027,47.463,-122.008,2620,37301,5,21,2014,UNK,-200,12627
7686202065,7/23/2014,170000.0,4,1.75,1920,7500,1.0,0.0,0.0,4,7,1920,0,1962,0,98198,47.4222,-122.318,1490,8000,7,23,2014,UNK,430,-500
4107100204,8/21/2014,2140000.0,4,3.25,3860,17820,1.0,0.0,4.0,4,10,2630,1230,1975,0,98004,47.6224,-122.215,4590,23760,8,21,2014,UNK,-730,-5940
7214810510,4/8/2015,480000.0,5,2.75,2760,7200,1.0,0.0,0.0,3,7,1430,1330,1979,0,98072,47.7563,-122.147,2460,8750,4,8,2015,UNK,300,-1550
5350201180,7/20/2014,1670000.0,4,3.75,3450,8395,2.0,0.0,4.0,4,10,2640,810,1993,0,98122,47.6134,-122.28200000000001,3180,5183,7,20,2014,UNK,270,3212
8148600055,5/13/2014,225000.0,3,1.0,1040,6535,1.0,0.0,0.0,3,6,1040,0,1947,0,98168,47.4906,-122.306,1100,6535,5,13,2014,UNK,-60,0
226039270,12/1/2014,615000.0,3,1.75,2220,7224,1.0,0.0,2.0,3,8,2040,180,1975,0,98177,47.773999999999994,-122.384,2540,9990,12,1,2014,UNK,-320,-2766
1220069035,11/20/2014,438950.0,4,2.5,2470,385506,2.0,0.0,3.0,3,7,2470,0,1991,0,98022,47.2396,-121.993,1680,158994,11,20,2014,UNK,790,226512
7466900320,3/4/2015,242000.0,3,1.75,1300,9856,1.0,0.0,0.0,4,7,1300,0,1962,0,98003,47.3448,-122.29799999999999,1400,9600,3,4,2015,UNK,-100,256
8078430030,7/16/2014,560000.0,3,2.5,1960,9686,1.0,0.0,0.0,3,8,1460,500,1989,0,98074,47.6339,-122.02600000000001,1960,8254,7,16,2014,UNK,0,1432
9523100550,10/3/2014,857500.0,3,1.5,2040,3960,2.0,0.0,2.0,5,8,2040,0,1928,0,98103,47.6658,-122.355,1540,3400,10,3,2014,UNK,500,560
8961970510,5/6/2014,685000.0,4,2.5,3030,7864,2.0,0.0,0.0,3,9,3030,0,1999,0,98074,47.6075,-122.01700000000001,2790,7034,5,6,2014,UNK,240,830
3574800810,4/3/2015,486000.0,4,3.0,2260,7336,2.0,0.0,0.0,4,7,2260,0,1977,0,98034,47.7297,-122.219,2200,7724,4,3,2015,UNK,60,-388
7732410390,6/5/2014,749000.0,3,2.5,2670,10338,2.0,0.0,0.0,3,9,2670,0,1987,0,98007,47.6599,-122.146,2670,8866,6,5,2014,UNK,0,1472
7697870700,11/14/2014,260000.0,3,2.5,1520,6298,2.0,0.0,0.0,3,7,1520,0,1986,0,98030,47.3687,-122.182,1670,7207,11,14,2014,UNK,-150,-909
9275702405,1/14/2015,1020000.0,3,1.75,3610,8502,1.5,0.0,2.0,3,10,2610,1000,1930,0,98126,47.583,-122.37899999999999,2900,5016,1,14,2015,UNK,710,3486
1370804461,3/10/2015,565000.0,3,1.75,1130,5111,1.0,0.0,0.0,4,7,930,200,1942,0,98199,47.6379,-122.4,1360,4424,3,10,2015,UNK,-230,687
4310702440,10/14/2014,355000.0,3,2.0,1480,2502,2.0,0.0,0.0,3,7,1480,0,1991,0,98103,47.6969,-122.338,1850,5000,10,14,2014,UNK,-370,-2498
3935900030,7/30/2014,775000.0,5,2.0,3540,9970,2.0,0.0,3.0,3,9,3540,0,1970,0,98125,47.7108,-122.277,2280,7195,7,30,2014,UNK,1260,2775
6385800030,4/22/2015,335000.0,4,2.25,2100,7305,1.0,0.0,0.0,4,7,1050,1050,1963,0,98188,47.4676,-122.296,1760,7308,4,22,2015,UNK,340,-3
1193000390,6/20/2014,1300000.0,5,4.0,3366,7800,2.5,0.0,2.0,3,8,2966,400,1937,0,98199,47.6466,-122.391,2340,6000,6,20,2014,UNK,1026,1800
8605900060,6/3/2014,545000.0,3,1.75,1810,3000,1.5,0.0,0.0,4,7,1810,0,1903,0,98107,47.6599,-122.363,1140,3000,6,3,2014,UNK,670,0
3964400160,11/18/2014,540000.0,3,1.75,1680,4240,1.5,0.0,0.0,4,7,1680,0,1926,0,98144,47.5745,-122.311,1460,4240,11,18,2014,UNK,220,0
1455600045,9/15/2014,687500.0,3,1.75,2450,9377,1.0,0.0,2.0,4,8,1540,910,1962,0,98125,47.7296,-122.28399999999999,2520,9725,9,15,2014,UNK,-70,-348
4031000520,7/8/2014,115000.0,1,2.0,1150,9812,1.0,0.0,0.0,4,7,1150,0,1962,0,98001,47.2951,-122.28399999999999,1200,9812,7,8,2014,UNK,-50,0
4031000520,11/25/2014,227000.0,1,2.0,1150,9812,1.0,0.0,0.0,4,7,1150,0,1962,0,98001,47.2951,-122.28399999999999,1200,9812,11,25,2014,UNK,-50,0
3299610240,4/29/2015,870000.0,4,2.5,3240,7621,2.0,0.0,2.0,3,9,3240,0,2003,0,98075,47.5641,-122.03200000000001,4610,7150,4,29,2015,UNK,-1370,471
1727850350,11/12/2014,1190000.0,4,2.5,3480,12164,1.5,0.0,0.0,4,11,3480,0,1984,0,98005,47.6404,-122.171,3960,16855,11,12,2014,UNK,-480,-4691
5416510990,9/10/2014,375000.0,4,2.5,2800,5000,2.0,0.0,0.0,3,9,2800,0,2006,0,98038,47.3596,-122.036,2960,5092,9,10,2014,N,-160,-92
4154303215,8/28/2014,902000.0,3,2.75,3240,7200,1.0,0.0,2.0,3,8,1620,1620,1960,0,98118,47.567,-122.273,2700,7200,8,28,2014,UNK,540,0
421000465,6/17/2014,269500.0,2,1.5,1480,7276,1.0,0.0,0.0,4,6,940,540,1978,0,98056,47.4942,-122.166,1090,6710,6,17,2014,UNK,390,566
9164100105,3/10/2015,570000.0,3,1.0,1700,4750,1.5,0.0,0.0,4,6,1200,500,1909,0,98117,47.6819,-122.389,1550,4750,3,10,2015,UNK,150,0
6300000320,8/21/2014,359950.0,2,1.0,1240,7590,1.0,0.0,0.0,4,7,1040,200,1939,0,98133,47.7061,-122.34,1190,5692,8,21,2014,UNK,50,1898
824059324,3/25/2015,1450000.0,4,3.5,3720,8301,2.0,0.0,0.0,3,10,2880,840,2008,0,98004,47.5885,-122.199,2080,9676,3,25,2015,N,1640,-1375
259900320,7/17/2014,615000.0,3,2.5,1910,3427,2.0,0.0,0.0,3,8,1910,0,2001,0,98052,47.6324,-122.11,2240,3720,7,17,2014,UNK,-330,-293
7888200140,6/4/2014,250000.0,4,2.0,2120,8701,1.5,0.0,0.0,4,7,2120,0,1960,0,98198,47.3722,-122.30799999999999,1720,8527,6,4,2014,UNK,400,174
7852130550,9/16/2014,530000.0,4,2.5,3020,6788,2.0,0.0,0.0,3,7,3020,0,2002,0,98065,47.5346,-121.881,2640,5325,9,16,2014,UNK,380,1463
2824089053,1/27/2015,474950.0,3,2.0,2250,222156,1.0,0.0,0.0,3,7,2250,0,1987,0,98065,47.542,-121.792,2110,121968,1,27,2015,UNK,140,100188
3935900350,2/22/2015,490000.0,4,2.0,1650,6480,2.0,0.0,0.0,5,7,1650,0,1947,0,98125,47.7117,-122.286,1650,6350,2,22,2015,UNK,0,130
5347200162,5/28/2014,210000.0,2,1.5,880,1157,2.0,0.0,0.0,3,7,880,0,2007,0,98126,47.5188,-122.376,1070,1203,5,28,2014,N,-190,-46
1953400520,11/14/2014,265500.0,3,1.0,1860,9225,1.0,0.0,0.0,3,7,1860,0,1957,0,98198,47.3904,-122.3,1740,12204,11,14,2014,UNK,120,-2979
1251200045,6/20/2014,1460000.0,5,3.25,3840,4800,3.0,0.0,3.0,3,10,2750,1090,2008,0,98144,47.5929,-122.29,2060,4800,6,20,2014,N,1780,0
1858600012,6/5/2014,310000.0,4,2.25,2192,12128,2.0,0.0,0.0,3,8,2192,0,2006,0,98030,47.3644,-122.2,1914,4649,6,5,2014,N,278,7479
4307310400,4/9/2015,324500.0,3,2.5,1590,4108,2.0,0.0,0.0,3,7,1590,0,2003,0,98056,47.4832,-122.181,2160,3912,4,9,2015,UNK,-570,196
6708200320,9/29/2014,599000.0,4,4.75,3700,11000,1.0,0.0,0.0,4,7,1840,1860,1962,0,98028,47.768,-122.251,1720,11564,9,29,2014,UNK,1980,-564
1473060030,7/9/2014,525000.0,4,2.5,3670,9958,2.0,0.0,0.0,3,10,3670,0,2005,0,98058,47.4617,-122.15899999999999,3300,10679,7,9,2014,N,370,-721
6163901382,5/15/2014,400000.0,3,1.0,1630,10304,1.0,0.0,0.0,5,7,1630,0,1953,0,98155,47.7548,-122.31700000000001,1480,8515,5,15,2014,UNK,150,1789
617000030,12/23/2014,887500.0,3,3.0,4230,54977,2.0,0.0,3.0,3,9,3780,450,1951,2000,98166,47.4176,-122.34299999999999,2880,27201,12,23,2014,Y,1350,27776
2887700875,7/23/2014,344000.0,2,1.0,1060,3325,1.5,0.0,0.0,4,6,770,290,1932,0,98115,47.6896,-122.307,1820,4275,7,23,2014,UNK,-760,-950
9465910030,5/15/2014,525000.0,3,2.5,2700,7434,2.0,0.0,0.0,3,9,2700,0,1991,0,98072,47.7434,-122.17399999999999,2660,8405,5,15,2014,UNK,40,-971
6918710340,8/22/2014,385000.0,3,2.25,2110,8000,2.0,0.0,0.0,3,8,2110,0,1975,0,98034,47.7311,-122.204,1740,7270,8,22,2014,UNK,370,730
629810560,12/17/2014,820000.0,4,2.5,3720,8633,2.0,0.0,0.0,3,10,3720,0,1999,0,98074,47.6085,-122.01299999999999,3515,9660,12,17,2014,UNK,205,-1027
1025039320,4/27/2015,1310000.0,4,3.5,3440,5000,2.0,0.0,0.0,3,11,2560,880,2006,0,98199,47.6672,-122.40899999999999,3090,10241,4,27,2015,N,350,-5241
3575200030,7/29/2014,549000.0,4,2.25,2420,59800,1.0,0.0,0.0,4,8,1350,1070,1985,0,98074,47.6206,-122.056,2160,17598,7,29,2014,UNK,260,42202
3298701070,2/25/2015,180000.0,3,1.0,1090,6771,1.5,0.0,0.0,3,7,1090,0,1929,0,98106,47.5177,-122.353,1230,4662,2,25,2015,UNK,-140,2109
7852011040,5/21/2014,589000.0,4,2.5,2910,5776,2.0,0.0,2.0,3,8,2910,0,1998,0,98065,47.5388,-121.87,2550,6750,5,21,2014,UNK,360,-974
1705400350,1/27/2015,350000.0,3,1.0,1050,5518,1.0,0.0,0.0,3,7,1050,0,1948,0,98118,47.5564,-122.27799999999999,1490,4269,1,27,2015,UNK,-440,1249
7682200320,4/9/2015,197400.0,3,2.0,1610,7575,1.0,0.0,0.0,4,7,1110,500,1965,0,98003,47.333999999999996,-122.3,1920,8400,4,9,2015,UNK,-310,-825
3814701090,8/6/2014,267000.0,3,2.5,1760,6477,2.0,0.0,0.0,4,8,1760,0,1986,0,98030,47.3731,-122.17200000000001,1890,6800,8,6,2014,UNK,-130,-323
8099800340,12/24/2014,480000.0,3,1.5,1540,20281,1.0,0.0,0.0,3,7,1540,0,1977,0,98075,47.5817,-122.007,1710,21090,12,24,2014,UNK,-170,-809
5418200340,10/13/2014,650000.0,4,2.5,2580,9450,1.0,0.0,0.0,4,8,1660,920,1959,0,98125,47.703,-122.28,2060,9450,10,13,2014,UNK,520,0
2767601805,2/13/2015,600000.0,2,1.0,1370,5000,1.5,0.0,0.0,3,7,1370,0,1905,0,98107,47.6744,-122.383,1500,5000,2,13,2015,UNK,-130,0
8682280340,4/30/2015,490000.0,2,1.75,1440,6265,1.0,0.0,0.0,3,8,1440,0,2005,0,98053,47.7028,-122.01299999999999,1810,5209,4,30,2015,N,-370,1056
1432900030,11/21/2014,225000.0,3,1.0,1410,7700,1.0,0.0,0.0,3,7,980,430,1962,0,98058,47.4577,-122.171,1510,7700,11,21,2014,UNK,-100,0
1546600125,7/3/2014,640000.0,3,2.25,1980,10115,1.0,0.0,0.0,3,8,1980,0,1959,0,98005,47.6384,-122.17399999999999,2800,10143,7,3,2014,UNK,-820,-28
7560000070,6/10/2014,710000.0,3,3.5,2440,3427,2.0,0.0,0.0,3,7,1990,450,2000,0,98005,47.589,-122.165,2440,2601,6,10,2014,UNK,0,826
2130200160,6/9/2014,325000.0,3,2.0,1350,11805,1.0,0.0,0.0,3,7,1350,0,1986,0,98019,47.7313,-121.971,1350,14200,6,9,2014,UNK,0,-2395
9238430140,7/25/2014,595000.0,3,3.25,3130,28001,1.0,0.0,0.0,3,9,2210,920,1985,0,98072,47.7741,-122.12200000000001,2710,34999,7,25,2014,UNK,420,-6998
7116000350,7/18/2014,128750.0,3,1.0,880,7004,1.0,0.0,0.0,3,5,880,0,1950,0,98002,47.3019,-122.21600000000001,880,7828,7,18,2014,UNK,0,-824
4039500390,10/17/2014,465000.0,3,2.25,1920,7300,1.0,0.0,0.0,3,7,1240,680,1961,0,98008,47.6078,-122.12799999999999,1920,7700,10,17,2014,UNK,0,-400
8031700186,7/26/2014,710000.0,4,1.75,2700,7625,1.0,0.0,0.0,4,8,1450,1250,1937,0,98115,47.6838,-122.323,1760,3300,7,26,2014,UNK,940,4325
7625702505,3/6/2015,605000.0,4,2.75,1670,6000,1.0,0.0,0.0,5,7,840,830,1917,0,98136,47.5496,-122.385,1100,6000,3,6,2015,UNK,570,0
7511000140,8/8/2014,994000.0,4,2.5,3470,20445,2.0,0.0,0.0,4,10,3470,0,1963,0,98040,47.547,-122.219,3360,21950,8,8,2014,UNK,110,-1505
3191000030,6/19/2014,489950.0,3,2.25,1820,7326,2.0,0.0,0.0,3,8,1820,0,1983,0,98034,47.7133,-122.21700000000001,2430,7696,6,19,2014,UNK,-610,-370
6150700394,5/6/2014,365000.0,3,1.5,1310,8160,1.0,0.0,0.0,3,7,1310,0,1950,0,98133,47.7291,-122.339,1090,7560,5,6,2014,UNK,220,600
1786640030,2/2/2015,359950.0,3,2.0,1790,7212,1.0,0.0,0.0,4,8,1790,0,1998,0,98042,47.3898,-122.154,2330,7212,2,2,2015,UNK,-540,0
7708200400,9/29/2014,495000.0,4,2.5,2460,4774,2.0,0.0,0.0,3,8,2460,0,2006,0,98059,47.4912,-122.145,2510,4399,9,29,2014,N,-50,375
4406000390,5/21/2014,255000.0,3,1.5,1060,9039,1.0,0.0,0.0,3,7,1060,0,1973,0,98058,47.4293,-122.15100000000001,1410,9515,5,21,2014,UNK,-350,-476
1926059094,8/12/2014,330000.0,3,1.75,1340,10276,1.0,0.0,0.0,4,7,1340,0,1961,0,98034,47.7207,-122.22200000000001,2950,7987,8,12,2014,UNK,-1610,2289
9413500350,7/7/2014,450000.0,3,1.75,1480,8394,1.0,0.0,0.0,4,8,1480,0,1971,0,98052,47.6634,-122.14399999999999,1920,9184,7,7,2014,UNK,-440,-790
7853240310,3/18/2015,655000.0,4,2.5,3500,11306,2.0,0.0,2.0,3,9,3500,0,2005,0,98065,47.5428,-121.861,3180,8028,3,18,2015,N,320,3278
5152800030,4/21/2015,485000.0,4,2.75,2910,16362,1.0,0.0,2.0,4,9,2120,790,1969,0,98003,47.3397,-122.322,2850,14904,4,21,2015,UNK,60,1458
1775950030,8/12/2014,375000.0,4,1.75,1940,15909,1.0,0.0,0.0,3,8,970,970,1974,0,98072,47.7578,-122.094,1940,15120,8,12,2014,UNK,0,789
4221250320,10/17/2014,570000.0,4,2.5,2280,4534,2.0,0.0,0.0,3,8,2280,0,2003,0,98075,47.5902,-122.01799999999999,2246,4534,10,17,2014,UNK,34,0
6749700117,4/23/2015,350000.0,3,2.25,1190,1022,3.0,0.0,0.0,3,8,1190,0,1998,0,98103,47.6972,-122.34899999999999,1210,1171,4,23,2015,UNK,-20,-149
290000075,2/25/2015,550000.0,3,1.0,1260,6000,1.0,0.0,3.0,3,7,1260,0,1951,0,98146,47.5058,-122.384,2020,6600,2,25,2015,UNK,-760,-600
1842100160,7/31/2014,513000.0,5,2.0,2270,8652,1.0,0.0,0.0,3,7,1150,1120,1965,0,98052,47.6692,-122.15100000000001,1950,8050,7,31,2014,UNK,320,602
4365200055,12/5/2014,450000.0,4,2.25,1990,7320,1.0,0.0,0.0,4,7,1030,960,1965,0,98126,47.5237,-122.376,1320,7320,12,5,2014,UNK,670,0
3644100030,2/9/2015,432500.0,4,1.75,1500,1856,1.0,0.0,0.0,5,7,750,750,1901,0,98144,47.5917,-122.296,1220,1739,2,9,2015,UNK,280,117
3220079017,2/13/2015,432000.0,5,2.75,2060,329903,1.5,0.0,3.0,5,7,2060,0,1989,0,98022,47.1776,-121.944,2240,220232,2,13,2015,UNK,-180,109671
8121200710,1/23/2015,480000.0,3,2.25,1950,8892,2.0,0.0,0.0,3,8,1950,0,1983,0,98052,47.7213,-122.11,1900,8750,1,23,2015,UNK,50,142
3574801740,7/28/2014,402200.0,3,1.75,1790,6980,1.0,0.0,0.0,3,7,1330,460,1980,0,98034,47.7311,-122.226,1770,8081,7,28,2014,UNK,20,-1101
644000102,4/13/2015,650000.0,3,1.0,1520,10227,1.0,0.0,0.0,4,6,1520,0,1951,0,98004,47.5872,-122.196,2710,10912,4,13,2015,UNK,-1190,-685
5315100784,4/24/2015,1200000.0,4,2.5,3240,13044,2.0,0.0,0.0,4,9,3240,0,1984,0,98040,47.5825,-122.242,2920,13044,4,24,2015,UNK,320,0
9578200030,7/28/2014,312000.0,3,2.0,2440,13250,1.0,0.0,0.0,4,8,1440,1000,1977,0,98030,47.375,-122.227,2400,10650,7,28,2014,UNK,40,2600
2313900810,4/2/2015,610000.0,4,2.0,2220,5821,1.5,0.0,0.0,4,7,1380,840,1916,0,98116,47.5723,-122.382,1850,5000,4,2,2015,UNK,370,821
1623300055,3/23/2015,823000.0,5,1.75,2640,7722,1.5,0.0,0.0,4,7,1650,990,1915,0,98117,47.6802,-122.361,1750,4000,3,23,2015,UNK,890,3722
9191200435,11/13/2014,471000.0,4,1.75,1450,3750,1.0,0.0,0.0,4,7,950,500,1925,0,98105,47.6706,-122.3,1850,4000,11,13,2014,UNK,-400,-250
2591020560,7/2/2014,481015.0,3,2.25,1550,5511,2.0,0.0,0.0,3,8,1550,0,1987,0,98033,47.6946,-122.185,1620,5511,7,2,2014,UNK,-70,0
1923000260,10/15/2014,1960000.0,5,4.5,6200,23373,3.0,0.0,1.0,4,11,5050,1150,1988,0,98040,47.5632,-122.215,3700,14486,10,15,2014,UNK,2500,8887
2193300390,9/23/2014,624000.0,4,3.25,2810,11250,1.0,0.0,0.0,3,8,1680,1130,1980,0,98052,47.692,-122.09899999999999,2110,11250,9,23,2014,UNK,700,0
7016200030,3/20/2015,480000.0,4,2.5,2080,7966,1.0,0.0,0.0,3,7,1200,880,1970,0,98011,47.7393,-122.181,1920,7500,3,20,2015,UNK,160,466
727500030,7/15/2014,815000.0,3,1.5,1370,8671,1.0,0.0,0.0,3,7,1370,0,1955,0,98004,47.6217,-122.198,1580,8671,7,15,2014,UNK,-210,0
1651800030,8/29/2014,1650000.0,4,2.25,2920,20400,1.0,0.0,0.0,4,11,2920,0,1966,0,98004,47.6237,-122.228,3080,20400,8,29,2014,UNK,-160,0
623049094,5/16/2014,180000.0,3,1.0,1000,18513,1.0,0.0,0.0,3,6,1000,0,1940,0,98146,47.5118,-122.348,1280,8113,5,16,2014,UNK,-280,10400
2538800030,2/17/2015,156601.0,2,1.75,1210,9750,1.0,0.0,0.0,3,7,1210,0,1984,0,98038,47.3438,-122.037,1650,9750,2,17,2015,UNK,-440,0
7714000310,7/19/2014,374950.0,4,2.5,2790,4650,2.0,0.0,0.0,3,8,2790,0,2004,0,98038,47.3557,-122.02600000000001,2850,4650,7,19,2014,N,-60,0
254000075,5/19/2014,368000.0,2,1.5,1660,4680,1.0,0.0,0.0,5,6,830,830,1908,0,98146,47.5134,-122.38799999999999,1930,5400,5,19,2014,UNK,-270,-720
1257201375,12/2/2014,550000.0,3,2.0,1650,3952,2.0,0.0,0.0,3,7,1650,0,1950,0,98103,47.6727,-122.33,1210,4560,12,2,2014,UNK,440,-608
8856004582,7/17/2014,198000.0,3,1.75,1300,6318,1.0,0.0,0.0,3,7,1300,0,1980,0,98001,47.2752,-122.251,1150,8002,7,17,2014,UNK,150,-1684
3205400240,5/13/2014,345000.0,3,1.75,1090,7200,1.0,0.0,0.0,3,7,1090,0,1968,0,98034,47.7227,-122.179,1240,7200,5,13,2014,UNK,-150,0
3738000070,3/9/2015,1710000.0,5,2.5,2660,6572,1.0,0.0,0.0,5,9,1960,700,1959,0,98039,47.6176,-122.223,3960,14595,3,9,2015,UNK,-1300,-8023
8856001090,1/30/2015,185900.0,3,1.0,940,10890,1.0,0.0,0.0,4,5,940,0,1909,0,98001,47.2763,-122.257,1370,10255,1,30,2015,UNK,-430,635
3224500240,6/17/2014,950000.0,3,2.75,2750,18029,1.0,0.0,2.0,5,9,1810,940,1978,0,98006,47.5617,-122.134,2850,10021,6,17,2014,UNK,-100,8008
4139460390,6/20/2014,995000.0,4,4.5,3850,13551,2.0,0.0,2.0,3,10,3000,850,1998,0,98006,47.5522,-122.103,3480,10737,6,20,2014,UNK,370,2814
3531900060,8/2/2014,345000.0,2,1.0,860,8250,1.0,0.0,0.0,3,7,860,0,1940,0,98133,47.7132,-122.334,1780,11200,8,2,2014,UNK,-920,-2950
4457300135,11/5/2014,741000.0,4,2.75,2070,10125,1.0,0.0,0.0,3,7,1390,680,1962,0,98040,47.5697,-122.219,1850,10125,11,5,2014,UNK,220,0
8682292090,7/9/2014,737000.0,2,2.25,2290,9772,1.0,0.0,0.0,3,8,2290,0,2007,0,98053,47.7199,-122.025,1810,6077,7,9,2014,N,480,3695
7278700069,5/21/2014,668750.0,4,2.5,2340,6420,1.0,0.0,2.0,3,8,1590,750,1964,0,98177,47.7728,-122.38600000000001,2110,10856,5,21,2014,UNK,230,-4436
5710610800,7/2/2014,575000.0,3,1.75,2680,8625,1.0,0.0,0.0,5,8,1590,1090,1974,0,98027,47.5316,-122.056,2620,14275,7,2,2014,UNK,60,-5650
8651443420,10/17/2014,280000.0,4,2.0,1710,5440,1.0,0.0,0.0,5,8,1030,680,1976,0,98042,47.36600000000001,-122.09299999999999,1620,6696,10,17,2014,UNK,90,-1256
7751800070,8/4/2014,583000.0,3,1.5,1800,10050,1.0,0.0,0.0,3,7,1800,0,1955,0,98008,47.6344,-122.126,1610,10050,8,4,2014,UNK,190,0
2570600140,1/28/2015,196000.0,3,2.25,1510,9600,1.0,0.0,0.0,1,7,1090,420,1966,0,98028,47.7758,-122.238,1870,10681,1,28,2015,UNK,-360,-1081
1565950260,5/15/2014,349950.0,3,2.5,1700,7496,2.0,0.0,0.0,3,8,1700,0,1994,0,98055,47.431999999999995,-122.189,2280,7496,5,15,2014,UNK,-580,0
7550801170,12/11/2014,429000.0,4,1.0,1350,3333,1.5,0.0,0.0,3,7,1350,0,1912,0,98107,47.6727,-122.397,1530,5000,12,11,2014,UNK,-180,-1667
6648701740,2/20/2015,270000.0,5,2.5,2140,10320,1.0,0.0,0.0,4,7,1330,810,1967,0,98031,47.3927,-122.194,2050,8964,2,20,2015,UNK,90,1356
7529500030,9/9/2014,385000.0,6,4.0,2700,7416,1.0,0.0,0.0,3,7,1350,1350,1969,0,98108,47.5525,-122.3,2260,5324,9,9,2014,UNK,440,2092
9523102420,9/22/2014,535000.0,1,1.0,920,5000,1.0,0.0,3.0,4,7,920,0,1906,0,98103,47.6748,-122.352,1890,5000,9,22,2014,UNK,-970,0
7283900521,4/20/2015,352500.0,3,1.75,1500,10269,1.0,0.0,0.0,3,7,1030,470,1958,0,98133,47.7672,-122.348,2090,10269,4,20,2015,UNK,-590,0
7519001275,3/1/2015,624000.0,3,1.75,1510,5200,1.0,0.0,0.0,4,7,860,650,1922,0,98117,47.6864,-122.365,1650,4160,3,1,2015,UNK,-140,1040
1432900350,12/17/2014,215000.0,5,1.5,1980,7958,1.5,0.0,0.0,3,7,1980,0,1962,0,98058,47.4571,-122.17,1510,8438,12,17,2014,UNK,470,-480
1924059248,6/2/2014,870000.0,4,3.0,4500,21780,2.0,0.0,2.0,3,9,3040,1460,1980,0,98040,47.5581,-122.213,3540,20473,6,2,2014,UNK,960,1307
6649500060,7/29/2014,440000.0,4,2.5,3220,8256,2.0,0.0,0.0,3,8,2610,610,2006,0,98059,47.495,-122.155,2500,9472,7,29,2014,N,720,-1216
2254501342,5/5/2015,518000.0,2,1.5,1140,1149,2.0,0.0,0.0,3,7,940,200,2001,0,98122,47.6124,-122.314,1460,1149,5,5,2015,UNK,-320,0
2025700260,3/25/2015,259500.0,3,2.25,1490,7589,2.0,0.0,0.0,3,7,1490,0,1993,0,98038,47.3474,-122.037,1510,6603,3,25,2015,UNK,-20,986
2386000070,10/29/2014,795127.0,4,3.25,4360,91158,1.0,0.0,0.0,3,10,3360,1000,1993,0,98053,47.6398,-121.985,3540,90940,10,29,2014,UNK,820,218
2206500105,8/18/2014,290000.0,3,1.0,960,9000,1.0,0.0,0.0,4,7,960,0,1955,0,98006,47.5765,-122.154,1520,9000,8,18,2014,UNK,-560,0
1953400045,4/23/2015,385000.0,4,3.0,2253,7700,2.0,0.0,0.0,3,7,2253,0,1957,0,98198,47.3935,-122.3,1786,9052,4,23,2015,UNK,467,-1352
3996900575,10/7/2014,259950.0,2,1.0,770,6542,1.0,0.0,0.0,3,6,770,0,1948,0,98155,47.747,-122.301,1120,8149,10,7,2014,UNK,-350,-1607
869700350,4/29/2015,330000.0,2,2.5,1310,2915,2.0,0.0,0.0,3,8,1310,0,1999,0,98059,47.4911,-122.154,1310,3425,4,29,2015,UNK,0,-510
7387500335,12/19/2014,280000.0,3,1.0,980,7480,1.0,0.0,0.0,3,6,830,150,1948,0,98106,47.5206,-122.363,1140,7480,12,19,2014,UNK,-160,0
6795100563,7/1/2014,595000.0,4,2.5,1820,20011,2.0,0.0,0.0,3,8,1820,0,1987,0,98075,47.5842,-122.045,2710,33915,7,1,2014,UNK,-890,-13904
8001470560,11/17/2014,925900.0,4,3.75,3980,7828,2.0,0.0,0.0,3,10,3980,0,2001,0,98074,47.6303,-122.065,3980,8910,11,17,2014,UNK,0,-1082
4140100200,8/8/2014,499000.0,3,2.25,3010,9600,2.0,0.0,0.0,3,8,2410,600,1978,0,98028,47.7671,-122.26299999999999,2620,9660,8,8,2014,UNK,390,-60
7212650510,4/3/2015,325000.0,4,2.5,1830,7762,2.0,0.0,0.0,3,8,1830,0,1993,0,98003,47.266999999999996,-122.31,2109,8966,4,3,2015,UNK,-279,-1204
686800070,6/10/2014,895000.0,5,2.5,2550,20875,1.0,0.0,0.0,4,9,1610,940,1953,0,98004,47.6336,-122.19200000000001,2510,21673,6,10,2014,UNK,40,-798
5126900200,4/29/2015,162248.0,2,1.0,800,8960,1.0,0.0,0.0,4,6,800,0,1944,0,98058,47.4756,-122.17399999999999,850,8082,4,29,2015,UNK,-50,878
6329000070,10/15/2014,1070000.0,3,2.25,2890,21480,2.0,0.0,4.0,3,8,1790,1100,1941,1989,98146,47.5027,-122.381,2110,8107,10,15,2014,Y,780,13373
5430300171,7/3/2014,430000.0,3,1.5,1810,5080,1.0,0.0,0.0,3,7,1030,780,1958,0,98115,47.6819,-122.287,1780,7620,7,3,2014,UNK,30,-2540
5430300171,1/29/2015,615500.0,3,1.5,1810,5080,1.0,0.0,0.0,3,7,1030,780,1958,0,98115,47.6819,-122.287,1780,7620,1,29,2015,UNK,30,-2540
2742100016,4/16/2015,260000.0,3,1.0,940,5650,1.0,0.0,0.0,3,6,940,0,1949,0,98118,47.5551,-122.292,1180,5276,4,16,2015,UNK,-240,374
1324079082,11/17/2014,295000.0,4,2.0,1810,42981,1.0,0.0,0.0,4,7,1810,0,1973,0,98024,47.5597,-121.85,1980,113691,11,17,2014,UNK,-170,-70710
1422200496,9/24/2014,1190000.0,3,1.75,2550,6117,2.0,0.0,0.0,3,9,1650,900,1951,2004,98122,47.6109,-122.285,2100,4967,9,24,2014,Y,450,1150
3754500566,11/20/2014,749950.0,4,2.5,2370,2971,2.0,0.0,2.0,3,9,2080,290,2008,0,98034,47.7064,-122.22399999999999,2970,7500,11,20,2014,N,-600,-4529
5132000140,6/18/2014,175000.0,6,1.0,1370,5080,1.5,0.0,0.0,3,6,1120,250,1931,0,98106,47.5238,-122.35,1020,5080,6,18,2014,UNK,350,0
5132000140,1/20/2015,415000.0,6,1.0,1370,5080,1.5,0.0,0.0,3,6,1120,250,1931,0,98106,47.5238,-122.35,1020,5080,1,20,2015,UNK,350,0
6131600240,11/19/2014,190000.0,3,1.0,1200,8316,1.0,0.0,0.0,4,6,1200,0,1953,0,98002,47.3231,-122.215,1250,8316,11,19,2014,UNK,-50,0
2768000295,4/17/2015,625000.0,3,1.75,2100,3264,1.5,0.0,0.0,5,7,1350,750,1912,0,98107,47.6702,-122.36399999999999,1720,3750,4,17,2015,UNK,380,-486
4046600320,8/26/2014,420000.0,3,2.25,2020,21010,2.0,0.0,0.0,3,7,2020,0,1995,0,98014,47.6988,-121.915,1850,18151,8,26,2014,UNK,170,2859
1598600320,4/16/2015,339900.0,4,1.5,1570,9210,1.0,0.0,2.0,3,7,1400,170,1965,0,98030,47.3864,-122.22,2326,9210,4,16,2015,UNK,-756,0
4140900270,4/27/2015,160000.0,2,1.0,1140,23030,1.0,0.0,0.0,3,8,1140,0,1980,0,98028,47.7637,-122.266,1850,14260,4,27,2015,UNK,-710,8770
5104510060,12/15/2014,353000.0,4,2.5,1830,5331,2.0,0.0,0.0,3,7,1830,0,2002,0,98038,47.3557,-122.016,1830,5175,12,15,2014,UNK,0,156
3578400710,2/6/2015,390000.0,3,2.0,1010,14183,1.0,0.0,0.0,3,8,1010,0,1982,0,98074,47.6232,-122.04299999999999,1750,11700,2,6,2015,UNK,-740,2483
4036400030,3/5/2015,675000.0,4,2.5,1770,9858,1.0,0.0,2.0,3,8,1770,0,1971,0,98155,47.7382,-122.287,2470,9858,3,5,2015,UNK,-700,0
6084200060,3/13/2015,400000.0,3,2.5,2120,3757,2.0,0.0,0.0,3,7,2120,0,2006,0,98059,47.4787,-122.12799999999999,2230,4103,3,13,2015,N,-110,-346
1251200055,6/26/2014,1340000.0,4,3.5,3190,5040,2.0,0.0,3.0,3,10,2160,1030,2003,0,98144,47.5928,-122.29,2390,4800,6,26,2014,UNK,800,240
8964800860,2/9/2015,1650000.0,4,2.5,2780,11904,1.0,0.0,1.0,5,8,1730,1050,1951,0,98004,47.6209,-122.21600000000001,3590,13860,2,9,2015,UNK,-810,-1956
9551200270,8/25/2014,1000000.0,5,3.0,3350,9450,2.0,0.0,0.0,5,8,2180,1170,1912,0,98103,47.6705,-122.34,2660,4500,8,25,2014,UNK,690,4950
3226059128,6/18/2014,850000.0,5,3.5,3450,28324,1.0,0.0,0.0,5,8,2350,1100,1972,0,98033,47.6991,-122.196,2640,14978,6,18,2014,UNK,810,13346
3438500798,7/15/2014,275000.0,3,1.5,1060,6954,1.0,0.0,0.0,4,6,1060,0,1983,0,98106,47.5498,-122.355,1560,6954,7,15,2014,UNK,-500,0
9286100200,8/13/2014,450000.0,3,2.5,1670,2589,2.0,0.0,0.0,3,8,1670,0,2000,0,98027,47.5314,-122.04700000000001,1670,2897,8,13,2014,UNK,0,-308
5151600390,11/13/2014,305000.0,4,1.75,2251,12731,1.0,0.0,1.0,4,8,1390,861,1957,0,98003,47.3369,-122.32,2520,12539,11,13,2014,UNK,-269,192
4172100240,9/2/2014,643002.0,3,2.5,1770,3744,1.5,0.0,0.0,3,7,1270,500,1929,0,98117,47.6807,-122.36399999999999,1400,4680,9,2,2014,UNK,370,-936
5422560830,4/13/2015,468000.0,2,1.75,1510,4500,1.0,0.0,0.0,3,8,1510,0,1978,0,98052,47.6644,-122.13,1740,6000,4,13,2015,UNK,-230,-1500
5104520640,2/20/2015,324950.0,4,2.5,1770,5000,2.0,0.0,0.0,3,7,1770,0,2004,0,98038,47.3506,-122.006,2080,5100,2,20,2015,N,-310,-100
8078550320,3/26/2015,290000.0,3,2.0,1260,7346,1.0,0.0,0.0,3,7,1260,0,1987,0,98031,47.4034,-122.176,1460,7363,3,26,2015,UNK,-200,-17
8099600160,4/29/2015,488500.0,3,2.0,1710,10959,1.0,0.0,0.0,4,7,1030,680,1981,0,98033,47.696999999999996,-122.199,1710,10498,4,29,2015,UNK,0,461
7287700059,8/13/2014,367950.0,3,1.75,2290,8234,1.0,0.0,0.0,4,7,1250,1040,1950,0,98133,47.7611,-122.351,1660,7200,8,13,2014,UNK,630,1034
8862000075,2/20/2015,285000.0,2,1.0,790,6555,1.0,0.0,0.0,2,6,790,0,1956,0,98146,47.5015,-122.35,1440,7601,2,20,2015,UNK,-650,-1046
8887001625,4/10/2015,417000.0,3,2.75,1820,52889,2.0,0.0,0.0,3,8,1820,0,1991,0,98070,47.50100000000001,-122.463,1820,45528,4,10,2015,UNK,0,7361
9464700340,7/8/2014,1120000.0,4,2.5,3180,31931,1.0,0.0,0.0,4,10,2390,790,1978,0,98007,47.6388,-122.149,3180,35007,7,8,2014,UNK,0,-3076
5451300117,4/22/2015,1550000.0,4,4.0,5280,17677,2.0,0.0,3.0,3,11,3220,2060,1978,0,98040,47.5323,-122.238,3470,17474,4,22,2015,UNK,1810,203
587550340,5/2/2014,604000.0,3,2.5,3240,33151,2.0,0.0,2.0,3,10,3240,0,1995,0,98023,47.3256,-122.37799999999999,4050,24967,5,2,2014,UNK,-810,8184
2591820070,4/28/2015,380000.0,3,2.5,2390,8102,2.0,0.0,0.0,4,8,2390,0,1986,0,98058,47.4378,-122.16,2310,8606,4,28,2015,UNK,80,-504
6679000960,11/16/2014,336500.0,4,2.5,2500,5264,2.0,0.0,0.0,3,7,2500,0,2003,0,98038,47.3853,-122.02799999999999,1960,5250,11,16,2014,UNK,540,14
9138100350,2/18/2015,685000.0,4,2.0,2290,6000,1.5,0.0,3.0,5,7,2290,0,1900,0,98115,47.6807,-122.318,2000,3150,2,18,2015,UNK,290,2850
6065300370,5/6/2015,4210000.0,5,6.0,7440,21540,2.0,0.0,0.0,3,12,5550,1890,2003,0,98006,47.5692,-122.189,4740,19329,5,6,2015,UNK,2700,2211
5315100393,12/11/2014,670000.0,3,1.0,1600,16868,1.0,0.0,1.0,3,7,990,610,1946,0,98040,47.5872,-122.241,2600,12735,12,11,2014,UNK,-1000,4133
5244800695,6/16/2014,524000.0,2,1.0,1120,2000,1.5,0.0,0.0,3,7,1120,0,1910,0,98109,47.6454,-122.354,1500,4000,6,16,2014,UNK,-380,-2000
3584000400,12/11/2014,172000.0,3,1.0,1340,10260,1.0,0.0,0.0,3,7,1340,0,1968,0,98003,47.3173,-122.31700000000001,1250,8775,12,11,2014,UNK,90,1485
6746701090,6/19/2014,680000.0,6,2.0,1670,3000,1.0,0.0,0.0,5,7,900,770,1911,0,98105,47.6637,-122.316,1330,1099,6,19,2014,UNK,340,1901
2421059017,5/23/2014,549900.0,4,3.0,2830,213879,2.0,0.0,0.0,4,8,2830,0,1987,0,98092,47.2925,-122.10700000000001,2250,213008,5,23,2014,UNK,580,871
4053200926,12/5/2014,357000.0,4,2.75,2700,49428,1.0,0.0,0.0,4,9,2700,0,1988,0,98042,47.3168,-122.079,2728,85905,12,5,2014,UNK,-28,-36477
7899800045,8/28/2014,107000.0,3,1.5,910,5120,1.0,0.0,0.0,3,6,910,0,1973,0,98106,47.5238,-122.35600000000001,1410,5132,8,28,2014,UNK,-500,-12
7899800045,12/2/2014,232900.0,3,1.5,910,5120,1.0,0.0,0.0,3,6,910,0,1973,0,98106,47.5238,-122.35600000000001,1410,5132,12,2,2014,UNK,-500,-12
9482700075,1/12/2015,800000.0,4,3.5,2370,3302,2.0,0.0,0.0,3,8,1610,760,1926,2014,98103,47.684,-122.34100000000001,2170,3800,1,12,2015,Y,200,-498
6300000368,3/27/2015,248500.0,2,1.5,880,1498,2.0,0.0,0.0,3,7,880,0,1999,0,98133,47.7063,-122.34200000000001,880,5060,3,27,2015,UNK,0,-3562
5135000160,6/12/2014,670000.0,3,2.5,2050,6420,1.0,0.0,3.0,3,8,1730,320,1956,0,98116,47.5708,-122.405,2370,7620,6,12,2014,UNK,-320,-1200
1022069050,2/27/2015,207000.0,3,1.75,1180,21275,1.0,0.0,0.0,4,6,1180,0,1958,0,98038,47.4018,-122.037,1490,35100,2,27,2015,UNK,-310,-13825
2599000370,11/3/2014,164000.0,3,1.0,1070,8250,1.0,0.0,0.0,3,7,1070,0,1961,0,98092,47.2899,-122.19200000000001,1190,8250,11,3,2014,UNK,-120,0
2652500126,2/17/2015,570500.0,2,1.0,1380,1800,2.0,0.0,0.0,3,7,1080,300,1954,0,98119,47.6416,-122.361,1600,3600,2,17,2015,UNK,-220,-1800
2923500550,6/25/2014,599990.0,3,2.25,2680,9162,1.0,0.0,0.0,3,8,1570,1110,1978,0,98027,47.5683,-122.09100000000001,2480,8261,6,25,2014,UNK,200,901
3760100200,10/6/2014,395000.0,5,1.75,2100,9599,1.0,0.0,0.0,3,7,1060,1040,1961,0,98034,47.7097,-122.21600000000001,1680,10712,10,6,2014,UNK,420,-1113
1226069045,8/27/2014,979500.0,4,3.75,4133,361548,2.0,0.0,0.0,3,11,4133,0,2000,0,98019,47.7479,-121.97200000000001,1970,291416,8,27,2014,UNK,2163,70132
3935900232,9/29/2014,207000.0,3,1.0,920,5546,1.0,0.0,0.0,2,6,920,0,1928,0,98125,47.7114,-122.28399999999999,1300,5546,9,29,2014,UNK,-380,0
3935900232,1/12/2015,237000.0,3,1.0,920,5546,1.0,0.0,0.0,2,6,920,0,1928,0,98125,47.7114,-122.28399999999999,1300,5546,1,12,2015,UNK,-380,0
224069105,4/10/2015,650100.0,2,1.0,1750,60872,1.0,0.0,0.0,4,7,1180,570,1973,0,98075,47.5946,-122.006,2480,5425,4,10,2015,UNK,-730,55447
8087800400,12/1/2014,385000.0,4,2.5,1950,7350,1.0,0.0,0.0,3,7,1150,800,1963,0,98052,47.65600000000001,-122.134,2050,9068,12,1,2014,UNK,-100,-1718
723049301,8/13/2014,335000.0,2,1.75,1660,11437,2.0,0.0,0.0,3,7,1660,0,1958,1992,98146,47.4899,-122.339,1290,7860,8,13,2014,Y,370,3577
4136920030,5/24/2014,347000.0,4,1.5,2670,10026,2.0,0.0,0.0,3,8,2670,0,1996,0,98092,47.2659,-122.215,2420,11900,5,24,2014,UNK,250,-1874
7686203385,3/26/2015,204000.0,3,1.0,980,8000,1.0,0.0,0.0,4,6,980,0,1954,0,98198,47.42,-122.31700000000001,1240,8000,3,26,2015,UNK,-260,0
7922710520,5/7/2015,615000.0,4,2.25,1780,10260,2.0,0.0,0.0,3,8,1780,0,1971,0,98052,47.6647,-122.14200000000001,2360,10080,5,7,2015,UNK,-580,180
824059293,10/28/2014,943500.0,3,2.25,2370,10890,2.0,0.0,0.0,4,7,2370,0,1980,0,98004,47.5827,-122.197,2370,9514,10,28,2014,UNK,0,1376
3959400335,4/23/2015,560000.0,3,2.0,1640,7333,1.0,0.0,0.0,4,7,1020,620,1941,0,98108,47.5636,-122.316,2130,4933,4,23,2015,UNK,-490,2400
6072760390,4/7/2015,547500.0,4,2.5,2610,7254,1.0,0.0,0.0,2,8,1610,1000,1975,0,98006,47.5618,-122.176,2250,7407,4,7,2015,UNK,360,-153
2787700030,10/10/2014,359500.0,4,1.75,2030,7210,1.0,0.0,0.0,3,7,1450,580,1968,0,98059,47.5067,-122.164,1750,8387,10,10,2014,UNK,280,-1177
6446200060,4/1/2015,660000.0,3,2.5,2590,35640,1.0,0.0,0.0,3,9,2590,0,1987,0,98029,47.5516,-122.03,2590,31200,4,1,2015,UNK,0,4440
1545800710,5/23/2014,258000.0,3,1.75,1620,7540,1.0,0.0,0.0,3,7,1310,310,1988,0,98038,47.3635,-122.052,1580,7540,5,23,2014,UNK,40,0
3522059196,6/27/2014,355000.0,3,1.75,2040,22693,1.0,0.0,0.0,4,8,2040,0,1980,0,98042,47.3519,-122.14,1950,6280,6,27,2014,UNK,90,16413
4365200186,6/6/2014,253500.0,2,1.0,810,4800,1.0,0.0,0.0,3,7,810,0,1948,0,98126,47.5232,-122.375,1240,7740,6,6,2014,UNK,-430,-2940
2064800890,4/15/2015,422500.0,3,1.0,1270,8920,1.0,0.0,0.0,5,7,1270,0,1969,0,98056,47.534,-122.17200000000001,1590,8589,4,15,2015,UNK,-320,331
9268710390,11/13/2014,239000.0,2,2.0,1470,2052,1.5,0.0,0.0,3,7,1470,0,1986,0,98003,47.3086,-122.32799999999999,1470,2052,11,13,2014,UNK,0,0
2273600260,4/3/2015,628000.0,3,2.25,1720,8521,1.0,0.0,0.0,4,7,1140,580,1984,0,98033,47.6882,-122.184,1530,8692,4,3,2015,UNK,190,-171
9206950200,3/10/2015,352000.0,2,2.5,1320,1957,1.0,0.0,0.0,3,8,660,660,2004,0,98106,47.5364,-122.365,1420,2198,3,10,2015,N,-100,-241
2291400341,2/3/2015,311600.0,3,2.25,1358,1196,3.0,0.0,0.0,3,7,1358,0,2007,0,98133,47.7052,-122.346,1358,1196,2,3,2015,N,0,0
1311400350,10/9/2014,235000.0,4,1.5,2070,7245,1.0,0.0,0.0,4,7,1060,1010,1964,0,98001,47.3417,-122.281,1450,7350,10,9,2014,UNK,620,-105
191100810,8/11/2014,870000.0,5,2.25,2910,9525,2.0,0.0,0.0,4,9,2910,0,1968,0,98040,47.5633,-122.21799999999999,2740,9525,8,11,2014,UNK,170,0
7895500550,3/19/2015,190848.0,4,1.5,1370,7904,1.0,0.0,0.0,3,7,900,470,1970,0,98001,47.3344,-122.28,1370,7900,3,19,2015,UNK,0,4
9221400335,10/1/2014,570000.0,4,1.75,2340,5080,1.0,0.0,0.0,5,7,1170,1170,1924,0,98115,47.6746,-122.32,1270,3270,10,1,2014,UNK,1070,1810
6087100070,5/23/2014,661254.0,4,4.0,2290,6250,1.5,0.0,0.0,5,7,1690,600,1940,0,98116,47.5824,-122.384,1920,4335,5,23,2014,UNK,370,1915
3052700695,5/7/2014,575000.0,4,2.0,1650,5000,1.0,0.0,0.0,3,7,1650,0,1955,0,98117,47.6781,-122.374,1690,2276,5,7,2014,UNK,-40,2724
6150200435,5/13/2014,230000.0,2,0.75,650,5360,1.0,0.0,0.0,4,5,650,0,1931,0,98133,47.7281,-122.335,1110,6700,5,13,2014,UNK,-460,-1340
5423040140,4/2/2015,680000.0,3,2.25,2300,9914,2.0,0.0,0.0,4,8,2300,0,1980,0,98027,47.5677,-122.086,2240,9032,4,2,2015,UNK,60,882
123039336,6/11/2014,148000.0,1,1.0,620,8261,1.0,0.0,0.0,3,5,620,0,1939,0,98106,47.5138,-122.36399999999999,1180,8244,6,11,2014,UNK,-560,17
123039336,12/8/2014,244900.0,1,1.0,620,8261,1.0,0.0,0.0,3,5,620,0,1939,0,98106,47.5138,-122.36399999999999,1180,8244,12,8,2014,UNK,-560,17
1446401290,10/30/2014,214950.0,3,1.0,1400,6600,1.0,0.0,0.0,3,6,1280,120,1954,0,98168,47.4845,-122.331,1730,6600,10,30,2014,UNK,-330,0
8010100135,10/30/2014,580000.0,3,1.5,1800,6250,1.0,0.0,0.0,3,8,1420,380,1947,0,98116,47.5778,-122.389,1800,5625,10,30,2014,UNK,0,625
8899000140,8/28/2014,263000.0,3,1.5,1300,7885,1.0,0.0,0.0,3,7,1300,0,1968,0,98055,47.4556,-122.209,1840,7600,8,28,2014,UNK,-540,285
2172000570,6/24/2014,317000.0,5,2.5,2360,11375,1.0,0.0,0.0,4,7,1180,1180,1962,0,98178,47.4875,-122.255,1160,7800,6,24,2014,UNK,1200,3575
1471701200,10/22/2014,302000.0,4,3.0,3320,13500,1.0,0.0,0.0,3,7,1750,1570,1963,0,98059,47.4596,-122.065,1830,13800,10,22,2014,UNK,1490,-300
9808700370,6/23/2014,899000.0,3,1.0,1480,6978,2.0,0.0,0.0,4,8,1480,0,1949,1985,98004,47.6497,-122.21700000000001,2660,13062,6,23,2014,Y,-1180,-6084
904000045,6/23/2014,1290000.0,3,2.5,2190,11394,1.0,0.0,0.0,3,8,1550,640,1956,0,98199,47.6685,-122.40899999999999,2190,9540,6,23,2014,UNK,0,1854
7680400140,6/26/2014,710000.0,3,3.25,3740,136915,2.5,0.0,0.0,3,11,3100,640,1990,0,98166,47.4549,-122.363,2400,16104,6,26,2014,UNK,1340,120811
3291800140,11/7/2014,230000.0,3,1.0,1360,9310,1.0,0.0,0.0,4,7,1020,340,1980,0,98056,47.4901,-122.185,1480,8330,11,7,2014,UNK,-120,980
3624039074,5/4/2015,430000.0,3,1.0,1210,5200,1.0,0.0,0.0,3,6,1210,0,1941,0,98126,47.53100000000001,-122.37299999999999,890,5200,5,4,2015,UNK,320,0
98001070,8/18/2014,1170000.0,5,4.25,4610,13252,2.0,0.0,4.0,3,11,4610,0,2004,0,98075,47.5878,-121.969,4400,15154,8,18,2014,N,210,-1902
5100402767,10/14/2014,397000.0,3,1.0,860,6380,1.5,0.0,0.0,4,7,860,0,1927,0,98115,47.6942,-122.315,1250,6380,10,14,2014,UNK,-390,0
2826049070,2/25/2015,595000.0,3,2.5,2250,8300,2.0,0.0,0.0,3,8,2250,0,2003,0,98125,47.7174,-122.30799999999999,1790,7626,2,25,2015,UNK,460,674
9414610240,3/10/2015,485000.0,3,1.75,2030,10089,1.0,0.0,0.0,4,8,1330,700,1976,0,98027,47.5217,-122.05,2030,9827,3,10,2015,UNK,0,262
4019301160,6/27/2014,755000.0,5,2.5,3260,24300,1.5,0.0,1.0,4,8,2310,950,1950,0,98155,47.7587,-122.274,2390,32057,6,27,2014,UNK,870,-7757
1217000340,6/6/2014,185000.0,3,1.0,1840,8100,1.0,0.0,0.0,4,7,920,920,1953,0,98166,47.455,-122.35,1250,8100,6,6,2014,UNK,590,0
1217000340,2/19/2015,340000.0,3,1.0,1840,8100,1.0,0.0,0.0,4,7,920,920,1953,0,98166,47.455,-122.35,1250,8100,2,19,2015,UNK,590,0
8081650400,6/24/2014,236000.0,4,2.75,2000,5827,2.0,0.0,0.0,3,7,2000,0,1997,0,98038,47.3629,-122.02600000000001,1710,6929,6,24,2014,UNK,290,-1102
9465910310,9/19/2014,550000.0,4,2.5,2810,7549,2.0,0.0,0.0,3,9,2810,0,1992,0,98072,47.7441,-122.17299999999999,2750,7642,9,19,2014,UNK,60,-93
9468200163,7/9/2014,680000.0,3,2.0,1780,5720,1.0,0.0,0.0,5,7,980,800,1925,0,98103,47.6794,-122.351,1620,5050,7,9,2014,UNK,160,670
305000310,4/21/2015,630000.0,4,2.5,2540,8706,2.0,0.0,0.0,3,9,2540,0,1997,0,98075,47.5855,-122.031,2540,6239,4,21,2015,UNK,0,2467
2624049035,6/17/2014,560000.0,3,2.0,2340,3477,1.0,0.0,1.0,5,7,1170,1170,1971,0,98118,47.54,-122.26700000000001,2110,6300,6,17,2014,UNK,230,-2823
8098400135,5/13/2014,385000.0,3,2.0,1480,6600,1.0,0.0,2.0,3,7,740,740,1943,0,98146,47.5081,-122.385,1250,7300,5,13,2014,UNK,230,-700
2291400342,10/22/2014,280000.0,3,2.25,1358,1141,3.0,0.0,0.0,3,7,1358,0,2007,0,98133,47.7052,-122.346,1358,1196,10,22,2014,N,0,-55
4051110240,8/25/2014,225000.0,3,2.5,1750,7490,1.0,0.0,0.0,4,7,1180,570,1979,0,98042,47.3746,-122.149,1570,7490,8,25,2014,UNK,180,0
3024059078,6/5/2014,610000.0,4,1.75,1830,29110,2.0,0.0,0.0,3,8,1230,600,1990,0,98040,47.5449,-122.215,3630,16488,6,5,2014,UNK,-1800,12622
3182100105,12/9/2014,592500.0,3,2.0,1170,6750,1.0,0.0,0.0,5,7,800,370,1947,0,98115,47.6752,-122.281,1330,6750,12,9,2014,UNK,-160,0
6705850140,10/9/2014,750000.0,4,2.75,3170,7634,2.0,0.0,0.0,3,10,3170,0,1992,0,98075,47.5774,-122.054,2940,7846,10,9,2014,UNK,230,-212
8651442440,10/23/2014,164000.0,4,1.0,1530,4875,2.0,0.0,0.0,3,7,1530,0,1977,0,98042,47.3638,-122.09100000000001,1470,4875,10,23,2014,UNK,60,0
3432500765,6/12/2014,320000.0,2,1.0,1100,8281,1.0,0.0,0.0,4,7,1100,0,1947,0,98155,47.7414,-122.315,1510,8281,6,12,2014,UNK,-410,0
3905100310,6/25/2014,544000.0,4,2.5,2030,3974,2.0,0.0,0.0,3,8,2030,0,1994,0,98029,47.5692,-122.006,1780,3953,6,25,2014,UNK,250,21
1328330510,9/9/2014,344950.0,3,1.75,1870,7500,1.0,0.0,0.0,5,8,1320,550,1978,0,98058,47.4428,-122.134,1870,7275,9,9,2014,UNK,0,225
4017050260,6/6/2014,539500.0,3,2.5,3080,12476,2.0,0.0,0.0,3,10,3080,0,1990,0,98038,47.3752,-122.029,3130,13631,6,6,2014,UNK,-50,-1155
2323069053,4/17/2015,420000.0,4,1.75,2480,60548,1.0,0.0,0.0,4,7,1600,880,1968,0,98027,47.4722,-122.001,2390,90169,4,17,2015,UNK,90,-29621
4022900951,4/2/2015,305000.0,2,1.0,910,22725,1.0,0.0,0.0,1,6,910,0,1926,0,98155,47.7712,-122.29899999999999,2000,14566,4,2,2015,UNK,-1090,8159
6450304630,12/1/2014,229000.0,2,1.0,810,5100,1.0,0.0,0.0,3,6,810,0,1955,0,98133,47.7317,-122.34299999999999,1500,5100,12,1,2014,UNK,-690,0
3303960060,6/19/2014,1070000.0,5,3.5,3990,9938,2.0,0.0,0.0,3,11,3990,0,2001,0,98059,47.5198,-122.156,3490,11734,6,19,2014,UNK,500,-1796
993001342,8/8/2014,397500.0,3,2.25,1430,1383,3.0,0.0,0.0,3,8,1430,0,2005,0,98103,47.6917,-122.34100000000001,1430,1347,8,8,2014,N,0,36
6743700030,4/1/2015,540000.0,4,2.0,2190,8402,2.0,0.0,0.0,4,6,2190,0,1928,0,98033,47.6944,-122.175,2210,7802,4,1,2015,UNK,-20,600
6696800030,9/23/2014,650000.0,4,2.5,2290,10186,2.0,0.0,0.0,3,8,2290,0,1985,0,98008,47.6353,-122.124,2150,10186,9,23,2014,UNK,140,0
4114601580,7/24/2014,1900000.0,6,4.0,3020,13237,2.0,1.0,4.0,3,8,2840,180,1942,1983,98144,47.5924,-122.287,3680,12620,7,24,2014,Y,-660,617
2025079045,6/23/2014,649000.0,2,1.75,2260,280962,2.0,0.0,2.0,3,9,1890,370,2005,0,98014,47.6359,-121.94,2860,219542,6,23,2014,N,-600,61420
182000350,3/25/2015,287500.0,5,2.0,2020,67953,1.5,0.0,0.0,4,7,1620,400,1936,0,98178,47.4891,-122.26299999999999,1270,13198,3,25,2015,UNK,750,54755
8082400136,6/26/2014,815000.0,4,2.75,2620,4743,1.0,0.0,2.0,4,8,1310,1310,1949,0,98117,47.6829,-122.4,1900,4764,6,26,2014,UNK,720,-21
6352600350,12/9/2014,795000.0,2,2.5,2830,8630,2.0,0.0,0.0,3,10,2830,0,2001,0,98074,47.6481,-122.081,3190,7515,12,9,2014,UNK,-360,1115
9414610070,1/30/2015,502775.0,3,1.75,1700,9840,1.0,0.0,0.0,4,8,1200,500,1976,0,98027,47.5192,-122.046,2040,14169,1,30,2015,UNK,-340,-4329
7812801125,1/12/2015,222900.0,2,1.0,1110,6411,1.0,0.0,0.0,3,6,1110,0,1944,0,98178,47.4962,-122.242,1150,6504,1,12,2015,UNK,-40,-93
1121039105,12/3/2014,399950.0,4,3.0,2150,64694,1.0,0.0,0.0,3,8,1450,700,1969,0,98023,47.3268,-122.38799999999999,2430,59612,12,3,2014,UNK,-280,5082
3591000030,8/23/2014,728000.0,4,2.5,2650,13684,2.0,0.0,0.0,3,9,2650,0,1994,0,98052,47.6278,-122.10799999999999,2650,12032,8,23,2014,UNK,0,1652
2386000240,9/29/2014,850000.0,5,3.5,3870,65556,2.0,0.0,0.0,3,10,3870,0,1994,0,98053,47.6403,-121.992,4290,67019,9,29,2014,UNK,-420,-1463
4254000060,10/2/2014,525000.0,4,2.75,2530,17856,2.0,0.0,0.0,3,8,2530,0,1998,0,98019,47.7356,-121.959,2530,14640,10,2,2014,UNK,0,3216
6623400193,9/3/2014,257000.0,3,1.0,1450,7850,1.5,0.0,0.0,5,7,1450,0,1910,0,98055,47.4299,-122.199,1360,10400,9,3,2014,UNK,90,-2550
8944550140,5/19/2014,433500.0,3,2.5,2200,3360,2.0,0.0,0.0,3,8,2200,0,2009,0,98118,47.5418,-122.287,2130,3423,5,19,2014,N,70,-63
2730500140,4/23/2015,314950.0,4,1.75,1890,9623,1.0,0.0,0.0,4,7,1290,600,1969,0,98001,47.2901,-122.279,1510,9711,4,23,2015,UNK,380,-88
5490210510,9/22/2014,500000.0,3,1.75,1530,14633,1.0,0.0,0.0,3,7,1100,430,1977,0,98052,47.6949,-122.119,1780,8100,9,22,2014,UNK,-250,6533
8718500560,6/27/2014,300000.0,3,1.5,1590,8911,1.0,0.0,0.0,3,7,1590,0,1956,0,98028,47.7394,-122.25200000000001,1590,9625,6,27,2014,UNK,0,-714
8651520160,7/7/2014,645000.0,4,2.5,2690,18653,2.0,0.0,0.0,3,8,2690,0,1985,0,98074,47.6449,-122.059,2230,9744,7,7,2014,UNK,460,8909
2868900160,10/2/2014,222500.0,3,1.0,990,10125,1.0,0.0,0.0,3,7,990,0,1972,0,98042,47.3422,-122.089,1360,10125,10,2,2014,UNK,-370,0
8062900030,7/15/2014,275000.0,3,1.75,1300,8099,1.0,0.0,0.0,4,7,1080,220,1976,0,98056,47.5026,-122.17200000000001,1270,8099,7,15,2014,UNK,30,0
3336000626,4/16/2015,498000.0,3,1.5,1720,6570,1.5,0.0,0.0,4,8,1720,0,1909,0,98118,47.5284,-122.265,1360,6000,4,16,2015,UNK,360,570
3226059083,6/26/2014,800000.0,3,1.75,2080,75794,1.0,0.0,0.0,3,7,2080,0,1958,0,98033,47.7018,-122.189,1870,11020,6,26,2014,UNK,210,64774
7212660960,8/14/2014,297000.0,3,2.5,1840,8234,2.0,0.0,0.0,3,8,1840,0,1994,0,98003,47.266999999999996,-122.31200000000001,1940,7601,8,14,2014,UNK,-100,633
1180007375,5/12/2015,625000.0,5,3.5,4010,6000,2.0,0.0,3.0,3,9,2560,1450,1997,0,98178,47.4928,-122.229,2440,6000,5,12,2015,UNK,1570,0
1150900060,10/30/2014,770000.0,4,2.5,3560,6187,2.0,0.0,0.0,3,9,3560,0,2003,0,98029,47.5593,-122.016,3190,6981,10,30,2014,UNK,370,-794
9528102110,9/17/2014,517000.0,3,2.25,1640,4635,1.5,0.0,0.0,3,8,1540,100,1930,0,98115,47.6793,-122.319,1530,4635,9,17,2014,UNK,110,0
1172000150,8/29/2014,238000.0,1,1.0,530,6350,1.0,0.0,0.0,5,5,530,0,1941,0,98103,47.6946,-122.35700000000001,1200,6350,8,29,2014,UNK,-670,0
1523049115,10/21/2014,234550.0,3,1.0,1990,15375,1.0,0.0,0.0,3,7,1140,850,1946,0,98168,47.4778,-122.288,1160,10236,10,21,2014,UNK,830,5139
4222310410,9/29/2014,230500.0,3,2.25,1690,7245,1.0,0.0,1.0,3,7,1160,530,1973,0,98003,47.3505,-122.305,1690,6720,9,29,2014,UNK,0,525
2568300210,6/28/2014,585000.0,5,2.5,2670,16777,1.5,0.0,0.0,4,7,1620,1050,1920,0,98125,47.7015,-122.301,1610,8227,6,28,2014,UNK,1060,8550
3131201320,8/22/2014,733000.0,4,1.75,1930,3876,1.5,0.0,0.0,5,7,1450,480,1924,0,98105,47.6604,-122.324,1280,3825,8,22,2014,UNK,650,51
1982201255,11/14/2014,357950.0,2,1.0,810,3880,1.0,0.0,0.0,3,7,810,0,1952,0,98107,47.6631,-122.365,900,4365,11,14,2014,UNK,-90,-485
125039025,6/11/2014,530000.0,3,1.75,1550,3680,1.0,0.0,0.0,3,7,1050,500,1927,0,98117,47.6817,-122.36,1560,4000,6,11,2014,UNK,-10,-320
5379805121,12/29/2014,377500.0,4,2.5,2640,10720,2.0,0.0,0.0,3,8,2640,0,1999,0,98188,47.4485,-122.27799999999999,1680,10018,12,29,2014,UNK,960,702
7853302520,2/6/2015,475000.0,4,2.5,2320,10046,2.0,0.0,0.0,3,7,2320,0,2006,0,98065,47.5406,-121.887,2320,5253,2,6,2015,N,0,4793
1921069101,5/8/2015,399000.0,3,1.75,2170,73616,1.0,0.0,0.0,3,7,2170,0,2008,0,98092,47.2881,-122.086,1710,297514,5,8,2015,N,460,-223898
9276202160,11/26/2014,660000.0,3,2.0,2080,5750,1.0,0.0,0.0,5,7,1040,0,1926,0,98116,47.5791,-122.39200000000001,1710,4830,11,26,2014,UNK,370,920
4037500230,10/7/2014,400000.0,5,2.25,2070,10488,1.0,0.0,0.0,4,7,1080,990,1958,0,98008,47.6095,-122.12200000000001,1740,9225,10,7,2014,UNK,330,1263
1982201345,5/2/2014,440000.0,2,1.0,800,4850,1.0,0.0,0.0,4,7,800,0,1944,0,98107,47.6639,-122.36399999999999,1150,4365,5,2,2014,UNK,-350,485
5469500180,2/6/2015,366400.0,4,2.25,2040,14383,1.0,0.0,0.0,4,8,1270,770,1977,0,98042,47.3849,-122.163,2030,11500,2,6,2015,UNK,10,2883
1088810040,3/20/2015,627250.0,4,2.5,2830,10677,2.0,0.0,0.0,3,9,2830,0,1993,0,98011,47.742,-122.208,2970,9619,3,20,2015,UNK,-140,1058
2117700085,7/30/2014,375950.0,3,1.75,1480,7560,1.0,0.0,0.0,3,6,1100,380,1920,1985,98117,47.6985,-122.36399999999999,1510,7250,7,30,2014,Y,-30,310
9211500730,2/18/2015,162000.0,3,2.25,1810,6750,1.0,0.0,0.0,3,7,1280,530,1978,0,98023,47.2976,-122.37700000000001,1690,7770,2,18,2015,UNK,120,-1020
4083801395,7/24/2014,780000.0,3,2.75,1970,2600,2.5,0.0,0.0,3,8,1970,0,1924,1994,98103,47.663000000000004,-122.335,1680,3120,7,24,2014,Y,290,-520
9274201006,5/7/2014,705000.0,4,2.5,2650,4316,1.5,0.0,0.0,3,8,1520,1130,1905,2013,98116,47.5866,-122.389,1690,5625,5,7,2014,Y,960,-1309
7205800040,12/23/2014,450000.0,4,2.5,2820,15233,1.0,0.0,2.0,4,9,1820,1000,1972,0,98003,47.3426,-122.321,2560,11998,12,23,2014,UNK,260,3235
3276180210,11/17/2014,311000.0,3,2.75,1400,7880,1.0,0.0,0.0,3,7,1000,400,1981,0,98056,47.5095,-122.193,1400,7279,11,17,2014,UNK,0,601
3904900530,6/13/2014,485000.0,3,2.5,1580,6065,2.0,0.0,0.0,3,8,1580,0,1985,0,98029,47.5692,-122.021,1770,6700,6,13,2014,UNK,-190,-635
9560800040,7/16/2014,485000.0,3,2.5,1800,11034,2.0,0.0,0.0,4,8,1800,0,1987,0,98072,47.7558,-122.14200000000001,1940,8900,7,16,2014,UNK,-140,2134
5249801411,10/10/2014,725000.0,5,3.75,3360,6000,2.0,0.0,0.0,3,8,2640,720,1963,1999,98118,47.558,-122.277,1930,6000,10,10,2014,Y,1430,0
3750603492,7/15/2014,185000.0,3,1.0,1510,17040,1.0,0.0,0.0,4,6,1510,0,1975,0,98001,47.2649,-122.285,1520,14000,7,15,2014,UNK,-10,3040
249000180,12/1/2014,1890000.0,4,4.25,4285,9345,2.0,0.0,0.0,3,10,4285,0,2013,0,98004,47.6332,-122.199,1570,8994,12,1,2014,N,2715,351
1796370180,5/8/2015,260000.0,3,2.25,1610,7423,2.0,0.0,0.0,4,7,1610,0,1990,0,98042,47.3713,-122.09100000000001,1530,8102,5,8,2015,UNK,80,-679
6699940120,4/30/2015,356000.0,4,2.5,2470,5074,2.0,0.0,0.0,3,8,2470,0,2004,0,98038,47.3457,-122.041,2470,5078,4,30,2015,N,0,-4
3830210230,3/19/2015,225205.0,3,1.0,1200,7220,1.0,0.0,0.0,3,6,1200,0,1977,0,98030,47.3746,-122.18299999999999,1200,7200,3,19,2015,UNK,0,20
9144100158,12/29/2014,445000.0,3,1.0,1260,8910,1.0,0.0,0.0,4,7,1260,0,1949,0,98117,47.7,-122.375,1560,8910,12,29,2014,UNK,-300,0
3332500636,6/5/2014,356000.0,2,1.0,920,4095,1.0,0.0,0.0,4,6,920,0,1914,0,98118,47.5484,-122.27799999999999,1460,4945,6,5,2014,UNK,-540,-850
5315100476,10/10/2014,760250.0,5,2.75,2540,8250,1.0,0.0,0.0,4,7,1440,1100,1953,0,98040,47.5875,-122.24,2540,11000,10,10,2014,UNK,0,-2750
8682260610,4/30/2015,572000.0,2,2.0,1870,5143,1.0,0.0,0.0,3,8,1870,0,2005,0,98053,47.7142,-122.03299999999999,1810,5143,4,30,2015,N,60,0
5700004525,6/24/2014,970000.0,3,2.25,3060,9950,1.5,0.0,2.0,4,9,1810,1250,1930,0,98144,47.57899999999999,-122.28399999999999,4950,10655,6,24,2014,UNK,-1890,-705
3303950220,8/31/2014,348450.0,4,2.5,1950,8628,2.0,0.0,0.0,3,8,1950,0,1994,0,98038,47.3817,-122.035,2210,9019,8,31,2014,UNK,-260,-391
7399800150,6/6/2014,535500.0,3,1.5,1730,40250,2.0,0.0,0.0,4,8,1730,0,1983,0,98072,47.7499,-122.111,1730,36250,6,6,2014,UNK,0,4000
1454600256,10/13/2014,710000.0,5,2.5,2570,9600,1.0,0.0,2.0,3,8,1620,950,1956,0,98125,47.7216,-122.28200000000001,2680,9900,10,13,2014,UNK,-110,-300
629000730,5/28/2014,745000.0,3,1.75,1490,9800,1.0,0.0,0.0,4,7,1140,350,1947,0,98004,47.583999999999996,-122.198,2310,9800,5,28,2014,UNK,-820,0
7520400040,6/20/2014,355000.0,4,2.5,2040,8265,2.0,0.0,0.0,3,7,2040,0,1996,0,98146,47.4973,-122.34100000000001,2160,8265,6,20,2014,UNK,-120,0
2799800180,3/23/2015,333000.0,4,2.5,2690,5505,2.0,0.0,0.0,3,8,2690,0,2004,0,98042,47.3666,-122.119,2690,5505,3,23,2015,N,0,0
2025701530,8/26/2014,282000.0,3,2.5,1610,6000,2.0,0.0,0.0,4,7,1610,0,1993,0,98038,47.349,-122.036,1570,6000,8,26,2014,UNK,40,0
1794501415,5/28/2014,840500.0,3,2.0,2520,5400,1.5,0.0,0.0,4,8,1410,1110,1906,0,98119,47.6365,-122.361,1960,5400,5,28,2014,UNK,560,0
4038500330,4/7/2015,432000.0,3,1.75,1550,8134,1.0,0.0,0.0,4,7,1550,0,1959,0,98008,47.6136,-122.12100000000001,1360,8000,4,7,2015,UNK,190,134
9297301065,10/29/2014,625000.0,3,1.0,1800,4800,1.0,0.0,2.0,4,9,900,900,1927,0,98126,47.5672,-122.37200000000001,1400,4800,10,29,2014,UNK,400,0
985000833,9/10/2014,209977.0,3,1.0,1170,6134,1.0,0.0,0.0,4,7,1170,0,1948,0,98168,47.4941,-122.31200000000001,1440,9823,9,10,2014,UNK,-270,-3689
3353400120,7/1/2014,174000.0,2,1.0,900,13531,1.0,0.0,0.0,3,6,900,0,1979,0,98001,47.2616,-122.251,1767,8308,7,1,2014,UNK,-867,5223
8860310120,4/22/2015,740000.0,4,2.0,2800,8540,1.0,0.0,0.0,4,8,1730,1070,1977,0,98052,47.6869,-122.126,2470,9400,4,22,2015,UNK,330,-860
9547200790,9/17/2014,518000.0,3,1.75,1830,4500,1.5,0.0,0.0,4,7,1830,0,1909,0,98115,47.676,-122.30799999999999,1830,4080,9,17,2014,UNK,0,420
9136103026,3/5/2015,539000.0,3,1.75,1380,3225,1.0,0.0,0.0,4,7,940,440,1915,0,98103,47.6652,-122.338,1250,3750,3,5,2015,UNK,130,-525
5710600620,4/29/2015,575000.0,3,2.75,1990,9600,1.0,0.0,0.0,3,8,1530,460,1978,0,98027,47.532,-122.05,2170,10400,4,29,2015,UNK,-180,-800
6003001999,2/9/2015,530000.0,2,1.75,1170,976,2.0,0.0,0.0,3,9,780,390,2010,0,98102,47.6192,-122.316,1280,1183,2,9,2015,N,-110,-207
922059020,7/16/2014,242025.0,4,1.75,1400,54014,1.5,0.0,0.0,4,7,1400,0,1935,0,98031,47.4153,-122.184,1910,8523,7,16,2014,UNK,-510,45491
644200065,3/6/2015,1030000.0,4,2.5,2620,11200,1.0,0.0,0.0,4,8,1770,850,1962,0,98004,47.5876,-122.193,2360,11200,3,6,2015,UNK,260,0
6929602390,8/26/2014,230000.0,3,1.0,880,7500,1.0,0.0,0.0,3,7,880,0,1978,0,98198,47.3837,-122.307,880,7500,8,26,2014,UNK,0,0
7399000230,1/7/2015,350000.0,4,2.5,2260,7500,1.0,0.0,0.0,3,8,1460,800,1965,0,98055,47.4645,-122.196,2260,7500,1,7,2015,UNK,0,0
3885805300,4/29/2015,595000.0,3,1.0,1300,11520,1.0,0.0,0.0,3,6,1300,0,1958,0,98033,47.6829,-122.195,1440,8064,4,29,2015,UNK,-140,3456
200800330,7/11/2014,440000.0,3,1.75,1450,6829,1.0,0.0,0.0,3,8,1450,0,1983,0,98052,47.7222,-122.10799999999999,1950,7622,7,11,2014,UNK,-500,-793
6819100330,2/20/2015,550000.0,3,1.0,1110,6000,1.0,0.0,0.0,3,7,1110,0,1904,0,98109,47.6461,-122.35700000000001,1460,6000,2,20,2015,UNK,-350,0
1338600175,5/7/2014,940000.0,4,2.25,1890,5940,1.0,0.0,1.0,3,9,1470,420,1963,0,98112,47.6316,-122.303,2430,5940,5,7,2014,UNK,-540,0
8728100781,5/16/2014,375000.0,3,1.5,1100,1751,2.0,0.0,0.0,3,8,940,160,2007,0,98144,47.5927,-122.306,1380,1751,5,16,2014,N,-280,0
871000515,12/5/2014,567500.0,2,1.5,1350,4592,1.0,0.0,0.0,3,7,1070,280,1939,0,98199,47.6511,-122.405,1610,5102,12,5,2014,UNK,-260,-510
6446200175,9/16/2014,735000.0,3,2.5,3020,50800,1.0,0.0,0.0,5,8,1510,1510,1968,0,98029,47.5529,-122.02600000000001,2400,27135,9,16,2014,UNK,620,23665
7889600230,10/17/2014,114000.0,2,1.0,730,5200,1.0,0.0,0.0,3,6,730,0,1928,0,98146,47.4943,-122.337,1220,6240,10,17,2014,UNK,-490,-1040
2652500210,8/25/2014,608000.0,2,1.0,1390,3600,1.0,0.0,0.0,4,7,1010,380,1913,0,98119,47.6422,-122.36,1590,3600,8,25,2014,UNK,-200,0
7302000210,11/7/2014,442500.0,3,1.5,2710,47419,1.5,0.0,0.0,3,7,2170,540,1980,0,98053,47.6522,-121.96600000000001,2130,48144,11,7,2014,UNK,580,-725
6450301530,10/16/2014,381800.0,4,2.0,1530,5250,1.0,0.0,0.0,3,7,1110,420,1981,0,98133,47.7336,-122.339,1100,5250,10,16,2014,UNK,430,0
7905200230,7/24/2014,330000.0,3,2.0,2170,3978,1.0,0.0,0.0,5,7,1340,0,1919,0,98116,47.57100000000001,-122.391,1350,4680,7,24,2014,UNK,820,-702
1049010620,5/13/2014,90000.0,2,1.0,790,2640,1.0,0.0,0.0,3,7,790,0,1973,0,98034,47.7351,-122.178,1310,2064,5,13,2014,UNK,-520,576
9284802825,7/24/2014,312000.0,2,1.75,1160,8625,1.0,0.0,0.0,4,6,1160,0,1941,0,98106,47.5509,-122.366,960,5750,7,24,2014,UNK,200,2875
3782100145,5/12/2014,339000.0,3,1.0,1080,8100,1.0,0.0,0.0,4,7,1080,0,1955,0,98155,47.777,-122.307,1080,8100,5,12,2014,UNK,0,0
8731951490,5/7/2014,313000.0,3,1.75,2190,8000,1.0,0.0,0.0,4,8,2190,0,1967,0,98023,47.3098,-122.381,1980,8000,5,7,2014,UNK,210,0
9202650210,5/7/2014,618080.0,3,2.5,2030,6500,2.0,0.0,0.0,3,8,2030,0,1988,0,98027,47.5654,-122.09200000000001,2030,8485,5,7,2014,UNK,0,-1985
2473450870,10/6/2014,325000.0,3,2.25,2480,8755,2.0,0.0,0.0,3,8,2480,0,1979,0,98058,47.4543,-122.125,2280,9940,10,6,2014,UNK,200,-1185
2899200040,7/15/2014,242000.0,4,1.0,2240,7620,1.0,0.0,0.0,3,7,1120,1120,1966,0,98146,47.5089,-122.346,1080,7620,7,15,2014,UNK,1160,0
2644900149,12/18/2014,364000.0,2,1.5,1650,7311,1.0,0.0,0.0,3,7,860,790,1978,0,98133,47.7772,-122.35700000000001,1660,7255,12,18,2014,UNK,-10,56
952005000,8/15/2014,545000.0,3,1.75,1700,5750,1.5,0.0,2.0,5,7,1450,250,1925,0,98126,47.5643,-122.38,1700,5750,8,15,2014,UNK,0,0
7298030210,12/23/2014,445000.0,3,2.5,2790,16173,2.0,0.0,0.0,3,10,2790,0,1988,0,98023,47.3043,-122.34299999999999,2890,11632,12,23,2014,UNK,-100,4541
3760500730,7/28/2014,1090000.0,4,2.75,3010,10830,2.0,0.0,3.0,4,9,3010,0,1980,0,98034,47.7005,-122.23200000000001,3010,10650,7,28,2014,UNK,0,180
1562000120,5/12/2014,660000.0,4,2.5,2550,10000,1.0,0.0,0.0,3,8,1290,1260,1964,0,98007,47.6208,-122.141,2270,8640,5,12,2014,UNK,280,1360
9290850760,10/28/2014,845000.0,4,2.5,2880,35610,1.0,0.0,0.0,3,10,2880,0,1989,0,98052,47.6911,-122.054,3460,35610,10,28,2014,UNK,-580,0
272000220,9/23/2014,417000.0,4,2.0,2090,4000,1.0,0.0,0.0,3,6,1060,1030,1907,0,98144,47.5893,-122.29899999999999,1590,4000,9,23,2014,UNK,500,0
418000145,4/28/2015,213800.0,2,1.0,740,5200,1.0,0.0,0.0,4,5,740,0,1952,0,98056,47.4934,-122.17299999999999,750,5200,4,28,2015,UNK,-10,0
3560800040,10/28/2014,400000.0,2,1.75,960,6200,1.0,0.0,0.0,4,7,960,0,1946,0,98136,47.5551,-122.396,1000,6000,10,28,2014,UNK,-40,200
1139000035,3/5/2015,759950.0,4,3.5,2100,7560,2.0,0.0,0.0,5,8,2100,0,2005,0,98133,47.7076,-122.35600000000001,1250,7560,3,5,2015,N,850,0
6681500150,4/23/2015,990000.0,4,2.5,2540,5930,2.0,0.0,0.0,3,9,2540,0,2003,0,98199,47.6451,-122.387,1400,4000,4,23,2015,UNK,1140,1930
2330000035,8/20/2014,710000.0,3,1.75,1650,10250,1.0,0.0,0.0,5,8,1650,0,1963,0,98005,47.6118,-122.169,2400,10250,8,20,2014,UNK,-750,0
3095000040,10/16/2014,315000.0,1,0.75,770,4600,1.0,0.0,0.0,4,6,770,0,1910,0,98126,47.5565,-122.37700000000001,1550,4600,10,16,2014,UNK,-780,0
3343300065,9/2/2014,515000.0,4,2.5,2280,14810,1.0,0.0,0.0,5,8,1500,780,1977,0,98056,47.5392,-122.186,2690,12196,9,2,2014,UNK,-410,2614
375000230,6/26/2014,638000.0,3,2.0,1660,3729,1.0,0.0,0.0,5,7,970,690,1922,0,98116,47.5741,-122.414,1560,3729,6,26,2014,UNK,100,0
7663700772,2/18/2015,370000.0,4,2.0,2020,8100,1.5,0.0,0.0,4,7,1160,860,1946,0,98125,47.7307,-122.29700000000001,1840,8680,2,18,2015,UNK,180,-580
302000065,1/29/2015,184000.0,3,1.0,970,14850,1.0,0.0,0.0,3,7,970,0,1968,0,98001,47.3251,-122.26799999999999,1410,14850,1,29,2015,UNK,-440,0
6134500220,7/28/2014,583800.0,3,2.5,2480,6600,2.0,0.0,0.0,3,8,2480,0,2002,0,98053,47.6313,-122.008,2310,6656,7,28,2014,UNK,170,-56
2787700580,10/28/2014,309500.0,3,1.0,1250,7320,1.0,0.0,0.0,3,7,1250,0,1968,0,98059,47.5074,-122.163,1770,7320,10,28,2014,UNK,-520,0
2806300065,4/22/2015,1960000.0,4,4.0,4430,31353,2.0,0.0,0.0,3,12,4430,0,1998,0,98005,47.6422,-122.15700000000001,3900,35237,4,22,2015,UNK,530,-3884
7866500035,8/5/2014,299000.0,1,1.0,740,5000,1.0,0.0,0.0,3,7,740,0,1923,0,98118,47.5519,-122.292,1400,4400,8,5,2014,UNK,-660,600
7689600360,6/13/2014,215000.0,2,1.0,710,7200,1.0,0.0,0.0,3,6,710,0,1943,0,98178,47.4903,-122.245,960,7200,6,13,2014,UNK,-250,0
3541600210,6/18/2014,410000.0,4,2.0,1970,10500,1.0,0.0,0.0,3,8,1820,150,1961,0,98166,47.479,-122.35600000000001,2090,12300,6,18,2014,UNK,-120,-1800
6821600065,10/30/2014,478000.0,2,1.0,820,6000,1.0,0.0,0.0,3,7,820,0,1939,0,98199,47.6494,-122.395,1630,6000,10,30,2014,UNK,-810,0
7625703405,9/10/2014,431000.0,2,1.0,1000,6500,1.0,0.0,0.0,4,7,1000,0,1918,0,98136,47.5474,-122.38799999999999,1280,6500,9,10,2014,UNK,-280,0
6979900360,7/9/2014,635000.0,4,2.5,3080,35430,2.0,0.0,0.0,3,9,3080,0,1997,0,98053,47.6325,-121.97,2640,28972,7,9,2014,UNK,440,6458
6072100790,4/8/2015,648000.0,5,2.25,2410,12000,2.0,0.0,0.0,4,8,2410,0,1973,0,98006,47.5434,-122.175,2080,12000,4,8,2015,UNK,330,0
4113800410,6/3/2014,640000.0,3,2.5,2370,11172,2.0,0.0,0.0,3,9,2370,0,1993,0,98056,47.5345,-122.179,2550,11558,6,3,2014,UNK,-180,-386
4139450760,12/15/2014,932808.0,5,4.5,4690,6705,2.0,0.0,0.0,3,10,3450,1240,1995,0,98006,47.5539,-122.10799999999999,4070,11505,12,15,2014,UNK,620,-4800
8682220150,6/6/2014,835000.0,2,2.0,2280,6815,1.0,0.0,0.0,3,8,2280,0,2002,0,98053,47.7103,-122.027,2280,6750,6,6,2014,UNK,0,65
2325039057,7/28/2014,469775.0,2,1.75,1530,7020,1.0,0.0,0.0,3,7,1030,500,1942,0,98199,47.6465,-122.395,2090,6600,7,28,2014,UNK,-560,420
2459900040,7/17/2014,587000.0,5,3.5,3610,52595,2.0,0.0,0.0,4,7,3610,0,1989,0,98014,47.6832,-121.90700000000001,1620,60112,7,17,2014,UNK,1990,-7517
6819100150,7/21/2014,677915.0,3,2.0,1740,3600,1.0,0.0,0.0,5,7,990,750,1923,0,98119,47.6448,-122.35799999999999,1250,3600,7,21,2014,UNK,490,0
7922900040,5/22/2014,1080000.0,4,3.0,3600,9200,1.0,0.0,4.0,4,9,2100,1500,1976,0,98008,47.5866,-122.116,2700,9775,5,22,2014,UNK,900,-575
430000035,7/5/2014,671000.0,4,3.0,3130,5700,1.5,0.0,0.0,3,7,1750,1380,1953,0,98115,47.6811,-122.28299999999999,2080,5700,7,5,2014,UNK,1050,0
7853301520,9/3/2014,695000.0,5,3.25,3940,9780,2.0,0.0,0.0,3,9,3940,0,2007,0,98065,47.5435,-121.88799999999999,3550,8468,9,3,2014,N,390,1312
1623049133,7/29/2014,205000.0,4,2.0,2200,13320,1.0,0.0,0.0,3,6,1100,1100,1944,0,98168,47.481,-122.292,1330,6099,7,29,2014,UNK,870,7221
4024101451,4/30/2015,350000.0,4,1.0,1510,7200,1.5,0.0,0.0,4,7,1510,0,1955,0,98155,47.761,-122.307,1950,10656,4,30,2015,UNK,-440,-3456
3211100730,8/4/2014,360000.0,3,1.75,1560,7930,2.0,0.0,0.0,4,7,1560,0,1980,0,98059,47.4779,-122.161,1720,8073,8,4,2014,UNK,-160,-143
9542840410,11/8/2014,313999.0,4,2.25,1870,4198,2.0,0.0,0.0,3,7,1870,0,2008,0,98038,47.3657,-122.021,1870,4184,11,8,2014,N,0,14
6648500580,4/21/2015,300000.0,3,2.25,2070,7225,1.0,0.0,0.0,3,8,1690,380,1979,0,98042,47.3551,-122.148,2070,7400,4,21,2015,UNK,0,-175
8665900206,4/23/2015,452000.0,2,1.75,1660,11747,1.0,0.0,0.0,3,7,830,830,1981,0,98155,47.7661,-122.306,1900,19850,4,23,2015,UNK,-240,-8103
3025079003,3/25/2015,495500.0,3,2.5,2010,57934,1.0,0.0,0.0,3,7,2010,0,1978,0,98014,47.6262,-121.96,2040,55527,3,25,2015,UNK,-30,2407
2377000040,12/18/2014,288000.0,3,1.0,1410,40500,1.0,0.0,0.0,4,7,1410,0,1961,0,98092,47.3199,-122.1,1570,40500,12,18,2014,UNK,-160,0
9315100210,2/17/2015,227490.0,3,1.75,1820,7194,1.0,0.0,0.0,4,7,1820,0,1967,0,98003,47.3352,-122.307,1420,7560,2,17,2015,UNK,400,-366
4046500720,11/7/2014,470950.0,3,2.5,2560,16420,2.0,0.0,0.0,4,8,2560,0,1989,0,98014,47.6916,-121.916,2120,16298,11,7,2014,UNK,440,122
8956000120,6/14/2014,735000.0,4,2.75,2450,4187,2.0,0.0,2.0,3,8,2450,0,2010,0,98027,47.5471,-122.016,2320,4187,6,14,2014,N,130,0
2862100366,10/15/2014,730000.0,7,2.75,3110,4400,1.5,0.0,0.0,5,7,2010,1100,1914,0,98105,47.6684,-122.319,1240,4280,10,15,2014,UNK,1870,120
1402660150,12/3/2014,412000.0,3,2.5,2210,7000,2.0,0.0,0.0,4,8,2210,0,1985,0,98058,47.4377,-122.132,2260,7224,12,3,2014,UNK,-50,-224
7853310450,6/6/2014,589500.0,4,2.5,2630,6326,2.0,0.0,0.0,3,9,2630,0,2008,0,98065,47.5222,-121.874,3240,6229,6,6,2014,N,-610,97
3812400455,11/4/2014,291000.0,7,1.0,2350,8636,1.0,0.0,0.0,3,7,1550,800,1962,0,98118,47.5432,-122.277,1500,7366,11,4,2014,UNK,850,1270
269000970,4/2/2015,1300000.0,5,3.75,4450,7680,2.0,0.0,0.0,3,9,3460,990,2010,0,98199,47.6418,-122.39200000000001,2550,6400,4,2,2015,N,1900,1280
1788800910,10/20/2014,190000.0,3,1.0,1200,10458,1.0,0.0,0.0,4,6,1200,0,1961,0,98023,47.3262,-122.34200000000001,1160,9000,10,20,2014,UNK,40,1458
8820902700,4/22/2015,456200.0,2,1.75,1210,7733,1.0,0.0,0.0,3,6,1210,0,1904,0,98125,47.7148,-122.28200000000001,1670,7733,4,22,2015,UNK,-460,0
8945300040,9/19/2014,225000.0,3,1.0,1290,8470,1.0,0.0,0.0,4,7,970,320,1966,0,98023,47.3054,-122.37100000000001,1300,7350,9,19,2014,UNK,-10,1120
3225069241,4/22/2015,2000000.0,3,2.5,3490,21064,1.0,1.0,4.0,3,10,2290,1200,1968,0,98074,47.6092,-122.073,1780,15244,4,22,2015,UNK,1710,5820
7202430150,7/9/2014,740000.0,4,2.5,3360,15091,2.0,0.0,0.0,3,9,3360,0,1997,0,98052,47.6649,-122.135,1930,9936,7,9,2014,UNK,1430,5155
2070100040,12/1/2014,467000.0,3,1.75,2660,5511,1.0,0.0,0.0,3,8,1330,1330,1948,0,98108,47.5575,-122.3,2030,6111,12,1,2014,UNK,630,-600
1139000620,10/8/2014,385000.0,2,1.0,770,7554,1.0,0.0,0.0,3,6,770,0,1946,0,98177,47.7057,-122.36,1390,7500,10,8,2014,UNK,-620,54
976000790,10/20/2014,670000.0,3,2.5,1800,4763,2.0,0.0,0.0,3,7,1240,560,1985,0,98119,47.646,-122.36200000000001,1790,4763,10,20,2014,UNK,10,0
6617500085,4/22/2015,500000.0,4,2.5,2900,5760,1.0,0.0,0.0,4,8,1660,1240,1959,0,98118,47.55,-122.272,2250,6098,4,22,2015,UNK,650,-338
6163900971,6/19/2014,352450.0,3,2.0,1430,6000,1.0,0.0,0.0,5,7,1430,0,1945,0,98155,47.7564,-122.316,1630,6315,6,19,2014,UNK,-200,-315
7135521530,10/28/2014,669888.0,4,2.75,2550,7591,2.0,0.0,0.0,3,9,2550,0,1989,0,98059,47.5302,-122.147,2670,7796,10,28,2014,UNK,-120,-205
4036800925,6/24/2014,405000.0,3,2.75,1310,7300,1.0,0.0,0.0,3,7,1310,0,1957,0,98008,47.6016,-122.12299999999999,1310,7030,6,24,2014,UNK,0,270
6751300065,5/6/2014,518000.0,3,1.5,1430,8000,1.0,0.0,0.0,4,7,1430,0,1956,0,98007,47.5874,-122.13600000000001,1450,8000,5,6,2014,UNK,-20,0
7192200040,10/1/2014,280000.0,4,1.0,1880,6288,1.0,0.0,0.0,3,7,1120,760,1974,0,98178,47.5101,-122.259,1880,6334,10,1,2014,UNK,0,-46
3629970610,7/18/2014,435000.0,3,2.5,1600,2375,2.0,0.0,0.0,3,7,1600,0,2005,0,98029,47.5531,-121.99600000000001,1830,2375,7,18,2014,N,-230,0
3797310230,5/7/2015,314950.0,3,2.0,1760,9732,1.0,0.0,0.0,3,7,1760,0,1996,0,98022,47.1923,-122.014,1910,9231,5,7,2015,UNK,-150,501
2781270210,2/24/2015,209900.0,2,2.0,1180,3003,2.0,0.0,0.0,3,6,1180,0,2005,0,98038,47.3491,-122.02,1310,3003,2,24,2015,N,-130,0
1330900230,4/16/2015,630000.0,4,2.5,2330,31705,2.0,0.0,0.0,4,8,2330,0,1980,0,98052,47.6471,-122.03,2460,36600,4,16,2015,UNK,-130,-4895
8917100206,7/18/2014,442000.0,4,1.5,1960,12688,1.5,0.0,0.0,4,7,1960,0,1962,0,98052,47.6304,-122.09700000000001,2050,9375,7,18,2014,UNK,-90,3313
1219000120,4/2/2015,340000.0,4,1.0,1140,13440,1.0,0.0,0.0,2,5,1140,0,1944,0,98166,47.4619,-122.344,1450,7560,4,2,2015,UNK,-310,5880
522059158,6/16/2014,230000.0,3,1.75,1400,6956,1.0,0.0,0.0,4,7,1400,0,1957,0,98031,47.4233,-122.198,1400,9375,6,16,2014,UNK,0,-2419
526059122,12/5/2014,495200.0,5,2.25,2710,22120,1.0,0.0,0.0,3,7,1410,1300,1955,0,98011,47.7642,-122.195,2850,12224,12,5,2014,UNK,-140,9896
293620180,3/31/2015,900000.0,4,2.5,3510,6745,2.0,0.0,0.0,3,10,3510,0,1998,0,98075,47.6016,-122.074,3320,8370,3,31,2015,UNK,190,-1625
945000410,3/13/2015,265000.0,2,1.0,910,4600,1.0,0.0,0.0,3,5,910,0,1917,0,98117,47.6916,-122.36200000000001,1020,4600,3,13,2015,UNK,-110,0
226059106,1/2/2015,489500.0,3,1.75,2090,65558,1.0,0.0,0.0,3,8,1330,760,1977,0,98072,47.7621,-122.12700000000001,2450,47178,1,2,2015,UNK,-360,18380
4166600610,5/14/2015,335000.0,3,2.0,1410,44866,1.0,0.0,0.0,4,7,1410,0,1985,0,98023,47.3273,-122.37,2950,29152,5,14,2015,UNK,-1540,15714
8854100220,12/5/2014,585000.0,3,3.25,3050,12700,2.0,0.0,0.0,3,8,2240,810,1990,0,98011,47.7445,-122.214,3050,12386,12,5,2014,UNK,0,314
5249804655,10/17/2014,800000.0,4,2.25,2010,7200,1.0,0.0,1.0,4,8,1010,1000,1950,0,98118,47.5591,-122.26700000000001,2010,7200,10,17,2014,UNK,0,0
2220069203,9/8/2014,379500.0,4,2.25,2120,53578,2.0,0.0,2.0,4,7,2120,0,1985,0,98022,47.2041,-122.021,2120,53578,9,8,2014,UNK,0,0
3298200790,8/12/2014,475000.0,3,1.0,1270,8000,1.0,0.0,0.0,4,6,1270,0,1959,0,98008,47.6175,-122.118,1210,7875,8,12,2014,UNK,60,125
4038400040,11/24/2014,520000.0,3,2.0,1670,8800,1.0,0.0,0.0,4,7,1150,520,1961,0,98008,47.6096,-122.132,2020,8250,11,24,2014,UNK,-350,550
7215730730,1/28/2015,515000.0,4,2.5,1800,4338,2.0,0.0,0.0,3,8,1800,0,2001,0,98075,47.5962,-122.015,1800,4507,1,28,2015,UNK,0,-169
3126049107,5/3/2015,577500.0,2,1.0,1640,5515,1.0,0.0,0.0,4,7,940,700,1926,0,98103,47.6912,-122.334,2054,5515,5,3,2015,UNK,-414,0
3110800040,7/16/2014,269900.0,3,2.25,1740,9672,1.0,0.0,0.0,4,7,1110,630,1963,0,98031,47.4149,-122.181,1640,9600,7,16,2014,UNK,100,72
2608300035,5/27/2014,329000.0,3,1.0,1600,5952,1.0,0.0,0.0,4,7,1150,450,1964,0,98106,47.5292,-122.36200000000001,1460,6200,5,27,2014,UNK,140,-248
7217400650,4/24/2015,458500.0,3,1.5,1280,1920,1.5,0.0,0.0,3,7,1280,0,1905,1990,98122,47.6117,-122.301,1280,3150,4,24,2015,Y,0,-1230
924069106,3/13/2015,890000.0,4,2.0,1480,11171,1.5,0.0,0.0,4,6,1480,0,1947,0,98075,47.5849,-122.051,2790,20680,3,13,2015,UNK,-1310,-9509
2310050040,4/1/2015,361500.0,4,2.5,1980,7334,2.0,0.0,0.0,3,7,1980,0,2003,0,98038,47.3528,-122.041,1850,7134,4,1,2015,UNK,130,200
7490000040,7/18/2014,2540000.0,5,3.25,3730,10626,1.0,0.0,4.0,4,10,3730,0,1963,0,98004,47.623999999999995,-122.221,4180,19110,7,18,2014,UNK,-450,-8484
6675500133,8/22/2014,325000.0,2,1.0,900,8374,1.0,0.0,0.0,3,7,900,0,1984,0,98034,47.7282,-122.225,1580,8965,8,22,2014,UNK,-680,-591
809001520,11/5/2014,1850000.0,4,3.25,3480,6000,3.0,0.0,0.0,3,8,3480,0,2014,0,98109,47.6353,-122.353,2200,4080,11,5,2014,N,1280,1920
1424200035,5/23/2014,945000.0,4,2.0,2840,13367,1.0,0.0,0.0,3,7,1420,1420,1952,0,98004,47.6237,-122.21,2840,12744,5,23,2014,UNK,0,623
5641300220,8/28/2014,370000.0,3,2.5,2490,4244,2.0,0.0,0.0,3,9,2490,0,2005,0,98042,47.3705,-122.131,2490,4748,8,28,2014,N,0,-504
8682292020,9/15/2014,450000.0,2,2.0,1510,4908,1.0,0.0,0.0,3,8,1510,0,2006,0,98053,47.7196,-122.024,1440,3921,9,15,2014,N,70,987
1604590230,4/24/2015,800000.0,4,2.5,2900,18303,2.0,0.0,0.0,4,10,2900,0,1994,0,98075,47.5981,-122.03,2900,18303,4,24,2015,UNK,0,0
2856101540,12/11/2014,676000.0,3,2.5,2240,3825,2.0,0.0,0.0,3,7,2240,0,1995,0,98117,47.6786,-122.389,1460,5100,12,11,2014,UNK,780,-1275
1336300610,4/2/2015,1270000.0,4,1.75,2040,5000,2.0,0.0,0.0,4,9,2040,0,1921,0,98102,47.6279,-122.315,3220,5600,4,2,2015,UNK,-1180,-600
3819500065,10/28/2014,290000.0,3,1.75,1460,7980,1.0,0.0,0.0,3,7,1460,0,1972,0,98028,47.7713,-122.265,1920,7980,10,28,2014,UNK,-460,0
2329600040,11/18/2014,158000.0,3,1.5,990,8925,1.0,0.0,0.0,4,7,990,0,1962,0,98003,47.3294,-122.331,1360,8625,11,18,2014,UNK,-370,300
4440900040,5/5/2014,379950.0,4,1.75,1970,9389,1.0,0.0,0.0,5,7,1140,830,1960,0,98133,47.7771,-122.339,1820,8135,5,5,2014,UNK,150,1254
7202260330,5/9/2014,583000.0,4,2.5,2660,4000,2.0,0.0,0.0,3,8,2660,0,2001,0,98053,47.6876,-122.038,2330,4517,5,9,2014,UNK,330,-517
425000230,12/30/2014,150000.0,2,1.0,870,5700,1.0,0.0,0.0,4,6,870,0,1957,0,98056,47.49800000000001,-122.17,1020,5700,12,30,2014,UNK,-150,0
5466400530,7/21/2014,261500.0,3,2.5,1740,6992,2.0,0.0,0.0,3,7,1740,0,1990,0,98042,47.3574,-122.15799999999999,1260,6825,7,21,2014,UNK,480,167
6600490220,10/14/2014,278000.0,4,2.5,2290,3777,2.0,0.0,0.0,3,7,2290,0,2004,0,98198,47.3617,-122.30799999999999,1480,3608,10,14,2014,N,810,169
2156500220,9/23/2014,555000.0,4,2.75,2170,7140,1.0,0.0,0.0,3,8,1290,880,1977,0,98052,47.691,-122.113,2120,7820,9,23,2014,UNK,50,-680
9438300035,8/27/2014,355000.0,3,1.75,2040,8173,1.0,0.0,0.0,3,7,1470,570,1958,0,98133,47.7439,-122.333,1900,8172,8,27,2014,UNK,140,1
4036800770,9/17/2014,375000.0,4,1.5,1770,6650,1.0,0.0,0.0,3,7,1770,0,1958,0,98008,47.6011,-122.124,1600,7000,9,17,2014,UNK,170,-350
4006000281,7/29/2014,227000.0,3,1.75,2380,12681,1.0,0.0,0.0,1,6,1380,1000,1918,0,98118,47.5294,-122.279,1720,6377,7,29,2014,UNK,660,6304
619079061,6/19/2014,335000.0,4,2.0,2030,103672,1.0,0.0,0.0,4,7,2030,0,1969,0,98022,47.1647,-121.973,1560,325393,6,19,2014,UNK,470,-221721
3586501135,6/6/2014,680000.0,3,2.25,2270,23900,1.0,0.0,0.0,3,9,1820,450,1975,0,98177,47.7506,-122.37200000000001,2520,28300,6,6,2014,UNK,-250,-4400
8819900220,2/5/2015,686500.0,2,1.75,1390,5025,1.5,0.0,0.0,4,8,1390,0,1928,0,98105,47.6701,-122.288,2160,5000,2,5,2015,UNK,-770,25
1775801020,11/24/2014,410000.0,3,1.75,1530,26642,1.0,0.0,0.0,3,7,1180,350,1988,0,98072,47.7422,-122.09700000000001,1550,13566,11,24,2014,UNK,-20,13076
3758900150,8/26/2014,425000.0,2,1.0,1430,13300,1.5,0.0,0.0,3,6,1230,200,1921,0,98033,47.6996,-122.20299999999999,1950,11421,8,26,2014,UNK,-520,1879
1954420230,3/10/2015,562500.0,3,2.5,2030,7549,1.0,0.0,0.0,3,8,2030,0,1988,0,98074,47.6187,-122.044,2040,7130,3,10,2015,UNK,-10,419
4307320230,10/14/2014,345000.0,4,2.5,2390,6976,2.0,0.0,0.0,3,7,2390,0,2003,0,98056,47.4807,-122.182,2390,6346,10,14,2014,UNK,0,630
7856620910,4/14/2015,627500.0,4,2.5,2540,11500,1.0,0.0,0.0,4,8,1640,900,1979,0,98006,47.5609,-122.15,2820,9800,4,14,2015,UNK,-280,1700
1624079021,3/13/2015,355000.0,3,1.0,1890,36300,1.0,0.0,0.0,3,7,1890,0,1962,0,98024,47.5719,-121.914,1746,54014,3,13,2015,UNK,144,-17714
4123800330,5/1/2015,335000.0,3,2.25,1870,5876,2.0,0.0,0.0,3,7,1870,0,1986,0,98038,47.3779,-122.045,1670,6203,5,1,2015,UNK,200,-327
7186800120,3/11/2015,350000.0,4,3.0,1780,4228,1.0,0.0,0.0,3,7,1780,0,1953,0,98118,47.5488,-122.287,1730,5304,3,11,2015,UNK,50,-1076
925069123,3/18/2015,590000.0,3,1.0,1610,58370,1.0,0.0,0.0,3,7,1610,0,1978,0,98053,47.6718,-122.044,2510,58127,3,18,2015,UNK,-900,243
5422420120,7/17/2014,252000.0,3,2.0,1420,6788,2.0,0.0,0.0,3,7,1420,0,1990,0,98023,47.2887,-122.351,1790,6607,7,17,2014,UNK,-370,181
5460500040,4/21/2015,1300000.0,5,4.0,4440,9270,1.0,0.0,0.0,5,10,2220,2220,1968,0,98040,47.5708,-122.212,2720,9614,4,21,2015,UNK,1720,-344
5113400264,11/19/2014,705000.0,4,2.0,1820,5001,2.0,0.0,0.0,3,7,1820,0,1947,0,98119,47.6438,-122.37299999999999,1440,5408,11,19,2014,UNK,380,-407
1828000230,7/14/2014,498000.0,3,2.0,1620,8400,1.0,0.0,0.0,3,7,1180,440,1968,0,98052,47.6574,-122.12799999999999,2120,8424,7,14,2014,UNK,-500,-24
6415100331,9/21/2014,312500.0,2,1.0,870,7227,1.0,0.0,0.0,3,7,870,0,1948,0,98133,47.7288,-122.331,1250,7252,9,21,2014,UNK,-380,-25
7686205370,11/24/2014,260000.0,4,1.75,1830,5375,1.0,0.0,0.0,2,7,1060,770,1962,0,98198,47.4169,-122.316,1040,7500,11,24,2014,UNK,790,-2125
8092501400,3/18/2015,209950.0,3,1.5,2290,9600,1.0,0.0,0.0,4,7,2290,0,1967,0,98042,47.3643,-122.111,1310,9600,3,18,2015,UNK,980,0
643300210,2/10/2015,610000.0,3,1.75,1110,10402,1.0,0.0,0.0,4,7,1110,0,1967,0,98006,47.5676,-122.177,2050,9660,2,10,2015,UNK,-940,742
7550801225,6/27/2014,500000.0,4,1.0,1440,7100,1.5,0.0,0.0,3,7,1440,0,1906,0,98107,47.6725,-122.396,1490,5000,6,27,2014,UNK,-50,2100
4078300040,2/24/2015,850000.0,3,3.5,3070,7050,1.0,0.0,3.0,3,8,1570,1500,1928,1996,98125,47.7076,-122.27600000000001,2350,5881,2,24,2015,Y,720,1169
4036100175,2/19/2015,689000.0,4,2.5,2440,11700,1.0,0.0,0.0,5,8,1480,960,1961,0,98006,47.5606,-122.184,2140,10807,2,19,2015,UNK,300,893
1036700220,11/10/2014,470000.0,4,2.0,2410,4680,2.0,0.0,0.0,3,9,2410,0,1974,0,98008,47.6234,-122.113,1910,4611,11,10,2014,UNK,500,69
1644500450,5/7/2014,640000.0,3,3.0,2270,5175,2.0,0.0,0.0,3,9,2130,140,2002,0,98056,47.51600000000001,-122.20299999999999,2850,5661,5,7,2014,UNK,-580,-486
6326000205,8/12/2014,290000.0,4,1.75,2340,7200,1.0,0.0,0.0,3,8,1590,750,1960,0,98146,47.497,-122.369,1970,7800,8,12,2014,UNK,370,-600
3375300150,12/18/2014,258500.0,3,2.5,1800,9000,2.0,0.0,0.0,3,7,1800,0,1983,0,98003,47.3186,-122.331,1670,8486,12,18,2014,UNK,130,514
2344300220,7/14/2014,1100000.0,4,3.5,2210,7597,1.0,0.0,0.0,4,9,1550,660,1977,2006,98004,47.5816,-122.197,2370,8811,7,14,2014,Y,-160,-1214
203101065,5/28/2014,420000.0,3,1.75,1820,22320,1.0,0.0,0.0,3,7,1250,570,1977,0,98053,47.6441,-121.96,2030,22320,5,28,2014,UNK,-210,0
5083100065,9/16/2014,230000.0,3,1.0,1190,9083,1.0,0.0,0.0,3,7,1190,0,1955,0,98198,47.4116,-122.29299999999999,1190,9450,9,16,2014,UNK,0,-367
1545804240,4/2/2015,252000.0,3,1.5,1400,6865,1.0,0.0,0.0,4,7,1400,0,1986,0,98038,47.3639,-122.04799999999999,1480,8125,4,2,2015,UNK,-80,-1260
2329720040,6/30/2014,515000.0,3,2.5,2600,4506,2.0,0.0,0.0,3,8,2600,0,2003,0,98028,47.7353,-122.22200000000001,2600,4658,6,30,2014,UNK,0,-152
7551300065,6/9/2014,425000.0,2,1.0,910,4635,1.0,0.0,0.0,4,6,910,0,1905,0,98107,47.675,-122.39299999999999,1740,5000,6,9,2014,UNK,-830,-365
4321200580,1/25/2015,575000.0,3,2.5,1760,2320,2.0,0.0,2.0,3,8,1760,0,1994,0,98126,47.5723,-122.376,1760,4698,1,25,2015,UNK,0,-2378
9164100040,10/26/2014,390000.0,2,1.0,860,5160,1.0,0.0,0.0,4,7,860,0,1909,0,98117,47.6823,-122.38799999999999,1090,5356,10,26,2014,UNK,-230,-196
7922750150,9/17/2014,561500.0,4,2.25,2310,9800,1.0,0.0,0.0,3,8,1780,530,1968,0,98033,47.6657,-122.178,2310,9800,9,17,2014,UNK,0,0
2804600155,5/7/2015,1350000.0,4,1.75,2000,3728,1.5,0.0,0.0,4,9,1820,180,1926,0,98112,47.643,-122.29899999999999,1950,3728,5,7,2015,UNK,50,0
5101402296,9/25/2014,835000.0,5,2.75,2460,7830,1.0,0.0,0.0,5,9,1490,970,1955,0,98115,47.6938,-122.31,2050,7830,9,25,2014,UNK,410,0
8019200845,2/18/2015,245000.0,2,1.0,1020,15000,1.5,0.0,0.0,3,6,1020,0,1933,0,98168,47.4956,-122.321,1480,14519,2,18,2015,UNK,-460,481
9286100150,8/11/2014,475200.0,3,2.5,1670,3980,2.0,0.0,0.0,3,8,1670,0,2000,0,98027,47.5317,-122.04700000000001,1670,2897,8,11,2014,UNK,0,1083
3727800065,11/13/2014,425000.0,2,1.0,790,5024,1.0,0.0,0.0,4,7,790,0,1941,0,98117,47.6833,-122.395,1330,5024,11,13,2014,UNK,-540,0
7657000085,2/2/2015,218000.0,2,1.5,2010,7755,2.0,0.0,0.0,3,7,2010,0,1952,0,98178,47.4947,-122.23299999999999,1360,8037,2,2,2015,UNK,650,-282
7954300120,8/22/2014,600000.0,4,2.5,2600,6536,2.0,0.0,0.0,3,9,2600,0,1999,0,98056,47.5232,-122.191,2640,6185,8,22,2014,UNK,-40,351
686400040,4/10/2015,545000.0,4,2.25,1890,7210,1.0,0.0,0.0,3,8,1890,0,1967,0,98008,47.6342,-122.117,1920,7210,4,10,2015,UNK,-30,0
853200040,4/28/2015,2410000.0,5,2.5,4600,23250,1.5,0.0,2.0,3,9,3600,1000,1918,2003,98004,47.62300000000001,-122.21799999999999,5500,20066,4,28,2015,Y,-900,3184
7857003046,5/6/2015,460000.0,5,3.0,2008,5050,1.0,0.0,0.0,3,7,1216,792,1992,0,98118,47.5376,-122.292,2040,5297,5,6,2015,UNK,-32,-247
5014000085,6/23/2014,425000.0,2,1.0,880,6413,1.0,0.0,0.0,3,7,880,0,1950,0,98116,47.573,-122.395,1360,6413,6,23,2014,UNK,-480,0
2205500355,10/21/2014,455000.0,3,1.75,1700,8360,1.0,0.0,0.0,4,7,850,850,1955,0,98006,47.5766,-122.147,1520,8360,10,21,2014,UNK,180,0
2595650220,4/21/2015,313100.0,3,2.0,1730,12821,1.0,0.0,0.0,3,8,1730,0,1994,0,98001,47.353,-122.272,1980,11336,4,21,2015,UNK,-250,1485
7880010150,6/23/2014,780000.0,4,3.5,3910,59863,2.0,0.0,0.0,4,10,2490,1420,1987,0,98027,47.4846,-122.06700000000001,2830,37674,6,23,2014,UNK,1080,22189
6386550040,12/23/2014,345500.0,4,2.5,2160,9682,2.0,0.0,0.0,3,8,2160,0,1999,0,98031,47.4106,-122.204,1770,9600,12,23,2014,UNK,390,82
1355000220,1/19/2015,243000.0,3,1.75,1200,8034,1.0,0.0,0.0,5,7,1200,0,1975,0,98031,47.4135,-122.18,1270,7600,1,19,2015,UNK,-70,434
6619900120,12/8/2014,670000.0,5,3.5,3860,9600,1.0,0.0,3.0,4,8,2660,1200,1973,0,98034,47.7139,-122.223,2440,9600,12,8,2014,UNK,1420,0
2132200230,2/11/2015,325000.0,3,1.5,1320,7560,1.0,0.0,0.0,3,6,840,480,1983,0,98019,47.7451,-121.98,1210,7560,2,11,2015,UNK,110,0
2988800065,12/2/2014,281000.0,2,1.0,1280,12500,1.0,0.0,0.0,3,7,1060,220,1951,0,98178,47.4833,-122.23700000000001,1460,17771,12,2,2014,UNK,-180,-5271
13001215,3/5/2015,130000.0,3,1.0,1100,5100,1.0,0.0,0.0,4,7,1100,0,1913,0,98108,47.5231,-122.33200000000001,1450,5100,3,5,2015,UNK,-350,0
705700530,7/30/2014,340000.0,3,2.5,2170,9798,2.0,0.0,0.0,3,7,2170,0,1995,0,98038,47.3817,-122.023,2020,8121,7,30,2014,UNK,150,1677
7230100120,2/9/2015,485000.0,4,2.75,2720,51396,2.0,0.0,0.0,4,8,2720,0,1977,0,98059,47.4777,-122.1,1960,51366,2,9,2015,UNK,760,30
9520900230,12/17/2014,642860.0,4,2.75,2520,6398,2.0,0.0,0.0,3,8,2520,0,2014,0,98072,47.7685,-122.15899999999999,2520,6398,12,17,2014,N,0,0
9828701085,10/3/2014,747000.0,3,1.75,2560,4800,1.0,0.0,0.0,3,7,1280,1280,1911,0,98112,47.6207,-122.295,1620,4800,10,3,2014,UNK,940,0
1926049385,7/29/2014,559950.0,4,2.5,2650,7200,2.0,0.0,0.0,3,8,2250,400,1979,0,98133,47.7317,-122.354,2110,7269,7,29,2014,UNK,540,-69
5680000455,11/17/2014,577288.0,4,2.75,2870,7200,2.0,0.0,0.0,3,9,2870,0,2008,0,98108,47.5688,-122.31700000000001,2030,5400,11,17,2014,N,840,1800
125039021,9/24/2014,575000.0,2,1.0,1230,2726,1.5,0.0,0.0,3,7,880,350,1920,0,98117,47.6815,-122.359,1710,3750,9,24,2014,UNK,-480,-1024
3241600150,5/5/2014,287000.0,3,1.0,1450,6000,1.0,0.0,0.0,4,7,1450,0,1953,0,98118,47.5238,-122.287,1170,6464,5,5,2014,UNK,280,-464
1245003006,11/10/2014,1150000.0,4,3.75,3180,9889,2.0,0.0,0.0,3,9,2500,680,2012,0,98033,47.6853,-122.204,2910,8558,11,10,2014,N,270,1331
2789000120,4/24/2015,335000.0,2,1.0,1800,8900,1.0,0.0,0.0,3,6,900,900,1945,0,98168,47.51,-122.323,2040,10450,4,24,2015,UNK,-240,-1550
6073300040,1/6/2015,375000.0,4,2.25,2020,12500,2.0,0.0,0.0,2,8,2020,0,1966,0,98056,47.5403,-122.175,1800,13175,1,6,2015,UNK,220,-675
7663700531,1/6/2015,325000.0,2,1.0,620,14823,1.0,0.0,0.0,3,6,620,0,1926,0,98125,47.7322,-122.3,1400,7930,1,6,2015,UNK,-780,6893
123059042,4/23/2015,530000.0,3,2.25,2190,220414,1.0,0.0,0.0,4,7,1330,860,1976,0,98059,47.5041,-122.102,2550,175982,4,23,2015,UNK,-360,44432
7149400450,1/12/2015,287000.0,4,2.25,1980,7081,1.0,0.0,0.0,3,7,1470,510,1977,0,98032,47.3669,-122.288,1980,7081,1,12,2015,UNK,0,0
9264911210,2/26/2015,320000.0,5,3.0,2970,7000,1.0,0.0,0.0,3,8,1810,1160,1979,0,98023,47.3079,-122.34100000000001,2630,8062,2,26,2015,UNK,340,-1062
7853300650,8/22/2014,425000.0,4,2.5,2270,4400,2.0,0.0,0.0,3,7,2270,0,2006,0,98065,47.5381,-121.88799999999999,2090,4400,8,22,2014,N,180,0
6383000150,8/6/2014,550000.0,3,1.0,1630,6009,1.0,0.0,3.0,4,8,1630,0,1954,0,98117,47.69300000000001,-122.383,2120,6009,8,6,2014,UNK,-490,0
5560000650,12/2/2014,135000.0,3,1.0,1520,8450,1.0,0.0,0.0,2,6,1120,400,1961,0,98023,47.328,-122.337,1320,8450,12,2,2014,UNK,200,0
5700002020,7/17/2014,695000.0,3,1.75,2080,5687,1.5,0.0,0.0,4,8,2080,0,1924,0,98144,47.5776,-122.289,2300,5995,7,17,2014,UNK,-220,-308
2141310540,5/6/2015,975000.0,5,2.5,3020,9648,1.0,0.0,2.0,4,9,1980,1040,1977,0,98006,47.5586,-122.134,2890,12598,5,6,2015,UNK,130,-2950
7247000035,5/20/2014,210000.0,4,1.75,2180,28710,1.0,0.0,0.0,3,8,1180,1000,1950,0,98198,47.405,-122.288,2180,28710,5,20,2014,UNK,0,0
4077800438,12/31/2014,518000.0,4,1.75,1780,8768,1.0,0.0,0.0,4,7,1050,730,1951,0,98125,47.7085,-122.28299999999999,1590,8100,12,31,2014,UNK,190,668
8821900155,7/9/2014,335500.0,3,1.0,1370,6780,2.0,0.0,0.0,3,6,1370,0,1930,0,98125,47.7156,-122.291,1450,7214,7,9,2014,UNK,-80,-434
1324039110,11/26/2014,750000.0,4,3.5,3050,7020,2.0,0.0,3.0,3,9,2050,1000,1984,0,98126,47.57100000000001,-122.374,2170,5900,11,26,2014,UNK,880,1120
5566100205,12/23/2014,515000.0,3,1.75,1490,12000,1.0,0.0,0.0,4,7,1490,0,1956,0,98006,47.568999999999996,-122.175,1630,12000,12,23,2014,UNK,-140,0
7222000209,5/21/2014,344500.0,4,2.75,1800,5453,1.0,0.0,0.0,3,7,1050,750,2002,0,98055,47.4632,-122.209,1820,6900,5,21,2014,UNK,-20,-1447
7867500021,6/16/2014,470000.0,3,1.5,1760,6723,1.0,0.0,0.0,3,7,1160,600,1958,0,98118,47.5514,-122.266,2080,8965,6,16,2014,UNK,-320,-2242
8563010540,9/4/2014,606150.0,4,1.75,1770,9848,1.0,0.0,0.0,3,8,1370,400,1967,0,98008,47.6208,-122.09899999999999,2040,9587,9,4,2014,UNK,-270,261
7349650120,11/20/2014,292000.0,4,2.75,2910,7712,1.0,0.0,0.0,3,7,1600,1310,1998,0,98002,47.2842,-122.198,2220,6649,11,20,2014,UNK,690,1063
620069061,5/7/2015,450000.0,3,2.5,2880,426452,2.0,0.0,3.0,3,7,2880,0,1979,0,98092,47.2485,-122.101,1460,320890,5,7,2015,UNK,1420,105562
9269200540,8/19/2014,429000.0,3,1.75,2520,5043,1.0,0.0,0.0,3,8,1260,1260,1957,0,98126,47.5339,-122.37200000000001,1360,4920,8,19,2014,UNK,1160,123
1939000040,8/20/2014,765000.0,4,2.5,3190,38119,2.0,0.0,0.0,3,9,3190,0,1988,0,98053,47.6698,-122.044,2560,36280,8,20,2014,UNK,630,1839
2767603026,4/15/2015,425000.0,2,1.0,540,2500,1.0,0.0,0.0,3,5,540,0,1905,0,98107,47.6729,-122.383,1290,5000,4,15,2015,UNK,-750,-2500
9477920120,2/12/2015,505000.0,4,2.5,3170,5340,2.0,0.0,0.0,3,7,3170,0,2000,0,98059,47.4911,-122.13799999999999,3010,5340,2,12,2015,UNK,160,0
4037200530,3/17/2015,544950.0,3,1.75,1830,7371,1.0,0.0,0.0,3,7,1830,0,1957,0,98008,47.6059,-122.12100000000001,1600,7700,3,17,2015,UNK,230,-329
8150600065,9/24/2014,382000.0,3,2.0,1360,4840,1.5,0.0,0.0,3,8,1360,0,1936,0,98126,47.5487,-122.376,1450,4840,9,24,2014,UNK,-90,0
4046600120,8/28/2014,475000.0,3,1.75,1870,25157,2.0,0.0,0.0,3,7,1870,0,1978,0,98014,47.695,-121.915,1870,15391,8,28,2014,UNK,0,9766
8835220210,4/17/2015,355000.0,3,1.5,1370,4790,2.0,0.0,0.0,4,7,1370,0,1982,0,98034,47.7253,-122.164,1370,3799,4,17,2015,UNK,0,991
7696300180,7/3/2014,410000.0,4,2.5,1700,9000,1.0,0.0,0.0,5,7,1700,0,1972,0,98034,47.7306,-122.23299999999999,1370,7592,7,3,2014,UNK,330,1408
6362900145,2/3/2015,450000.0,4,2.0,1960,5008,1.0,0.0,0.0,3,6,980,980,1900,0,98144,47.5958,-122.29899999999999,1175,2315,2,3,2015,UNK,785,2693
7663700968,5/28/2014,565000.0,7,4.5,4140,9066,1.0,0.0,0.0,3,7,2070,2070,1978,0,98125,47.7302,-122.291,1440,1865,5,28,2014,UNK,2700,7201
6844700975,4/14/2015,529100.0,2,1.0,1290,6528,1.5,0.0,0.0,4,7,1290,0,1941,0,98115,47.693999999999996,-122.29,1670,5712,4,14,2015,UNK,-380,816
7853300720,2/12/2015,452500.0,4,2.5,2460,6454,2.0,0.0,0.0,3,7,2460,0,2006,0,98065,47.5381,-121.89,2320,4578,2,12,2015,N,140,1876
4222200210,5/22/2014,245000.0,4,2.0,1580,8000,1.0,0.0,0.0,3,7,1040,540,1967,0,98003,47.3467,-122.304,1550,8000,5,22,2014,UNK,30,0
7518505040,3/30/2015,415000.0,1,1.0,700,2550,1.0,0.0,0.0,3,6,700,0,1954,0,98117,47.6783,-122.383,1330,4110,3,30,2015,UNK,-630,-1560
6646200770,7/24/2014,610000.0,4,2.5,2410,15899,2.0,0.0,3.0,3,9,2410,0,1990,0,98074,47.6242,-122.04,2360,11412,7,24,2014,UNK,50,4487
1262700040,10/16/2014,363500.0,4,1.75,2180,9702,1.0,0.0,0.0,5,7,1090,1090,1962,0,98178,47.4973,-122.26799999999999,2020,9792,10,16,2014,UNK,160,-90
6811000220,2/4/2015,510000.0,3,2.75,1950,12630,1.0,0.0,0.0,4,8,1230,0,1969,0,98052,47.6301,-122.10700000000001,1990,12196,2,4,2015,UNK,-40,434
6979900330,3/25/2015,650000.0,4,2.5,2630,28298,2.0,0.0,0.0,3,8,2630,0,1996,0,98053,47.6314,-121.96799999999999,2840,26071,3,25,2015,UNK,-210,2227
984200540,1/14/2015,290000.0,4,2.5,2050,9015,2.0,0.0,0.0,4,7,2050,0,1973,0,98058,47.4357,-122.16799999999999,1780,8820,1,14,2015,UNK,270,195
7812800155,3/18/2015,170000.0,3,1.0,790,6750,1.0,0.0,0.0,2,6,790,0,1944,0,98178,47.4984,-122.24,960,6298,3,18,2015,UNK,-170,452
7228500610,3/30/2015,510000.0,2,1.0,1070,5280,1.0,0.0,0.0,3,6,1070,0,1900,0,98122,47.6168,-122.303,1380,2370,3,30,2015,UNK,-310,2910
1225069038,5/5/2014,2280000.0,7,8.0,13540,307752,3.0,0.0,4.0,3,12,9410,4130,1999,0,98053,47.6675,-121.986,4850,217800,5,5,2014,UNK,8690,89952
5162100650,9/22/2014,316000.0,4,2.5,2320,7379,2.0,0.0,0.0,3,8,2320,0,1987,0,98003,47.3432,-122.316,2230,7614,9,22,2014,UNK,90,-235
3904902510,5/12/2014,690000.0,4,2.5,2670,13463,2.0,0.0,0.0,4,9,2670,0,1989,0,98029,47.5627,-122.01799999999999,2560,10982,5,12,2014,UNK,110,2481
418000330,8/8/2014,199950.0,2,1.0,700,5200,1.0,0.0,0.0,5,5,700,0,1952,0,98056,47.4924,-122.17399999999999,970,5200,8,8,2014,UNK,-270,0
7689600330,8/13/2014,207000.0,3,1.0,860,7740,1.0,0.0,0.0,3,6,860,0,1960,0,98178,47.4906,-122.244,980,7200,8,13,2014,UNK,-120,540
2473370870,4/16/2015,449950.0,4,2.25,3490,8400,1.5,0.0,0.0,4,8,3490,0,1976,0,98058,47.4513,-122.12799999999999,2320,8723,4,16,2015,UNK,1170,-323
2023069054,3/18/2015,361550.0,3,1.75,1160,257875,1.0,0.0,0.0,2,7,1160,0,1980,0,98059,47.4655,-122.072,1420,15450,3,18,2015,UNK,-260,242425
293800410,9/24/2014,824000.0,4,3.5,3650,57538,2.0,0.0,0.0,3,10,3650,0,1996,0,98077,47.7711,-122.041,3730,56257,9,24,2014,UNK,-80,1281
7752000065,1/6/2015,537000.0,3,1.75,1550,10050,1.0,0.0,0.0,5,7,1550,0,1957,0,98008,47.6345,-122.12299999999999,1720,10050,1,6,2015,UNK,-170,0
191100870,8/5/2014,838400.0,4,2.5,2620,9525,2.5,0.0,0.0,4,9,2620,0,1974,0,98040,47.5631,-122.219,2580,9525,8,5,2014,UNK,40,0
5347200220,9/11/2014,225000.0,2,1.0,720,4758,1.0,0.0,0.0,3,6,720,0,1947,0,98126,47.5176,-122.376,990,4920,9,11,2014,UNK,-270,-162
7604400150,4/23/2015,329900.0,3,2.0,1380,5198,1.0,0.0,0.0,4,7,1380,0,1982,0,98106,47.5514,-122.35700000000001,1320,6827,4,23,2015,UNK,60,-1629
3024089057,1/6/2015,282500.0,4,1.0,1170,34925,1.0,0.0,0.0,4,6,1170,0,1942,0,98065,47.5305,-121.84100000000001,1610,28108,1,6,2015,UNK,-440,6817
2212901010,4/6/2015,229950.0,3,1.75,1170,11960,1.0,0.0,0.0,4,7,1170,0,1969,0,98042,47.3279,-122.13600000000001,1230,9800,4,6,2015,UNK,-60,2160
6414100482,3/31/2015,500000.0,2,1.0,1630,12059,1.0,0.0,0.0,3,7,1270,360,1947,0,98125,47.7228,-122.314,1660,8800,3,31,2015,UNK,-30,3259
9455200329,11/4/2014,495000.0,3,1.75,1890,6557,1.0,0.0,0.0,3,8,1890,0,1967,0,98125,47.7032,-122.286,1920,6793,11,4,2014,UNK,-30,-236
9536601996,6/10/2014,149500.0,3,1.0,1010,9450,1.0,0.0,0.0,4,7,1010,0,1959,0,98198,47.3592,-122.315,1240,9450,6,10,2014,UNK,-230,0
1546600230,8/18/2014,726000.0,3,2.5,2040,10033,1.0,0.0,0.0,4,8,1420,620,1974,0,98005,47.6375,-122.17299999999999,2260,10115,8,18,2014,UNK,-220,-82
8691330330,4/9/2015,899000.0,4,2.5,4080,10295,2.0,0.0,0.0,3,10,4080,0,1998,0,98075,47.5933,-121.98200000000001,3470,10295,4,9,2015,UNK,610,0
7788400065,3/15/2015,317000.0,3,1.0,1270,8925,1.0,0.0,0.0,5,7,1270,0,1955,0,98056,47.5124,-122.165,1270,8996,3,15,2015,UNK,0,-71
2771101251,3/26/2015,395000.0,1,1.0,790,3000,1.0,0.0,0.0,3,6,790,0,1953,0,98199,47.6544,-122.38600000000001,1110,4100,3,26,2015,UNK,-320,-1100
4475000120,2/2/2015,360000.0,4,3.0,2580,6740,2.0,0.0,0.0,3,8,2580,0,1999,0,98058,47.4296,-122.185,2010,6740,2,2,2015,UNK,570,0
3905120540,6/18/2014,570000.0,4,2.5,2290,6738,2.0,0.0,0.0,3,8,2290,0,1996,0,98029,47.5714,-122.005,2100,6261,6,18,2014,UNK,190,477
8562890910,6/19/2014,320000.0,4,2.5,3490,5000,2.0,0.0,0.0,3,8,3490,0,2003,0,98042,47.3772,-122.12700000000001,2910,5025,6,19,2014,UNK,580,-25
7701700040,9/25/2014,320000.0,3,1.75,1510,30185,1.5,0.0,0.0,3,7,1510,0,1976,0,98058,47.4118,-122.089,1470,12465,9,25,2014,UNK,40,17720
7237300330,3/12/2015,268000.0,5,2.5,2400,4564,2.0,0.0,0.0,3,7,2400,0,2004,0,98042,47.369,-122.126,1880,4109,3,12,2015,N,520,455
7883608693,6/27/2014,191000.0,2,1.0,900,3400,1.0,0.0,0.0,5,6,900,0,1905,0,98108,47.5269,-122.314,940,6000,6,27,2014,UNK,-40,-2600
4363700304,8/4/2014,400000.0,2,1.0,1270,7440,1.0,0.0,0.0,4,7,910,360,1949,0,98126,47.5285,-122.37200000000001,1040,7500,8,4,2014,UNK,230,-60
2768100040,7/1/2014,515000.0,2,1.0,1050,5000,1.0,0.0,0.0,5,7,1050,0,1907,0,98107,47.6699,-122.369,1340,5000,7,1,2014,UNK,-290,0
7853220120,4/16/2015,610000.0,4,2.5,2950,9010,2.0,0.0,0.0,3,9,2950,0,2004,0,98065,47.53100000000001,-121.86,3160,8813,4,16,2015,N,-210,197
9547204675,10/24/2014,538000.0,2,1.75,1850,3060,1.0,0.0,0.0,3,7,1060,790,1929,1992,98115,47.6821,-122.30799999999999,1850,4080,10,24,2014,Y,0,-1020
7852150220,6/3/2014,432000.0,3,2.5,1970,4036,2.0,0.0,0.0,4,7,1970,0,2003,0,98065,47.5335,-121.869,1960,5020,6,3,2014,UNK,10,-984
5089700720,1/27/2015,335000.0,4,2.25,2400,8592,2.0,0.0,0.0,3,8,2400,0,1978,0,98055,47.4383,-122.193,2180,8100,1,27,2015,UNK,220,492
3705900124,2/20/2015,302000.0,5,1.75,2360,8642,1.5,0.0,0.0,5,7,2060,300,1926,0,98133,47.7617,-122.335,1950,8491,2,20,2015,UNK,410,151
5425700150,8/4/2014,787500.0,4,1.75,1580,9382,1.0,0.0,0.0,3,7,1080,500,1963,0,98039,47.6353,-122.23200000000001,2010,9382,8,4,2014,UNK,-430,0
6141100065,12/18/2014,420000.0,3,1.0,1790,7055,1.0,0.0,0.0,5,8,1520,270,1937,0,98133,47.718,-122.355,1710,7055,12,18,2014,UNK,80,0
2726079098,9/18/2014,560000.0,3,2.5,2840,216493,2.0,0.0,0.0,3,9,2840,0,1991,0,98014,47.702,-121.89200000000001,2820,175111,9,18,2014,UNK,20,41382
3904960150,4/23/2015,535000.0,3,2.5,1970,6634,2.0,0.0,0.0,3,8,1970,0,1989,0,98029,47.5759,-122.012,2090,6176,4,23,2015,UNK,-120,458
3298700156,6/10/2014,310000.0,3,2.5,1780,6771,1.0,0.0,0.0,3,7,1230,550,1990,0,98106,47.5237,-122.353,1780,6771,6,10,2014,UNK,0,0
5700000180,12/8/2014,760000.0,5,2.0,3920,5250,1.5,0.0,0.0,5,7,2560,1360,1910,0,98144,47.5798,-122.294,1830,4240,12,8,2014,UNK,2090,1010
646910620,9/22/2014,242500.0,3,1.75,1550,1905,2.0,0.0,0.0,3,7,1550,0,2005,0,98055,47.4331,-122.195,1550,1866,9,22,2014,N,0,39
2397100975,2/20/2015,1310000.0,6,3.0,2980,7200,1.5,0.0,2.0,3,8,2980,0,1911,0,98119,47.6366,-122.36200000000001,1720,3600,2,20,2015,UNK,1260,3600
5365200040,10/16/2014,235000.0,3,1.0,1270,7153,1.0,0.0,0.0,5,6,1270,0,1949,0,98055,47.4815,-122.226,1650,7153,10,16,2014,UNK,-380,0
4157600180,2/23/2015,598780.0,4,2.25,3040,12160,1.0,0.0,0.0,4,7,1520,1520,1963,0,98007,47.5911,-122.133,2560,12090,2,23,2015,UNK,480,70
723099044,8/7/2014,433200.0,3,2.5,2075,16200,2.0,0.0,0.0,3,8,2075,0,2002,0,98045,47.4848,-121.698,2300,32379,8,7,2014,UNK,-225,-16179
3343300644,5/11/2015,343000.0,2,1.0,1110,9920,1.0,0.0,0.0,5,6,700,410,1942,0,98056,47.5454,-122.19200000000001,2830,10091,5,11,2015,UNK,-1720,-171
2870000040,11/10/2014,145000.0,2,1.0,800,8125,1.0,0.0,0.0,3,6,800,0,1964,0,98033,47.6836,-122.17399999999999,2390,8125,11,10,2014,UNK,-1590,0
739000035,1/16/2015,291970.0,1,1.0,680,21727,1.0,0.0,0.0,3,5,680,0,1952,1995,98058,47.44600000000001,-122.175,1470,19406,1,16,2015,Y,-790,2321
8118600155,3/18/2015,599950.0,3,1.0,1680,7910,1.0,0.0,0.0,3,7,1680,0,1949,0,98146,47.5085,-122.385,1330,7910,3,18,2015,UNK,350,0
3025059072,7/25/2014,1750000.0,4,2.5,3910,22710,1.5,0.0,0.0,3,8,3910,0,1908,2003,98004,47.6295,-122.21700000000001,2920,16544,7,25,2014,Y,990,6166
524059241,3/19/2015,870000.0,4,1.75,2780,11000,1.0,0.0,0.0,3,9,1560,1220,1964,0,98004,47.595,-122.20299999999999,2350,11700,3,19,2015,UNK,430,-700
2215900410,5/8/2015,323000.0,4,2.75,2000,9083,2.0,0.0,0.0,4,7,2000,0,1992,0,98038,47.3511,-122.05799999999999,1690,7735,5,8,2015,UNK,310,1348
7215730410,8/25/2014,727000.0,4,3.0,3150,9703,2.0,0.0,0.0,3,9,3150,0,2001,0,98075,47.5962,-122.01799999999999,3150,8819,8,25,2014,UNK,0,884
3751600146,10/23/2014,166000.0,1,1.0,1120,17332,1.0,0.0,0.0,3,7,1120,0,1988,0,98001,47.2972,-122.26700000000001,1280,17334,10,23,2014,UNK,-160,-2
3461000120,4/30/2015,450000.0,4,1.75,1740,12204,1.0,0.0,0.0,3,7,1270,470,1961,0,98155,47.7675,-122.277,2190,12204,4,30,2015,UNK,-450,0
9238500040,6/24/2014,400000.0,3,2.5,2970,23100,1.0,0.0,0.0,3,7,1510,1460,1967,0,98072,47.7735,-122.133,2390,20300,6,24,2014,UNK,580,2800
9238500040,2/10/2015,599000.0,3,2.5,2970,23100,1.0,0.0,0.0,3,7,1510,1460,1967,0,98072,47.7735,-122.133,2390,20300,2,10,2015,UNK,580,2800
3751604895,6/5/2014,165000.0,3,1.0,1150,19200,1.0,0.0,0.0,4,5,1150,0,1908,0,98001,47.2756,-122.27,1290,19200,6,5,2014,UNK,-140,0
8961800035,6/5/2014,229000.0,2,1.0,1190,7408,1.0,0.0,0.0,3,6,830,360,1941,0,98168,47.5094,-122.31,1140,7408,6,5,2014,UNK,50,0
1154100205,10/13/2014,305000.0,1,1.0,900,7500,1.0,0.0,0.0,3,5,900,0,1946,0,98155,47.7553,-122.28299999999999,1470,7500,10,13,2014,UNK,-570,0
9274203036,9/15/2014,930000.0,3,3.25,2950,4446,2.0,0.0,0.0,3,9,2450,500,2001,0,98116,47.5852,-122.391,1930,4255,9,15,2014,UNK,1020,191
3296000040,9/23/2014,542000.0,3,2.5,1990,15985,1.0,0.0,0.0,3,8,1540,450,1964,0,98007,47.6205,-122.141,2470,10125,9,23,2014,UNK,-480,5860
1421069123,9/9/2014,214000.0,3,1.0,1020,9147,1.0,0.0,0.0,4,6,1020,0,1900,1965,98010,47.3127,-122.00200000000001,1600,9700,9,9,2014,Y,-580,-553
1245500276,9/9/2014,718000.0,3,2.5,2070,7200,2.0,0.0,0.0,3,8,2070,0,2001,0,98033,47.6946,-122.211,1650,8877,9,9,2014,UNK,420,-1677
263000325,6/11/2014,349000.0,3,2.5,1430,1002,3.0,0.0,0.0,3,8,1430,0,2002,0,98103,47.698,-122.34899999999999,1430,1530,6,11,2014,UNK,0,-528
8802400644,5/5/2015,305000.0,3,2.5,2030,8000,2.0,0.0,0.0,3,7,2030,0,1997,0,98031,47.4024,-122.21600000000001,2290,7945,5,5,2015,UNK,-260,55
9826701345,7/15/2014,498000.0,3,2.5,1620,2640,2.0,0.0,0.0,4,7,1620,0,1900,1993,98122,47.6036,-122.305,1370,3840,7,15,2014,Y,250,-1200
3221059044,5/23/2014,799950.0,4,3.5,4220,196817,2.0,0.0,0.0,3,10,4220,0,1993,0,98092,47.2642,-122.18700000000001,2500,195395,5,23,2014,UNK,1720,1422
9430110120,5/5/2015,737000.0,3,2.5,2300,7800,2.0,0.0,2.0,3,9,2300,0,1997,0,98052,47.6842,-122.155,2300,8187,5,5,2015,UNK,0,-387
424069275,12/26/2014,860000.0,4,3.25,3830,10005,2.0,0.0,0.0,3,10,3830,0,2001,0,98075,47.5953,-122.039,2555,5204,12,26,2014,UNK,1275,4801
9485940330,7/2/2014,339950.0,3,2.5,2390,34041,1.0,0.0,0.0,3,8,1840,550,1984,0,98042,47.3546,-122.081,2460,35686,7,2,2014,UNK,-70,-1645
2787460120,5/16/2014,249000.0,3,2.25,1440,7673,1.0,0.0,0.0,3,7,940,500,1982,0,98031,47.4034,-122.178,1440,8418,5,16,2014,UNK,0,-745
293000180,5/7/2015,370000.0,2,1.0,910,5525,1.0,0.0,0.0,2,6,910,0,1910,0,98126,47.5322,-122.37899999999999,1620,5525,5,7,2015,UNK,-710,0
7785000220,10/13/2014,725000.0,3,2.0,1550,12262,1.0,0.0,0.0,4,7,1550,0,1964,0,98040,47.5755,-122.21600000000001,2900,12372,10,13,2014,UNK,-1350,-110
1523059183,12/5/2014,529000.0,5,2.5,2380,91476,1.0,0.0,0.0,4,8,1580,800,1976,0,98059,47.479,-122.15299999999999,1880,12870,12,5,2014,UNK,500,78606
9536601852,3/17/2015,310000.0,4,2.75,2060,8100,1.0,0.0,0.0,4,7,1310,750,1988,0,98198,47.3581,-122.31700000000001,1540,8100,3,17,2015,UNK,520,0
2591800530,10/27/2014,315000.0,4,2.25,1880,9163,2.0,0.0,0.0,3,8,1880,0,1981,0,98058,47.4362,-122.165,1900,7980,10,27,2014,UNK,-20,1183
1732800865,10/2/2014,1300000.0,4,2.5,3470,4160,2.0,0.0,0.0,3,9,2480,990,1927,0,98119,47.63,-122.363,2280,5440,10,2,2014,UNK,1190,-1280
2525000760,11/5/2014,435000.0,3,2.0,2360,12744,2.0,0.0,0.0,5,7,2360,0,1964,0,98059,47.483000000000004,-122.164,1650,8625,11,5,2014,UNK,710,4119
428100580,7/16/2014,350000.0,3,1.75,1970,10800,1.0,0.0,0.0,4,7,1300,670,1979,0,98056,47.5107,-122.17200000000001,1970,8768,7,16,2014,UNK,0,2032
2143700676,9/8/2014,240000.0,3,1.0,1040,7800,1.0,0.0,0.0,3,7,1040,0,1948,0,98055,47.4804,-122.229,1780,8400,9,8,2014,UNK,-740,-600
2313900610,4/28/2015,410000.0,3,2.25,1420,3750,2.0,0.0,0.0,3,7,1420,0,1987,0,98116,47.5725,-122.383,1430,4664,4,28,2015,UNK,-10,-914
8946410040,9/23/2014,430000.0,4,2.75,2290,5249,2.0,0.0,0.0,3,7,2290,0,2003,0,98059,47.4916,-122.162,2270,4348,9,23,2014,UNK,20,901
3275730120,8/18/2014,446000.0,4,2.5,1530,8375,1.0,0.0,0.0,3,7,1020,510,1974,0,98034,47.7174,-122.236,1650,9794,8,18,2014,UNK,-120,-1419
7334500120,6/11/2014,240000.0,3,1.5,1360,9760,1.5,0.0,0.0,5,7,1360,0,1984,0,98045,47.4648,-121.757,1310,11456,6,11,2014,UNK,50,-1696
5561401210,1/8/2015,595000.0,4,3.0,3680,35736,1.5,0.0,0.0,4,8,2320,1360,1970,0,98027,47.4703,-122.015,3210,39512,1,8,2015,UNK,470,-3776
8651410330,3/6/2015,215150.0,3,1.0,920,4770,1.0,0.0,0.0,4,6,920,0,1969,0,98042,47.3654,-122.08200000000001,920,4770,3,6,2015,UNK,0,0
4058801325,5/22/2014,319950.0,2,1.0,1070,5824,1.0,0.0,2.0,5,7,1070,0,1949,0,98178,47.507,-122.242,2090,7980,5,22,2014,UNK,-1020,-2156
2817100910,6/16/2014,385000.0,3,2.0,1590,9912,2.0,0.0,0.0,3,8,1590,0,2000,0,98070,47.3731,-122.43,1670,9912,6,16,2014,UNK,-80,0
8647800040,3/25/2015,280000.0,3,2.5,1600,6700,2.0,0.0,0.0,3,8,1600,0,1991,0,98042,47.3618,-122.074,1790,7577,3,25,2015,UNK,-190,-877
1138010180,5/11/2015,399950.0,3,2.5,1510,7300,1.0,0.0,0.0,3,7,1040,470,1974,0,98034,47.7153,-122.211,1360,7300,5,11,2015,UNK,150,0
4014400237,5/23/2014,132500.0,3,1.0,1080,10500,1.0,0.0,0.0,3,7,1080,0,1967,0,98001,47.32,-122.27799999999999,1200,9607,5,23,2014,UNK,-120,893
9358000650,4/23/2015,399950.0,2,0.75,1330,2856,1.0,0.0,0.0,4,7,930,400,1916,0,98126,47.5671,-122.37,1330,2856,4,23,2015,UNK,0,0
6150200180,7/21/2014,290000.0,2,1.0,850,6800,1.0,0.0,0.0,3,7,850,0,1948,0,98133,47.7282,-122.337,870,6800,7,21,2014,UNK,-20,0
8146300180,5/12/2015,860000.0,5,2.25,1960,8592,1.0,0.0,0.0,4,8,1290,670,1958,0,98004,47.6066,-122.19200000000001,1720,8592,5,12,2015,UNK,240,0
2424049029,5/29/2014,3100000.0,6,4.25,6980,15682,3.0,0.0,4.0,4,12,5330,1650,1999,0,98040,47.5552,-122.23100000000001,3930,18367,5,29,2014,UNK,3050,-2685
3352400905,5/16/2014,245000.0,4,1.0,1530,7200,1.5,0.0,0.0,3,7,1400,130,1948,0,98178,47.5015,-122.262,1530,7200,5,16,2014,UNK,0,0
393000385,12/15/2014,255000.0,3,1.5,1320,7980,1.0,0.0,0.0,3,7,1320,0,1956,0,98178,47.5068,-122.259,2000,7700,12,15,2014,UNK,-680,280
7417100133,11/13/2014,310000.0,4,3.0,2320,7200,2.0,0.0,0.0,3,7,2320,0,1976,0,98155,47.7703,-122.31200000000001,2050,10000,11,13,2014,UNK,270,-2800
3782100035,8/13/2014,299000.0,3,1.0,960,8100,1.0,0.0,0.0,3,7,960,0,1955,0,98155,47.7763,-122.305,1080,8100,8,13,2014,UNK,-120,0
3905120330,11/10/2014,575000.0,4,2.5,2040,5508,2.0,0.0,0.0,4,8,2040,0,1996,0,98029,47.5719,-122.007,2130,5496,11,10,2014,UNK,-90,12
9310300211,11/14/2014,284000.0,3,1.0,1080,8214,1.0,0.0,0.0,3,7,1080,0,1944,0,98133,47.7401,-122.348,1850,13560,11,14,2014,UNK,-770,-5346
1868900035,4/7/2015,840000.0,3,1.75,2020,4800,1.0,0.0,0.0,4,8,1090,930,1926,0,98115,47.6726,-122.294,1680,4800,4,7,2015,UNK,340,0
3574801510,8/13/2014,442573.0,3,1.75,1780,7567,1.0,0.0,0.0,3,7,1290,490,1980,0,98034,47.7314,-122.225,1910,8645,8,13,2014,UNK,-130,-1078
5102400035,10/8/2014,560000.0,3,1.0,1140,7028,1.0,0.0,0.0,3,8,1140,0,1931,0,98115,47.6948,-122.322,1350,6923,10,8,2014,UNK,-210,105
2810100040,5/7/2014,485000.0,3,2.0,1610,4160,1.0,0.0,0.0,4,7,1010,600,1917,0,98136,47.5421,-122.38799999999999,1040,4400,5,7,2014,UNK,570,-240
785000040,3/18/2015,472500.0,4,1.75,1440,8536,1.0,0.0,0.0,4,7,1440,0,1961,0,98033,47.6775,-122.18,1720,9748,3,18,2015,UNK,-280,-1212
3861470120,11/26/2014,1610000.0,4,2.75,4270,25807,2.0,0.0,0.0,3,11,4270,0,1996,0,98004,47.5951,-122.206,3860,20723,11,26,2014,UNK,410,5084
8813400155,12/19/2014,808000.0,8,3.75,3460,4600,2.0,0.0,0.0,3,7,2860,600,1987,0,98105,47.6617,-122.289,2170,3750,12,19,2014,UNK,1290,850
526059199,10/22/2014,398000.0,3,1.75,1890,16001,1.5,0.0,0.0,4,7,1890,0,1950,0,98011,47.7663,-122.20100000000001,1820,11450,10,22,2014,UNK,70,4551
5126300770,2/17/2015,340000.0,3,2.5,2240,6000,2.0,0.0,0.0,3,8,2240,0,2003,0,98059,47.4837,-122.13799999999999,2400,6000,2,17,2015,UNK,-160,0
2734100395,5/13/2015,380000.0,2,1.0,760,4000,1.5,0.0,0.0,3,6,760,0,1910,0,98108,47.5462,-122.32,1130,4000,5,13,2015,UNK,-370,0
795000865,9/12/2014,235000.0,3,1.0,1020,6173,1.0,0.0,0.0,3,6,780,240,1948,0,98168,47.5042,-122.329,1330,5909,9,12,2014,UNK,-310,264
3763300040,10/27/2014,400000.0,3,1.5,1330,9900,1.0,0.0,0.0,3,7,1330,0,1956,0,98034,47.7167,-122.23299999999999,1940,9900,10,27,2014,UNK,-610,0
1777600880,7/11/2014,582000.0,5,2.5,2780,12335,1.0,0.0,0.0,4,8,1590,1190,1968,0,98006,47.5681,-122.12799999999999,2750,9930,7,11,2014,UNK,30,2405
3361401210,12/31/2014,209000.0,2,1.0,1070,6120,1.0,0.0,0.0,3,6,1070,0,1962,0,98168,47.4989,-122.31700000000001,1130,6120,12,31,2014,UNK,-60,0
1431600180,4/3/2015,335000.0,5,3.0,2660,7700,1.5,0.0,0.0,4,7,1670,990,1962,0,98058,47.46,-122.17399999999999,1610,7700,4,3,2015,UNK,1050,0
7454001120,12/12/2014,285950.0,2,1.0,710,7120,1.0,0.0,0.0,5,6,710,0,1942,0,98146,47.5122,-122.374,1100,7020,12,12,2014,UNK,-390,100
5561100180,11/7/2014,645000.0,5,2.25,3340,52476,2.0,0.0,0.0,4,8,3340,0,1975,0,98027,47.4553,-121.98700000000001,2460,48351,11,7,2014,UNK,880,4125
8658303080,12/23/2014,312000.0,2,1.0,1160,7500,1.5,0.0,0.0,4,7,1160,0,1916,0,98014,47.6499,-121.916,1110,7500,12,23,2014,UNK,50,0
6795100589,10/10/2014,663000.0,3,2.25,2840,59677,1.0,0.0,0.0,3,7,1580,1260,1967,0,98075,47.5828,-122.044,2220,31688,10,10,2014,UNK,620,27989
3345100184,10/20/2014,443950.0,3,1.75,2000,36000,1.0,0.0,0.0,3,6,2000,0,1946,0,98056,47.5217,-122.182,2100,9681,10,20,2014,UNK,-100,26319
9284801165,5/30/2014,315000.0,3,2.0,1060,5750,1.0,0.0,0.0,3,7,1060,0,1981,0,98126,47.5523,-122.37200000000001,1080,5750,5,30,2014,UNK,-20,0
7229100180,3/23/2015,302200.0,4,1.5,1730,10396,1.0,0.0,0.0,3,7,1730,0,1964,0,98058,47.4497,-122.16799999999999,1510,10396,3,23,2015,UNK,220,0
9808630120,1/8/2015,770000.0,3,2.5,2190,2658,2.0,0.0,3.0,4,9,2190,0,1979,0,98033,47.6528,-122.20299999999999,2315,2538,1,8,2015,UNK,-125,120
2473411210,1/22/2015,374950.0,4,1.75,1660,8160,1.0,0.0,0.0,3,8,1660,0,1974,0,98058,47.4483,-122.12899999999999,1800,7684,1,22,2015,UNK,-140,476
8029500180,6/11/2014,330000.0,3,2.5,2210,7557,2.0,0.0,0.0,3,9,2210,0,1989,0,98023,47.3079,-122.39299999999999,2440,8641,6,11,2014,UNK,-230,-1084
3438503014,10/20/2014,230000.0,2,1.0,870,7020,1.0,0.0,0.0,4,6,570,300,1942,0,98106,47.5404,-122.352,1730,7020,10,20,2014,UNK,-860,0
5100403882,4/27/2015,967000.0,4,2.5,3100,7250,2.0,0.0,0.0,3,9,3100,0,2010,0,98115,47.6961,-122.316,1240,6670,4,27,2015,N,1860,580
6909200401,9/8/2014,536500.0,4,2.5,1720,3515,2.0,0.0,2.0,3,8,1470,0,2000,0,98144,47.591,-122.29299999999999,1140,2208,9,8,2014,UNK,580,1307
2113700360,6/27/2014,315000.0,6,4.0,3120,4240,2.0,0.0,2.0,4,7,2090,1030,1993,0,98106,47.5305,-122.353,1460,4240,6,27,2014,UNK,1660,0
2028701075,7/16/2014,626000.0,3,1.0,1040,4240,1.0,0.0,0.0,4,7,860,180,1924,0,98117,47.6768,-122.367,1170,4240,7,16,2014,UNK,-130,0
3755200220,7/18/2014,334009.0,4,2.0,1650,9305,1.0,0.0,0.0,4,6,1650,0,1960,0,98034,47.7183,-122.213,1860,7486,7,18,2014,UNK,-210,1819
2767800065,1/29/2015,429000.0,2,1.0,1010,5000,1.0,0.0,0.0,2,7,1010,0,1924,0,98107,47.6715,-122.365,1410,5000,1,29,2015,UNK,-400,0
1136100087,2/5/2015,818000.0,4,2.5,4020,44431,2.0,0.0,0.0,3,10,4020,0,1987,0,98072,47.7467,-122.132,3440,52900,2,5,2015,UNK,580,-8469
3422059257,8/28/2014,326000.0,5,2.75,2166,6342,2.0,0.0,0.0,3,8,2166,0,2013,0,98042,47.3461,-122.152,2474,5948,8,28,2014,N,-308,394
3438502083,6/12/2014,310000.0,5,3.0,1880,5000,1.0,0.0,0.0,3,7,1100,780,1997,0,98106,47.5453,-122.363,1640,5000,6,12,2014,UNK,240,0
930000234,4/21/2015,525000.0,4,2.0,2260,7680,1.0,0.0,0.0,4,7,1130,1130,1947,0,98177,47.7193,-122.361,1800,7680,4,21,2015,UNK,460,0
2475200330,4/3/2015,350000.0,3,2.25,2010,4400,1.5,0.0,0.0,3,7,2010,0,1986,0,98055,47.4735,-122.189,1720,4187,4,3,2015,UNK,290,213
6352600650,4/2/2015,936000.0,4,2.5,3330,8897,2.0,0.0,0.0,3,10,3330,0,2001,0,98074,47.6484,-122.08,3150,7515,4,2,2015,UNK,180,1382
4415600040,11/29/2014,226000.0,3,1.0,1520,7200,1.0,0.0,0.0,3,7,1030,490,1954,0,98166,47.4527,-122.352,1530,7201,11,29,2014,UNK,-10,-1
7974700150,5/1/2015,1250000.0,5,3.5,3510,4798,2.0,0.0,0.0,3,10,2700,810,2008,0,98105,47.669,-122.28200000000001,1460,1684,5,1,2015,N,2050,3114
820079043,8/19/2014,428000.0,3,1.75,1580,507038,1.0,0.0,2.0,4,7,1580,0,1985,0,98022,47.2303,-121.936,2040,210394,8,19,2014,UNK,-460,296644
8910500150,5/29/2014,329932.0,3,1.5,1460,5040,1.0,0.0,0.0,3,7,1100,360,1971,0,98133,47.7112,-122.35700000000001,2330,7560,5,29,2014,UNK,-870,-2520
8910500150,1/20/2015,539000.0,3,1.5,1460,5040,1.0,0.0,0.0,3,7,1100,360,1971,0,98133,47.7112,-122.35700000000001,2330,7560,1,20,2015,UNK,-870,-2520
1938400410,3/10/2015,275000.0,3,1.75,1650,7700,1.0,0.0,0.0,4,8,1650,0,1977,0,98023,47.3155,-122.365,2020,7700,3,10,2015,UNK,-370,0
7338200180,9/10/2014,590000.0,4,2.5,2660,35010,2.0,0.0,2.0,3,9,2660,0,1993,0,98045,47.4816,-121.714,2330,35448,9,10,2014,UNK,330,-438
3636800180,1/23/2015,782000.0,4,2.5,3510,24604,2.0,0.0,0.0,3,10,3510,0,1997,0,98053,47.6772,-122.056,3530,26673,1,23,2015,UNK,-20,-2069
9545240180,6/16/2014,575000.0,4,2.5,2120,9603,2.0,0.0,0.0,3,8,2120,0,1985,0,98027,47.5348,-122.053,1990,9611,6,16,2014,UNK,130,-8
3293700482,1/14/2015,509000.0,3,2.25,1780,9315,2.0,0.0,0.0,3,7,1780,0,1996,0,98133,47.7484,-122.353,1780,8545,1,14,2015,UNK,0,770
7968000120,5/9/2014,290000.0,4,2.5,2000,13300,1.0,0.0,0.0,4,7,1200,800,1968,0,98001,47.353,-122.294,1800,9810,5,9,2014,UNK,200,3490
7655900062,7/28/2014,305240.0,3,1.0,1300,9000,1.0,0.0,0.0,3,7,1300,0,1956,0,98133,47.7352,-122.337,1500,9600,7,28,2014,UNK,-200,-600
4321200970,6/10/2014,555000.0,3,2.0,2180,4976,1.5,0.0,2.0,4,8,1680,500,1930,0,98126,47.573,-122.38,1850,5000,6,10,2014,UNK,330,-24
8645540040,7/25/2014,317000.0,3,2.0,1790,8228,1.0,0.0,0.0,3,7,1390,400,1980,0,98058,47.4658,-122.17200000000001,1880,8228,7,25,2014,UNK,-90,0
7504200120,6/13/2014,430000.0,3,2.0,1910,5040,1.5,0.0,0.0,3,8,1910,0,1971,0,98074,47.6312,-122.061,1980,4275,6,13,2014,UNK,-70,765
3867400175,2/24/2015,850000.0,2,1.5,1800,4144,1.0,0.0,4.0,4,7,900,900,1962,0,98116,47.5934,-122.39,2090,4173,2,24,2015,UNK,-290,-29
4022906222,11/26/2014,469000.0,3,2.25,2620,10659,1.0,0.0,0.0,3,7,1660,960,1976,0,98155,47.7643,-122.273,1820,12071,11,26,2014,UNK,800,-1412
7346600092,7/30/2014,327200.0,2,2.0,1440,8425,1.0,0.0,0.0,4,6,1440,0,1942,1983,98168,47.4831,-122.296,1430,12037,7,30,2014,Y,10,-3612
3222049044,6/12/2014,835000.0,3,3.0,2790,12523,2.0,1.0,4.0,4,8,1600,1190,1977,0,98198,47.3571,-122.324,2990,11476,6,12,2014,UNK,-200,1047
1843100580,9/3/2014,360000.0,4,2.5,2340,13445,2.0,0.0,0.0,3,8,2340,0,1990,0,98042,47.373999999999995,-122.125,2340,11188,9,3,2014,UNK,0,2257
393000142,12/11/2014,372000.0,4,2.5,2070,8658,2.0,0.0,0.0,3,8,2070,0,1999,0,98178,47.5072,-122.257,2010,7215,12,11,2014,UNK,60,1443
3288200360,3/26/2015,453000.0,3,1.0,2160,11484,1.5,0.0,0.0,4,7,2160,0,1968,0,98034,47.7277,-122.185,2270,10080,3,26,2015,UNK,-110,1404
5379800040,8/13/2014,275000.0,2,1.75,2090,11317,1.0,0.0,0.0,5,7,1090,1000,1931,0,98188,47.4594,-122.279,1940,11317,8,13,2014,UNK,150,0
6843600040,7/2/2014,475000.0,4,2.5,2040,7260,2.0,0.0,0.0,4,7,2040,0,1963,0,98133,47.7399,-122.33200000000001,2040,7360,7,2,2014,UNK,0,-100
1091500120,2/13/2015,310000.0,4,2.75,1950,9720,1.0,0.0,0.0,3,7,1400,550,1986,0,98031,47.3969,-122.205,2300,10530,2,13,2015,UNK,-350,-810
7148200040,2/10/2015,173000.0,4,2.0,1200,8460,1.0,0.0,0.0,5,7,1200,0,1957,0,98188,47.4413,-122.277,1350,8623,2,10,2015,UNK,-150,-163
1623089025,4/3/2015,313500.0,5,3.0,2240,94960,1.0,0.0,0.0,3,6,2240,0,1985,0,98045,47.481,-121.788,1780,43400,4,3,2015,UNK,460,51560
3278600760,7/29/2014,345000.0,3,2.5,1360,1489,2.0,0.0,0.0,3,8,1360,0,2007,0,98126,47.549,-122.37200000000001,1360,1688,7,29,2014,N,0,-199
1226039054,3/16/2015,436000.0,3,1.5,1500,10200,1.0,0.0,0.0,3,8,1300,200,1955,0,98177,47.7598,-122.359,1950,9500,3,16,2015,UNK,-450,700
798000145,9/24/2014,244500.0,2,1.75,1300,14500,1.0,0.0,0.0,3,6,650,0,1939,0,98168,47.4989,-122.329,1370,12986,9,24,2014,UNK,-70,1514
7905400040,7/11/2014,206000.0,3,1.75,1140,9800,1.0,0.0,0.0,4,7,1140,0,1968,0,98001,47.3063,-122.27,1370,9800,7,11,2014,UNK,-230,0
3825310720,4/21/2015,890000.0,4,2.5,2930,9158,2.0,0.0,0.0,3,9,2930,0,2005,0,98052,47.7065,-122.13,3590,8065,4,21,2015,N,-660,1093
4137000540,1/22/2015,329950.0,4,2.25,2140,8874,2.0,0.0,0.0,3,8,2140,0,1986,0,98092,47.2654,-122.21700000000001,2140,8789,1,22,2015,UNK,0,85
120059044,2/17/2015,250000.0,3,1.75,1628,286355,1.0,0.0,0.0,3,7,1628,0,1996,0,98092,47.2558,-122.12200000000001,1490,216344,2,17,2015,UNK,138,70011
420069021,10/27/2014,246000.0,3,2.0,1990,203861,1.0,0.0,0.0,3,7,1990,0,1949,0,98022,47.2507,-122.039,2760,217800,10,27,2014,UNK,-770,-13939
622100092,7/16/2014,440000.0,3,1.75,1950,19747,1.0,0.0,0.0,3,7,1150,800,1979,0,98072,47.7685,-122.162,2560,9674,7,16,2014,UNK,-610,10073
3876312620,9/24/2014,395000.0,4,1.75,1910,8117,1.0,0.0,0.0,3,7,1460,450,1975,0,98072,47.7344,-122.17299999999999,1810,8100,9,24,2014,UNK,100,17
3331001165,9/26/2014,305000.0,3,1.0,820,5150,1.0,0.0,0.0,5,6,820,0,1918,0,98118,47.5514,-122.28399999999999,1100,5150,9,26,2014,UNK,-280,0
2019200220,9/23/2014,160000.0,3,2.25,1470,8682,1.0,0.0,0.0,3,7,1160,310,1985,0,98003,47.2729,-122.29899999999999,1670,8359,9,23,2014,UNK,-200,323
2019200220,2/26/2015,269000.0,3,2.25,1470,8682,1.0,0.0,0.0,3,7,1160,310,1985,0,98003,47.2729,-122.29899999999999,1670,8359,2,26,2015,UNK,-200,323
7956200220,8/11/2014,169500.0,3,1.0,1060,10023,1.0,0.0,0.0,3,6,1060,0,1962,0,98023,47.2869,-122.36,1060,10023,8,11,2014,UNK,0,0
6632900452,12/5/2014,690500.0,4,2.75,3130,8920,2.0,0.0,0.0,3,8,3130,0,2014,0,98155,47.7397,-122.316,1450,9183,12,5,2014,N,1680,-263
8165100035,12/3/2014,245560.0,2,1.5,1260,9693,1.0,0.0,0.0,3,7,1260,0,1957,0,98177,47.7775,-122.365,1800,9693,12,3,2014,UNK,-540,0
9264930970,3/11/2015,345000.0,4,2.75,2200,13498,2.0,0.0,0.0,3,8,2200,0,1987,0,98023,47.3148,-122.35,2190,11850,3,11,2015,UNK,10,1648
3344500085,10/15/2014,383000.0,4,1.75,2580,19607,1.0,0.0,2.0,4,8,1290,1290,1958,0,98056,47.5067,-122.197,1970,9569,10,15,2014,UNK,610,10038
3320000222,8/27/2014,388500.0,3,2.25,1350,944,2.0,0.0,0.0,3,8,1050,300,2007,0,98144,47.5997,-122.31200000000001,1350,1245,8,27,2014,N,0,-301
3375300210,9/18/2014,250000.0,3,1.75,1350,8548,1.0,0.0,0.0,3,7,1350,0,1985,0,98003,47.3179,-122.33,1660,8538,9,18,2014,UNK,-310,10
5469500580,2/3/2015,455500.0,3,1.75,2290,19000,1.0,0.0,0.0,4,9,1650,640,1973,0,98042,47.3837,-122.15799999999999,2900,13034,2,3,2015,UNK,-610,5966
8146100610,12/1/2014,672000.0,3,1.0,1220,8573,1.0,0.0,0.0,4,7,1220,0,1954,0,98004,47.6088,-122.193,1390,8573,12,1,2014,UNK,-170,0
3223059123,6/30/2014,550000.0,4,1.5,2750,128502,1.0,0.0,0.0,2,7,1500,1250,1958,0,98055,47.4345,-122.198,1470,11514,6,30,2014,UNK,1280,116988
2325059101,5/6/2015,487000.0,3,1.75,1430,12632,1.0,0.0,0.0,3,7,1430,0,1959,0,98008,47.6371,-122.12299999999999,1750,10350,5,6,2015,UNK,-320,2282
9475710040,8/20/2014,291375.0,4,2.5,2220,6233,2.0,0.0,0.0,3,7,2220,0,2001,0,98059,47.4887,-122.15,2220,5352,8,20,2014,UNK,0,881
9310300175,3/4/2015,225000.0,3,1.0,1490,15850,1.0,0.0,0.0,3,7,1490,0,1946,0,98133,47.7411,-122.34700000000001,1950,13228,3,4,2015,UNK,-460,2622
8099900040,11/11/2014,519950.0,5,3.5,2440,10200,2.0,0.0,0.0,4,7,2440,0,1974,0,98075,47.5814,-122.00299999999999,2000,10568,11,11,2014,UNK,440,-368
3224800120,8/26/2014,250000.0,3,2.5,2070,8400,2.0,0.0,0.0,4,8,2070,0,1990,0,98002,47.3099,-122.206,2070,9239,8,26,2014,UNK,0,-839
4232903265,9/18/2014,614950.0,3,1.0,1500,2400,1.5,0.0,0.0,5,7,1500,0,1900,0,98119,47.6333,-122.36200000000001,1780,3600,9,18,2014,UNK,-280,-1200
8861500065,1/14/2015,599500.0,4,2.25,2020,10260,2.0,0.0,0.0,4,7,2020,0,1984,0,98052,47.6801,-122.11399999999999,2020,10311,1,14,2015,UNK,0,-51
3585300365,9/24/2014,625000.0,4,1.5,2190,13660,1.0,0.0,3.0,3,8,2190,0,1952,0,98177,47.7658,-122.37,2520,20500,9,24,2014,UNK,-330,-6840
8019200360,5/6/2015,248500.0,2,1.0,780,10064,1.0,0.0,0.0,4,7,780,0,1958,0,98168,47.4913,-122.318,1090,14750,5,6,2015,UNK,-310,-4686
2862100205,9/30/2014,469950.0,5,2.0,1220,4200,1.0,0.0,0.0,4,6,1090,130,1921,0,98105,47.6677,-122.321,1790,4200,9,30,2014,UNK,-570,0
7420100040,4/22/2015,525000.0,3,1.5,1840,10956,1.0,0.0,0.0,4,8,1840,0,1970,0,98033,47.6746,-122.164,1680,10950,4,22,2015,UNK,160,6
223039229,9/2/2014,787500.0,2,2.5,2390,6928,2.0,0.0,3.0,4,8,1810,580,1949,1982,98146,47.5101,-122.391,2390,12852,9,2,2014,Y,0,-5924
7967950040,4/16/2015,485000.0,4,2.5,3710,15935,1.0,0.0,0.0,3,10,2130,1580,2005,0,98001,47.3528,-122.26700000000001,3674,17913,4,16,2015,N,36,-1978
1443500120,4/7/2015,310000.0,2,1.0,750,5379,1.0,0.0,0.0,3,6,750,0,1919,0,98118,47.5324,-122.272,1030,5511,4,7,2015,UNK,-280,-132
3920000040,10/10/2014,280000.0,5,2.0,2110,7919,1.0,0.0,0.0,3,7,1110,1000,1966,0,98118,47.5164,-122.26700000000001,1590,5250,10,10,2014,UNK,520,2669
126059021,4/2/2015,200000.0,4,1.0,1020,42966,1.5,0.0,0.0,4,6,1020,0,1922,0,98072,47.7617,-122.11,2250,37680,4,2,2015,UNK,-1230,5286
8106300970,10/10/2014,490000.0,3,2.5,3080,7363,2.0,0.0,0.0,3,9,3080,0,2006,0,98055,47.4473,-122.205,2860,5273,10,10,2014,N,220,2090
9320900610,12/31/2014,146000.0,3,1.0,900,4770,1.0,0.0,0.0,3,6,900,0,1969,2009,98023,47.3038,-122.36200000000001,900,3480,12,31,2014,Y,0,1290
5647900650,11/20/2014,500000.0,5,3.0,3720,25474,2.0,0.0,4.0,3,9,2090,1630,1986,0,98001,47.3296,-122.256,1870,14547,11,20,2014,UNK,1850,10927
1432701430,9/10/2014,242500.0,3,1.0,940,7380,1.0,0.0,0.0,3,6,940,0,1959,0,98058,47.4516,-122.175,1210,8095,9,10,2014,UNK,-270,-715
6632300477,10/6/2014,324950.0,3,1.0,1040,7288,1.0,0.0,0.0,3,7,1040,0,1959,0,98125,47.7287,-122.311,1160,7287,10,6,2014,UNK,-120,1
9476200150,4/16/2015,231500.0,2,1.0,1000,7615,1.0,0.0,0.0,4,6,1000,0,1943,0,98056,47.49,-122.191,1060,8000,4,16,2015,UNK,-60,-385
8029500450,5/29/2014,300000.0,3,2.5,2080,9827,2.0,0.0,0.0,3,8,2080,0,1989,0,98023,47.3058,-122.39399999999999,2660,9861,5,29,2014,UNK,-580,-34
9510320150,12/2/2014,545000.0,4,2.5,2500,50595,2.0,0.0,0.0,3,9,2500,0,1997,0,98045,47.4736,-121.73100000000001,2765,33720,12,2,2014,UNK,-265,16875
415100085,2/17/2015,350000.0,3,1.0,1050,8583,1.0,0.0,0.0,5,6,1050,0,1955,0,98133,47.7451,-122.339,1460,7351,2,17,2015,UNK,-410,1232
8562850150,5/23/2014,467100.0,3,1.75,1620,8645,1.0,0.0,0.0,3,7,1190,430,1973,0,98052,47.6651,-122.15100000000001,2010,8645,5,23,2014,UNK,-390,0
1951600150,4/8/2015,180000.0,3,1.0,1610,8500,1.5,0.0,0.0,3,7,1610,0,1959,0,98032,47.3717,-122.29700000000001,1070,8750,4,8,2015,UNK,540,-250
6745700150,7/10/2014,749000.0,4,1.5,2130,5000,2.0,0.0,0.0,4,8,2130,0,1920,0,98144,47.5828,-122.291,2560,5000,7,10,2014,UNK,-430,0
9211520410,10/9/2014,245000.0,3,2.5,1460,11593,2.0,0.0,0.0,3,7,1460,0,1989,0,98023,47.2984,-122.385,1640,9703,10,9,2014,UNK,-180,1890
3388000040,8/19/2014,260000.0,5,1.0,1600,7350,1.0,0.0,0.0,5,7,1600,0,1962,0,98031,47.3943,-122.196,1600,7725,8,19,2014,UNK,0,-375
3566800040,6/7/2014,490000.0,3,3.0,1730,2940,3.0,0.0,0.0,3,7,1730,0,1985,0,98117,47.6911,-122.39200000000001,1690,4410,6,7,2014,UNK,40,-1470
4221250120,8/27/2014,565000.0,4,2.5,2280,4602,2.0,0.0,0.0,3,8,2280,0,2003,0,98075,47.5895,-122.01899999999999,2280,4193,8,27,2014,UNK,0,409
1402600040,8/25/2014,330000.0,4,2.25,2430,7490,2.0,0.0,0.0,3,8,2430,0,1983,0,98058,47.4406,-122.139,2070,7469,8,25,2014,UNK,360,21
2720000120,11/4/2014,295000.0,3,1.0,1380,7575,1.0,0.0,0.0,4,7,1380,0,1963,0,98056,47.5139,-122.18700000000001,1320,7600,11,4,2014,UNK,60,-25
3359500665,10/9/2014,725000.0,3,1.5,1790,6000,1.5,0.0,0.0,4,7,1790,0,1903,0,98115,47.6754,-122.325,1290,3500,10,9,2014,UNK,500,2500
7732650040,9/3/2014,1140000.0,4,2.5,3370,10602,2.0,0.0,0.0,3,10,3370,0,1999,0,98007,47.6591,-122.147,2950,9949,9,3,2014,UNK,420,653
2874600040,8/4/2014,680000.0,3,2.25,2920,6300,1.0,0.0,0.0,3,8,1710,1210,1956,0,98177,47.7065,-122.37,1940,6300,8,4,2014,UNK,980,0
6154900065,10/30/2014,490000.0,2,1.0,2180,9300,1.0,0.0,0.0,4,7,1090,1090,1947,0,98177,47.7032,-122.37100000000001,1830,7378,10,30,2014,UNK,350,1922
3491300180,4/27/2015,635000.0,3,1.75,1480,6985,1.5,0.0,0.0,4,7,1200,280,1926,0,98117,47.68600000000001,-122.374,1480,5588,4,27,2015,UNK,0,1397
619079096,4/6/2015,750000.0,3,2.5,2350,715690,1.5,0.0,0.0,4,9,2350,0,1979,0,98022,47.1622,-121.971,1280,325393,4,6,2015,UNK,1070,390297
9264920620,12/9/2014,330000.0,4,2.25,2440,8098,2.0,0.0,0.0,3,8,2440,0,1983,0,98023,47.3126,-122.346,2110,7911,12,9,2014,UNK,330,187
7899800730,3/24/2015,270000.0,3,2.5,1350,1189,2.0,0.0,0.0,3,7,1080,270,2007,0,98106,47.5218,-122.35799999999999,1300,1182,3,24,2015,N,50,7
8944750730,5/14/2014,340000.0,3,2.25,1970,3716,2.0,0.0,0.0,3,7,1970,0,1997,0,98056,47.4907,-122.167,1780,3716,5,14,2014,UNK,190,0
2922703150,3/4/2015,413252.0,3,0.75,1110,3960,1.0,0.0,0.0,3,7,1110,0,1951,0,98117,47.6834,-122.366,1610,5530,3,4,2015,UNK,-500,-1570
293610040,2/10/2015,600000.0,4,2.75,2950,5803,2.0,0.0,0.0,3,9,2950,0,2007,0,98028,47.7368,-122.23100000000001,2940,5803,2,10,2015,N,10,0
7215720410,4/15/2015,726888.0,5,3.0,2970,7261,2.0,0.0,0.0,3,9,2970,0,1999,0,98075,47.5994,-122.01899999999999,2970,8437,4,15,2015,UNK,0,-1176
5550300175,12/6/2014,285000.0,2,1.0,720,6400,1.0,0.0,0.0,4,6,720,0,1943,0,98126,47.5286,-122.368,1030,6400,12,6,2014,UNK,-310,0
1588600040,2/6/2015,365000.0,2,1.0,770,5680,1.0,0.0,0.0,4,6,770,0,1929,0,98117,47.6951,-122.366,1170,5514,2,6,2015,UNK,-400,166
7819000040,3/9/2015,295000.0,4,2.0,1650,7200,1.0,0.0,0.0,3,7,1650,0,1964,0,98133,47.7543,-122.344,1410,7200,3,9,2015,UNK,240,0
1839920180,3/18/2015,460000.0,3,2.25,1620,7350,1.0,0.0,0.0,3,7,1170,450,1969,0,98034,47.7248,-122.179,1800,7350,3,18,2015,UNK,-180,0
2560803085,9/25/2014,230000.0,3,1.5,1510,10588,1.5,0.0,0.0,3,7,1510,0,1947,0,98198,47.3775,-122.319,1360,2873,9,25,2014,UNK,150,7715
6414100133,5/22/2014,337000.0,3,1.0,1070,6109,1.0,0.0,0.0,5,7,1070,0,1951,0,98125,47.7207,-122.32,1170,7200,5,22,2014,UNK,-100,-1091
164000174,9/8/2014,300000.0,3,1.0,1010,6300,1.0,0.0,0.0,3,7,1010,0,1957,0,98133,47.7304,-122.352,1480,7480,9,8,2014,UNK,-470,-1180
1118001201,1/30/2015,2300000.0,4,2.5,3370,8402,1.0,0.0,0.0,5,10,2240,1130,1962,0,98112,47.6349,-122.29,3190,8700,1,30,2015,UNK,180,-298
5104510720,12/10/2014,360000.0,4,2.5,2000,5500,2.0,0.0,0.0,3,8,2000,0,2003,0,98038,47.3552,-122.014,2000,5512,12,10,2014,UNK,0,-12
3904910650,3/16/2015,585000.0,3,2.5,2060,10839,2.0,0.0,0.0,3,8,2060,0,1987,0,98029,47.5675,-122.016,2180,8126,3,16,2015,UNK,-120,2713
9211500620,10/8/2014,182700.0,3,2.25,1740,6650,1.0,0.0,0.0,3,7,1240,500,1978,0,98023,47.2979,-122.37899999999999,1740,7000,10,8,2014,UNK,0,-350
9211500620,4/28/2015,305000.0,3,2.25,1740,6650,1.0,0.0,0.0,3,7,1240,500,1978,0,98023,47.2979,-122.37899999999999,1740,7000,4,28,2015,UNK,0,-350
6402710120,5/5/2014,309950.0,3,2.5,1880,7838,2.0,0.0,0.0,3,7,1880,0,1994,0,98055,47.4439,-122.19,1810,7915,5,5,2014,UNK,70,-77
1245001739,3/16/2015,550000.0,3,1.0,960,12527,1.0,0.0,0.0,3,7,960,0,1972,0,98033,47.6891,-122.20299999999999,1220,7579,3,16,2015,UNK,-260,4948
6817850040,11/11/2014,825000.0,3,2.5,3280,26413,1.0,0.0,3.0,3,11,2670,610,1985,0,98074,47.6395,-122.05,3280,25211,11,11,2014,UNK,0,1202
9839301165,10/1/2014,998500.0,2,1.0,1570,4400,1.5,0.0,0.0,4,8,1570,0,1914,0,98122,47.6112,-122.29299999999999,1850,4400,10,1,2014,UNK,-280,0
1854900410,11/1/2014,644500.0,4,2.5,2990,5342,2.0,0.0,0.0,3,8,2990,0,2004,0,98074,47.6124,-122.009,2990,5936,11,1,2014,N,0,-594
2787700180,1/12/2015,320000.0,3,2.0,1250,8636,1.0,0.0,0.0,5,7,1250,0,1968,0,98059,47.5066,-122.15899999999999,1620,7653,1,12,2015,UNK,-370,983
1843130210,10/15/2014,266950.0,3,2.5,1920,4803,2.0,0.0,0.0,3,7,1920,0,2005,0,98042,47.3745,-122.12700000000001,2240,5231,10,15,2014,N,-320,-428
205000450,5/14/2014,633100.0,4,2.5,2470,33305,2.0,0.0,0.0,3,9,2470,0,1993,0,98053,47.6303,-121.99,2440,33305,5,14,2014,UNK,30,0
3626039279,8/5/2014,395000.0,2,1.0,960,6700,1.0,0.0,0.0,3,7,960,0,1951,0,98103,47.6955,-122.35700000000001,1350,6700,8,5,2014,UNK,-390,0
3126049261,3/16/2015,259250.0,3,1.0,940,5904,1.0,0.0,0.0,3,6,940,0,1947,0,98103,47.699,-122.35,870,5728,3,16,2015,UNK,70,176
8658303265,11/6/2014,300000.0,3,1.0,1260,5000,1.0,0.0,0.0,4,6,1260,0,1968,0,98014,47.6492,-121.915,1180,7500,11,6,2014,UNK,80,-2500
2421059009,2/20/2015,413000.0,3,1.75,2280,139392,1.0,0.0,0.0,3,8,2280,0,1977,0,98092,47.291000000000004,-122.118,2280,117176,2,20,2015,UNK,0,22216
3111300040,8/1/2014,435000.0,3,2.25,1740,8491,1.0,0.0,0.0,3,8,1240,500,1958,0,98177,47.7758,-122.37899999999999,2080,8494,8,1,2014,UNK,-340,-3
1770000330,10/3/2014,500000.0,4,2.75,2630,15000,1.0,0.0,0.0,4,7,1690,940,1976,0,98072,47.7425,-122.089,1800,16500,10,3,2014,UNK,830,-1500
4174600264,8/1/2014,402000.0,4,1.75,2430,5481,1.0,0.0,0.0,3,8,1430,1000,1953,0,98108,47.5569,-122.29799999999999,2050,5508,8,1,2014,UNK,380,-27
822039025,5/1/2015,777700.0,3,2.5,2260,251460,1.5,0.0,0.0,3,10,2260,0,1995,0,98070,47.4096,-122.449,1610,244372,5,1,2015,UNK,650,7088
9521101065,3/23/2015,580000.0,2,1.5,1220,5000,1.0,0.0,2.0,4,7,1220,0,1938,0,98103,47.6624,-122.348,2090,3850,3,23,2015,UNK,-870,1150
3244500158,9/8/2014,570000.0,3,1.75,2580,40392,1.0,0.0,0.0,3,9,1390,1190,1986,0,98072,47.7637,-122.134,2460,46173,9,8,2014,UNK,120,-5781
3603000410,12/8/2014,174950.0,2,1.0,730,6000,1.0,0.0,0.0,3,6,730,0,1950,0,98198,47.3832,-122.3,1750,7200,12,8,2014,UNK,-1020,-1200
7548300441,5/7/2014,300000.0,2,1.0,760,3001,1.0,0.0,0.0,3,6,760,0,1913,0,98144,47.5874,-122.311,1750,5000,5,7,2014,UNK,-990,-1999
3034200142,9/23/2014,435000.0,3,1.5,1740,6988,1.0,0.0,0.0,3,7,1600,140,1950,0,98133,47.7211,-122.33,1650,7500,9,23,2014,UNK,90,-512
8651611590,5/28/2014,840000.0,4,2.5,3420,8405,2.0,0.0,0.0,3,10,3420,0,2000,0,98074,47.6328,-122.064,3230,8460,5,28,2014,UNK,190,-55
2978800120,6/18/2014,469000.0,5,2.5,2240,7543,1.0,0.0,0.0,3,7,1140,1100,1966,0,98177,47.7756,-122.37200000000001,2110,7408,6,18,2014,UNK,130,135
7011200515,11/12/2014,870000.0,4,1.75,1920,3600,2.0,0.0,0.0,4,8,1920,0,1907,0,98119,47.6382,-122.368,1920,3600,11,12,2014,UNK,0,0
7199340620,6/4/2014,532000.0,4,1.75,2020,7029,1.0,0.0,0.0,4,7,1430,590,1979,0,98052,47.6983,-122.12700000000001,1780,7200,6,4,2014,UNK,240,-171
7291700065,3/26/2015,455000.0,4,1.5,1880,11400,1.0,0.0,0.0,3,7,1280,600,1955,0,98177,47.7718,-122.381,1880,11400,3,26,2015,UNK,0,0
2129700142,7/31/2014,201000.0,3,1.0,1010,25277,1.0,0.0,0.0,5,5,1010,0,1961,0,98019,47.7242,-121.95100000000001,1570,213879,7,31,2014,UNK,-560,-188602
318300040,9/23/2014,649000.0,5,3.25,3990,13087,2.0,0.0,0.0,3,9,2400,1590,1991,0,98042,47.3632,-122.061,2580,13633,9,23,2014,UNK,1410,-546
5101400871,5/24/2015,445500.0,2,1.75,1390,6670,1.0,0.0,0.0,3,6,720,670,1941,0,98115,47.6914,-122.30799999999999,920,6380,5,24,2015,UNK,470,290
2561360120,5/27/2014,475000.0,3,2.0,1230,11502,1.0,0.0,0.0,4,7,1230,0,1984,0,98052,47.7017,-122.12700000000001,1660,11727,5,27,2014,UNK,-430,-225
293800120,4/30/2015,590000.0,4,2.5,2940,29013,2.0,0.0,0.0,3,10,2940,0,1992,0,98077,47.7635,-122.044,3010,34071,4,30,2015,UNK,-70,-5058
2595300155,2/24/2015,565000.0,4,1.5,2190,8296,2.0,0.0,0.0,3,7,2190,0,1935,1963,98136,47.5158,-122.385,1160,8160,2,24,2015,Y,1030,136
2853600155,9/15/2014,110000.0,1,1.0,640,10280,1.0,0.0,0.0,2,5,640,0,1920,0,98126,47.5144,-122.368,1090,9000,9,15,2014,UNK,-450,1280
4365200555,12/19/2014,375000.0,3,2.5,1670,7740,1.0,0.0,0.0,3,7,1130,540,1974,0,98126,47.5222,-122.37,1220,7740,12,19,2014,UNK,450,0
2473100790,7/18/2014,255000.0,3,1.5,1240,8528,1.0,0.0,0.0,4,7,1240,0,1967,0,98058,47.4478,-122.15700000000001,1570,8064,7,18,2014,UNK,-330,464
8019200925,4/29/2015,315000.0,5,1.75,1850,14800,1.5,0.0,0.0,3,6,1760,90,1937,0,98168,47.4935,-122.321,1250,14800,4,29,2015,UNK,600,0
6071600450,11/20/2014,496600.0,4,2.25,2020,8400,1.0,0.0,0.0,4,8,1350,670,1961,0,98006,47.5488,-122.171,2060,8400,11,20,2014,UNK,-40,0
5249803036,7/14/2014,380000.0,3,1.0,1020,4800,1.0,0.0,0.0,3,7,1020,0,1944,0,98118,47.5615,-122.272,1400,5465,7,14,2014,UNK,-380,-665
3222069151,11/10/2014,338950.0,3,1.75,1610,22496,1.0,0.0,0.0,4,7,1610,0,1974,0,98042,47.3443,-122.073,2050,35772,11,10,2014,UNK,-440,-13276
5561400610,10/19/2014,542500.0,5,3.5,2730,42500,1.0,0.0,0.0,3,8,1530,1200,1989,0,98027,47.4587,-121.99600000000001,3180,37970,10,19,2014,UNK,-450,4530
5700000905,8/16/2014,739000.0,5,2.5,2840,5000,1.0,0.0,0.0,4,7,1620,1220,1913,0,98144,47.5817,-122.291,2200,5000,8,16,2014,UNK,640,0
3362401935,6/19/2014,549000.0,4,1.75,1290,3060,2.0,0.0,0.0,4,7,1290,0,1906,0,98103,47.6798,-122.348,1510,4080,6,19,2014,UNK,-220,-1020
2893000610,6/24/2014,252000.0,3,2.25,1670,7881,1.0,0.0,0.0,4,7,1190,480,1977,0,98031,47.4105,-122.18,1870,7820,6,24,2014,UNK,-200,61
7856410411,9/22/2014,1700000.0,4,4.5,3860,15246,2.0,0.0,4.0,3,11,2940,920,2004,0,98006,47.56,-122.161,3750,14790,9,22,2014,N,110,456
8156600155,6/11/2014,735000.0,4,1.75,2460,5100,1.5,0.0,0.0,5,7,1450,1010,1909,0,98115,47.6782,-122.3,1560,5100,6,11,2014,UNK,900,0
2560803248,7/9/2014,270000.0,4,2.5,1660,8063,1.0,0.0,0.0,4,7,1660,0,1978,0,98198,47.3761,-122.32,1060,8437,7,9,2014,UNK,600,-374
1118001215,2/4/2015,2250000.0,3,2.5,3420,8700,1.0,0.0,0.0,3,9,2890,530,1951,0,98112,47.6352,-122.29,3370,8700,2,4,2015,UNK,50,0
1437500035,10/10/2014,155000.0,2,1.0,1010,43056,1.5,0.0,0.0,3,5,1010,0,1990,0,98014,47.7105,-121.316,830,18297,10,10,2014,UNK,180,24759
2124049229,3/2/2015,469000.0,4,2.5,2240,5624,1.0,0.0,0.0,3,7,1520,720,1961,0,98108,47.5574,-122.30799999999999,2240,7495,3,2,2015,UNK,0,-1871
7129304225,1/8/2015,305000.0,4,2.25,2340,5250,2.0,0.0,0.0,5,7,2340,0,1965,0,98118,47.5183,-122.266,1540,5250,1,8,2015,UNK,800,0
7986400180,7/10/2014,675000.0,3,1.75,1920,4500,1.0,0.0,0.0,5,7,960,960,1924,0,98107,47.6645,-122.35700000000001,1190,4000,7,10,2014,UNK,730,500
809001970,12/31/2014,931000.0,3,2.5,2460,6600,1.5,0.0,0.0,4,8,1560,900,1929,0,98109,47.6364,-122.351,2090,3400,12,31,2014,UNK,370,3200
7979900145,2/5/2015,385000.0,3,1.0,1470,11398,1.0,0.0,0.0,3,8,1470,0,1950,0,98155,47.746,-122.296,1710,11407,2,5,2015,UNK,-240,-9
3299600040,2/14/2015,815000.0,3,2.5,3400,12442,2.0,0.0,0.0,3,9,3400,0,2001,0,98075,47.5611,-122.03200000000001,3250,8635,2,14,2015,UNK,150,3807
8651730580,3/30/2015,531000.0,3,2.25,1910,8390,1.0,0.0,0.0,3,7,1910,0,1979,0,98034,47.73,-122.21600000000001,2410,8390,3,30,2015,UNK,-500,0
1250201175,3/23/2015,386500.0,4,1.0,1400,3600,1.0,0.0,0.0,4,6,700,700,1901,0,98144,47.5972,-122.295,1690,3600,3,23,2015,UNK,-290,0
8651510610,6/26/2014,475580.0,3,1.75,1520,11085,1.0,0.0,0.0,3,8,1520,0,1983,0,98074,47.646,-122.068,2310,9647,6,26,2014,UNK,-790,1438
7017200120,8/20/2014,358000.0,2,1.0,930,5077,1.0,0.0,0.0,3,6,930,0,1939,0,98133,47.7095,-122.35,1080,5803,8,20,2014,UNK,-150,-726
9272201385,10/22/2014,677500.0,5,1.0,2340,4730,2.0,0.0,0.0,3,8,1810,530,1918,0,98116,47.5895,-122.385,2100,4970,10,22,2014,UNK,240,-240
518500210,5/8/2014,868500.0,3,2.5,2920,3942,3.0,0.0,0.0,3,10,2920,0,2008,0,98056,47.53100000000001,-122.204,2920,3942,5,8,2014,N,0,0
3260000120,2/9/2015,599380.0,3,1.75,1270,7350,1.0,0.0,0.0,4,7,1270,0,1967,0,98005,47.6046,-122.16799999999999,1880,7350,2,9,2015,UNK,-610,0
7504030220,10/8/2014,712000.0,4,2.25,2450,11960,1.0,0.0,0.0,3,10,2450,0,1979,0,98074,47.6351,-122.06,2600,11960,10,8,2014,UNK,-150,0
7972601885,4/30/2015,350000.0,5,1.75,1380,7620,1.0,0.0,0.0,3,7,1180,200,1955,0,98106,47.5279,-122.345,1990,7620,4,30,2015,UNK,-610,0
2331300395,5/10/2014,875000.0,4,2.0,2520,6000,1.0,0.0,0.0,3,8,1400,1120,1921,2007,98103,47.6767,-122.35,1580,3720,5,10,2014,Y,940,2280
2597710450,3/4/2015,365000.0,3,2.25,2290,7350,2.0,0.0,0.0,3,8,2290,0,1988,0,98058,47.428999999999995,-122.162,2170,7529,3,4,2015,UNK,120,-179
8122600145,5/21/2014,452000.0,4,2.0,1660,6150,1.0,0.0,0.0,3,6,850,810,1945,0,98126,47.5371,-122.368,1110,6250,5,21,2014,UNK,550,-100
629000410,2/17/2015,915000.0,3,2.75,2800,9750,1.0,0.0,0.0,5,7,1400,1400,1957,0,98004,47.5862,-122.20200000000001,2800,9530,2,17,2015,UNK,0,220
7202380120,1/5/2015,482500.0,3,2.5,1690,3068,2.0,0.0,0.0,3,7,1690,0,2005,0,98053,47.6763,-122.02799999999999,1690,3260,1,5,2015,N,0,-192
2926049437,10/14/2014,425000.0,3,1.0,1180,7200,1.5,0.0,0.0,4,7,1180,0,1949,0,98133,47.7121,-122.333,2240,7875,10,14,2014,UNK,-1060,-675
9550202700,12/11/2014,460000.0,2,1.75,1390,4160,1.0,0.0,0.0,5,6,790,600,1916,0,98105,47.6681,-122.324,1090,4160,12,11,2014,UNK,300,0
1231000458,7/20/2014,666570.0,4,2.0,2320,7400,1.5,0.0,0.0,5,7,1620,700,1913,0,98118,47.5558,-122.26899999999999,1740,4000,7,20,2014,UNK,580,3400
9485930120,10/14/2014,390000.0,3,2.25,2270,32112,1.0,0.0,0.0,4,8,1740,530,1980,0,98042,47.3451,-122.094,2310,41606,10,14,2014,UNK,-40,-9494
7923100410,10/9/2014,650000.0,4,1.75,2640,8215,1.0,0.0,0.0,4,7,1500,1140,1966,0,98008,47.5819,-122.125,2070,7875,10,9,2014,UNK,570,340
2571910210,10/1/2014,305000.0,3,2.0,1680,8487,1.0,0.0,0.0,3,7,1680,0,1993,0,98022,47.1959,-122.01,2080,8560,10,1,2014,UNK,-400,-73
3395800155,8/5/2014,250000.0,3,1.0,990,8100,1.0,0.0,0.0,3,6,990,0,1949,0,98146,47.4839,-122.34100000000001,1210,8100,8,5,2014,UNK,-220,0
9558040230,4/6/2015,438800.0,4,2.5,2770,4432,2.0,0.0,0.0,3,9,2770,0,2004,0,98058,47.4541,-122.117,2770,5423,4,6,2015,N,0,-991
7129302185,12/15/2014,290000.0,2,1.0,950,5650,1.0,0.0,0.0,5,6,950,0,1943,0,98118,47.5149,-122.257,1250,5650,12,15,2014,UNK,-300,0
7841300230,5/1/2015,324950.0,4,2.0,2160,4800,2.0,0.0,0.0,4,7,1290,870,1929,0,98055,47.4777,-122.212,1570,4800,5,1,2015,UNK,590,0
2768300650,12/1/2014,453000.0,3,2.5,1650,1838,2.0,0.0,0.0,4,7,1270,380,1991,0,98107,47.6666,-122.367,1550,1558,12,1,2014,UNK,100,280
546000865,9/19/2014,556000.0,3,1.0,1800,4005,1.5,0.0,0.0,4,7,1160,640,1929,0,98117,47.6876,-122.38,1240,4005,9,19,2014,UNK,560,0
7708300150,11/18/2014,315000.0,3,2.0,1660,11135,1.0,0.0,0.0,3,8,1660,0,1971,0,98045,47.4897,-121.787,1660,11560,11,18,2014,UNK,0,-425
3709500180,5/27/2014,445830.0,3,2.5,1870,5449,2.0,0.0,0.0,3,8,1870,0,2003,0,98011,47.7557,-122.22,2000,7687,5,27,2014,UNK,-130,-2238
9273200145,10/10/2014,1260000.0,3,3.5,3220,3960,2.0,0.0,4.0,3,10,2760,460,1991,0,98116,47.5909,-122.384,3080,4444,10,10,2014,UNK,140,-484
2025700730,5/2/2014,287200.0,3,3.0,1850,19966,1.0,0.0,0.0,4,7,1090,760,1992,0,98038,47.3493,-122.03399999999999,1410,6715,5,2,2014,UNK,440,13251
2215500220,9/23/2014,525000.0,4,1.5,1580,6360,1.5,0.0,0.0,3,7,1290,290,1945,0,98115,47.6873,-122.286,1690,6360,9,23,2014,UNK,-110,0
3758900220,12/26/2014,1140000.0,4,4.25,4590,17621,2.0,0.0,0.0,3,10,3160,1430,2003,0,98033,47.6973,-122.205,3800,12268,12,26,2014,UNK,790,5353
7229900925,10/10/2014,381000.0,3,1.75,2700,18246,1.0,0.0,0.0,4,7,1510,1190,1967,0,98059,47.4817,-122.09700000000001,1620,16986,10,10,2014,UNK,1080,1260
6632900084,6/6/2014,360000.0,3,1.75,1020,7020,1.5,0.0,0.0,4,7,1020,0,1953,0,98155,47.7362,-122.314,1020,5871,6,6,2014,UNK,0,1149
7137300040,5/4/2015,619000.0,5,3.5,2950,2932,3.0,0.0,0.0,3,8,2950,0,2004,0,98144,47.5923,-122.29799999999999,1580,2047,5,4,2015,N,1370,885
222069029,2/19/2015,535000.0,2,1.75,1780,224769,1.0,0.0,0.0,4,8,1780,0,1976,0,98038,47.4158,-122.00200000000001,2060,71560,2,19,2015,UNK,-280,153209
7518503685,10/9/2014,402000.0,2,1.0,710,5100,1.0,0.0,0.0,5,7,710,0,1905,0,98117,47.6765,-122.381,1530,5100,10,9,2014,UNK,-820,0
7701930180,11/10/2014,600000.0,4,3.5,4300,70407,2.0,0.0,0.0,3,10,2710,1590,1992,0,98058,47.4472,-122.09200000000001,3520,26727,11,10,2014,UNK,780,43680
5072420040,9/10/2014,549950.0,3,2.5,2080,8690,1.0,0.0,0.0,3,8,1430,650,1974,0,98166,47.4424,-122.344,2400,9625,9,10,2014,UNK,-320,-935
4058802300,8/20/2014,300000.0,4,2.0,2360,7440,1.0,0.0,0.0,3,7,1180,1180,1955,0,98178,47.5044,-122.245,1680,7800,8,20,2014,UNK,680,-360
5127100210,3/25/2015,360000.0,6,2.0,2210,9870,2.0,0.0,0.0,4,7,2210,0,1969,1995,98059,47.4751,-122.145,1390,9912,3,25,2015,Y,820,-42
6453300306,9/10/2014,419000.0,7,3.25,4340,8521,2.0,0.0,0.0,3,7,2550,1790,1986,0,98106,47.52,-122.338,1890,8951,9,10,2014,UNK,2450,-430
4442800166,4/7/2015,510000.0,3,3.0,1320,1012,3.0,0.0,0.0,3,8,1320,0,2009,0,98117,47.6904,-122.395,1320,1536,4,7,2015,N,0,-524
8078490330,9/16/2014,319950.0,3,2.5,1980,9907,2.0,0.0,0.0,3,8,1980,0,1991,0,98022,47.1903,-122.01299999999999,2050,9907,9,16,2014,UNK,-70,0
2322069010,10/7/2014,1180000.0,5,5.0,3960,94089,2.0,0.0,0.0,3,10,3960,0,1998,0,98038,47.38,-122.01100000000001,2240,64468,10,7,2014,UNK,1720,29621
9558021010,10/3/2014,381000.0,4,2.5,2130,6003,2.0,0.0,0.0,3,8,2130,0,2003,0,98058,47.4518,-122.12,1940,4529,10,3,2014,UNK,190,1474
6700390230,5/5/2015,256900.0,3,2.5,1720,3951,2.0,0.0,0.0,3,7,1720,0,1992,0,98031,47.4033,-122.18700000000001,1720,3605,5,5,2015,UNK,0,346
1841400150,2/19/2015,346000.0,5,1.0,1790,30456,1.0,0.0,0.0,4,7,1350,440,1964,0,98030,47.3469,-122.195,2420,35647,2,19,2015,UNK,-630,-5191
6873000150,12/8/2014,465000.0,2,2.25,1390,1222,3.0,0.0,0.0,3,7,1340,50,2009,0,98052,47.6754,-122.12100000000001,1480,1369,12,8,2014,N,-90,-147
5710500230,5/6/2015,545000.0,3,2.0,1900,9975,1.0,0.0,0.0,3,8,1500,400,1973,0,98027,47.5307,-122.054,2140,9825,5,6,2015,UNK,-240,150
9528102060,7/30/2014,516000.0,2,1.75,1640,3090,1.0,0.0,0.0,4,7,910,730,1925,0,98115,47.678999999999995,-122.319,1510,4120,7,30,2014,UNK,130,-1030
2490200450,6/9/2014,550000.0,4,2.5,2700,5100,1.0,0.0,0.0,4,8,1440,1260,1968,0,98136,47.5331,-122.384,1880,5100,6,9,2014,UNK,820,0
4178500580,5/5/2015,339950.0,4,2.25,2200,7150,2.0,0.0,0.0,4,7,2200,0,1990,0,98042,47.3595,-122.089,1740,7150,5,5,2015,UNK,460,0
4325700085,3/25/2015,417000.0,3,1.0,1310,8514,1.0,0.0,0.0,4,7,1310,0,1953,0,98133,47.7502,-122.353,1310,8514,3,25,2015,UNK,0,0
5606000120,2/25/2015,906000.0,4,2.5,2480,5000,1.0,0.0,3.0,3,8,1480,1000,1951,0,98105,47.6653,-122.272,2240,6071,2,25,2015,UNK,240,-1071
5451220150,11/12/2014,980000.0,4,2.25,3010,9800,2.0,0.0,0.0,4,9,3010,0,1973,0,98040,47.5336,-122.223,2510,9800,11,12,2014,UNK,500,0
7954300620,4/13/2015,555000.0,4,2.5,2450,5079,2.0,0.0,0.0,3,9,2450,0,2001,0,98056,47.5214,-122.191,2690,6675,4,13,2015,UNK,-240,-1596
2591010040,11/10/2014,468000.0,2,1.75,1250,7029,1.0,0.0,0.0,4,7,1250,0,1986,0,98033,47.6936,-122.186,1680,8470,11,10,2014,UNK,-430,-1441
3321079060,10/20/2014,378000.0,3,1.75,2610,117176,1.0,0.0,0.0,3,7,1390,1220,1981,0,98022,47.2585,-121.925,2140,142005,10,20,2014,UNK,470,-24829
7229900145,12/16/2014,430000.0,4,2.5,2010,16020,1.5,0.0,0.0,5,8,2010,0,1962,0,98059,47.4821,-122.10799999999999,1420,16020,12,16,2014,UNK,590,0
5710610790,5/16/2014,730100.0,4,2.5,3120,14300,2.0,0.0,0.0,3,9,3120,0,2003,0,98027,47.5318,-122.055,2580,10005,5,16,2014,UNK,540,4295
937000220,9/4/2014,219000.0,4,1.5,1370,7944,1.5,0.0,0.0,3,7,1370,0,1961,0,98198,47.4224,-122.289,1370,9181,9,4,2014,UNK,0,-1237
7504001320,11/21/2014,570000.0,3,2.5,2420,11953,1.0,0.0,0.0,3,9,2420,0,1990,0,98074,47.6285,-122.054,2420,12215,11,21,2014,UNK,0,-262
3832710450,11/19/2014,262500.0,4,2.75,1500,7036,1.0,0.0,0.0,3,7,1060,440,1979,0,98032,47.3665,-122.27600000000001,1620,7200,11,19,2014,UNK,-120,-164
8567450180,5/29/2014,525000.0,5,2.5,2630,9216,2.0,0.0,0.0,3,8,2630,0,2003,0,98019,47.7379,-121.96600000000001,2020,4980,5,29,2014,UNK,610,4236
4443801590,4/2/2015,520000.0,2,1.0,950,3880,1.0,0.0,0.0,4,6,950,0,1919,0,98117,47.687,-122.389,1660,3880,4,2,2015,UNK,-710,0
7399200770,12/9/2014,417400.0,3,3.0,2680,12285,1.0,0.0,0.0,4,8,2680,0,1970,0,98055,47.4633,-122.196,2610,9558,12,9,2014,UNK,70,2727
8562740530,5/12/2014,788000.0,4,3.25,3680,5759,2.0,0.0,0.0,3,9,2840,840,2003,0,98027,47.5367,-122.06700000000001,3620,6006,5,12,2014,UNK,60,-247
5592900230,12/24/2014,320000.0,3,1.0,1270,7400,1.0,0.0,2.0,4,7,1270,0,1956,0,98056,47.4831,-122.191,1800,7400,12,24,2014,UNK,-530,0
3693900155,9/5/2014,950000.0,6,1.0,2330,5000,1.5,0.0,0.0,4,7,2330,0,1920,0,98117,47.6789,-122.397,1570,5000,9,5,2014,UNK,760,0
3782100155,5/27/2014,255000.0,3,1.0,960,8100,1.0,0.0,0.0,3,7,960,0,1955,0,98155,47.7766,-122.307,1120,8100,5,27,2014,UNK,-160,0
104550580,5/20/2014,260000.0,4,2.5,1990,6671,2.0,0.0,0.0,3,7,1990,0,1989,0,98023,47.3078,-122.35799999999999,1862,6566,5,20,2014,UNK,128,105
4365200620,3/12/2015,394000.0,3,1.0,1450,7930,1.0,0.0,0.0,4,6,1150,300,1923,0,98126,47.5212,-122.37100000000001,1040,7740,3,12,2015,UNK,410,190
226059161,12/31/2014,575000.0,4,2.5,2280,27441,2.0,0.0,0.0,3,8,2280,0,1996,0,98072,47.7628,-122.12299999999999,2350,35020,12,31,2014,UNK,-70,-7579
5316100220,3/19/2015,1250000.0,4,2.25,1830,7200,2.0,0.0,2.0,3,8,1750,80,1923,0,98112,47.6315,-122.28200000000001,3100,7200,3,19,2015,UNK,-1270,0
1387300760,8/4/2014,385000.0,3,2.25,1650,7800,1.0,0.0,0.0,3,7,1260,390,1969,0,98011,47.7377,-122.197,1760,8268,8,4,2014,UNK,-110,-468
2521059042,11/7/2014,456000.0,5,2.75,2720,193406,1.0,0.0,4.0,4,7,1700,1020,1968,0,98092,47.2838,-122.12100000000001,2820,248292,11,7,2014,UNK,-100,-54886
7974200902,5/6/2015,637000.0,4,2.5,1710,5000,1.0,0.0,0.0,3,8,1110,600,1979,0,98115,47.6772,-122.285,1750,5304,5,6,2015,UNK,-40,-304
259600910,11/10/2014,485000.0,5,1.5,1420,9900,1.0,0.0,0.0,3,7,1050,370,1964,0,98008,47.6348,-122.118,1580,8075,11,10,2014,UNK,-160,1825
4375700065,5/12/2014,315275.0,3,1.75,1440,8040,1.0,0.0,0.0,3,7,960,480,1951,0,98125,47.7128,-122.306,1500,8040,5,12,2014,UNK,-60,0
2473100330,9/23/2014,252500.0,2,1.5,1280,8710,1.0,0.0,0.0,3,7,1280,0,1967,0,98058,47.4472,-122.16,1520,9375,9,23,2014,UNK,-240,-665
1523069095,3/23/2015,240000.0,2,1.0,1320,24319,1.0,0.0,0.0,3,7,1320,0,1966,0,98027,47.4741,-122.015,1430,98445,3,23,2015,UNK,-110,-74126
5101402428,11/12/2014,790000.0,4,2.5,2560,12760,1.0,0.0,0.0,4,7,1760,800,1949,0,98115,47.6947,-122.303,1760,6384,11,12,2014,UNK,800,6376
1072100085,5/14/2014,310000.0,3,1.0,1480,7830,1.0,0.0,0.0,3,7,1480,0,1952,0,98133,47.7703,-122.336,1450,7830,5,14,2014,UNK,30,0
9322800230,12/12/2014,1250000.0,4,2.5,2960,20240,2.0,0.0,4.0,4,10,2960,0,1985,0,98146,47.5075,-122.389,2500,14960,12,12,2014,UNK,460,5280
2695600455,1/28/2015,425000.0,2,1.0,1160,5038,1.0,0.0,0.0,5,7,740,420,1942,0,98126,47.5304,-122.38,1160,5076,1,28,2015,UNK,0,-38
8946400210,6/3/2014,548000.0,3,2.5,2110,4099,2.0,0.0,0.0,3,8,2110,0,2001,0,98072,47.7508,-122.17,2110,4871,6,3,2014,UNK,0,-772
1523069197,5/3/2014,379880.0,3,2.5,1650,14054,1.0,0.0,0.0,4,7,1130,520,1986,0,98027,47.4821,-122.01700000000001,1940,87555,5,3,2014,UNK,-290,-73501
8078420230,5/30/2014,530000.0,3,2.5,1950,9906,2.0,0.0,0.0,3,8,1950,0,1988,0,98074,47.6363,-122.025,1860,7689,5,30,2014,UNK,90,2217
2723069052,4/20/2015,695000.0,3,2.25,2600,220300,1.5,0.0,0.0,5,8,2120,480,1977,0,98027,47.4562,-122.016,2760,215600,4,20,2015,UNK,-160,4700
9297300395,5/27/2014,435000.0,3,1.0,1270,4000,1.5,0.0,2.0,3,7,1270,0,1928,0,98126,47.5695,-122.376,1560,4000,5,27,2014,UNK,-290,0
1428000970,5/21/2014,540000.0,3,1.75,1300,62290,1.0,0.0,0.0,3,7,1300,0,1983,0,98053,47.6529,-121.979,1850,52272,5,21,2014,UNK,-550,10018
1774000720,6/20/2014,425000.0,3,2.25,1790,10209,1.0,0.0,0.0,3,7,1290,500,1967,0,98072,47.7492,-122.086,1840,9900,6,20,2014,UNK,-50,309
2826049106,7/15/2014,490000.0,3,2.5,1930,7266,2.0,0.0,0.0,3,8,1930,0,2005,0,98125,47.7191,-122.309,1930,7266,7,15,2014,N,0,0
2113700205,7/3/2014,220000.0,4,1.0,1200,6000,1.5,0.0,0.0,3,6,1200,0,1923,0,98106,47.5307,-122.352,950,4000,7,3,2014,UNK,250,2000
1036450360,1/7/2015,540000.0,4,2.5,2050,3784,2.0,0.0,0.0,3,8,2050,0,2001,0,98034,47.7189,-122.181,2050,3366,1,7,2015,UNK,0,418
714000155,12/22/2014,670000.0,3,1.0,1710,6195,1.0,0.0,0.0,3,7,1410,300,1946,0,98105,47.6706,-122.265,1610,6195,12,22,2014,UNK,100,0
686800065,11/19/2014,667500.0,3,1.75,2130,20423,1.0,0.0,0.0,3,9,2130,0,1953,0,98004,47.6339,-122.19200000000001,2370,20875,11,19,2014,UNK,-240,-452
5323100120,9/16/2014,585000.0,3,3.5,1700,2197,2.0,0.0,0.0,3,8,1260,440,2010,0,98116,47.5767,-122.41,1360,1418,9,16,2014,N,340,779
8658300455,11/18/2014,225000.0,3,1.5,1390,12500,1.0,0.0,0.0,4,6,1390,0,1976,0,98014,47.6496,-121.90799999999999,1390,9000,11,18,2014,UNK,0,3500
2202500150,8/19/2014,375000.0,3,1.0,1230,9877,1.0,0.0,0.0,3,7,1230,0,1954,0,98006,47.5745,-122.13600000000001,1240,9965,8,19,2014,UNK,-10,-88
258100040,11/24/2014,335000.0,3,2.0,1490,8847,1.0,0.0,0.0,4,7,1490,0,1967,0,98177,47.7639,-122.363,1640,7572,11,24,2014,UNK,-150,1275
4027700021,3/11/2015,680000.0,5,3.25,2440,15815,2.0,0.0,0.0,3,8,1990,450,2014,0,98155,47.773999999999994,-122.28,2500,14201,3,11,2015,N,-60,1614
9828701747,1/23/2015,600000.0,3,1.0,970,4800,1.0,0.0,0.0,3,6,970,0,1950,0,98112,47.6212,-122.29799999999999,1500,2042,1,23,2015,UNK,-530,2758
1523049207,8/5/2014,161000.0,4,2.0,1700,8043,1.0,0.0,0.0,3,7,850,850,1954,0,98168,47.4758,-122.288,1540,13260,8,5,2014,UNK,160,-5217
1523049207,1/14/2015,220000.0,4,2.0,1700,8043,1.0,0.0,0.0,3,7,850,850,1954,0,98168,47.4758,-122.288,1540,13260,1,14,2015,UNK,160,-5217
2131701075,12/4/2014,420000.0,3,1.75,1720,5000,1.5,0.0,0.0,3,8,1720,0,1932,2009,98019,47.738,-121.98299999999999,1410,8300,12,4,2014,Y,310,-3300
1794500870,3/27/2015,710000.0,3,1.0,1400,2250,1.5,0.0,0.0,3,7,1400,0,1909,0,98119,47.6373,-122.35799999999999,1630,3600,3,27,2015,UNK,-230,-1350
6383000790,1/22/2015,626000.0,4,2.5,2570,7221,1.0,0.0,0.0,4,8,1570,1000,1958,0,98117,47.6921,-122.387,2440,7274,1,22,2015,UNK,130,-53
723049448,7/22/2014,279500.0,3,1.5,1200,8040,1.0,0.0,0.0,4,7,1200,0,1959,0,98146,47.4901,-122.34100000000001,1450,9315,7,22,2014,UNK,-250,-1275
5093300325,5/23/2014,1610000.0,4,3.5,4390,11600,2.0,0.0,3.0,3,11,3060,1330,1990,0,98040,47.5862,-122.24600000000001,3240,12000,5,23,2014,UNK,1150,-400
7547300120,8/1/2014,325000.0,2,1.0,1080,5000,1.0,0.0,0.0,3,7,1080,0,1954,0,98106,47.5682,-122.359,1010,5000,8,1,2014,UNK,70,0
2473000720,7/17/2014,380000.0,4,2.25,1860,7980,1.0,0.0,0.0,4,8,1860,0,1966,0,98058,47.4524,-122.15,1860,8814,7,17,2014,UNK,0,-834
7697800040,8/26/2014,470000.0,4,2.75,2150,9820,1.0,0.0,0.0,4,8,1220,930,1979,0,98011,47.7758,-122.2,2060,9830,8,26,2014,UNK,90,-10
1442860120,12/5/2014,363000.0,4,3.0,2250,12142,2.0,0.0,0.0,3,8,2250,0,1986,0,98058,47.4338,-122.16,2300,9003,12,5,2014,UNK,-50,3139
9542800610,2/19/2015,245000.0,4,2.25,2050,7700,2.0,0.0,0.0,3,7,2050,0,1977,0,98023,47.3009,-122.375,1780,7700,2,19,2015,UNK,270,0
6003501400,2/26/2015,525000.0,3,1.0,1010,3520,1.0,0.0,0.0,3,7,1010,0,1902,0,98102,47.6208,-122.319,1300,1233,2,26,2015,UNK,-290,2287
5493100366,6/25/2014,1700000.0,5,3.5,5850,22885,2.0,0.0,2.0,4,11,4670,1180,1978,0,98004,47.606,-122.211,3240,19020,6,25,2014,UNK,2610,3865
6681500205,5/4/2015,658500.0,4,2.25,1900,5000,1.0,0.0,0.0,3,7,1400,500,1963,0,98199,47.6456,-122.387,1710,4994,5,4,2015,UNK,190,6
2594200230,4/24/2015,680000.0,2,1.0,1020,8442,1.0,0.0,4.0,4,7,920,100,1941,0,98136,47.5145,-122.391,2550,10323,4,24,2015,UNK,-1530,-1881
624110450,2/25/2015,835000.0,4,2.0,3390,16025,2.0,0.0,0.0,4,10,3390,0,1987,0,98077,47.7222,-122.056,3950,15277,2,25,2015,UNK,-560,748
2768100180,6/6/2014,595000.0,4,2.5,1990,2175,2.0,0.0,0.0,3,8,1680,310,2005,0,98107,47.6696,-122.37100000000001,1560,2087,6,6,2014,N,430,88
9406700180,4/16/2015,419000.0,4,2.5,3190,4980,2.0,0.0,0.0,3,9,3190,0,2005,0,98038,47.3657,-122.03399999999999,2830,6720,4,16,2015,N,360,-1740
2122059077,9/15/2014,198900.0,2,1.0,1210,18700,1.0,0.0,0.0,4,7,1210,0,1940,0,98042,47.3752,-122.166,2250,10048,9,15,2014,UNK,-1040,8652
624110610,5/15/2014,1090000.0,4,3.25,3740,12080,1.0,0.0,0.0,3,10,2000,1740,1988,0,98077,47.7214,-122.056,4210,15277,5,15,2014,UNK,-470,-3197
3575302245,4/23/2015,500000.0,3,3.5,2150,4368,2.0,0.0,0.0,3,8,1610,540,1998,0,98074,47.6213,-122.065,2390,16630,4,23,2015,UNK,-240,-12262
2287600040,7/11/2014,575000.0,4,1.75,2440,8100,1.0,0.0,0.0,4,9,1620,820,1960,0,98177,47.7201,-122.361,2030,8100,7,11,2014,UNK,410,0
2026049183,4/2/2015,324950.0,2,1.5,1230,1516,3.0,0.0,0.0,3,8,1230,0,2000,0,98125,47.7265,-122.314,1352,1411,4,2,2015,UNK,-122,105
216500040,2/26/2015,259000.0,3,2.5,2740,7980,2.0,0.0,0.0,4,7,2740,0,1964,0,98168,47.473,-122.3,1470,8611,2,26,2015,UNK,1270,-631
6705800040,5/16/2014,551000.0,2,2.0,2260,9604,1.0,0.0,0.0,3,9,2260,0,1990,0,98011,47.7718,-122.208,2260,10747,5,16,2014,UNK,0,-1143
9266701115,8/8/2014,488000.0,2,1.5,1000,5125,1.0,0.0,0.0,3,7,1000,0,1942,1968,98103,47.6926,-122.34700000000001,1090,5100,8,8,2014,Y,-90,25
3811000180,3/5/2015,635000.0,4,2.25,2350,46173,2.0,0.0,0.0,4,8,2350,0,1980,0,98053,47.6657,-122.06700000000001,2390,36567,3,5,2015,UNK,-40,9606
1561900180,3/11/2015,395000.0,3,2.5,2300,8938,2.0,0.0,0.0,3,9,2300,0,1989,0,98031,47.4181,-122.211,2570,9694,3,11,2015,UNK,-270,-756
3432500760,8/18/2014,370000.0,3,1.0,1440,8287,1.5,0.0,0.0,4,7,1440,0,1928,0,98155,47.7438,-122.315,1330,8285,8,18,2014,UNK,110,2
7465900205,10/24/2014,675000.0,4,3.0,2780,5000,1.5,0.0,0.0,5,7,1710,1070,1919,0,98116,47.5721,-122.381,1150,5000,10,24,2014,UNK,1630,0
6629300120,4/2/2015,402000.0,3,1.0,1200,6825,1.0,0.0,0.0,3,7,1200,0,1954,2013,98133,47.7491,-122.353,1470,8100,4,2,2015,Y,-270,-1275
3026059011,8/13/2014,825000.0,3,2.75,3040,24192,2.0,0.0,0.0,4,10,3040,0,1987,0,98034,47.7108,-122.225,2770,5728,8,13,2014,UNK,270,18464
822069029,2/17/2015,579000.0,3,2.75,2660,223027,1.0,0.0,0.0,3,8,1330,1330,1962,0,98038,47.4127,-122.071,1560,222591,2,17,2015,UNK,1100,436
9826701490,2/25/2015,455000.0,5,2.0,1510,3000,2.0,0.0,0.0,3,6,1510,0,1983,0,98122,47.6029,-122.304,1610,3600,2,25,2015,UNK,-100,-600
4137020360,7/22/2014,265000.0,3,2.5,1780,6527,2.0,0.0,0.0,3,8,1780,0,1989,0,98092,47.2578,-122.21700000000001,2040,8840,7,22,2014,UNK,-260,-2313
1115700040,12/1/2014,713500.0,5,2.75,2920,9163,1.0,0.0,0.0,4,8,1520,1400,1976,0,98006,47.5668,-122.169,2250,9163,12,1,2014,UNK,670,0
1061400180,1/6/2015,240000.0,3,1.0,1550,12670,1.0,0.0,0.0,4,7,1550,0,1962,0,98056,47.5024,-122.169,1550,8880,1,6,2015,UNK,0,3790
820079081,9/11/2014,570000.0,4,3.0,2710,217800,2.5,0.0,0.0,3,9,2710,0,2006,0,98022,47.2411,-121.932,2710,217800,9,11,2014,N,0,0
2524069072,6/26/2014,243800.0,3,1.0,1140,27760,1.0,0.0,0.0,4,6,1140,0,1981,0,98027,47.5372,-121.97200000000001,1690,87300,6,26,2014,UNK,-550,-59540
9521101520,12/12/2014,543000.0,2,1.0,940,3864,1.0,0.0,0.0,4,8,940,0,1918,0,98103,47.6631,-122.345,1440,3956,12,12,2014,UNK,-500,-92
5016002240,10/8/2014,1010000.0,3,2.25,2160,7500,2.0,0.0,0.0,3,10,2160,0,1982,0,98112,47.6232,-122.29899999999999,1550,3839,10,8,2014,UNK,610,3661
424069010,7/21/2014,625000.0,4,2.25,2470,17008,2.0,0.0,0.0,4,8,2470,0,1979,0,98075,47.5924,-122.04799999999999,2470,31798,7,21,2014,UNK,0,-14790
5104540610,9/25/2014,459950.0,4,2.5,2800,6567,2.0,0.0,0.0,3,9,2800,0,2006,0,98038,47.3555,-122.00200000000001,3400,5900,9,25,2014,N,-600,667
8567300150,10/31/2014,370000.0,4,2.75,2420,39704,1.0,0.0,0.0,3,9,2420,0,1985,0,98038,47.4053,-122.03,2760,36303,10,31,2014,UNK,-340,3401
2976800749,10/31/2014,150000.0,4,2.0,1460,7254,1.0,0.0,0.0,3,6,1460,0,1959,0,98178,47.5056,-122.25399999999999,1460,7236,10,31,2014,UNK,0,18
7015200790,6/24/2014,683500.0,3,1.5,1820,5756,1.5,0.0,0.0,3,7,1640,180,1946,0,98119,47.6479,-122.367,1760,6169,6,24,2014,UNK,60,-413
2770604104,6/4/2014,499950.0,3,2.5,1520,2208,2.0,0.0,0.0,3,8,1040,480,2007,0,98119,47.6419,-122.374,1610,1618,6,4,2014,N,-90,590
1624049092,6/30/2014,255000.0,2,1.0,1320,9967,1.0,0.0,0.0,3,6,940,380,1919,0,98108,47.5693,-122.296,1970,7587,6,30,2014,UNK,-650,2380
8078570410,3/26/2015,279000.0,3,2.5,1920,7779,2.0,0.0,0.0,3,7,1920,0,1989,0,98031,47.4024,-122.171,1960,7536,3,26,2015,UNK,-40,243
7974200456,12/1/2014,910000.0,5,3.0,2640,5096,2.0,0.0,0.0,3,10,2640,0,2009,0,98115,47.6809,-122.288,1610,5217,12,1,2014,N,1030,-121
752000035,5/20/2014,699000.0,4,2.5,2650,7945,2.0,0.0,0.0,3,9,2650,0,2006,0,98125,47.7113,-122.296,1200,7920,5,20,2014,N,1450,25
3262300322,4/8/2015,1650000.0,4,3.25,3640,13530,1.0,0.0,0.0,3,9,2570,1070,1924,2000,98039,47.6293,-122.238,2760,15000,4,8,2015,Y,880,-1470
5412300410,3/25/2015,248000.0,3,1.0,1420,8800,1.0,0.0,0.0,4,6,1090,330,1981,0,98030,47.3746,-122.181,1480,8000,3,25,2015,UNK,-60,800
4013200145,11/7/2014,429000.0,3,1.0,1540,37950,1.0,0.0,0.0,4,7,1090,450,1959,0,98001,47.3259,-122.289,1820,24375,11,7,2014,UNK,-280,13575
2623039018,10/27/2014,685000.0,4,1.0,1550,15239,1.5,1.0,4.0,3,6,1370,180,1930,0,98166,47.4502,-122.37799999999999,1790,22047,10,27,2014,UNK,-240,-6808
8122100650,7/31/2014,316000.0,2,1.0,730,5040,1.0,0.0,0.0,3,6,730,0,1927,0,98126,47.5387,-122.374,790,5040,7,31,2014,UNK,-60,0
1005000220,3/10/2015,410000.0,2,1.0,2020,7540,1.0,0.0,0.0,3,7,1010,1010,1921,0,98118,47.5359,-122.28,1270,4652,3,10,2015,UNK,750,2888
1023089096,8/8/2014,299000.0,3,1.0,1200,15843,1.0,0.0,2.0,3,7,1200,0,1955,0,98045,47.4991,-121.779,1410,15843,8,8,2014,UNK,-210,0
1392800035,6/18/2014,559000.0,2,1.0,1240,6400,1.0,0.0,1.0,4,7,1060,180,1938,0,98126,47.5493,-122.37700000000001,1240,6400,6,18,2014,UNK,0,0
1523069072,7/23/2014,575000.0,3,2.25,2680,100188,2.0,0.0,0.0,4,8,1580,1100,1978,0,98027,47.4776,-122.02,2540,60548,7,23,2014,UNK,140,39640
519000043,7/14/2014,602000.0,3,2.5,1640,3804,2.0,0.0,0.0,3,8,1640,0,1998,0,98122,47.6103,-122.3,1440,3230,7,14,2014,UNK,200,574
475000975,5/22/2014,492000.0,4,2.0,1640,5000,2.0,0.0,0.0,3,7,1640,0,1907,1983,98107,47.6662,-122.365,1240,5000,5,22,2014,Y,400,0
4142450040,3/27/2015,293500.0,3,2.5,1610,5024,2.0,0.0,0.0,3,7,1610,0,2004,0,98038,47.3833,-122.04299999999999,1790,3717,3,27,2015,N,-180,1307
2824059043,7/22/2014,481000.0,3,2.75,2290,14810,1.0,0.0,0.0,5,7,1400,890,1967,0,98056,47.5343,-122.185,2540,8640,7,22,2014,UNK,-250,6170
8558600085,5/9/2014,311100.0,4,2.25,2130,8078,1.0,0.0,0.0,4,7,1380,750,1977,0,98055,47.4482,-122.209,2300,8112,5,9,2014,UNK,-170,-34
8649400410,4/17/2015,375000.0,3,1.75,2140,13598,1.5,0.0,0.0,4,7,1620,520,1970,0,98014,47.7139,-121.321,930,10150,4,17,2015,UNK,1210,3448
2523089025,2/10/2015,1080000.0,3,3.0,4020,435600,1.5,0.0,2.0,3,10,4020,0,1999,0,98045,47.4418,-121.73100000000001,2590,283140,2,10,2015,UNK,1430,152460
9512500720,4/28/2015,500000.0,5,2.5,2030,8400,1.0,0.0,0.0,3,7,1330,700,1968,0,98052,47.6713,-122.152,1920,8400,4,28,2015,UNK,110,0
2461900760,4/1/2015,553000.0,3,1.0,1380,6250,1.0,0.0,0.0,4,7,1380,0,1918,0,98136,47.5514,-122.385,2270,6250,4,1,2015,UNK,-890,0
2877104196,12/6/2014,760000.0,3,2.0,1780,1750,1.0,0.0,2.0,3,8,1400,380,1927,2014,98103,47.6797,-122.35700000000001,1780,3750,12,6,2014,Y,0,-2000
2493200325,5/9/2015,589500.0,4,1.5,1440,3200,1.0,0.0,1.0,4,7,960,480,1960,0,98136,47.5269,-122.383,1650,6400,5,9,2015,UNK,-210,-3200
5210200410,11/14/2014,840000.0,5,2.75,2790,20824,1.0,0.0,0.0,3,9,1680,1110,1959,0,98115,47.6948,-122.28200000000001,2380,10465,11,14,2014,UNK,410,10359
1954700410,8/1/2014,2550000.0,4,3.0,4190,8805,2.5,0.0,2.0,5,9,3490,700,1928,0,98112,47.6181,-122.28399999999999,3780,8558,8,1,2014,UNK,410,247
9253900210,7/7/2014,1280000.0,3,2.5,3870,46609,2.0,0.0,3.0,3,9,3870,0,1997,0,98008,47.5966,-122.11200000000001,4030,17880,7,7,2014,UNK,-160,28729
984000450,12/1/2014,260000.0,3,2.5,1850,7875,1.0,0.0,0.0,3,7,1250,600,1968,0,98058,47.434,-122.171,1930,8062,12,1,2014,UNK,-80,-187
993002247,7/16/2014,430000.0,3,2.25,1550,1469,3.0,0.0,0.0,3,8,1550,0,2004,0,98103,47.6911,-122.34100000000001,1520,1465,7,16,2014,N,30,4
7517500610,3/4/2015,781000.0,3,2.5,1920,1896,3.0,0.0,3.0,3,8,1920,0,2000,0,98103,47.6616,-122.35600000000001,1670,2994,3,4,2015,UNK,250,-1098
3438500981,3/28/2015,280000.0,2,1.0,790,13170,1.0,0.0,0.0,3,6,790,0,1947,0,98106,47.5487,-122.35700000000001,970,12700,3,28,2015,UNK,-180,470
2011400021,7/1/2014,392000.0,5,2.25,3740,32481,1.5,0.0,0.0,3,8,2240,1500,1958,0,98198,47.3965,-122.314,2040,11398,7,1,2014,UNK,1700,21083
4038100360,2/10/2015,466200.0,3,1.5,1340,8856,1.0,0.0,0.0,4,7,1340,0,1959,0,98008,47.6094,-122.126,1850,8740,2,10,2015,UNK,-510,116
2028700360,5/23/2014,641000.0,3,1.75,1620,3975,1.0,0.0,0.0,5,7,940,680,1926,0,98117,47.6786,-122.368,1320,3922,5,23,2014,UNK,300,53
9144100035,3/24/2015,350000.0,3,1.0,1680,8010,1.0,0.0,0.0,3,7,840,840,1951,0,98117,47.6993,-122.376,1890,8778,3,24,2015,UNK,-210,-768
8665050530,2/4/2015,450000.0,3,2.0,1610,4364,2.0,0.0,0.0,3,8,1610,0,1996,0,98029,47.5672,-122.00399999999999,2010,4364,2,4,2015,UNK,-400,0
5425700205,5/20/2014,1800000.0,4,3.5,4460,16953,1.0,0.0,0.0,3,9,2550,1910,1962,0,98039,47.6338,-122.23200000000001,1980,13370,5,20,2014,UNK,2480,3583
7399100040,3/9/2015,185000.0,3,1.5,1200,1848,2.0,0.0,0.0,3,8,1200,0,1966,0,98055,47.4658,-122.191,1270,1848,3,9,2015,UNK,-70,0
7809200035,1/23/2015,290000.0,2,1.0,1250,12507,1.0,0.0,0.0,5,7,1250,0,1958,0,98056,47.4972,-122.176,1250,12498,1,23,2015,UNK,0,9
1825069072,4/30/2015,964000.0,3,2.5,3630,9475,2.0,0.0,0.0,3,11,3630,0,1999,0,98074,47.6544,-122.085,3250,11605,4,30,2015,UNK,380,-2130
2524049318,5/28/2014,2000000.0,4,3.0,4260,18000,2.0,0.0,2.0,3,11,4260,0,2000,0,98040,47.5355,-122.24,3540,17015,5,28,2014,UNK,720,985
7527200360,6/11/2014,545000.0,3,2.5,2180,15693,1.0,0.0,0.0,4,8,1850,330,1979,0,98075,47.592,-122.08200000000001,2270,24000,6,11,2014,UNK,-90,-8307
3041700035,3/12/2015,609950.0,3,2.25,1760,10350,1.0,0.0,0.0,4,7,1330,430,1979,0,98033,47.6605,-122.18799999999999,2210,11337,3,12,2015,UNK,-450,-987
625049318,8/4/2014,605000.0,4,2.0,1820,7626,1.0,0.0,0.0,5,7,990,830,1941,0,98103,47.6878,-122.34200000000001,1390,5904,8,4,2014,UNK,430,1722
6071400360,9/8/2014,550000.0,4,2.5,2120,9163,1.0,0.0,0.0,4,8,1450,670,1961,0,98006,47.5551,-122.17200000000001,2120,9166,9,8,2014,UNK,0,-3
8127700720,1/20/2015,905000.0,4,2.75,2730,4268,2.0,0.0,1.0,3,9,2730,0,2009,0,98199,47.6397,-122.395,2340,5000,1,20,2015,N,390,-732
1402650360,10/23/2014,384200.0,3,2.5,2430,7613,2.0,0.0,0.0,4,8,2430,0,1986,0,98058,47.4383,-122.135,2440,8342,10,23,2014,UNK,-10,-729
3277800845,7/11/2014,370000.0,3,1.0,1170,1105,1.0,0.0,0.0,3,7,1170,0,1965,0,98126,47.5448,-122.375,1380,1399,7,11,2014,UNK,-210,-294
2771603050,12/4/2014,717500.0,3,1.0,2090,4000,1.5,0.0,2.0,3,8,1890,200,1931,0,98199,47.6393,-122.39200000000001,2090,4000,12,4,2014,UNK,0,0
1068000150,5/1/2015,2000000.0,4,3.25,3910,7500,2.0,0.0,2.0,4,11,2550,1360,1933,0,98199,47.6448,-122.40899999999999,3070,7500,5,1,2015,UNK,840,0
126039213,12/3/2014,365500.0,2,1.0,1140,15624,1.0,0.0,0.0,4,6,1140,0,1909,0,98177,47.7673,-122.367,2110,15493,12,3,2014,UNK,-970,131
7537300210,1/28/2015,580000.0,2,1.5,1460,5700,1.5,0.0,0.0,3,7,1460,0,1912,0,98115,47.6838,-122.31200000000001,1780,3800,1,28,2015,UNK,-320,1900
764000155,11/7/2014,415000.0,4,1.5,2700,14760,1.5,0.0,0.0,5,9,2700,0,1940,0,98022,47.1996,-122.00299999999999,1670,7200,11,7,2014,UNK,1030,7560
7454000555,1/13/2015,272000.0,2,1.0,670,6300,1.0,0.0,0.0,4,6,670,0,1942,0,98126,47.5145,-122.374,740,6300,1,13,2015,UNK,-70,0
2215500205,5/5/2014,600000.0,3,1.75,1880,6360,1.0,0.0,0.0,4,7,1040,840,1945,0,98115,47.6878,-122.286,1770,6175,5,5,2014,UNK,110,185
3013300085,5/15/2014,744000.0,4,3.0,1980,5352,2.5,0.0,0.0,3,8,1980,0,1941,2005,98136,47.532,-122.385,1680,5352,5,15,2014,Y,300,0
3760500222,6/3/2014,830000.0,3,3.0,2080,10521,1.5,0.0,0.0,3,9,2080,0,2004,0,98034,47.6987,-122.228,3730,11840,6,3,2014,N,-1650,-1319
6145601312,10/29/2014,322000.0,3,3.25,1380,1225,3.0,0.0,0.0,3,7,1380,0,2000,0,98133,47.7035,-122.351,1380,1704,10,29,2014,UNK,0,-479
3750605674,9/17/2014,270000.0,3,2.5,1808,19200,1.0,0.0,0.0,3,8,1808,0,2005,0,98001,47.2598,-122.281,1450,14400,9,17,2014,N,358,4800
1001200035,3/6/2015,272450.0,3,1.0,1350,7973,1.5,0.0,0.0,3,7,1350,0,1954,0,98188,47.4323,-122.292,1310,7491,3,6,2015,UNK,40,482
2768300736,4/8/2015,605000.0,3,3.0,1760,2114,2.0,0.0,0.0,3,7,1400,0,2008,0,98107,47.6666,-122.37,1300,1500,4,8,2015,N,460,614
5255300150,5/11/2015,510000.0,3,1.75,1950,8325,1.0,0.0,0.0,4,7,1950,0,1962,0,98011,47.7685,-122.2,1950,8325,5,11,2015,UNK,0,0
5015001215,4/23/2015,1130000.0,4,3.5,3170,4000,2.0,0.0,0.0,3,10,2340,830,1999,0,98112,47.6265,-122.29799999999999,1770,4000,4,23,2015,UNK,1400,0
4219400580,6/12/2014,1690000.0,4,2.5,3000,7500,2.0,0.0,0.0,3,9,3000,0,1937,1994,98105,47.6571,-122.277,2580,5000,6,12,2014,Y,420,2500
6151800612,1/7/2015,162000.0,4,1.0,1460,16638,1.0,0.0,0.0,4,6,1460,0,1975,0,98010,47.3431,-122.04799999999999,1460,16638,1,7,2015,UNK,0,0
7893207510,5/6/2015,337500.0,3,1.75,1350,5850,1.0,0.0,0.0,4,7,1050,300,1973,0,98198,47.4225,-122.32799999999999,1710,7757,5,6,2015,UNK,-360,-1907
8899200720,3/31/2015,312000.0,3,2.25,1470,7857,1.0,0.0,0.0,4,7,1180,290,1973,0,98055,47.4547,-122.209,1900,7600,3,31,2015,UNK,-430,257
7167000040,8/13/2014,740000.0,4,3.0,3350,199253,2.0,0.0,0.0,3,10,3350,0,2004,0,98010,47.3602,-121.988,3350,183897,8,13,2014,N,0,15356
7167000040,3/5/2015,700000.0,4,3.0,3350,199253,2.0,0.0,0.0,3,10,3350,0,2004,0,98010,47.3602,-121.988,3350,183897,3,5,2015,N,0,15356
7771300035,9/25/2014,328000.0,4,1.0,1360,8136,1.0,0.0,0.0,3,7,1360,0,1948,0,98133,47.7366,-122.333,1570,8132,9,25,2014,UNK,-210,4
7967700530,2/13/2015,241000.0,3,1.0,1020,7538,1.0,0.0,0.0,3,7,1020,0,1981,0,98032,47.3587,-122.288,1650,7201,2,13,2015,UNK,-630,337
6669150790,7/31/2014,265000.0,3,2.25,1840,6750,1.0,0.0,0.0,4,7,1270,570,1980,0,98031,47.4075,-122.17200000000001,1750,7004,7,31,2014,UNK,90,-254
1921059213,3/27/2015,246000.0,5,1.75,2030,10200,1.0,0.0,0.0,4,7,2030,0,1958,0,98002,47.2867,-122.209,1760,11550,3,27,2015,UNK,270,-1350
723049533,9/30/2014,271000.0,4,1.75,1490,9112,1.0,0.0,0.0,3,6,970,520,1940,0,98146,47.4991,-122.345,1650,8411,9,30,2014,UNK,-160,701
797000276,6/25/2014,270000.0,2,1.0,2060,8398,1.0,0.0,0.0,3,7,1260,800,1962,0,98168,47.50899999999999,-122.324,1690,13495,6,25,2014,UNK,370,-5097
6381500720,11/17/2014,395000.0,4,2.0,2240,7085,1.5,0.0,0.0,3,7,2240,0,1944,1992,98125,47.7309,-122.305,1440,7085,11,17,2014,Y,800,0
3812400789,7/31/2014,340000.0,3,2.0,1460,5715,1.0,0.0,0.0,3,7,1460,0,1957,0,98118,47.54,-122.27600000000001,1400,5715,7,31,2014,UNK,60,0
3451000206,10/16/2014,340000.0,3,1.75,2140,13260,1.0,0.0,0.0,3,7,1240,900,1948,0,98146,47.5074,-122.353,1640,13260,10,16,2014,UNK,500,0
8165501540,3/6/2015,335000.0,2,2.25,1420,1246,2.0,0.0,0.0,3,8,1420,0,2007,0,98106,47.5394,-122.368,1420,1826,3,6,2015,N,0,-580
3131201563,6/25/2014,435000.0,2,1.0,1060,3036,1.5,0.0,0.0,4,6,1060,0,1943,0,98105,47.6578,-122.324,1730,5535,6,25,2014,UNK,-670,-2499
6813600365,10/9/2014,527950.0,4,1.75,1760,3600,1.0,0.0,0.0,5,7,880,880,1926,0,98103,47.6889,-122.33,1500,5580,10,9,2014,UNK,260,-1980
1822039138,2/27/2015,600000.0,2,2.25,2320,18919,2.0,0.0,4.0,4,8,2320,0,1976,0,98070,47.3905,-122.462,1610,18919,2,27,2015,UNK,710,0
4443800555,7/16/2014,667000.0,3,1.75,1770,3880,1.0,0.0,0.0,3,8,1300,0,1963,0,98117,47.6846,-122.39200000000001,1430,3880,7,16,2014,UNK,340,0
627300145,8/14/2014,1150000.0,10,5.25,4590,10920,1.0,0.0,2.0,3,9,2500,2090,2008,0,98004,47.5861,-122.113,2730,10400,8,14,2014,N,1860,520
9133600120,4/8/2015,417000.0,3,2.5,2040,11211,2.0,0.0,0.0,3,8,2040,0,2000,0,98055,47.4867,-122.223,1830,11964,4,8,2015,UNK,210,-753
2354300910,3/10/2015,451000.0,4,1.75,1260,7250,1.0,0.0,0.0,3,6,1260,0,1943,0,98027,47.5267,-122.03200000000001,1880,7250,3,10,2015,UNK,-620,0
6917700665,2/18/2015,580000.0,2,1.0,1650,9780,1.0,0.0,0.0,3,7,950,700,1943,0,98199,47.6549,-122.39399999999999,1650,5458,2,18,2015,UNK,0,4322
7214710210,12/17/2014,570000.0,4,2.25,2380,36446,2.0,0.0,0.0,4,8,2380,0,1977,0,98077,47.7644,-122.072,2790,40005,12,17,2014,UNK,-410,-3559
2649500155,6/10/2014,750000.0,5,3.25,2750,7500,2.0,0.0,1.0,3,7,2150,600,1937,0,98033,47.6636,-122.20299999999999,2750,7500,6,10,2014,UNK,0,0
3343301385,5/27/2014,685000.0,3,2.5,2810,7700,2.0,0.0,0.0,3,9,2810,0,2001,0,98006,47.5464,-122.191,2910,8250,5,27,2014,UNK,-100,-550
1237500720,12/26/2014,275000.0,3,2.0,1340,9764,1.0,0.0,0.0,3,7,1340,0,1944,0,98052,47.6786,-122.161,1310,9764,12,26,2014,UNK,30,0
1724069043,6/18/2014,739888.0,3,2.5,2420,43177,2.0,0.0,4.0,4,8,1690,730,1989,0,98075,47.568999999999996,-122.05799999999999,3740,8717,6,18,2014,UNK,-1320,34460
8682210650,5/27/2014,715000.0,2,2.5,2160,5581,1.0,0.0,0.0,3,8,2160,0,2002,0,98053,47.7017,-122.023,2315,5652,5,27,2014,UNK,-155,-71
2025049025,3/25/2015,800000.0,4,2.0,2450,4400,1.0,0.0,0.0,3,7,1450,1000,1913,1980,98102,47.6414,-122.32700000000001,1890,1386,3,25,2015,Y,560,3014
7883605695,11/24/2014,350000.0,3,1.5,1870,9000,1.0,0.0,0.0,3,7,1120,750,1923,0,98108,47.5224,-122.318,1850,6000,11,24,2014,UNK,20,3000
2120069003,11/24/2014,220000.0,3,1.0,1000,223462,1.0,0.0,2.0,4,6,1000,0,1933,0,98022,47.2099,-122.04299999999999,1710,105850,11,24,2014,UNK,-710,117612
7852130720,10/9/2014,452500.0,3,2.5,2240,7791,2.0,0.0,0.0,3,7,2240,0,2002,0,98065,47.5361,-121.88,2480,5018,10,9,2014,UNK,-240,2773
3832060120,3/16/2015,280000.0,4,2.5,2200,5893,2.0,0.0,0.0,3,7,2200,0,2008,0,98042,47.3333,-122.055,2200,5757,3,16,2015,N,0,136
4356200120,10/23/2014,248000.0,1,1.0,790,12000,1.0,0.0,0.0,3,6,790,0,1918,0,98118,47.5146,-122.265,1900,6000,10,23,2014,UNK,-1110,6000
4073200124,4/17/2015,305000.0,2,1.0,890,7200,1.0,0.0,0.0,3,7,740,150,1949,0,98115,47.6998,-122.27799999999999,1290,7200,4,17,2015,UNK,-400,0
2113700790,3/12/2015,435010.0,3,1.0,1270,4000,1.0,0.0,0.0,3,7,1120,150,1954,0,98106,47.5293,-122.354,1220,4600,3,12,2015,UNK,50,-600
9274202620,7/18/2014,678100.0,3,1.75,1850,2860,1.5,0.0,0.0,5,8,1210,640,1931,0,98116,47.5853,-122.39,1660,3120,7,18,2014,UNK,190,-260
2026049124,5/9/2014,325000.0,3,2.25,1352,1694,3.0,0.0,0.0,3,8,1352,0,2007,0,98125,47.7265,-122.315,1439,1387,5,9,2014,N,-87,307
1828000760,7/14/2014,529950.0,3,2.0,1540,8400,1.0,0.0,0.0,3,7,1180,360,1968,0,98052,47.6554,-122.12899999999999,1550,8760,7,14,2014,UNK,-10,-360
6187700175,12/23/2014,440000.0,3,1.75,1640,8529,1.0,0.0,0.0,5,7,1640,0,1951,0,98155,47.7751,-122.32,1730,7769,12,23,2014,UNK,-90,760
6371500040,3/16/2015,585000.0,3,1.0,1350,4800,1.5,0.0,0.0,3,7,1350,0,1928,0,98116,47.5749,-122.412,1360,4800,3,16,2015,UNK,-10,0
8929000040,8/20/2014,462608.0,3,2.5,2010,2778,2.0,0.0,0.0,3,8,1390,620,2014,0,98029,47.5528,-121.999,1540,1689,8,20,2014,N,470,1089
2970800145,4/7/2015,350500.0,3,1.75,2080,5200,1.0,0.0,0.0,3,7,1040,1040,1974,0,98166,47.4738,-122.35,1410,6550,4,7,2015,UNK,670,-1350
8588000610,11/10/2014,210000.0,3,1.0,1040,8125,1.0,0.0,0.0,3,7,1040,0,1956,0,98003,47.3171,-122.316,1200,9375,11,10,2014,UNK,-160,-1250
3905080870,2/6/2015,510000.0,3,2.5,1890,5929,2.0,0.0,0.0,3,8,1890,0,1993,0,98029,47.5697,-121.994,2060,5775,2,6,2015,UNK,-170,154
2457200040,5/6/2015,280000.0,3,2.25,1810,7630,1.0,0.0,0.0,4,7,1810,0,1959,0,98056,47.497,-122.18,1830,7594,5,6,2015,UNK,-20,36
3971700580,3/3/2015,385000.0,3,1.75,1930,14389,1.0,0.0,0.0,3,7,1130,800,1963,1998,98155,47.7733,-122.31700000000001,1730,14378,3,3,2015,Y,200,11
7304300760,6/25/2014,349000.0,3,1.0,1010,8184,1.0,0.0,0.0,4,6,1010,0,1947,0,98155,47.7416,-122.319,1010,8184,6,25,2014,UNK,0,0
5561720180,8/26/2014,252000.0,3,2.25,1740,10836,1.0,0.0,0.0,3,7,910,830,1981,0,98031,47.3976,-122.166,2090,7500,8,26,2014,UNK,-350,3336
1370801565,10/30/2014,1100000.0,4,2.5,2910,8881,2.0,0.0,1.0,3,10,1940,970,1932,0,98199,47.6424,-122.411,2540,5250,10,30,2014,UNK,370,3631
1822350180,12/11/2014,375000.0,3,2.25,1330,8004,2.0,0.0,0.0,3,7,1330,0,1985,0,98034,47.7098,-122.21700000000001,1300,7971,12,11,2014,UNK,30,33
1310900610,7/14/2014,336000.0,4,2.25,2210,11700,2.0,0.0,0.0,4,8,2210,0,1967,0,98032,47.3648,-122.28399999999999,2040,9000,7,14,2014,UNK,170,2700
9285800330,7/2/2014,732000.0,3,3.75,2670,6517,2.5,0.0,4.0,4,8,2020,650,1977,0,98126,47.5702,-122.38,2010,6073,7,2,2014,UNK,660,444
6620400205,8/6/2014,200000.0,2,1.0,1000,6227,1.0,0.0,0.0,3,6,1000,0,1949,0,98168,47.51300000000001,-122.333,1240,6250,8,6,2014,UNK,-240,-23
1644510040,5/28/2014,681716.0,4,2.5,3150,7277,2.0,0.0,0.0,3,9,3150,0,2006,0,98056,47.5159,-122.20200000000001,3030,8643,5,28,2014,N,120,-1366
6151800606,2/25/2015,235000.0,3,1.75,1520,12246,1.0,0.0,0.0,4,6,1520,0,1971,0,98010,47.3434,-122.04899999999999,1460,12246,2,25,2015,UNK,60,0
5245600120,10/9/2014,257500.0,3,1.0,1690,13825,1.0,0.0,0.0,3,7,1210,480,1955,0,98148,47.4256,-122.322,1190,9450,10,9,2014,UNK,500,4375
8951900065,9/29/2014,315000.0,3,1.0,1070,9497,1.0,0.0,0.0,3,7,1070,0,1955,0,98028,47.7425,-122.23,1710,9561,9,29,2014,UNK,-640,-64
226039186,5/20/2014,299950.0,3,1.0,910,8000,1.0,0.0,0.0,4,6,740,170,1950,0,98177,47.7746,-122.37799999999999,2090,9007,5,20,2014,UNK,-1180,-1007
3558900450,7/11/2014,530000.0,4,2.25,2130,8640,1.0,0.0,0.0,3,7,1430,700,1969,0,98034,47.7087,-122.198,2120,8826,7,11,2014,UNK,10,-186
3179100790,9/15/2014,766500.0,2,1.75,2230,6930,1.0,0.0,0.0,4,8,1530,700,1947,0,98105,47.6705,-122.277,1970,6930,9,15,2014,UNK,260,0
9808590210,5/13/2014,860000.0,4,2.5,3560,11119,1.0,0.0,2.0,3,10,2290,1270,1986,0,98004,47.6456,-122.19,3290,11385,5,13,2014,UNK,270,-266
1781500220,1/31/2015,690000.0,3,2.5,2590,4961,2.0,0.0,0.0,3,9,2590,0,1944,2007,98126,47.5271,-122.381,1230,4961,1,31,2015,Y,1360,0
3126049052,3/18/2015,551000.0,4,1.75,2040,6348,1.0,0.0,0.0,3,7,1020,1020,1962,0,98103,47.6964,-122.336,1770,5047,3,18,2015,UNK,270,1301
8677900120,11/21/2014,530000.0,3,2.75,2100,20150,1.0,0.0,0.0,4,7,2100,0,1955,0,98034,47.7206,-122.24799999999999,2100,15500,11,21,2014,UNK,0,4650
5408100035,4/20/2015,568000.0,3,1.0,1340,7260,1.5,0.0,0.0,3,7,1340,0,1953,0,98125,47.7016,-122.295,1830,6822,4,20,2015,UNK,-490,438
3827600040,5/20/2014,749950.0,3,2.5,2770,10773,2.0,0.0,2.0,3,9,2770,0,1992,0,98008,47.5754,-122.12,2530,10423,5,20,2014,UNK,240,350
7504100910,10/6/2014,535000.0,3,2.5,2400,12546,1.0,0.0,0.0,3,9,2400,0,1983,0,98074,47.6317,-122.041,2940,12150,10,6,2014,UNK,-540,396
2068500210,4/9/2015,234300.0,3,1.0,1140,9779,1.0,0.0,0.0,3,7,1140,0,1963,0,98055,47.424,-122.20100000000001,1520,9814,4,9,2015,UNK,-380,-35
2172000035,8/21/2014,190000.0,2,1.0,930,11450,1.0,0.0,0.0,3,6,930,0,1946,0,98178,47.4862,-122.264,1150,11450,8,21,2014,UNK,-220,0
4039400410,10/10/2014,525000.0,4,1.75,1820,6600,1.0,0.0,0.0,5,7,1820,0,1960,0,98007,47.606,-122.135,1430,8800,10,10,2014,UNK,390,-2200
7519000580,11/6/2014,610000.0,4,1.0,1390,3708,1.5,0.0,0.0,4,7,1390,0,1926,0,98117,47.685,-122.363,1430,3708,11,6,2014,UNK,-40,0
9828702266,10/3/2014,520000.0,3,2.5,1480,1165,3.0,0.0,0.0,3,8,1480,0,2006,0,98144,47.6199,-122.3,1480,1231,10,3,2014,N,0,-66
2770602170,4/22/2015,375000.0,2,1.0,760,6000,1.0,0.0,0.0,3,6,760,0,1942,0,98199,47.646,-122.384,1360,6000,4,22,2015,UNK,-600,0
3260100330,5/28/2014,600000.0,3,1.75,1580,7416,1.0,0.0,0.0,3,7,1150,430,1967,0,98005,47.6056,-122.17299999999999,1730,7416,5,28,2014,UNK,-150,0
925059219,10/23/2014,664000.0,4,2.5,1870,16200,1.0,0.0,0.0,5,8,1250,620,1974,0,98033,47.6651,-122.17399999999999,2000,11250,10,23,2014,UNK,-130,4950
1257201010,5/4/2015,698000.0,2,1.0,1510,4080,1.0,0.0,0.0,3,7,1010,500,1923,0,98103,47.6742,-122.329,1660,4080,5,4,2015,UNK,-150,0
476000333,8/27/2014,418000.0,3,2.0,1250,1306,3.0,0.0,0.0,3,7,1250,0,2001,0,98107,47.6705,-122.39,1320,1250,8,27,2014,UNK,-70,56
1721059218,8/18/2014,271675.0,3,1.75,2140,13068,1.0,0.0,0.0,4,7,1460,680,1974,0,98092,47.3099,-122.197,2090,17424,8,18,2014,UNK,50,-4356
6400700220,5/7/2015,450000.0,3,1.0,1540,9028,1.0,0.0,0.0,4,6,1540,0,1968,0,98033,47.6698,-122.177,1450,9028,5,7,2015,UNK,90,0
524069115,5/9/2014,759000.0,3,2.25,2950,78843,1.5,0.0,0.0,3,9,2950,0,2006,0,98075,47.5917,-122.068,3880,78843,5,9,2014,N,-930,0
8818900155,1/15/2015,599950.0,6,3.0,2020,4129,1.0,0.0,0.0,3,7,1230,790,1994,0,98105,47.6648,-122.324,2080,4080,1,15,2015,UNK,-60,49
2321300325,1/22/2015,810000.0,4,2.75,2820,5000,1.5,0.0,0.0,3,8,2170,650,1927,0,98199,47.6376,-122.39399999999999,1740,5000,1,22,2015,UNK,1080,0
2131200925,7/29/2014,331292.0,3,1.75,1660,10000,1.0,0.0,0.0,3,7,1660,0,1972,0,98019,47.74100000000001,-121.978,1770,10000,7,29,2014,UNK,-110,0
3726800220,4/6/2015,348000.0,3,1.75,1830,2417,1.0,0.0,0.0,3,7,930,900,1919,0,98144,47.5723,-122.309,1320,3200,4,6,2015,UNK,510,-783
3488300085,9/19/2014,435000.0,2,1.0,720,5600,1.0,0.0,0.0,4,7,720,0,1920,0,98116,47.5641,-122.391,1330,5600,9,19,2014,UNK,-610,0
6415100297,2/19/2015,530000.0,3,2.5,2160,9063,2.0,0.0,0.0,3,8,2160,0,1992,0,98133,47.7296,-122.333,2160,9063,2,19,2015,UNK,0,0
9265400210,9/22/2014,227000.0,3,1.75,1510,9837,2.0,0.0,0.0,3,7,1510,0,1989,0,98001,47.2576,-122.255,1470,8054,9,22,2014,UNK,40,1783
2787000040,10/3/2014,285000.0,3,1.5,1870,42070,1.0,0.0,0.0,3,7,1870,0,1953,0,98168,47.50899999999999,-122.31299999999999,1870,19965,10,3,2014,UNK,0,22105
3425059218,3/17/2015,740000.0,4,2.25,2860,26136,1.0,0.0,0.0,3,8,1640,1220,1977,0,98005,47.6033,-122.15799999999999,2670,25040,3,17,2015,UNK,190,1096
1591600676,3/11/2015,246000.0,3,1.0,990,9145,1.5,0.0,0.0,4,6,990,0,1939,0,98146,47.5022,-122.36,1640,8320,3,11,2015,UNK,-650,825
2843200085,2/17/2015,260000.0,3,1.0,1910,8710,1.0,0.0,0.0,3,7,1080,830,1954,0,98168,47.5038,-122.3,1460,8944,2,17,2015,UNK,450,-234
2561320120,8/11/2014,366000.0,3,2.0,1350,10200,1.0,0.0,0.0,3,7,1350,0,1977,0,98074,47.6159,-122.05,1820,9600,8,11,2014,UNK,-470,600
8835400775,10/26/2014,594950.0,4,3.25,2557,9480,2.0,0.0,2.0,3,7,2557,0,1948,1993,98118,47.5449,-122.262,2220,8340,10,26,2014,Y,337,1140
2767704525,3/27/2015,608000.0,3,2.75,2610,5000,2.0,0.0,0.0,4,7,1710,900,1946,0,98107,47.6729,-122.37299999999999,1500,5000,3,27,2015,UNK,1110,0
3343901848,4/8/2015,313100.0,3,2.0,1720,11875,1.0,0.0,0.0,5,6,1720,0,1905,0,98056,47.5068,-122.191,1860,7500,4,8,2015,UNK,-140,4375
7137800085,10/3/2014,185000.0,3,1.75,1170,9085,1.0,0.0,0.0,3,7,1170,0,1967,0,98023,47.2808,-122.354,1230,9085,10,3,2014,UNK,-60,0
1443500925,5/4/2015,455000.0,2,1.0,1140,11480,1.0,0.0,0.0,3,6,1140,0,1907,0,98118,47.5328,-122.274,1550,8150,5,4,2015,UNK,-410,3330
8731800210,7/11/2014,235000.0,3,2.5,2350,9051,1.0,0.0,0.0,4,8,1570,780,1966,0,98023,47.3126,-122.36399999999999,2270,8748,7,11,2014,UNK,80,303
8155000040,10/30/2014,230000.0,3,1.0,1020,12289,1.0,0.0,0.0,4,7,1020,0,1967,0,98058,47.4235,-122.155,1300,9894,10,30,2014,UNK,-280,2395
9279200910,11/20/2014,770000.0,4,2.25,2730,5000,1.0,0.0,0.0,5,7,1460,1270,1955,0,98116,47.5843,-122.39299999999999,2010,5000,11,20,2014,UNK,720,0
7697920150,10/2/2014,240000.0,4,2.25,1830,7614,2.0,0.0,0.0,3,7,1830,0,1991,0,98030,47.3682,-122.179,1860,6930,10,2,2014,UNK,-30,684
7202290620,2/19/2015,461000.0,3,2.5,1690,3026,2.0,0.0,0.0,3,7,1690,0,2002,0,98053,47.6885,-122.04299999999999,1650,3161,2,19,2015,UNK,40,-135
5093301285,3/27/2015,1580000.0,4,2.5,2900,10500,1.0,0.0,3.0,5,8,1450,1450,1963,0,98040,47.5838,-122.24600000000001,2900,9201,3,27,2015,UNK,0,1299
1524069044,10/9/2014,1820000.0,4,4.5,6380,88714,2.0,0.0,0.0,3,12,6380,0,2006,0,98029,47.5592,-122.015,3040,7113,10,9,2014,N,3340,81601
7202340450,11/23/2014,452000.0,3,2.5,1690,4000,2.0,0.0,0.0,3,7,1690,0,2004,0,98053,47.6788,-122.03399999999999,1690,4000,11,23,2014,N,0,0
3629921120,10/3/2014,765000.0,4,2.5,2660,5043,2.0,0.0,2.0,3,9,2660,0,2003,0,98029,47.5445,-121.99600000000001,3010,5500,10,3,2014,UNK,-350,-457
524069020,4/22/2015,1050000.0,4,4.0,4550,54013,1.0,0.0,1.0,4,9,2300,2250,1989,0,98075,47.5964,-122.07700000000001,3540,39634,4,22,2015,UNK,1010,14379
2273600410,5/5/2015,546000.0,3,3.0,1530,9999,1.0,0.0,0.0,4,7,1150,380,1983,0,98033,47.6869,-122.186,1530,8556,5,5,2015,UNK,0,1443
3186600515,1/22/2015,781000.0,3,2.5,2070,4463,1.5,0.0,0.0,5,8,1780,290,1931,0,98115,47.6853,-122.305,2070,5000,1,22,2015,UNK,0,-537
7923000360,1/20/2015,538000.0,4,1.75,1880,7953,1.0,0.0,0.0,4,7,1880,0,1965,0,98008,47.5838,-122.12299999999999,1750,8591,1,20,2015,UNK,130,-638
6678900150,8/19/2014,790000.0,4,2.5,2240,8664,1.0,0.0,0.0,5,8,1470,770,1975,0,98033,47.6621,-122.189,2210,8860,8,19,2014,UNK,30,-196
9482700455,10/21/2014,696500.0,4,2.75,2540,4400,1.5,0.0,0.0,5,7,1630,910,1925,0,98103,47.6832,-122.34299999999999,1560,3920,10,21,2014,UNK,980,480
3861500330,4/30/2015,276000.0,3,2.0,1370,8137,1.0,0.0,0.0,4,7,1370,0,1988,0,98003,47.2802,-122.303,1660,8840,4,30,2015,UNK,-290,-703
6163901033,9/2/2014,269000.0,2,1.0,770,8612,1.0,0.0,0.0,3,6,770,0,1953,0,98155,47.7547,-122.323,1290,8407,9,2,2014,UNK,-520,205
2426039123,1/30/2015,2420000.0,5,4.75,7880,24250,2.0,0.0,2.0,3,13,7880,0,1996,0,98177,47.7334,-122.36200000000001,2740,10761,1,30,2015,UNK,5140,13489
624069003,1/2/2015,829000.0,4,2.75,2970,59677,1.0,0.0,2.0,4,8,1610,1360,1973,0,98075,47.5953,-122.08,2930,42489,1,2,2015,UNK,40,17188
7454000145,3/6/2015,122000.0,2,1.0,740,6840,1.0,0.0,0.0,3,6,740,0,1942,0,98126,47.5168,-122.37299999999999,740,6840,3,6,2015,UNK,0,0
4402700230,8/21/2014,352500.0,3,1.5,1360,7680,1.0,0.0,0.0,3,7,1360,0,1955,0,98133,47.7441,-122.337,1630,7679,8,21,2014,UNK,-270,1
1432701510,10/21/2014,249000.0,4,2.0,1280,7560,1.0,0.0,0.0,5,6,1280,0,1959,0,98058,47.45,-122.175,1250,7690,10,21,2014,UNK,30,-130
1115100119,12/8/2014,360000.0,4,2.0,1920,7803,1.0,0.0,0.0,3,7,1080,840,1962,0,98155,47.758,-122.325,1940,8147,12,8,2014,UNK,-20,-344
2553300120,5/4/2015,629500.0,3,2.0,2020,10584,1.0,0.0,0.0,3,10,2020,0,1994,0,98075,47.5851,-122.02799999999999,3030,9870,5,4,2015,UNK,-1010,714
2481630180,6/25/2014,1140000.0,4,2.25,3310,127631,2.0,0.0,0.0,5,9,3310,0,1924,1956,98072,47.732,-122.134,3830,43959,6,25,2014,Y,-520,83672
2525049246,10/17/2014,1550000.0,2,2.25,2950,15593,1.0,0.0,0.0,4,8,1560,1390,1942,1986,98039,47.6209,-122.236,2060,19855,10,17,2014,Y,890,-4262
7236300065,7/18/2014,275000.0,3,1.5,1320,7695,1.0,0.0,0.0,4,7,1320,0,1959,0,98056,47.4908,-122.181,1370,8295,7,18,2014,UNK,-50,-600
1854900330,9/9/2014,697000.0,4,2.5,3160,6961,2.0,0.0,0.0,3,8,3160,0,2005,0,98074,47.6125,-122.01,3110,5058,9,9,2014,N,50,1903
203101210,5/7/2014,379500.0,2,1.0,1640,17335,1.0,0.0,0.0,3,7,840,800,1978,0,98053,47.6397,-121.95299999999999,2440,17850,5,7,2014,UNK,-800,-515
622100074,11/10/2014,720000.0,3,2.75,2440,76531,1.0,0.0,0.0,3,10,1640,800,1980,0,98072,47.7672,-122.161,1890,10042,11,10,2014,UNK,550,66489
5014600180,5/13/2014,675000.0,4,2.5,3000,5548,2.0,0.0,0.0,3,9,3000,0,2006,0,98059,47.5399,-122.18799999999999,2870,5000,5,13,2014,N,130,548
809002295,10/29/2014,1170000.0,5,2.5,2810,6000,2.5,0.0,0.0,3,9,2810,0,1907,0,98109,47.6367,-122.35,2240,4800,10,29,2014,UNK,570,1200
7533800325,5/20/2014,1100000.0,3,2.0,2390,6888,2.0,0.0,1.0,5,8,2390,0,1939,0,98115,47.6839,-122.274,2390,7920,5,20,2014,UNK,0,-1032
5637500180,6/12/2014,520000.0,4,1.0,2080,3500,1.5,0.0,0.0,5,7,1260,820,1926,0,98136,47.5445,-122.383,1380,5900,6,12,2014,UNK,700,-2400
3971700981,10/3/2014,415000.0,3,1.75,2650,7500,1.5,0.0,0.0,4,7,1590,1060,1962,0,98155,47.7716,-122.31700000000001,1340,7500,10,3,2014,UNK,1310,0
2267000453,6/27/2014,415000.0,3,2.5,1060,1536,2.0,0.0,0.0,3,8,1060,0,2000,0,98117,47.6907,-122.395,1220,1316,6,27,2014,UNK,-160,220
5029000120,4/7/2015,450000.0,3,2.25,1940,8312,1.0,0.0,1.0,4,7,1220,720,1963,0,98166,47.4556,-122.346,2060,9503,4,7,2015,UNK,-120,-1191
3735900325,4/27/2015,485000.0,2,1.0,1080,4080,1.0,0.0,0.0,3,8,1080,0,1948,0,98115,47.6899,-122.32,1890,4080,4,27,2015,UNK,-810,0
6187100360,4/27/2015,294000.0,3,2.25,1700,9600,2.0,0.0,0.0,3,7,1700,0,1984,0,98042,47.39,-122.15799999999999,1930,9600,4,27,2015,UNK,-230,0
7237500530,7/9/2014,1040000.0,4,3.5,4440,10660,2.0,0.0,0.0,3,11,4440,0,2003,0,98059,47.5294,-122.137,4390,9976,7,9,2014,UNK,50,684
2207500880,7/28/2014,690000.0,3,1.0,1580,4000,2.0,0.0,0.0,3,8,1580,0,1905,0,98102,47.6363,-122.32,2190,4000,7,28,2014,UNK,-610,0
7937900220,10/9/2014,716500.0,5,2.75,3630,38461,2.0,0.0,0.0,3,11,3630,0,2000,0,98058,47.4289,-122.094,4440,50378,10,9,2014,UNK,-810,-11917
2767603615,9/3/2014,481000.0,2,2.25,1290,1137,3.0,0.0,0.0,3,8,1290,0,2007,0,98107,47.6718,-122.382,1290,1332,9,3,2014,N,0,-195
8121100325,4/19/2015,575000.0,4,2.75,1960,4635,1.0,0.0,0.0,4,7,1000,960,1968,0,98118,47.5693,-122.285,1830,6180,4,19,2015,UNK,130,-1545
8712100720,8/15/2014,785000.0,3,2.0,2090,5015,1.5,0.0,0.0,5,7,2090,0,1920,0,98112,47.6378,-122.301,1930,4250,8,15,2014,UNK,160,765
1223059081,3/25/2015,480000.0,3,1.75,1960,43995,1.0,0.0,0.0,3,7,1960,0,1970,0,98059,47.4915,-122.10600000000001,1960,42253,3,25,2015,UNK,0,1742
9323610180,8/19/2014,720000.0,3,2.25,2120,9297,2.0,0.0,0.0,4,8,2120,0,1981,0,98006,47.5561,-122.154,2620,10352,8,19,2014,UNK,-500,-1055
2722059275,5/12/2015,536000.0,3,2.75,2290,34548,2.0,0.0,3.0,4,7,2290,0,1984,0,98042,47.3691,-122.163,399,275299,5,12,2015,UNK,1891,-240751
1545800205,6/13/2014,324900.0,4,2.5,1880,7965,2.0,0.0,0.0,3,7,1880,0,2000,0,98038,47.3642,-122.052,1570,7584,6,13,2014,UNK,310,381
4303200555,8/15/2014,265000.0,2,1.0,770,5160,1.0,0.0,0.0,3,6,770,0,1943,0,98106,47.5304,-122.35600000000001,920,5160,8,15,2014,UNK,-150,0
2267000730,7/1/2014,545000.0,3,2.5,1530,3210,1.5,0.0,0.0,5,7,1010,520,1928,0,98117,47.6913,-122.39299999999999,1330,4410,7,1,2014,UNK,200,-1200
1926049154,1/15/2015,465000.0,2,1.5,1450,27075,1.0,0.0,0.0,3,7,1450,0,1940,0,98133,47.7281,-122.353,1890,10599,1,15,2015,UNK,-440,16476
3300790540,1/9/2015,292500.0,3,2.25,1690,7320,2.0,0.0,0.0,3,7,1690,0,1987,0,98198,47.3889,-122.316,1520,7450,1,9,2015,UNK,170,-130
2652501215,7/2/2014,860000.0,4,1.75,1880,3720,1.5,0.0,0.0,4,7,1880,0,1924,0,98109,47.6431,-122.35600000000001,2090,4095,7,2,2014,UNK,-210,-375
2426059124,12/16/2014,1050000.0,4,3.25,4160,47480,2.0,0.0,0.0,3,10,4160,0,1995,0,98072,47.7266,-122.115,3400,40428,12,16,2014,UNK,760,7052
164000237,6/12/2014,495000.0,4,2.5,2140,7245,2.0,0.0,0.0,3,7,2140,0,2003,0,98133,47.729,-122.35,2080,7875,6,12,2014,UNK,60,-630
1453602283,5/7/2015,342000.0,2,2.0,1320,1462,3.0,0.0,0.0,3,7,1320,0,1997,0,98125,47.7223,-122.29,1430,1650,5,7,2015,UNK,-110,-188
8081650330,6/25/2014,320000.0,4,2.5,2000,10051,2.0,0.0,0.0,3,7,2000,0,1997,0,98038,47.3625,-122.025,2000,6686,6,25,2014,UNK,0,3365
3797000205,9/24/2014,444000.0,3,2.0,1460,2610,2.0,0.0,0.0,3,8,1460,0,1987,0,98103,47.6864,-122.345,1320,3000,9,24,2014,UNK,140,-390
8921000040,6/25/2014,804100.0,4,2.5,3070,8086,2.0,0.0,0.0,3,10,3070,0,2005,0,98059,47.5399,-122.16,3320,10738,6,25,2014,N,-250,-2652
6791100410,9/19/2014,432000.0,3,2.5,1660,15000,1.0,0.0,0.0,4,7,1660,0,1970,0,98075,47.5803,-122.05,2060,15015,9,19,2014,UNK,-400,-15
7224000450,12/30/2014,230000.0,6,1.5,1810,4838,1.5,0.0,0.0,4,5,1050,760,1905,0,98055,47.4874,-122.20200000000001,1300,4838,12,30,2014,UNK,510,0
3303980650,8/27/2014,935000.0,4,3.5,3510,11200,2.0,0.0,0.0,3,11,3510,0,2001,0,98059,47.5193,-122.15,3600,12124,8,27,2014,UNK,-90,-924
7589200191,8/7/2014,634950.0,3,3.0,2180,2650,1.5,0.0,0.0,5,8,1410,770,1930,0,98117,47.6891,-122.375,1570,4820,8,7,2014,UNK,610,-2170
9547200530,1/12/2015,780000.0,6,4.0,3300,5720,1.0,0.0,0.0,3,8,1960,1340,1963,0,98115,47.676,-122.309,2030,4080,1,12,2015,UNK,1270,1640
8635751120,5/19/2014,611000.0,4,2.5,2460,4200,2.0,0.0,0.0,3,8,2460,0,1998,0,98074,47.6031,-122.021,2330,4200,5,19,2014,UNK,130,0
1982201465,11/21/2014,475999.0,4,1.75,1880,4175,1.5,0.0,0.0,3,7,1090,790,1944,0,98107,47.6646,-122.36399999999999,1700,3758,11,21,2014,UNK,180,417
8648700450,12/16/2014,565000.0,3,2.0,2290,9450,1.0,0.0,0.0,3,9,1670,620,1979,0,98008,47.5692,-122.1,2750,11700,12,16,2014,UNK,-460,-2250
3586501085,8/8/2014,630000.0,4,2.5,2290,26720,2.0,0.0,0.0,3,8,2290,0,1977,0,98177,47.7502,-122.374,2290,26720,8,8,2014,UNK,0,0
7701990040,6/17/2014,840000.0,4,3.5,3860,18334,2.0,0.0,0.0,3,10,3120,740,1996,0,98077,47.7095,-122.075,3550,18334,6,17,2014,UNK,310,0
3420069060,11/7/2014,790000.0,3,2.5,2640,432036,1.5,0.0,3.0,3,10,2640,0,1996,0,98022,47.1795,-122.036,1500,560617,11,7,2014,UNK,1140,-128581
1822069052,7/9/2014,450000.0,5,2.5,2850,209523,1.0,0.0,0.0,4,7,1930,0,1925,1968,98058,47.3939,-122.089,2220,209523,7,9,2014,Y,630,0
4385701285,12/23/2014,1270000.0,4,3.25,3020,4000,1.5,0.0,0.0,5,8,1920,1100,1927,0,98112,47.6395,-122.279,2400,4000,12,23,2014,UNK,620,0
2810600210,4/22/2015,520000.0,3,2.0,1510,3760,1.0,0.0,0.0,5,7,930,580,1925,0,98136,47.5425,-122.39,1510,3760,4,22,2015,UNK,0,0
1624049170,10/17/2014,446800.0,4,2.0,2410,8712,1.0,0.0,0.0,3,7,1260,1150,1958,0,98144,47.5729,-122.302,2220,6038,10,17,2014,UNK,190,2674
871001085,1/29/2015,652000.0,3,1.0,1470,6122,1.0,0.0,0.0,3,8,1200,270,1948,0,98199,47.6517,-122.406,2200,6122,1,29,2015,UNK,-730,0
4104500191,5/22/2014,1170000.0,3,2.75,2890,12130,2.0,0.0,3.0,4,10,2830,60,1987,0,98033,47.6505,-122.20299999999999,2415,11538,5,22,2014,UNK,475,592
98030530,6/10/2014,745000.0,4,3.25,3490,7024,2.0,0.0,0.0,3,10,3490,0,2006,0,98075,47.5834,-121.97200000000001,3450,6866,6,10,2014,N,40,158
1025049115,6/25/2014,594000.0,3,2.25,1270,1406,2.0,0.0,0.0,3,8,1060,210,2014,0,98105,47.6647,-122.28399999999999,1160,1327,6,25,2014,N,110,79
9331800580,3/10/2015,257000.0,2,1.0,1000,3700,1.0,0.0,0.0,3,6,800,200,1929,0,98118,47.552,-122.29,1270,5000,3,10,2015,UNK,-270,-1300
9826701320,7/1/2014,485000.0,4,1.75,1430,4096,2.0,0.0,0.0,3,7,1430,0,1900,0,98122,47.604,-122.306,1640,3377,7,1,2014,UNK,-210,719
2426049079,5/6/2015,330000.0,3,1.0,1060,20040,1.0,0.0,0.0,3,6,1060,0,1943,0,98034,47.7281,-122.235,1768,10800,5,6,2015,UNK,-708,9240
204000175,7/31/2014,381000.0,3,2.0,1680,8946,1.0,0.0,0.0,3,6,940,740,1996,0,98053,47.6379,-121.96600000000001,1550,11625,7,31,2014,UNK,130,-2679
822039004,6/13/2014,849900.0,2,2.0,2280,641203,2.0,0.0,0.0,3,9,2280,0,1990,0,98070,47.4125,-122.455,2030,224334,6,13,2014,UNK,250,416869
3735900205,4/2/2015,793000.0,4,2.5,2450,4080,1.5,0.0,0.0,4,8,1490,960,1930,0,98115,47.6899,-122.319,2000,4080,4,2,2015,UNK,450,0
823000174,7/28/2014,920000.0,3,2.25,3650,5353,2.0,0.0,4.0,4,7,2200,1450,1947,0,98144,47.5949,-122.291,1950,4970,7,28,2014,UNK,1700,383
3300701575,4/22/2015,455000.0,2,1.0,830,4000,1.0,0.0,0.0,4,6,830,0,1947,0,98117,47.6909,-122.381,1420,4000,4,22,2015,UNK,-590,0
4128500210,5/13/2014,975000.0,4,2.5,3490,7494,2.0,0.0,3.0,3,11,3490,0,2000,0,98006,47.559,-122.12700000000001,3260,8437,5,13,2014,UNK,230,-943
1934800142,12/3/2014,375000.0,2,1.5,1050,1046,2.0,0.0,0.0,3,8,960,90,2007,0,98122,47.6028,-122.309,1470,1768,12,3,2014,N,-420,-722
1189000205,3/11/2015,400000.0,2,2.5,1170,1811,2.0,0.0,0.0,3,8,1170,0,2001,0,98122,47.6132,-122.29700000000001,1250,3146,3,11,2015,UNK,-80,-1335
4040800120,2/11/2015,447000.0,3,1.0,1220,7200,1.0,0.0,0.0,4,7,1220,0,1965,0,98008,47.6218,-122.116,1320,7200,2,11,2015,UNK,-100,0
1238501099,10/31/2014,470000.0,3,1.75,1310,8600,1.0,0.0,0.0,4,7,1310,0,1987,0,98033,47.68600000000001,-122.185,2510,8515,10,31,2014,UNK,-1200,85
6705870040,10/15/2014,665000.0,4,2.5,3130,7582,2.0,0.0,0.0,3,8,3130,0,2004,0,98075,47.577,-122.055,2990,6441,10,15,2014,N,140,1141
7340601063,9/3/2014,295500.0,3,1.75,1590,41550,1.5,0.0,0.0,3,6,1290,300,1933,1989,98168,47.4817,-122.28,2990,6464,9,3,2014,Y,-1400,35086
7212660540,1/15/2015,200000.0,4,2.5,1720,8638,2.0,0.0,0.0,3,8,1720,0,1994,0,98003,47.2704,-122.31299999999999,1870,7455,1,15,2015,UNK,-150,1183
1426079047,9/11/2014,620000.0,3,2.25,2520,212137,2.0,0.0,0.0,3,9,1590,930,2005,0,98019,47.7384,-121.87799999999999,2000,212137,9,11,2014,N,520,0
6817800220,8/29/2014,434900.0,3,2.0,1520,11067,1.0,0.0,0.0,3,7,1140,380,1983,0,98074,47.6326,-122.03299999999999,1280,11371,8,29,2014,UNK,240,-304
1336800065,3/24/2015,1330000.0,4,2.25,3260,4640,2.0,0.0,0.0,5,9,2360,900,1907,0,98112,47.6272,-122.31200000000001,3240,5800,3,24,2015,UNK,20,-1160
9413900035,1/9/2015,1650000.0,4,3.25,3910,7500,2.0,0.0,0.0,3,10,3910,0,2006,0,98033,47.6527,-122.198,2600,9235,1,9,2015,N,1310,-1735
9113200180,9/5/2014,852500.0,4,2.5,3480,6315,2.0,0.0,0.0,3,9,2360,1120,2000,0,98052,47.6841,-122.161,3620,5233,9,5,2014,UNK,-140,1082
4215250220,12/9/2014,790000.0,3,2.5,3040,34670,2.0,0.0,0.0,4,10,3040,0,1983,0,98072,47.7565,-122.12899999999999,3480,35001,12,9,2014,UNK,-440,-331
8563030330,3/13/2015,565000.0,4,1.75,2030,7350,1.0,0.0,0.0,3,8,2030,0,1966,0,98008,47.6274,-122.094,2000,7998,3,13,2015,UNK,30,-648
5634500688,3/25/2015,1130000.0,6,3.25,3870,24700,2.0,0.0,0.0,3,10,2520,1350,1989,0,98028,47.7517,-122.23299999999999,2360,30030,3,25,2015,UNK,1510,-5330
1657530450,12/22/2014,289950.0,3,2.5,1870,1436,2.0,0.0,0.0,3,7,1870,0,2004,0,98059,47.4899,-122.166,1720,1852,12,22,2014,N,150,-416
1624059219,11/5/2014,850000.0,2,2.0,2640,13939,1.0,0.0,1.0,5,8,1640,1000,1963,0,98006,47.5647,-122.165,2880,14810,11,5,2014,UNK,-240,-871
7942600975,5/12/2014,505000.0,4,1.75,1940,4800,1.0,0.0,0.0,5,7,1030,910,1922,0,98122,47.6054,-122.314,1450,4800,5,12,2014,UNK,490,0
8835200610,10/28/2014,372000.0,3,2.5,1710,5633,2.0,0.0,0.0,3,7,1710,0,1981,0,98034,47.7232,-122.161,1540,5000,10,28,2014,UNK,170,633
7524200180,10/23/2014,207000.0,4,2.0,1690,7728,1.5,0.0,0.0,4,7,1690,0,1967,0,98198,47.3666,-122.318,1480,8009,10,23,2014,UNK,210,-281
5451100220,5/13/2014,780000.0,3,1.75,2340,10495,1.0,0.0,0.0,4,8,2340,0,1967,0,98040,47.5386,-122.226,3120,11068,5,13,2014,UNK,-780,-573
4047200065,6/23/2014,400000.0,4,1.75,1700,20283,1.5,0.0,0.0,3,7,1340,360,1965,0,98019,47.7694,-121.90299999999999,1680,21369,6,23,2014,UNK,20,-1086
3374900035,2/23/2015,440250.0,3,1.5,1850,8124,1.0,0.0,0.0,4,7,1850,0,1948,0,98177,47.7275,-122.359,1530,8123,2,23,2015,UNK,320,1
7010700580,3/3/2015,585000.0,2,2.0,1370,7920,1.0,0.0,0.0,3,8,950,420,1949,0,98199,47.6589,-122.397,1370,4680,3,3,2015,UNK,0,3240
4139440360,9/18/2014,850000.0,4,2.5,2900,9972,2.0,0.0,0.0,3,9,2900,0,1993,0,98006,47.5536,-122.12100000000001,2901,8567,9,18,2014,UNK,-1,1405
3126049154,9/25/2014,570000.0,3,3.0,2400,3192,2.0,0.0,0.0,3,7,2400,0,1991,0,98103,47.6963,-122.348,1360,3192,9,25,2014,UNK,1040,0
1331900410,6/20/2014,869000.0,4,3.0,3740,30884,2.0,0.0,0.0,3,9,3060,680,1988,0,98072,47.7505,-122.117,3240,37031,6,20,2014,UNK,500,-6147
3432501395,9/24/2014,551000.0,4,2.75,2170,5988,2.0,0.0,0.0,3,8,2170,0,2014,0,98155,47.7484,-122.31700000000001,1170,8147,9,24,2014,N,1000,-2159
8945100530,3/13/2015,172380.0,3,1.0,970,8378,1.0,0.0,0.0,4,6,970,0,1962,0,98023,47.3078,-122.365,1050,8563,3,13,2015,UNK,-80,-185
3121069038,3/26/2015,355000.0,3,2.5,2620,78843,1.0,0.0,3.0,4,7,1310,1310,1964,0,98092,47.2584,-122.09299999999999,2330,130244,3,26,2015,UNK,290,-51401
4139440730,2/25/2015,728935.0,4,2.5,2980,10194,2.0,0.0,0.0,3,9,2980,0,1993,0,98006,47.5515,-122.12,2980,10053,2,25,2015,UNK,0,141
9808640040,3/6/2015,850000.0,3,2.5,2340,1919,2.0,0.0,2.0,4,9,2340,0,1981,0,98033,47.6512,-122.20299999999999,2415,2166,3,6,2015,UNK,-75,-247
423059077,12/23/2014,515000.0,5,1.75,1880,48787,2.0,0.0,0.0,3,6,1880,0,1922,0,98059,47.5094,-122.165,1690,8401,12,23,2014,UNK,190,40386
8005100571,12/5/2014,215000.0,2,1.0,1480,5325,1.0,0.0,0.0,4,7,1120,360,1925,0,98022,47.2079,-121.993,1670,5800,12,5,2014,UNK,-190,-475
9324320040,6/16/2014,220000.0,4,2.5,2240,9826,1.0,0.0,0.0,4,7,1370,870,1988,0,98023,47.31399999999999,-122.36399999999999,1980,9826,6,16,2014,UNK,260,0
3825310970,7/24/2014,845000.0,4,2.5,2940,7675,2.0,0.0,0.0,3,9,2940,0,2004,0,98052,47.7054,-122.12899999999999,3120,6574,7,24,2014,N,-180,1101
1930301540,2/23/2015,390000.0,1,1.0,710,4000,1.0,0.0,0.0,4,6,610,100,1928,0,98103,47.6562,-122.354,1440,4500,2,23,2015,UNK,-730,-500
723049158,3/13/2015,135000.0,4,1.0,1460,18599,1.5,0.0,0.0,3,5,1460,0,1940,0,98146,47.5006,-122.351,1320,8100,3,13,2015,UNK,140,10499
6116500366,4/1/2015,439000.0,3,1.0,1530,19007,1.0,0.0,0.0,4,8,1290,240,1949,0,98166,47.4508,-122.352,2090,20962,4,1,2015,UNK,-560,-1955
7954300330,7/8/2014,585000.0,4,2.5,2630,6185,2.0,0.0,0.0,3,9,2630,0,1999,0,98056,47.5229,-122.19200000000001,2720,6185,7,8,2014,UNK,-90,0
2346800180,3/9/2015,620000.0,5,1.0,2230,16800,1.5,0.0,3.0,4,7,1700,530,1923,0,98136,47.5161,-122.395,2730,18400,3,9,2015,UNK,-500,-1600
452001475,9/2/2014,477000.0,3,1.0,960,3600,1.0,0.0,0.0,4,7,960,0,1906,0,98117,47.6758,-122.369,1580,5000,9,2,2014,UNK,-620,-1400
952006783,10/14/2014,399500.0,2,1.5,1180,1722,2.0,0.0,0.0,3,8,1180,0,2006,0,98116,47.5626,-122.384,1490,1469,10,14,2014,N,-310,253
2013802060,9/27/2014,500000.0,2,1.0,1760,27332,1.0,1.0,4.0,4,7,1300,460,1951,0,98198,47.3799,-122.325,2590,16630,9,27,2014,UNK,-830,10702
1787600209,9/9/2014,432500.0,3,2.5,1340,8867,2.0,0.0,0.0,3,8,1340,0,1984,0,98125,47.724,-122.32700000000001,1630,7287,9,9,2014,UNK,-290,1580
9542100085,10/28/2014,940000.0,4,2.25,2800,18673,1.0,0.0,0.0,5,9,1650,1150,1965,0,98005,47.5893,-122.177,2800,15300,10,28,2014,UNK,0,3373
3025059124,8/28/2014,3170000.0,5,3.5,4330,11979,1.0,0.0,4.0,3,12,2090,2240,2008,0,98004,47.6251,-122.21799999999999,4320,12000,8,28,2014,N,10,-21
7504021490,5/12/2014,1080000.0,3,2.5,3720,11610,2.0,0.0,0.0,3,11,3720,0,1982,0,98074,47.636,-122.04899999999999,3530,11877,5,12,2014,UNK,190,-267
8651440230,8/15/2014,229999.0,4,2.0,1670,5200,1.0,0.0,0.0,4,7,1030,640,1977,0,98042,47.3652,-122.09,1500,5200,8,15,2014,UNK,170,0
1003400155,8/11/2014,233000.0,3,1.0,1100,7657,1.0,0.0,0.0,3,7,1100,0,1955,0,98188,47.4374,-122.285,1300,8000,8,11,2014,UNK,-200,-343
7852190410,6/26/2014,600000.0,3,2.5,3240,8016,2.0,0.0,0.0,3,8,2910,330,2004,0,98065,47.5382,-121.87700000000001,2990,7561,6,26,2014,N,250,455
2968801085,5/8/2015,334000.0,4,1.5,1680,7620,1.0,0.0,0.0,4,7,1180,500,1965,0,98166,47.4578,-122.351,1460,7620,5,8,2015,UNK,220,0
7771300155,7/16/2014,332500.0,3,1.0,1030,8164,1.0,0.0,0.0,4,7,1030,0,1950,0,98133,47.7353,-122.334,1340,8164,7,16,2014,UNK,-310,0
9320870040,6/26/2014,249900.0,3,2.5,1630,7700,1.0,0.0,0.0,3,7,1120,510,1978,0,98031,47.3876,-122.211,1640,8160,6,26,2014,UNK,-10,-460
623049047,10/23/2014,310000.0,3,2.0,2610,12180,1.0,0.0,0.0,3,7,1670,940,1918,0,98146,47.5063,-122.346,1520,12180,10,23,2014,UNK,1090,0
9505100035,11/5/2014,200000.0,2,1.0,1250,8520,1.0,0.0,0.0,3,6,1250,0,1928,0,98126,47.5158,-122.37799999999999,1040,8520,11,5,2014,UNK,210,0
8114000040,7/25/2014,310000.0,4,1.75,1480,11200,1.0,0.0,0.0,4,7,1480,0,1969,0,98059,47.5064,-122.141,1480,20310,7,25,2014,UNK,0,-9110
424000145,7/7/2014,230000.0,3,1.0,1390,6000,1.0,0.0,0.0,3,5,1390,0,1954,0,98056,47.4977,-122.175,1170,6000,7,7,2014,UNK,220,0
7857003953,10/20/2014,420000.0,4,2.5,1940,5414,2.0,0.0,0.0,3,8,1940,0,1997,0,98108,47.5461,-122.29899999999999,2050,6307,10,20,2014,UNK,-110,-893
3630110220,10/12/2014,785000.0,4,2.5,2960,4750,2.0,0.0,0.0,3,9,2960,0,2005,0,98029,47.5544,-121.993,2960,4750,10,12,2014,N,0,0
251500330,10/14/2014,1780000.0,3,2.25,4320,19225,1.0,0.0,0.0,4,10,2160,2160,1972,0,98004,47.6368,-122.21600000000001,3430,18469,10,14,2014,UNK,890,756
1900600040,5/7/2014,265000.0,5,1.5,1500,7112,1.0,0.0,0.0,5,6,760,740,1920,0,98166,47.4692,-122.35,1200,7112,5,7,2014,UNK,300,0
6163901383,9/23/2014,295000.0,2,1.0,840,10465,1.0,0.0,0.0,3,6,840,0,1951,0,98155,47.755,-122.31700000000001,1320,8515,9,23,2014,UNK,-480,1950
4054530210,2/18/2015,896000.0,4,2.5,3560,46644,2.0,0.0,0.0,3,11,3560,0,1992,0,98077,47.7268,-122.05,3520,50261,2,18,2015,UNK,40,-3617
5088500210,1/12/2015,415000.0,4,2.75,2390,9968,1.0,0.0,0.0,4,9,1390,1000,1989,0,98038,47.3706,-122.056,2560,12385,1,12,2015,UNK,-170,-2417
424500035,2/12/2015,250000.0,3,1.75,1200,5478,1.0,0.0,0.0,5,6,1200,0,1955,0,98056,47.4959,-122.17399999999999,1270,6855,2,12,2015,UNK,-70,-1377
6762700515,4/21/2015,1480000.0,3,2.5,2570,5000,2.0,0.0,0.0,3,11,2570,0,1984,0,98102,47.6295,-122.32,1570,5000,4,21,2015,UNK,1000,0
1562200040,4/7/2015,635000.0,5,2.25,2180,6000,1.0,0.0,0.0,4,8,1430,750,1966,0,98007,47.6235,-122.14299999999999,2160,8800,4,7,2015,UNK,20,-2800
3401700040,4/1/2015,905000.0,3,2.5,3450,48787,2.0,0.0,0.0,3,10,3450,0,1987,0,98072,47.739,-122.12899999999999,2810,41040,4,1,2015,UNK,640,7747
7202330610,7/21/2014,528000.0,3,2.5,2020,5613,2.0,0.0,0.0,3,7,2020,0,2003,0,98053,47.6835,-122.035,2020,4609,7,21,2014,UNK,0,1004
8835350230,8/25/2014,530000.0,3,2.5,2480,7480,2.0,0.0,0.0,3,9,2480,0,1992,0,98072,47.771,-122.166,2480,7480,8,25,2014,UNK,0,0
4057300180,8/7/2014,310000.0,3,1.5,1140,3104,2.0,0.0,0.0,3,7,1140,0,1988,0,98029,47.5707,-122.01799999999999,1150,2981,8,7,2014,UNK,-10,123
1023059186,1/26/2015,252000.0,3,1.0,1530,9465,1.0,0.0,0.0,4,7,1530,0,1960,0,98059,47.4915,-122.15100000000001,1530,9465,1,26,2015,UNK,0,0
6672500040,8/11/2014,334500.0,3,2.0,1700,8160,1.0,0.0,0.0,3,7,1120,580,1961,0,98133,47.74,-122.339,1740,8181,8,11,2014,UNK,-40,-21
3265300410,5/6/2015,370000.0,3,1.0,2150,8480,1.0,0.0,0.0,3,8,1610,540,1951,0,98115,47.6996,-122.30799999999999,1620,5203,5,6,2015,UNK,530,3277
7549801565,12/19/2014,311000.0,3,2.0,1190,7840,1.5,0.0,0.0,4,6,1190,0,1918,0,98108,47.5531,-122.31200000000001,1460,3240,12,19,2014,UNK,-270,4600
2114700040,4/14/2015,260000.0,3,2.75,1730,4131,2.0,0.0,2.0,3,7,1480,250,1975,0,98106,47.5327,-122.346,1570,4120,4,14,2015,UNK,160,11
3375300360,7/1/2014,217500.0,3,1.75,1400,9546,1.0,0.0,0.0,4,7,1400,0,1984,0,98003,47.3179,-122.331,1660,8550,7,1,2014,UNK,-260,996
7237301010,2/18/2015,290000.0,3,2.5,2200,4240,2.0,0.0,0.0,3,7,2200,0,2003,0,98042,47.3715,-122.12700000000001,2200,4311,2,18,2015,UNK,0,-71
1245500691,10/7/2014,500000.0,3,1.5,960,4600,1.0,0.0,0.0,3,6,960,0,1944,0,98033,47.6937,-122.213,2230,9350,10,7,2014,UNK,-1270,-4750
1604601225,4/20/2015,423500.0,3,2.0,1770,6000,1.0,0.0,3.0,3,7,1100,670,1984,0,98118,47.5644,-122.29,1300,3000,4,20,2015,UNK,470,3000
5411600180,12/24/2014,715000.0,4,2.5,2970,5722,2.0,0.0,0.0,3,9,2970,0,2005,0,98074,47.6134,-122.042,3940,4848,12,24,2014,N,-970,874
3331001115,7/28/2014,299000.0,3,2.5,1590,3121,2.0,0.0,0.0,3,7,1590,0,1994,0,98118,47.5515,-122.28399999999999,1090,4900,7,28,2014,UNK,500,-1779
11300120,6/30/2014,635000.0,3,2.5,3350,4007,2.0,0.0,0.0,3,8,2550,800,2005,0,98034,47.7277,-122.20700000000001,2340,4167,6,30,2014,N,1010,-160
8691310040,8/26/2014,806000.0,4,2.5,3370,9629,2.0,0.0,0.0,3,10,3370,0,1999,0,98075,47.5896,-121.978,3360,10335,8,26,2014,UNK,10,-706
4307350450,5/31/2014,289950.0,3,2.5,1960,3480,2.0,0.0,0.0,3,7,1960,0,2004,0,98056,47.4802,-122.18,2560,3500,5,31,2014,N,-600,-20
2460700650,10/10/2014,280000.0,3,1.75,1360,6603,1.0,0.0,0.0,4,7,1360,0,1981,0,98058,47.4619,-122.16799999999999,1770,7107,10,10,2014,UNK,-410,-504
9558050450,3/30/2015,479950.0,3,2.5,2780,6000,2.0,0.0,0.0,3,9,2780,0,2004,0,98058,47.4569,-122.118,1940,3466,3,30,2015,N,840,2534
3793500730,6/27/2014,394000.0,4,2.5,3000,9793,2.0,0.0,0.0,3,7,3000,0,2002,0,98038,47.3655,-122.02799999999999,1890,7557,6,27,2014,UNK,1110,2236
1026069061,1/29/2015,682000.0,4,2.5,3600,203425,2.0,0.0,0.0,3,9,3400,200,1979,0,98077,47.7597,-122.01799999999999,3150,202989,1,29,2015,UNK,450,436
3797002160,7/24/2014,409950.0,2,1.0,990,3000,1.0,0.0,0.0,4,6,990,0,1918,0,98103,47.6839,-122.345,1120,3000,7,24,2014,UNK,-130,0
1251200155,9/11/2014,1000000.0,4,3.5,2990,4200,2.0,0.0,4.0,5,9,2000,990,1925,0,98144,47.593,-122.289,2390,4200,9,11,2014,UNK,600,0
4319200450,1/20/2015,436000.0,4,1.0,1200,6600,1.5,0.0,2.0,3,7,1200,0,1908,0,98136,47.5372,-122.382,1810,6600,1,20,2015,UNK,-610,0
2762600035,9/9/2014,279000.0,3,1.0,1530,15975,1.0,0.0,0.0,3,7,970,560,1952,0,98168,47.4766,-122.32600000000001,1540,15975,9,9,2014,UNK,-10,0
9269200150,7/15/2014,390000.0,1,1.75,1440,4920,1.0,0.0,0.0,3,7,720,720,1923,0,98126,47.534,-122.376,1440,4920,7,15,2014,UNK,0,0
2623029003,12/16/2014,635000.0,3,1.75,1940,167125,1.0,1.0,1.0,4,7,1480,460,1955,0,98070,47.458999999999996,-122.50399999999999,1910,127195,12,16,2014,UNK,30,39930
104560120,7/18/2014,304400.0,4,2.75,2140,8100,2.0,0.0,0.0,4,7,2140,0,1990,0,98023,47.3075,-122.359,1960,7002,7,18,2014,UNK,180,1098
7266200085,3/25/2015,780000.0,5,1.75,2330,3800,1.5,0.0,0.0,3,7,1360,970,1927,0,98115,47.6835,-122.30799999999999,2100,3800,3,25,2015,UNK,230,0
2622029072,10/1/2014,520000.0,4,3.5,2734,210201,2.0,0.0,0.0,5,8,2734,0,1974,0,98070,47.3652,-122.50399999999999,2270,187308,10,1,2014,UNK,464,22893
5101406375,3/19/2015,580000.0,3,1.75,1950,10633,1.0,0.0,0.0,3,7,1250,700,1978,0,98125,47.7019,-122.31299999999999,1290,6380,3,19,2015,UNK,660,4253
2698200210,9/8/2014,274000.0,3,1.75,1440,7198,1.0,0.0,0.0,3,7,990,450,1981,0,98055,47.4333,-122.194,1550,7156,9,8,2014,UNK,-110,42
1328340120,2/9/2015,315000.0,3,2.25,1530,7906,1.0,0.0,0.0,3,7,1150,380,1980,0,98058,47.4418,-122.13600000000001,1460,7875,2,9,2015,UNK,70,31
2380000040,8/6/2014,390000.0,4,1.75,1910,77574,1.0,0.0,0.0,4,8,1910,0,1971,0,98042,47.3932,-122.12,2130,37026,8,6,2014,UNK,-220,40548
5490700085,9/11/2014,340000.0,5,2.0,1750,8220,1.0,0.0,0.0,3,7,1750,0,1956,0,98155,47.7694,-122.321,1210,6760,9,11,2014,UNK,540,1460
1226059101,7/1/2014,502000.0,3,2.25,1600,45613,2.0,0.0,0.0,4,8,1600,0,1983,0,98072,47.7523,-122.117,2320,43005,7,1,2014,UNK,-720,2608
1081200360,8/6/2014,260000.0,3,1.75,1750,11180,1.0,0.0,0.0,3,8,1750,0,1968,0,98059,47.4713,-122.117,1730,11180,8,6,2014,UNK,20,0
148000450,5/30/2014,399000.0,2,1.0,940,4800,1.0,0.0,0.0,4,6,940,0,1911,1955,98116,47.5756,-122.414,980,5900,5,30,2014,Y,-40,-1100
7831800395,5/15/2014,312500.0,2,1.0,880,6345,1.0,0.0,0.0,3,7,880,0,1919,0,98106,47.5341,-122.35799999999999,1440,6345,5,15,2014,UNK,-560,0
4024101395,5/13/2014,370000.0,3,1.75,1650,8254,1.0,0.0,0.0,5,7,1060,590,1951,0,98155,47.7596,-122.304,2280,9450,5,13,2014,UNK,-630,-1196
686550040,6/19/2014,1240000.0,4,3.5,3820,13224,2.0,0.0,0.0,3,10,3280,540,1990,0,98004,47.6005,-122.199,3340,9700,6,19,2014,UNK,480,3524
2337000150,2/20/2015,230000.0,3,1.5,1900,9630,1.0,0.0,0.0,3,8,1900,0,1967,0,98023,47.3352,-122.344,2010,9630,2,20,2015,UNK,-110,0
1068000559,10/3/2014,1280000.0,4,1.75,3720,8448,1.0,0.0,3.0,4,9,1960,1760,1947,0,98199,47.6425,-122.406,2540,7064,10,3,2014,UNK,1180,1384
7899800120,8/20/2014,294350.0,3,1.0,1410,5120,1.5,0.0,0.0,3,6,1210,200,1925,0,98106,47.5238,-122.355,1330,5120,8,20,2014,UNK,80,0
425000175,10/13/2014,208950.0,3,1.0,960,5700,1.0,0.0,0.0,4,5,960,0,1956,0,98056,47.4983,-122.17200000000001,960,5700,10,13,2014,UNK,0,0
8682262260,11/6/2014,515000.0,2,1.75,1930,5570,1.0,0.0,0.0,3,8,1930,0,2005,0,98053,47.7173,-122.03399999999999,1810,5178,11,6,2014,N,120,392
5608010650,4/8/2015,965000.0,4,2.5,3420,9575,2.0,0.0,0.0,3,11,3420,0,1994,0,98027,47.5527,-122.095,3310,8192,4,8,2015,UNK,110,1383
5350200870,3/26/2015,925000.0,4,2.75,3010,3400,2.0,0.0,2.0,3,9,2240,770,1923,2009,98122,47.6142,-122.28399999999999,1940,5080,3,26,2015,Y,1070,-1680
1279300085,3/18/2015,654500.0,4,1.0,1780,5000,1.5,0.0,0.0,3,8,1780,0,1947,0,98115,47.6761,-122.29700000000001,2030,5000,3,18,2015,UNK,-250,0
1081300450,8/14/2014,364000.0,4,2.5,2080,11050,1.0,0.0,0.0,4,8,2080,0,1969,0,98059,47.472,-122.119,1850,11050,8,14,2014,UNK,230,0
8698600395,3/24/2015,150000.0,2,1.0,1250,5208,1.0,0.0,0.0,3,7,1050,200,1951,0,98002,47.3063,-122.219,1030,5354,3,24,2015,UNK,220,-146
5381000072,5/14/2014,349950.0,5,3.0,2257,10117,1.0,0.0,0.0,3,8,1363,0,2005,0,98188,47.4524,-122.28399999999999,1540,10700,5,14,2014,N,717,-583
2877103111,8/25/2014,585000.0,3,1.5,1670,5000,1.5,0.0,0.0,4,7,1670,0,1912,0,98117,47.678000000000004,-122.36,1750,5000,8,25,2014,UNK,-80,0
2159800120,3/17/2015,801501.0,4,2.25,2250,13500,2.0,0.0,0.0,4,9,2250,0,1980,0,98007,47.621,-122.15100000000001,2730,13500,3,17,2015,UNK,-480,0
2724079061,10/10/2014,610000.0,3,1.75,1650,221720,1.0,0.0,0.0,3,7,1650,0,1992,0,98024,47.5297,-121.90100000000001,2520,221284,10,10,2014,UNK,-870,436
1843100610,5/21/2014,382000.0,5,2.25,2880,11965,2.0,0.0,0.0,4,8,2880,0,1990,0,98042,47.3734,-122.124,2370,10715,5,21,2014,UNK,510,1250
120069003,12/1/2014,495000.0,4,3.0,3620,403693,2.0,0.0,2.0,3,9,3620,0,1980,0,98022,47.2527,-121.98,2230,148811,12,1,2014,UNK,1390,254882
3226049401,11/3/2014,447500.0,3,1.75,1950,6504,1.0,0.0,0.0,3,8,1530,420,1953,0,98115,47.6934,-122.32799999999999,1660,6552,11,3,2014,UNK,290,-48
259800610,2/20/2015,575000.0,4,2.5,2280,9491,1.0,0.0,0.0,4,7,1290,990,1966,0,98008,47.6297,-122.117,1560,8050,2,20,2015,UNK,720,1441
635000145,10/7/2014,565000.0,2,1.75,1740,4736,1.5,0.0,2.0,4,7,1040,700,1907,0,98144,47.5994,-122.287,2020,4215,10,7,2014,UNK,-280,521
3764800540,5/22/2014,348580.0,3,1.0,1220,7876,1.0,0.0,0.0,3,7,1220,0,1966,0,98034,47.7317,-122.20100000000001,1340,7876,5,22,2014,UNK,-120,0
6672700120,10/16/2014,459000.0,4,1.75,2260,9703,1.0,0.0,0.0,2,8,1660,600,1978,0,98052,47.6622,-122.145,2390,8455,10,16,2014,UNK,-130,1248
2126079124,4/2/2015,375000.0,4,2.0,1790,61419,2.0,0.0,2.0,2,7,1790,0,1988,0,98019,47.7216,-121.90700000000001,1790,62290,4,2,2015,UNK,0,-871
2331550120,9/4/2014,310000.0,4,2.5,2440,7093,2.0,0.0,0.0,3,7,2440,0,1999,0,98030,47.3817,-122.204,1860,6072,9,4,2014,UNK,580,1021
2190600243,11/18/2014,210000.0,3,1.5,1400,9600,1.0,0.0,0.0,4,7,1400,0,1964,0,98003,47.2878,-122.29700000000001,2210,15000,11,18,2014,UNK,-810,-5400
7853340330,9/11/2014,384205.0,3,2.75,1810,3292,2.0,0.0,0.0,3,8,1810,0,2014,0,98065,47.5164,-121.87700000000001,1810,2769,9,11,2014,N,0,523
3185600040,5/22/2014,180000.0,2,1.0,1400,4500,1.0,0.0,0.0,3,7,900,500,1922,0,98055,47.4866,-122.219,1400,5500,5,22,2014,UNK,0,-1000
3185600040,12/24/2014,310000.0,2,1.0,1400,4500,1.0,0.0,0.0,3,7,900,500,1922,0,98055,47.4866,-122.219,1400,5500,12,24,2014,UNK,0,-1000
253600180,2/3/2015,427500.0,4,2.5,2010,6294,2.0,0.0,0.0,3,7,2010,0,2000,0,98028,47.776,-122.24,1870,4394,2,3,2015,UNK,140,1900
7011201475,5/27/2014,780000.0,3,3.0,2520,2152,1.5,0.0,0.0,3,8,1560,960,1925,2006,98119,47.6363,-122.37100000000001,1140,2152,5,27,2014,Y,1380,0
2525049266,8/21/2014,1760000.0,3,2.25,3060,16000,2.0,0.0,0.0,3,10,3060,0,1988,0,98039,47.6189,-122.23,3510,13162,8,21,2014,UNK,-450,2838
9542830540,3/3/2015,339950.0,4,2.5,2150,4000,2.0,0.0,0.0,3,7,2150,0,2010,0,98038,47.3655,-122.01799999999999,1610,4000,3,3,2015,N,540,0
8965400210,7/1/2014,820000.0,3,2.25,2880,9750,2.0,0.0,0.0,3,10,2880,0,1989,0,98006,47.5575,-122.119,2920,11090,7,1,2014,UNK,-40,-1340
8682291970,9/24/2014,398000.0,2,2.0,1300,3865,1.0,0.0,0.0,3,8,1300,0,2006,0,98053,47.7193,-122.024,1350,4199,9,24,2014,N,-50,-334
5561300540,6/2/2014,492000.0,3,1.75,2770,39927,1.0,0.0,0.0,4,8,1580,1190,1978,0,98027,47.4669,-122.00299999999999,2420,36384,6,2,2014,UNK,350,3543
2722049092,1/8/2015,240000.0,4,1.5,1780,14810,1.0,0.0,0.0,4,8,1180,600,1950,0,98032,47.3581,-122.288,1450,6728,1,8,2015,UNK,330,8082
5469502380,6/9/2014,599950.0,4,3.5,3730,15029,2.0,0.0,2.0,3,10,2440,1290,1991,0,98042,47.3804,-122.163,3440,14280,6,9,2014,UNK,290,749
2023049218,7/16/2014,105500.0,2,1.0,930,7740,1.0,0.0,0.0,1,5,930,0,1932,0,98148,47.4611,-122.324,1620,8584,7,16,2014,UNK,-690,-844
2023049218,3/16/2015,445000.0,2,1.0,930,7740,1.0,0.0,0.0,1,5,930,0,1932,0,98148,47.4611,-122.324,1620,8584,3,16,2015,UNK,-690,-844
1920079103,9/11/2014,390500.0,2,1.75,1460,426450,1.0,0.0,0.0,5,7,960,500,1966,0,98022,47.2079,-121.96700000000001,1810,17350,9,11,2014,UNK,-350,409100
7760400210,2/24/2015,255000.0,3,2.0,1310,8454,1.0,0.0,0.0,3,7,1310,0,1994,0,98042,47.3697,-122.075,1310,8454,2,24,2015,UNK,0,0
8078390150,6/26/2014,675750.0,4,2.5,2770,10274,2.0,0.0,0.0,3,9,2770,0,1989,0,98029,47.5748,-122.01799999999999,2270,7210,6,26,2014,UNK,500,3064
3528900401,7/1/2014,1640000.0,3,3.25,3140,5445,2.0,0.0,3.0,4,10,2240,900,1913,0,98109,47.6406,-122.34700000000001,2950,5250,7,1,2014,UNK,190,195
5104520720,9/30/2014,353500.0,4,2.5,1770,9239,2.0,0.0,0.0,3,7,1770,0,2004,0,98038,47.3512,-122.006,2150,5450,9,30,2014,N,-380,3789
8146100580,10/20/2014,765000.0,3,1.0,1220,7585,1.0,0.0,0.0,4,7,1220,0,1954,0,98004,47.6094,-122.194,1380,8918,10,20,2014,UNK,-160,-1333
7852020620,3/3/2015,563500.0,4,2.5,2190,4944,2.0,0.0,0.0,3,8,2190,0,1999,0,98065,47.5341,-121.866,2190,5108,3,3,2015,UNK,0,-164
5249803010,1/21/2015,439000.0,4,2.0,1800,5465,1.0,0.0,0.0,3,7,900,900,1942,0,98118,47.56100000000001,-122.272,1400,5400,1,21,2015,UNK,400,65
5459500145,6/13/2014,975000.0,5,2.75,3100,10014,1.0,0.0,2.0,4,9,1660,1440,1973,0,98040,47.5734,-122.213,3230,10279,6,13,2014,UNK,-130,-265
7853302110,4/6/2015,469900.0,3,2.5,2270,4399,2.0,0.0,0.0,3,7,2270,0,2007,0,98065,47.5415,-121.884,2060,4399,4,6,2015,N,210,0
7304300905,4/23/2015,252000.0,3,1.0,1300,8184,2.0,0.0,0.0,3,6,1300,0,1947,0,98155,47.7469,-122.319,1120,8184,4,23,2015,UNK,180,0
6119200085,6/12/2014,495000.0,3,2.0,1769,9300,1.0,0.0,0.0,4,7,1769,0,1955,2009,98166,47.441,-122.34200000000001,1870,10226,6,12,2014,Y,-101,-926
622049106,12/2/2014,570000.0,6,2.5,3370,15625,1.0,0.0,0.0,3,8,1770,1600,1964,0,98166,47.4223,-122.34299999999999,2790,15681,12,2,2014,UNK,580,-56
1624049275,8/12/2014,327000.0,4,2.5,1630,5361,2.0,0.0,0.0,3,7,1630,0,1999,0,98144,47.5704,-122.294,1920,5046,8,12,2014,UNK,-290,315
5035300871,10/14/2014,898000.0,2,2.25,2470,7658,1.0,0.0,0.0,4,8,1480,990,1954,0,98199,47.653,-122.416,2070,7270,10,14,2014,UNK,400,388
1329500120,1/9/2015,300000.0,4,2.5,2600,8572,2.0,0.0,0.0,3,8,2600,0,2003,0,98001,47.3155,-122.266,2170,5288,1,9,2015,UNK,430,3284
7504400620,4/13/2015,418500.0,3,2.0,1800,12440,1.0,0.0,0.0,3,8,1220,580,1978,0,98074,47.6254,-122.05,2460,12352,4,13,2015,UNK,-660,88
8029550180,3/25/2015,450000.0,4,2.5,2240,4616,2.0,0.0,0.0,3,7,1840,400,2001,0,98056,47.5118,-122.194,2260,5200,3,25,2015,UNK,-20,-584
5072200040,5/2/2014,403000.0,3,2.0,1960,13100,1.0,0.0,2.0,5,8,1650,310,1957,0,98166,47.4419,-122.34,1960,10518,5,2,2014,UNK,0,2582
6141100330,6/12/2014,440000.0,3,1.0,1710,6556,1.5,0.0,0.0,4,7,1200,510,1926,0,98133,47.7185,-122.354,1410,6563,6,12,2014,UNK,300,-7
7131300063,4/29/2015,350000.0,4,1.75,2140,4959,1.0,0.0,0.0,3,7,1080,1060,1965,0,98118,47.5166,-122.266,1590,5250,4,29,2015,UNK,550,-291
2807100155,5/15/2014,240000.0,3,2.0,1400,6200,1.0,0.0,0.0,3,6,700,700,1948,0,98133,47.7634,-122.34,1410,7564,5,15,2014,UNK,-10,-1364
1819800286,6/16/2014,460000.0,2,1.0,890,2100,1.0,0.0,0.0,4,6,760,130,1919,0,98107,47.65600000000001,-122.359,1600,4250,6,16,2014,UNK,-710,-2150
2663000580,9/19/2014,825000.0,4,1.0,1820,4000,2.0,0.0,0.0,3,8,1820,0,1923,0,98102,47.6259,-122.321,2050,4000,9,19,2014,UNK,-230,0
7749500970,2/26/2015,267500.0,3,2.25,1860,12000,1.0,0.0,0.0,4,7,1860,0,1976,0,98092,47.2942,-122.19,1815,9604,2,26,2015,UNK,45,2396
3599600150,9/4/2014,201000.0,3,1.0,1220,22443,1.0,0.0,0.0,4,7,1220,0,1972,0,98001,47.2633,-122.245,1260,19950,9,4,2014,UNK,-40,2493
7853310720,6/17/2014,479500.0,3,2.75,2300,4637,2.0,0.0,0.0,3,8,2300,0,2008,0,98065,47.5216,-121.87799999999999,2420,5699,6,17,2014,N,-120,-1062
4239410220,4/2/2015,210000.0,2,1.0,1520,4700,2.0,0.0,0.0,4,7,1520,0,1978,0,98092,47.3187,-122.182,1140,3906,4,2,2015,UNK,380,794
9136103027,6/8/2014,445000.0,2,1.0,1440,3225,1.0,0.0,0.0,3,7,960,480,1915,0,98103,47.6653,-122.338,1160,3630,6,8,2014,UNK,280,-405
3432501415,7/14/2014,265000.0,3,1.75,1170,8148,1.0,0.0,0.0,3,7,1170,0,1952,0,98155,47.7479,-122.318,1200,8147,7,14,2014,UNK,-30,1
3432501415,11/11/2014,399000.0,3,1.75,1170,8148,1.0,0.0,0.0,3,7,1170,0,1952,0,98155,47.7479,-122.318,1200,8147,11,11,2014,UNK,-30,1
1026069044,10/10/2014,785000.0,4,2.25,3200,53357,2.0,0.0,0.0,4,9,3200,0,1972,0,98077,47.755,-122.035,2650,54014,10,10,2014,UNK,550,-657
1152600220,6/23/2014,831500.0,5,2.5,4470,35124,2.5,0.0,0.0,3,11,4470,0,1984,0,98072,47.7377,-122.084,4050,34118,6,23,2014,UNK,420,1006
9478500770,4/3/2015,360000.0,4,2.5,2570,4557,2.0,0.0,0.0,3,7,2570,0,2009,0,98042,47.367,-122.115,2200,4500,4,3,2015,N,370,57
6388920410,4/23/2015,655000.0,3,2.5,2370,7916,2.0,0.0,0.0,3,9,2370,0,1990,0,98056,47.528,-122.171,2500,8221,4,23,2015,UNK,-130,-305
3579800180,5/4/2015,449950.0,4,1.5,1800,10150,1.5,0.0,0.0,4,7,1800,0,1958,0,98034,47.7325,-122.242,1630,10660,5,4,2015,UNK,170,-510
8860300220,4/29/2015,612000.0,5,2.5,2300,7000,1.0,0.0,0.0,3,8,1290,1010,1975,0,98052,47.6875,-122.12200000000001,2080,7280,4,29,2015,UNK,220,-280
1823069287,7/29/2014,575000.0,3,2.5,3240,33661,2.0,0.0,0.0,3,8,3240,0,2001,0,98059,47.4785,-122.095,1870,43560,7,29,2014,UNK,1370,-9899
8854000410,2/12/2015,557000.0,3,2.5,2280,18241,1.0,0.0,0.0,3,9,960,1320,1995,0,98011,47.7453,-122.213,3100,12465,2,12,2015,UNK,-820,5776
3344500183,1/28/2015,375000.0,4,1.75,1870,12500,1.0,0.0,1.0,5,6,1030,840,1943,0,98056,47.511,-122.197,2060,14141,1,28,2015,UNK,-190,-1641
2891400410,2/27/2015,369000.0,3,2.25,1820,99752,1.0,0.0,0.0,4,7,1820,0,1969,0,98092,47.2838,-122.006,1850,117612,2,27,2015,UNK,-30,-17860
7129800063,4/20/2015,330000.0,5,2.75,2390,6282,1.0,0.0,0.0,4,7,1290,1100,1966,0,98118,47.5149,-122.26299999999999,1690,5202,4,20,2015,UNK,700,1080
3179100220,4/27/2015,1030000.0,4,1.75,2110,6708,1.0,0.0,3.0,3,8,1410,700,1941,0,98105,47.67,-122.274,2140,7006,4,27,2015,UNK,-30,-298
1931300815,3/26/2015,550000.0,2,1.0,980,4800,1.0,0.0,0.0,4,7,980,0,1910,0,98103,47.6569,-122.348,1570,2640,3,26,2015,UNK,-590,2160
6163900333,11/10/2014,338000.0,3,1.75,1250,7710,1.0,0.0,0.0,4,7,1250,0,1947,0,98155,47.7623,-122.31700000000001,1340,7710,11,10,2014,UNK,-90,0
4389201075,7/31/2014,1900000.0,4,2.5,3680,13351,2.0,0.0,2.0,5,9,3680,0,1946,1982,98004,47.6154,-122.214,3410,11700,7,31,2014,Y,270,1651
2122700120,8/20/2014,235000.0,3,1.0,2230,8163,1.0,0.0,0.0,3,7,1230,1000,1966,0,98118,47.5215,-122.275,2380,6874,8,20,2014,UNK,-150,1289
2291401115,11/25/2014,349950.0,1,1.0,1230,9300,1.5,0.0,0.0,4,6,1230,0,1918,0,98133,47.7055,-122.348,1190,6820,11,25,2014,UNK,40,2480
7229100040,7/29/2014,300000.0,5,2.5,2093,10350,1.5,0.0,0.0,5,7,2093,0,1963,0,98058,47.4495,-122.17,1520,10350,7,29,2014,UNK,573,0
3204800040,11/3/2014,431000.0,3,1.75,1660,12865,1.0,0.0,0.0,5,7,1660,0,1967,0,98056,47.5375,-122.175,1610,12400,11,3,2014,UNK,50,465
8092700220,4/11/2015,280000.0,5,2.5,1630,20750,1.0,0.0,0.0,4,7,1100,530,1975,0,98042,47.3657,-122.113,1630,8640,4,11,2015,UNK,0,12110
7503800210,3/26/2015,295000.0,4,2.5,1677,7209,2.0,0.0,0.0,3,7,1677,0,2011,0,98023,47.2957,-122.35700000000001,2236,7209,3,26,2015,N,-559,0
2781250150,4/23/2015,445000.0,4,2.5,2990,6383,2.0,0.0,0.0,3,7,2990,0,2003,0,98038,47.3499,-122.027,2640,6454,4,23,2015,UNK,350,-71
2024089011,8/26/2014,550000.0,5,1.0,2150,262231,1.5,0.0,0.0,3,7,2150,0,1900,0,98065,47.5519,-121.803,1460,46609,8,26,2014,UNK,690,215622
2427910040,8/26/2014,515000.0,4,2.5,2890,15067,2.0,0.0,0.0,3,9,2890,0,2003,0,98024,47.5666,-121.90700000000001,3090,15398,8,26,2014,UNK,-200,-331
3123059107,5/20/2014,555000.0,3,2.5,3050,158558,1.0,0.0,0.0,4,9,3050,0,1987,0,98055,47.4326,-122.208,2960,31050,5,20,2014,UNK,90,127508
7211400506,9/8/2014,265000.0,3,2.5,1410,2500,2.0,0.0,0.0,3,7,1410,0,2006,0,98146,47.5132,-122.35799999999999,1290,5190,9,8,2014,N,120,-2690
8129700085,9/24/2014,597000.0,4,2.5,2280,2432,2.0,0.0,0.0,5,8,1520,760,1921,0,98103,47.6605,-122.355,1690,2099,9,24,2014,UNK,590,333
3271301175,8/15/2014,661000.0,2,1.0,1260,5800,1.0,0.0,0.0,4,7,1260,0,1939,0,98199,47.6501,-122.40899999999999,1830,5800,8,15,2014,UNK,-570,0
7203101970,7/15/2014,362764.0,3,2.0,1460,4350,2.0,0.0,0.0,3,7,1460,0,2008,0,98053,47.69600000000001,-122.02600000000001,1740,4622,7,15,2014,N,-280,-272
1787600146,8/21/2014,427000.0,4,2.5,1600,14000,1.0,0.0,0.0,3,8,1310,290,1950,0,98125,47.7258,-122.32600000000001,1600,10200,8,21,2014,UNK,0,3800
5255200220,12/5/2014,405000.0,3,1.75,2020,8531,1.0,0.0,0.0,3,7,2020,0,1965,0,98011,47.7691,-122.199,1950,8449,12,5,2014,UNK,70,82
937000330,12/24/2014,157000.0,3,1.5,1170,11530,1.0,0.0,0.0,3,7,1170,0,1960,0,98198,47.4211,-122.29,1550,8605,12,24,2014,UNK,-380,2925
937000330,3/19/2015,246500.0,3,1.5,1170,11530,1.0,0.0,0.0,3,7,1170,0,1960,0,98198,47.4211,-122.29,1550,8605,3,19,2015,UNK,-380,2925
6817800730,1/8/2015,386500.0,2,1.5,1280,11071,1.0,0.0,0.0,3,7,850,430,1984,0,98074,47.6351,-122.03299999999999,1280,10879,1,8,2015,UNK,0,192
1898900040,6/6/2014,300000.0,4,2.5,2680,15508,2.0,0.0,0.0,3,8,2680,0,1999,0,98023,47.3025,-122.39,1960,15586,6,6,2014,UNK,720,-78
9264901510,11/7/2014,240000.0,3,1.75,1770,8571,1.0,0.0,0.0,3,8,1270,500,1978,0,98023,47.3109,-122.339,2120,7711,11,7,2014,UNK,-350,860
3343301490,9/9/2014,818500.0,5,3.5,4790,12957,2.0,0.0,1.0,3,9,3110,1680,2005,0,98006,47.5469,-122.194,2620,13538,9,9,2014,N,2170,-581
1645000097,8/9/2014,249000.0,3,1.75,1300,8500,1.0,0.0,0.0,4,7,1300,0,1964,0,98022,47.208999999999996,-122.005,1410,7800,8,9,2014,UNK,-110,700
2923501020,9/29/2014,580000.0,4,2.25,2610,7700,1.0,0.0,0.0,3,8,1700,910,1977,0,98027,47.5659,-122.089,2260,8266,9,29,2014,UNK,350,-566
4139900180,4/20/2015,2340000.0,4,2.5,4500,35200,1.0,0.0,0.0,3,13,4500,0,1988,0,98006,47.5477,-122.126,4760,35200,4,20,2015,UNK,-260,0
2621760360,9/26/2014,333000.0,4,2.5,2100,7366,2.0,0.0,0.0,3,8,2100,0,1997,0,98042,47.3703,-122.10700000000001,2060,7324,9,26,2014,UNK,40,42
5702380730,8/23/2014,230000.0,2,2.0,1340,7605,1.0,0.0,0.0,3,7,1340,0,1992,0,98022,47.1936,-121.98100000000001,1670,7136,8,23,2014,UNK,-330,469
1604601855,2/13/2015,360500.0,3,1.0,970,6180,1.0,0.0,3.0,3,6,970,0,1974,0,98118,47.5658,-122.291,1120,4500,2,13,2015,UNK,-150,1680
6777800150,7/22/2014,265000.0,3,1.75,2200,7200,1.0,0.0,0.0,3,8,1270,930,1962,0,98032,47.3745,-122.27600000000001,1800,8000,7,22,2014,UNK,400,-800
1563103040,10/25/2014,490000.0,2,1.0,990,5000,1.0,0.0,0.0,3,7,990,0,1941,0,98116,47.5666,-122.40299999999999,2250,6032,10,25,2014,UNK,-1260,-1032
7550800736,5/6/2015,600000.0,2,1.75,1180,5000,1.0,0.0,0.0,2,7,880,300,1925,0,98107,47.6749,-122.398,1470,5000,5,6,2015,UNK,-290,0
1138000410,9/15/2014,307500.0,3,1.0,980,6530,1.0,0.0,0.0,3,7,980,0,1969,0,98034,47.7133,-122.213,1220,6723,9,15,2014,UNK,-240,-193
7555220150,12/17/2014,670000.0,4,2.25,2370,9636,1.0,0.0,0.0,3,8,1660,710,1976,0,98033,47.6497,-122.194,2350,9588,12,17,2014,UNK,20,48
3021059197,10/21/2014,247200.0,3,1.5,1910,10583,1.5,0.0,0.0,4,7,1910,0,1922,1967,98002,47.2782,-122.212,1770,9068,10,21,2014,Y,140,1515
2923500230,12/16/2014,2600000.0,4,4.5,5270,12195,2.0,1.0,4.0,3,11,3400,1870,1979,0,98027,47.5696,-122.09,3390,9905,12,16,2014,UNK,1880,2290
4039500610,8/20/2014,440000.0,3,1.75,1430,8400,1.0,0.0,0.0,4,7,1430,0,1961,0,98008,47.6073,-122.12700000000001,1570,7800,8,20,2014,UNK,-140,600
3904910610,5/6/2015,700000.0,4,2.5,2490,7694,2.0,0.0,0.0,3,8,2490,0,1987,0,98029,47.567,-122.016,2140,8126,5,6,2015,UNK,350,-432
2489200230,3/11/2015,756100.0,4,2.0,2000,8317,1.5,0.0,0.0,4,8,2000,0,1917,0,98126,47.5394,-122.37899999999999,1390,6001,3,11,2015,UNK,610,2316
2600100180,10/20/2014,555000.0,4,2.75,2600,19275,1.0,0.0,0.0,3,8,1620,980,1978,0,98006,47.5523,-122.162,2230,10119,10,20,2014,UNK,370,9156
6909200355,4/24/2015,830000.0,5,3.5,2880,3750,2.0,0.0,2.0,3,8,2270,610,2001,0,98144,47.5905,-122.292,2060,4000,4,24,2015,UNK,820,-250
7575500040,12/12/2014,180000.0,3,1.0,1010,8863,1.0,0.0,0.0,4,6,1010,0,1990,0,98022,47.1955,-121.999,1090,8410,12,12,2014,UNK,-80,453
6192400180,10/6/2014,775000.0,5,3.5,3290,5600,2.0,0.0,0.0,3,9,2670,620,2004,0,98052,47.7056,-122.119,3130,5600,10,6,2014,N,160,0
5125400385,8/5/2014,220000.0,4,1.75,1530,18400,1.5,0.0,0.0,4,6,1530,0,1938,0,98002,47.32899999999999,-122.219,1620,13535,8,5,2014,UNK,-90,4865
7811100230,7/24/2014,650000.0,4,2.75,2020,15810,1.0,0.0,0.0,4,9,1620,400,1967,0,98005,47.5921,-122.155,2210,10160,7,24,2014,UNK,-190,5650
6608500220,12/24/2014,410000.0,3,1.75,1340,9975,1.0,0.0,0.0,4,7,1340,0,1961,0,98033,47.7012,-122.169,1340,10050,12,24,2014,UNK,0,-75
705730180,10/21/2014,339995.0,4,2.5,2180,5367,2.0,0.0,0.0,3,7,2180,0,2000,0,98038,47.3775,-122.022,2180,5130,10,21,2014,UNK,0,237
4039700870,2/19/2015,1160000.0,5,1.75,2870,9680,1.0,0.0,4.0,5,9,1440,1430,1966,0,98008,47.6122,-122.111,2940,9729,2,19,2015,UNK,-70,-49
238000201,7/23/2014,440000.0,3,2.75,2070,9697,2.0,0.0,0.0,4,7,1330,740,1929,0,98188,47.4327,-122.28299999999999,2000,14436,7,23,2014,UNK,70,-4739
4365700330,7/30/2014,275000.0,2,1.75,930,7080,1.0,0.0,0.0,3,6,930,0,1923,2006,98106,47.5224,-122.36,1100,7680,7,30,2014,Y,-170,-600
4249000230,8/29/2014,766000.0,3,2.5,2270,9822,2.0,0.0,0.0,3,9,2270,0,1988,0,98052,47.6685,-122.137,2790,8089,8,29,2014,UNK,-520,1733
1099750610,7/10/2014,231500.0,3,2.25,1630,7900,1.0,0.0,0.0,4,7,1130,500,1973,0,98023,47.3076,-122.37700000000001,1630,8200,7,10,2014,UNK,0,-300
3123089010,12/29/2014,472000.0,3,2.0,2770,89298,2.0,0.0,0.0,3,9,2770,0,2004,0,98045,47.4291,-121.84200000000001,2040,109771,12,29,2014,N,730,-20473
9578050120,8/8/2014,1330000.0,4,2.5,4010,37076,2.0,0.0,0.0,4,12,4010,0,1990,0,98052,47.7139,-122.10600000000001,4280,35326,8,8,2014,UNK,-270,1750
1423049029,3/6/2015,265000.0,4,1.75,1970,8390,1.0,0.0,0.0,3,7,1140,830,1955,0,98178,47.4861,-122.251,1710,10890,3,6,2015,UNK,260,-2500
1703900155,11/13/2014,325000.0,2,1.0,790,6000,1.0,0.0,0.0,3,7,790,0,1948,0,98118,47.5543,-122.273,960,6000,11,13,2014,UNK,-170,0
1397300120,7/29/2014,364500.0,3,1.75,1740,8424,1.0,0.0,0.0,5,7,1040,700,1954,0,98133,47.7508,-122.352,1370,8424,7,29,2014,UNK,370,0
7304301085,1/29/2015,322500.0,2,1.0,1130,8184,1.0,0.0,0.0,3,6,1130,0,1947,0,98155,47.7473,-122.32,1010,8184,1,29,2015,UNK,120,0
603001020,4/16/2015,338900.0,3,1.75,1180,4000,1.0,0.0,0.0,3,7,1040,140,1929,0,98118,47.5226,-122.28399999999999,1430,4000,4,16,2015,UNK,-250,0
5332200530,6/13/2014,910000.0,5,2.5,2350,4000,2.0,0.0,0.0,3,9,2350,0,1993,0,98112,47.6265,-122.296,1840,4000,6,13,2014,UNK,510,0
5332200530,4/24/2015,1020000.0,5,2.5,2350,4000,2.0,0.0,0.0,3,9,2350,0,1993,0,98112,47.6265,-122.296,1840,4000,4,24,2015,UNK,510,0
4475800065,6/13/2014,459950.0,3,1.75,1850,6869,1.0,0.0,2.0,5,6,1100,750,1919,1934,98166,47.4648,-122.363,1850,10096,6,13,2014,Y,0,-3227
4305500180,10/14/2014,584950.0,4,3.0,3220,6224,1.5,0.0,0.0,3,9,3220,0,2009,0,98059,47.4813,-122.12899999999999,2950,6224,10,14,2014,N,270,0
9269750220,12/23/2014,252000.0,3,1.75,2050,11313,1.0,0.0,0.0,3,7,1520,530,1987,0,98023,47.2837,-122.35799999999999,1620,8065,12,23,2014,UNK,430,3248
6802210330,4/29/2015,270000.0,3,2.5,1430,8470,1.0,0.0,0.0,3,7,1190,240,1992,0,98022,47.1943,-121.991,1670,8418,4,29,2015,UNK,-240,52
98020220,10/30/2014,750000.0,4,2.5,3210,8938,2.0,0.0,0.0,3,10,3210,0,2005,0,98075,47.582,-121.971,3740,8108,10,30,2014,N,-530,830
6837700175,12/1/2014,775000.0,3,1.75,3520,12350,1.0,0.0,4.0,4,8,1530,1990,1960,0,98116,47.5837,-122.382,2140,7800,12,1,2014,UNK,1380,4550
1895450230,2/18/2015,325000.0,3,2.5,2260,8120,2.0,0.0,0.0,3,8,2260,0,2004,0,98023,47.2924,-122.35700000000001,2250,7784,2,18,2015,N,10,336
1853080180,10/26/2014,810000.0,5,3.25,3290,6422,2.0,0.0,0.0,3,9,3290,0,2012,0,98074,47.5933,-122.061,3210,6891,10,26,2014,N,80,-469
3582750120,7/15/2014,409000.0,2,2.25,1640,2128,2.0,0.0,0.0,4,8,1640,0,1974,0,98028,47.753,-122.25200000000001,1640,2128,7,15,2014,UNK,0,0
3319500385,6/16/2014,400000.0,4,1.75,1580,5340,1.0,0.0,0.0,3,7,1130,450,1947,0,98144,47.6003,-122.306,830,980,6,16,2014,UNK,750,4360
2783100230,5/12/2015,530000.0,4,2.25,1940,8270,2.0,0.0,0.0,5,7,1940,0,1962,0,98133,47.7567,-122.333,1800,7743,5,12,2015,UNK,140,527
1238501098,3/13/2015,580000.0,3,2.25,1580,8506,2.0,0.0,0.0,3,7,1580,0,1987,0,98033,47.68600000000001,-122.185,2253,8515,3,13,2015,UNK,-673,-9
8562900180,5/9/2014,491300.0,3,1.75,1750,11340,1.0,0.0,1.0,4,7,1300,450,1987,0,98074,47.6099,-122.05799999999999,2310,11340,5,9,2014,UNK,-560,0
7140200450,12/31/2014,272000.0,4,2.75,1810,7350,1.0,0.0,0.0,4,7,1200,610,1980,0,98030,47.3703,-122.171,1750,7350,12,31,2014,UNK,60,0
220069106,4/1/2015,599950.0,3,2.5,1970,106722,1.0,0.0,4.0,3,9,1970,0,1985,0,98022,47.2498,-122.00299999999999,2910,101494,4,1,2015,UNK,-940,5228
3905040040,2/26/2015,464000.0,3,2.5,1770,5146,2.0,0.0,0.0,3,8,1770,0,1992,0,98029,47.5704,-121.999,1870,5146,2,26,2015,UNK,-100,0
3797000330,6/23/2014,471001.0,3,1.75,1800,6000,1.0,0.0,0.0,5,7,900,900,1905,0,98103,47.6867,-122.34899999999999,1800,3000,6,23,2014,UNK,0,3000
6669150530,11/17/2014,230000.0,3,1.5,1500,11616,1.0,0.0,0.0,3,7,1100,400,1980,0,98031,47.4062,-122.17399999999999,1830,8288,11,17,2014,UNK,-330,3328
3298200620,7/14/2014,358000.0,3,1.0,940,6695,1.0,0.0,0.0,4,6,940,0,1959,0,98008,47.6195,-122.12,1230,7400,7,14,2014,UNK,-290,-705
8024202170,8/20/2014,510000.0,3,2.25,2340,6183,1.0,0.0,0.0,3,7,1210,1130,1929,0,98115,47.6979,-122.31,1970,6183,8,20,2014,UNK,370,0
1788900230,7/22/2014,86500.0,3,1.0,840,9480,1.0,0.0,0.0,3,6,840,0,1960,0,98023,47.3277,-122.34100000000001,840,9420,7,22,2014,UNK,0,60
1788900230,4/3/2015,199950.0,3,1.0,840,9480,1.0,0.0,0.0,3,6,840,0,1960,0,98023,47.3277,-122.34100000000001,840,9420,4,3,2015,UNK,0,60
3220200040,6/16/2014,1710000.0,3,3.25,2940,5432,3.0,0.0,3.0,4,10,2440,500,1978,0,98109,47.6299,-122.354,4400,5500,6,16,2014,UNK,-1460,-68
7645900355,3/13/2015,850000.0,3,2.75,3180,3680,2.0,0.0,0.0,4,9,2190,990,1918,0,98126,47.577,-122.38,2000,3680,3,13,2015,UNK,1180,0
458000065,9/23/2014,542000.0,4,2.5,2020,3440,1.5,0.0,0.0,4,7,1480,540,1928,0,98117,47.6885,-122.376,1520,5080,9,23,2014,UNK,500,-1640
123039604,7/1/2014,102500.0,2,1.0,820,4320,1.0,0.0,0.0,3,5,820,0,1937,0,98106,47.513999999999996,-122.359,780,7424,7,1,2014,UNK,40,-3104
1223089077,4/1/2015,718000.0,3,1.75,4060,136290,1.0,0.0,0.0,3,8,2810,1250,1995,0,98045,47.4843,-121.719,1300,51836,4,1,2015,UNK,2760,84454
4039800180,12/22/2014,625000.0,4,2.25,2660,22194,1.0,0.0,0.0,4,8,2180,480,1977,0,98008,47.6142,-122.10700000000001,2660,18135,12,22,2014,UNK,0,4059
7304301005,5/23/2014,350000.0,3,1.0,1010,11244,1.0,0.0,0.0,4,7,1010,0,1947,0,98155,47.7467,-122.321,1220,11242,5,23,2014,UNK,-210,2
7899800915,2/9/2015,216000.0,2,1.0,710,5120,1.0,0.0,0.0,3,6,710,0,1918,0,98106,47.5224,-122.35700000000001,1150,1252,2,9,2015,UNK,-440,3868
164000271,9/5/2014,340000.0,3,1.0,980,7228,1.5,0.0,0.0,3,7,980,0,1946,0,98133,47.7294,-122.353,1070,7228,9,5,2014,UNK,-90,0
7010700976,11/14/2014,505000.0,3,1.0,1100,5400,1.5,0.0,0.0,3,7,1100,0,1908,0,98199,47.6604,-122.396,1770,4400,11,14,2014,UNK,-670,1000
6699300330,5/13/2015,372000.0,5,2.5,2840,6010,2.0,0.0,0.0,3,8,2840,0,2003,0,98001,47.3161,-122.27,2740,5509,5,13,2015,UNK,100,501
8732020770,9/4/2014,263850.0,4,2.25,2300,7524,2.0,0.0,0.0,4,8,2300,0,1978,0,98023,47.313,-122.38799999999999,2270,8025,9,4,2014,UNK,30,-501
1795800040,9/3/2014,1350000.0,4,3.25,5370,20388,2.0,0.0,4.0,4,11,5370,0,1990,0,98198,47.405,-122.331,2770,22270,9,3,2014,UNK,2600,-1882
5104450720,11/19/2014,325000.0,4,2.5,2280,9899,2.0,0.0,0.0,3,8,2280,0,1987,0,98058,47.46100000000001,-122.148,1970,9451,11,19,2014,UNK,310,448
2113200065,10/27/2014,289000.0,2,1.0,1010,7740,1.0,0.0,0.0,3,6,890,120,1924,0,98106,47.5323,-122.355,1030,6000,10,27,2014,UNK,-20,1740
4027700799,2/26/2015,364000.0,3,2.25,1420,6600,1.0,0.0,0.0,3,7,1160,260,1987,0,98028,47.77,-122.265,1920,7902,2,26,2015,UNK,-500,-1302
3902310210,8/22/2014,610000.0,4,2.5,2100,8800,1.0,0.0,0.0,5,8,1250,850,1980,0,98033,47.6909,-122.186,2100,9000,8,22,2014,UNK,0,-200
9283800230,6/25/2014,531500.0,4,2.75,3110,49765,1.0,0.0,0.0,4,8,3110,0,1958,1972,98010,47.3343,-122.044,1880,19709,6,25,2014,Y,1230,30056
114100234,4/30/2015,402500.0,3,2.25,2160,9540,2.0,0.0,0.0,3,8,2160,0,1979,0,98028,47.7668,-122.243,1720,12593,4,30,2015,UNK,440,-3053
7625703065,6/4/2014,375000.0,2,1.0,820,6250,1.0,0.0,0.0,4,5,820,0,1922,0,98136,47.5479,-122.384,1300,6250,6,4,2014,UNK,-480,0
427000065,1/26/2015,537500.0,5,2.5,4340,9108,1.0,0.0,0.0,5,8,2170,2170,1979,0,98118,47.5384,-122.27600000000001,2030,6812,1,26,2015,UNK,2310,2296
7844200040,7/31/2014,375000.0,3,1.75,2100,9066,1.0,0.0,0.0,3,8,1440,660,1962,0,98188,47.4294,-122.292,2000,9132,7,31,2014,UNK,100,-66
9315300230,8/20/2014,293550.0,4,1.75,1250,8840,1.0,0.0,0.0,4,7,910,340,1979,0,98198,47.4138,-122.31700000000001,1410,8378,8,20,2014,UNK,-160,462
1774200230,1/20/2015,585000.0,6,3.0,3870,43787,2.0,0.0,0.0,3,8,2700,1170,1976,0,98077,47.7642,-122.098,2600,35381,1,20,2015,UNK,1270,8406
2781250530,8/12/2014,225000.0,2,2.5,1360,2693,2.0,0.0,0.0,3,6,1360,0,2003,0,98038,47.3492,-122.025,1360,2693,8,12,2014,UNK,0,0
7796600085,1/8/2015,185000.0,4,1.0,1400,8684,1.5,0.0,0.0,3,7,1400,0,1957,0,98146,47.4887,-122.344,1520,8712,1,8,2015,UNK,-120,-28
3205400150,6/17/2014,402000.0,3,1.5,1450,7375,1.0,0.0,0.0,3,7,1010,440,1968,0,98034,47.7212,-122.179,1350,7440,6,17,2014,UNK,100,-65
2207200455,4/9/2015,585000.0,5,1.75,1880,16617,1.0,0.0,0.0,3,7,960,920,1963,0,98007,47.6003,-122.132,1720,8400,4,9,2015,UNK,160,8217
9523100458,6/17/2014,549000.0,2,2.5,1380,953,3.0,0.0,0.0,3,9,1380,0,2006,0,98103,47.6654,-122.355,1430,3400,6,17,2014,N,-50,-2447
5035300325,4/14/2015,1810000.0,3,2.25,2910,15626,1.5,0.0,0.0,4,9,2510,400,1923,0,98199,47.6534,-122.412,2370,6519,4,14,2015,UNK,540,9107
3840700593,4/6/2015,345000.0,3,1.75,1380,10529,1.0,0.0,0.0,3,7,1380,0,1967,0,98034,47.7119,-122.23299999999999,1670,5694,4,6,2015,UNK,-290,4835
1683800120,11/17/2014,302500.0,3,2.25,3100,11985,1.0,0.0,0.0,4,7,1790,1310,1963,0,98198,47.3825,-122.31,1770,7954,11,17,2014,UNK,1330,4031
2722059183,10/14/2014,218500.0,4,1.75,1400,25500,1.0,0.0,0.0,4,7,1400,0,1964,0,98042,47.36,-122.164,2170,25500,10,14,2014,UNK,-770,0
4083305870,10/1/2014,705000.0,2,2.0,1650,6840,1.5,0.0,0.0,5,7,1650,0,1916,0,98103,47.6512,-122.338,1700,4560,10,1,2014,UNK,-50,2280
8651400730,4/28/2015,191000.0,3,1.0,840,5525,1.0,0.0,0.0,5,6,840,0,1969,0,98042,47.3607,-122.085,920,5330,4,28,2015,UNK,-80,195
7302000120,6/10/2014,695000.0,3,2.5,2550,45254,2.0,0.0,0.0,3,9,2550,0,2001,0,98053,47.6498,-121.964,2190,49222,6,10,2014,UNK,360,-3968
797000258,4/2/2015,350000.0,2,2.75,2820,11770,2.0,0.0,0.0,3,7,1630,1190,1947,0,98168,47.5102,-122.324,1690,12500,4,2,2015,UNK,1130,-730
9100000040,8/7/2014,480000.0,3,1.75,1710,4080,1.0,0.0,0.0,4,7,1130,580,1979,0,98136,47.5563,-122.39200000000001,1200,4080,8,7,2014,UNK,510,0
8651441520,3/2/2015,220000.0,3,1.0,820,5200,1.0,0.0,0.0,4,6,820,0,1977,0,98042,47.363,-122.094,1120,5200,3,2,2015,UNK,-300,0
6843310120,10/29/2014,535000.0,4,2.25,2620,33578,2.0,0.0,0.0,3,7,2620,0,1977,0,98075,47.5921,-122.01299999999999,2520,35160,10,29,2014,UNK,100,-1582
3585900150,5/19/2014,1000000.0,2,1.75,2430,23400,1.0,0.0,4.0,3,10,2430,0,1951,0,98177,47.7616,-122.37200000000001,3150,23600,5,19,2014,UNK,-720,-200
9144100206,11/25/2014,592000.0,3,1.75,1560,7424,1.0,0.0,0.0,5,8,1560,0,1940,0,98117,47.6981,-122.374,1370,7424,11,25,2014,UNK,190,0
2871000360,11/24/2014,775000.0,4,2.5,3060,6826,2.0,0.0,0.0,3,9,3060,0,2004,0,98052,47.7006,-122.11200000000001,3110,6932,11,24,2014,N,-50,-106
4307330120,9/17/2014,320000.0,3,2.5,1680,4584,2.0,0.0,0.0,3,7,1680,0,2003,0,98056,47.4794,-122.182,2160,4621,9,17,2014,UNK,-480,-37
6117900120,3/17/2015,760000.0,3,3.25,3320,15022,2.0,0.0,0.0,3,10,3320,0,1989,0,98166,47.428999999999995,-122.34100000000001,3430,15018,3,17,2015,UNK,-110,4
1939120540,7/22/2014,640000.0,3,2.5,2390,8315,2.0,0.0,0.0,4,9,2390,0,1990,0,98074,47.6271,-122.02799999999999,2370,7816,7,22,2014,UNK,20,499
421000455,5/2/2015,253200.0,3,1.0,1360,5840,1.0,0.0,0.0,4,5,1360,0,1953,0,98056,47.4945,-122.166,1250,6708,5,2,2015,UNK,110,-868
6600790210,7/16/2014,228000.0,2,1.0,1800,9236,1.0,0.0,0.0,3,7,1800,0,1954,0,98030,47.3792,-122.198,1730,5701,7,16,2014,UNK,70,3535
1771000540,11/4/2014,325000.0,3,1.0,1160,9525,1.0,0.0,0.0,4,7,1160,0,1968,0,98077,47.7431,-122.073,1160,10640,11,4,2014,UNK,0,-1115
5561300730,6/5/2014,530000.0,4,3.25,4160,35654,2.0,0.0,0.0,3,8,2760,1400,1973,0,98027,47.4683,-122.008,2500,35675,6,5,2014,UNK,1660,-21
9542830210,2/11/2015,300000.0,4,2.25,1660,3200,2.0,0.0,0.0,3,7,1660,0,2011,0,98038,47.3666,-122.01899999999999,1960,3558,2,11,2015,N,-300,-358
263000155,5/5/2014,418000.0,3,2.0,1410,6030,1.5,0.0,0.0,4,7,1410,0,1930,0,98103,47.6994,-122.34700000000001,1410,6300,5,5,2014,UNK,0,-270
4058801575,12/17/2014,415000.0,4,1.75,2230,9625,1.0,0.0,4.0,3,8,1180,1050,1955,0,98178,47.508,-122.244,2300,8211,12,17,2014,UNK,-70,1414
7852150120,5/20/2014,384000.0,3,2.5,1700,4000,2.0,0.0,0.0,3,7,1700,0,2003,0,98065,47.5327,-121.87100000000001,1700,4417,5,20,2014,UNK,0,-417
2095500040,6/13/2014,325000.0,3,2.5,2070,8337,2.0,0.0,0.0,3,8,2070,0,1997,0,98030,47.3658,-122.176,2030,7248,6,13,2014,UNK,40,1089
8832900120,12/22/2014,600000.0,3,1.75,2300,12682,1.0,0.0,2.0,3,8,2300,0,1955,0,98028,47.7588,-122.27,2720,14643,12,22,2014,UNK,-420,-1961
9542850580,10/10/2014,760000.0,4,2.25,3040,9690,1.0,0.0,0.0,4,9,1940,1100,1978,0,98005,47.5923,-122.169,2430,9690,10,10,2014,UNK,610,0
3530430155,5/30/2014,168000.0,2,1.5,1220,3568,1.5,0.0,0.0,4,8,1220,0,1976,0,98198,47.3804,-122.318,1180,3678,5,30,2014,UNK,40,-110
2225039081,10/20/2014,405000.0,3,1.0,960,3960,1.0,0.0,0.0,3,7,960,0,1943,0,98199,47.6465,-122.404,1550,6050,10,20,2014,UNK,-590,-2090
7923300230,5/4/2015,479000.0,3,1.0,1480,10094,1.0,0.0,0.0,4,7,1480,0,1956,0,98007,47.5942,-122.13600000000001,1430,10083,5,4,2015,UNK,50,11
8021701115,8/26/2014,549000.0,3,2.0,1560,5130,1.0,0.0,0.0,5,7,1150,410,1915,0,98103,47.6913,-122.333,1560,4500,8,26,2014,UNK,0,630
5515600087,12/9/2014,215000.0,3,1.5,1100,33600,1.0,0.0,0.0,3,7,1100,0,1967,0,98001,47.3185,-122.29,1570,32700,12,9,2014,UNK,-470,900
952006680,1/29/2015,550000.0,2,1.5,900,5750,1.0,0.0,2.0,3,7,900,0,1940,0,98116,47.5623,-122.384,1300,1413,1,29,2015,UNK,-400,4337
6411600043,7/2/2014,389000.0,4,1.75,2400,7700,1.5,0.0,0.0,4,7,1500,900,1927,0,98133,47.7125,-122.33200000000001,1530,7700,7,2,2014,UNK,870,0
1523089266,7/22/2014,447500.0,3,2.5,2320,15024,2.0,0.0,0.0,3,8,2320,0,1990,0,98045,47.4829,-121.766,2300,15145,7,22,2014,UNK,20,-121
866400040,10/13/2014,540000.0,5,3.0,2570,5590,1.0,0.0,0.0,3,8,1580,0,2009,0,98034,47.7271,-122.228,2020,10500,10,13,2014,N,550,-4910
8092500150,4/28/2015,273500.0,4,2.75,1300,9638,1.0,0.0,0.0,2,7,1300,0,1983,0,98042,47.3683,-122.109,1670,9638,4,28,2015,UNK,-370,0
5637200450,10/17/2014,257000.0,5,2.75,2930,10148,2.0,0.0,0.0,3,9,2930,0,2002,0,98059,47.4887,-122.145,2930,8425,10,17,2014,UNK,0,1723
5126400230,5/24/2014,199000.0,2,1.0,720,7200,1.0,0.0,0.0,5,6,720,0,1943,0,98058,47.4763,-122.177,970,8027,5,24,2014,UNK,-250,-827
7137950720,3/4/2015,339100.0,4,2.5,2350,10655,2.0,0.0,0.0,3,8,2350,0,1992,0,98092,47.3284,-122.171,2210,7028,3,4,2015,UNK,140,3627
1473120230,12/23/2014,435000.0,4,2.5,2940,7590,2.0,0.0,0.0,3,9,2940,0,1991,0,98058,47.4341,-122.16,2550,8360,12,23,2014,UNK,390,-770
1604600085,7/11/2014,400000.0,3,2.5,2020,3000,1.0,0.0,0.0,4,6,1010,1010,1910,0,98118,47.5621,-122.291,1670,3000,7,11,2014,UNK,350,0
123079023,11/24/2014,356000.0,2,1.0,1430,365904,1.0,0.0,0.0,3,7,1010,420,1991,0,98065,47.51300000000001,-121.85700000000001,2300,253519,11,24,2014,UNK,-870,112385
705000120,4/6/2015,395000.0,3,1.0,950,6951,1.0,0.0,0.0,4,7,950,0,1950,0,98125,47.7263,-122.3,1410,7200,4,6,2015,UNK,-460,-249
1930300410,3/4/2015,575000.0,2,1.0,1250,4320,1.0,0.0,0.0,4,7,850,400,1911,0,98103,47.6549,-122.352,1520,4320,3,4,2015,UNK,-270,0
9393700065,4/23/2015,515000.0,3,1.75,1300,5120,1.5,0.0,0.0,4,6,1300,0,1925,0,98116,47.5589,-122.39399999999999,1090,5124,4,23,2015,UNK,210,-4
6814600355,6/19/2014,618250.0,4,3.25,2520,3360,1.5,0.0,0.0,4,8,1550,970,1931,0,98115,47.6801,-122.315,1730,3360,6,19,2014,UNK,790,0
9477100620,2/19/2015,245000.0,3,1.5,1330,7125,2.0,0.0,0.0,3,7,1330,0,1968,0,98034,47.7308,-122.194,1570,7350,2,19,2015,UNK,-240,-225
6788203060,10/10/2014,690000.0,3,2.75,2480,3240,1.5,0.0,0.0,3,9,1890,590,1929,0,98112,47.6399,-122.311,2160,3240,10,10,2014,UNK,320,0
5706200360,11/6/2014,465000.0,5,2.25,3020,10010,1.0,0.0,0.0,3,7,1510,1510,1959,0,98027,47.5249,-122.044,1760,10878,11,6,2014,UNK,1260,-868
8732130730,11/20/2014,280000.0,3,1.75,1770,8240,1.0,0.0,0.0,4,7,1240,530,1978,0,98023,47.3066,-122.37799999999999,2060,8250,11,20,2014,UNK,-290,-10
4202400395,3/16/2015,285000.0,3,1.75,1930,6533,1.0,0.0,0.0,3,7,1230,0,1960,0,98055,47.4883,-122.221,2030,5954,3,16,2015,UNK,-100,579
705700210,3/16/2015,320000.0,3,2.25,1650,7047,2.0,0.0,0.0,3,7,1650,0,1994,0,98038,47.3826,-122.027,2010,7763,3,16,2015,UNK,-360,-716
2817100040,2/13/2015,355000.0,4,3.0,2580,9601,2.0,0.0,0.0,4,7,2130,450,1992,0,98070,47.3726,-122.43299999999999,1900,10092,2,13,2015,UNK,680,-491
686300880,4/27/2015,670000.0,3,2.0,2570,10078,1.5,0.0,0.0,3,8,2570,0,1965,0,98008,47.6275,-122.12,2660,8013,4,27,2015,UNK,-90,2065
8122100355,9/24/2014,550000.0,1,1.0,2880,7560,1.0,0.0,0.0,3,7,1440,1440,1925,2014,98126,47.537,-122.375,1400,5040,9,24,2014,Y,1480,2520
3797000145,10/15/2014,765000.0,4,2.75,2660,4500,1.5,0.0,0.0,5,8,1860,800,1909,0,98103,47.6864,-122.34700000000001,1830,4000,10,15,2014,UNK,830,500
1704900180,10/30/2014,430000.0,3,1.0,1560,5225,1.5,0.0,0.0,3,7,1260,300,1927,0,98118,47.5554,-122.279,1560,5322,10,30,2014,UNK,0,-97
9241900150,8/27/2014,950000.0,3,2.5,3080,8448,2.0,0.0,2.0,3,9,3080,0,2000,0,98199,47.6469,-122.389,2500,6400,8,27,2014,UNK,580,2048
5249803185,10/15/2014,525000.0,4,1.75,2540,7200,1.0,0.0,0.0,4,7,1270,1270,1947,0,98118,47.5579,-122.271,1650,7200,10,15,2014,UNK,890,0
1598600209,10/20/2014,300000.0,6,2.5,3080,8163,1.0,0.0,0.0,3,7,1580,1500,1985,0,98030,47.3859,-122.221,1850,8658,10,20,2014,UNK,1230,-495
3260810580,4/17/2015,345000.0,3,2.75,2190,7258,2.0,0.0,0.0,3,8,2190,0,2000,0,98003,47.3486,-122.301,2190,8645,4,17,2015,UNK,0,-1387
2423059060,4/20/2015,838000.0,3,3.75,2930,150945,2.0,0.0,0.0,3,8,2930,0,1972,2000,98058,47.4658,-122.115,2070,43935,4,20,2015,Y,860,107010
5461300150,12/11/2014,1800000.0,5,2.75,2880,20274,1.0,0.0,3.0,4,9,1660,1220,1959,0,98004,47.6267,-122.22200000000001,3750,20220,12,11,2014,UNK,-870,54
3422059010,3/27/2015,390000.0,3,1.75,2160,98445,2.0,0.0,0.0,3,8,2160,0,1978,0,98042,47.35,-122.162,2004,44431,3,27,2015,UNK,156,54014
6795100330,6/25/2014,1150000.0,3,2.0,2110,18815,2.0,0.0,0.0,5,7,2110,0,1979,0,98075,47.5836,-122.042,2690,21010,6,25,2014,UNK,-580,-2195
1776420150,7/23/2014,295000.0,4,2.25,1830,5720,2.0,0.0,0.0,3,7,1830,0,2003,0,98030,47.3604,-122.179,1960,5754,7,23,2014,UNK,-130,-34
3735900770,10/17/2014,775000.0,4,4.0,3180,7650,2.0,0.0,0.0,3,8,2530,650,1920,0,98115,47.6887,-122.319,2000,4080,10,17,2014,UNK,1180,3570
4123840210,3/18/2015,380000.0,3,2.5,1880,6047,2.0,0.0,0.0,3,8,1880,0,1993,0,98038,47.3722,-122.044,2120,7188,3,18,2015,UNK,-240,-1141
5076700145,4/27/2015,550000.0,3,1.0,1140,8180,1.0,0.0,0.0,3,7,1140,0,1959,0,98005,47.5851,-122.17200000000001,1510,8588,4,27,2015,UNK,-370,-408
2482500040,7/17/2014,199900.0,5,1.75,1798,11232,1.0,0.0,0.0,3,7,1798,0,1967,0,98001,47.3266,-122.291,1300,15582,7,17,2014,UNK,498,-4350
2589300065,9/16/2014,329900.0,3,1.75,1670,5209,1.5,0.0,0.0,5,7,1670,0,1908,0,98118,47.5362,-122.271,1990,4960,9,16,2014,UNK,-320,249
2332700081,9/1/2014,898000.0,3,2.25,2580,11060,1.0,0.0,0.0,3,8,2580,0,1964,0,98005,47.6113,-122.164,2580,13868,9,1,2014,UNK,0,-2808
9201000610,6/3/2014,875000.0,4,2.25,3720,12384,1.0,0.0,2.0,5,8,1860,1860,1970,0,98075,47.5836,-122.074,3180,15541,6,3,2014,UNK,540,-3157
2822049254,5/16/2014,375000.0,4,2.5,2790,7956,2.0,0.0,0.0,3,9,2790,0,2005,0,98198,47.3681,-122.31,1660,8192,5,16,2014,N,1130,-236
2310110120,8/8/2014,365000.0,3,2.5,2190,5091,2.0,0.0,0.0,3,8,2190,0,2004,0,98038,47.3506,-122.039,2200,5948,8,8,2014,N,-10,-857
2887700995,5/8/2014,530000.0,4,2.75,2280,2850,1.5,0.0,0.0,4,7,1540,740,1930,0,98115,47.6871,-122.307,1680,3800,5,8,2014,UNK,600,-950
8651410120,3/18/2015,225500.0,3,1.0,1100,5200,1.0,0.0,0.0,4,6,1100,0,1969,0,98042,47.3643,-122.081,920,5200,3,18,2015,UNK,180,0
7399000580,11/17/2014,318000.0,4,2.25,2180,7000,1.0,0.0,0.0,3,8,1680,500,1969,0,98055,47.4651,-122.19200000000001,2000,8000,11,17,2014,UNK,180,-1000
7524950210,4/1/2015,910000.0,4,2.5,2770,9798,2.0,0.0,0.0,4,9,2770,0,1986,0,98027,47.562,-122.081,3040,11100,4,1,2015,UNK,-270,-1302
1021049057,10/8/2014,207000.0,3,1.0,1980,18730,1.0,0.0,0.0,4,7,1280,700,1943,0,98001,47.3221,-122.28200000000001,1356,9450,10,8,2014,UNK,624,9280
824059042,5/30/2014,1890000.0,5,3.5,4180,17935,2.0,0.0,0.0,3,11,4180,0,2004,0,98004,47.5873,-122.20200000000001,2950,13760,5,30,2014,N,1230,4175
7525410120,9/5/2014,624500.0,6,3.0,3030,31920,1.0,0.0,0.0,4,8,1670,1360,1980,0,98075,47.575,-122.03299999999999,2890,35100,9,5,2014,UNK,140,-3180
2770600841,6/4/2014,640000.0,3,2.5,1690,1553,2.5,0.0,0.0,3,8,1690,0,2007,0,98199,47.6443,-122.385,1910,1553,6,4,2014,N,-220,0
2423069164,4/10/2015,500000.0,3,2.0,1990,65340,2.0,0.0,0.0,3,8,1990,0,1986,0,98027,47.4726,-121.99,2120,59241,4,10,2015,UNK,-130,6099
3876000120,3/4/2015,390000.0,5,1.75,2250,8970,1.0,0.0,0.0,4,7,1500,750,1966,0,98034,47.7217,-122.18799999999999,1940,8710,3,4,2015,UNK,310,260
3705000120,7/29/2014,284000.0,3,2.25,2080,2050,1.5,0.0,0.0,3,7,1550,530,2003,0,98042,47.4199,-122.15700000000001,2080,2275,7,29,2014,UNK,0,-225
323069158,6/26/2014,620000.0,3,2.0,2460,41343,1.0,0.0,0.0,4,8,2460,0,1988,0,98027,47.5142,-122.021,2500,53885,6,26,2014,UNK,-40,-12542
6669240230,3/17/2015,306000.0,3,2.5,2588,5702,2.0,0.0,0.0,3,8,2588,0,2008,0,98042,47.3453,-122.15100000000001,2403,5703,3,17,2015,N,185,-1
7504400120,9/19/2014,495000.0,4,1.75,2570,12039,1.0,0.0,0.0,3,8,1910,660,1978,0,98074,47.62600000000001,-122.04799999999999,2200,12384,9,19,2014,UNK,370,-345
1038000040,6/5/2014,499950.0,3,2.5,2370,12753,2.0,0.0,0.0,3,7,2370,0,2001,0,98019,47.7359,-121.984,2280,16808,6,5,2014,UNK,90,-4055
9238450330,11/10/2014,330000.0,3,1.0,1070,10563,1.0,0.0,0.0,3,7,1070,0,1969,0,98072,47.7687,-122.166,1840,9638,11,10,2014,UNK,-770,925
1982200330,5/13/2014,665000.0,3,2.0,1940,5820,1.5,0.0,0.0,5,7,1150,790,1944,0,98107,47.6638,-122.36200000000001,990,3880,5,13,2014,UNK,950,1940
1732800175,6/30/2014,850000.0,3,2.5,2650,2387,2.0,0.0,0.0,3,8,1830,820,1920,0,98119,47.6315,-122.36200000000001,1870,2216,6,30,2014,UNK,780,171
8078350220,9/11/2014,599950.0,4,2.5,2290,6318,2.0,0.0,0.0,4,8,2290,0,1988,0,98029,47.57,-122.02,2150,7350,9,11,2014,UNK,140,-1032
3990200065,10/22/2014,360000.0,4,2.5,2050,9143,2.0,0.0,0.0,3,8,2050,0,1992,0,98166,47.4597,-122.355,1510,9484,10,22,2014,UNK,540,-341
3825311210,8/27/2014,699000.0,3,2.5,2680,5497,2.0,0.0,0.0,3,9,2680,0,2001,0,98052,47.7043,-122.12799999999999,2780,5497,8,27,2014,UNK,-100,0
1862400087,3/13/2015,475000.0,3,1.75,1520,8100,1.0,0.0,0.0,5,6,760,760,1945,0,98117,47.6966,-122.375,1040,8100,3,13,2015,UNK,480,0
3522029124,12/3/2014,575000.0,3,2.0,2690,435600,2.0,0.0,0.0,3,8,2690,0,1992,0,98070,47.3477,-122.51899999999999,1700,163350,12,3,2014,UNK,990,272250
1250200418,5/27/2014,345000.0,2,1.5,1180,844,2.0,0.0,0.0,3,7,990,190,2005,0,98144,47.5998,-122.3,1170,1400,5,27,2014,N,10,-556
7967900150,4/30/2015,367950.0,4,2.5,3030,9500,2.0,0.0,0.0,3,8,3030,0,1989,0,98001,47.3511,-122.287,2650,9500,4,30,2015,UNK,380,0
5631501073,6/25/2014,374500.0,3,2.25,1400,11400,2.0,0.0,0.0,3,8,1400,0,1984,0,98028,47.7428,-122.23100000000001,2180,9248,6,25,2014,UNK,-780,2152
2826049197,8/4/2014,607500.0,4,2.5,3000,8100,2.0,0.0,0.0,3,8,3000,0,1992,0,98125,47.7151,-122.305,1550,8100,8,4,2014,UNK,1450,0
1775920210,5/30/2014,374000.0,3,1.0,1200,9800,1.0,0.0,0.0,4,7,1200,0,1971,0,98072,47.7412,-122.109,1220,10220,5,30,2014,UNK,-20,-420
5272200035,9/3/2014,390000.0,3,1.0,1000,6947,1.0,0.0,0.0,3,7,1000,0,1947,0,98125,47.7142,-122.319,1000,6947,9,3,2014,UNK,0,0
9525100040,4/7/2015,705000.0,4,3.25,2740,5339,2.5,0.0,0.0,3,9,2740,0,2004,0,98103,47.6706,-122.35600000000001,1770,4820,4,7,2015,N,970,519
7853221010,10/29/2014,467000.0,3,2.5,1990,4978,2.0,0.0,0.0,3,8,1990,0,2004,0,98065,47.5323,-121.85600000000001,2650,6816,10,29,2014,N,-660,-1838
2500600297,8/14/2014,243500.0,3,3.0,2110,7794,1.0,0.0,0.0,3,6,2110,0,1981,0,98198,47.4005,-122.29299999999999,1330,10044,8,14,2014,UNK,780,-2250
8562791010,7/7/2014,593000.0,3,2.75,1830,1850,2.0,0.0,0.0,3,10,1690,140,2011,0,98027,47.5307,-122.074,2310,2680,7,7,2014,N,-480,-830
3550800040,11/14/2014,223000.0,3,1.0,940,7980,1.0,0.0,0.0,3,6,940,0,1961,0,98146,47.5107,-122.345,1050,7980,11,14,2014,UNK,-110,0
8857640210,4/20/2015,574000.0,4,2.5,2980,10179,2.0,0.0,2.0,3,9,2980,0,2003,0,98038,47.3895,-122.03299999999999,2980,8828,4,20,2015,UNK,0,1351
8898700120,6/4/2014,400000.0,3,2.0,2260,11305,1.0,0.0,0.0,3,7,1130,1130,1986,0,98055,47.4544,-122.204,2080,10248,6,4,2014,UNK,180,1057
1242700035,11/3/2014,772000.0,4,2.75,3470,70131,1.0,0.0,0.0,4,8,1750,1720,1962,0,98005,47.6339,-122.18,2950,43560,11,3,2014,UNK,520,26571
7200001005,5/1/2015,593777.0,3,1.75,1510,10450,1.0,0.0,0.0,4,7,1510,0,1964,0,98052,47.684,-122.113,1310,9450,5,1,2015,UNK,200,1000
4174600072,12/23/2014,539500.0,4,3.5,2710,5722,2.0,0.0,0.0,4,8,2040,670,1997,0,98108,47.5591,-122.302,2500,5722,12,23,2014,UNK,210,0
3630060150,4/1/2015,550000.0,3,2.5,2080,2625,2.0,0.0,0.0,3,8,2080,0,2006,0,98029,47.5469,-121.99700000000001,1760,2772,4,1,2015,N,320,-147
3348401490,6/30/2014,265000.0,2,2.0,1860,10856,1.0,0.0,0.0,3,8,1260,600,1952,0,98178,47.4989,-122.265,1250,10008,6,30,2014,UNK,610,848
7214810150,10/2/2014,428000.0,3,1.75,2120,9350,1.0,0.0,0.0,3,7,1280,840,1979,0,98072,47.7562,-122.145,2200,9000,10,2,2014,UNK,-80,350
1566100450,4/28/2015,505000.0,3,2.0,1110,8375,1.0,0.0,0.0,5,7,1110,0,1951,0,98115,47.6978,-122.29700000000001,1410,7734,4,28,2015,UNK,-300,641
7851990120,7/1/2014,925000.0,5,5.5,5190,12637,2.0,0.0,2.0,3,11,5190,0,2001,0,98065,47.5424,-121.87200000000001,3840,12637,7,1,2014,UNK,1350,0
8937500040,1/2/2015,230000.0,3,1.75,1520,15344,1.0,0.0,0.0,3,8,1520,0,1968,0,98023,47.3308,-122.365,2270,14981,1,2,2015,UNK,-750,363
1149600120,8/20/2014,695000.0,4,2.5,2650,9990,2.0,0.0,0.0,3,10,2650,0,1990,0,98029,47.5605,-122.016,2710,8012,8,20,2014,UNK,-60,1978
7853240040,4/14/2015,700000.0,4,2.75,3350,7857,2.0,0.0,2.0,3,9,3350,0,2004,0,98065,47.5398,-121.859,3870,7886,4,14,2015,N,-520,-29
7517500085,4/25/2015,712500.0,3,1.75,1770,2800,1.5,0.0,0.0,3,7,1770,0,1914,0,98103,47.6631,-122.35700000000001,1630,3254,4,25,2015,UNK,140,-454
9527310180,4/3/2015,480000.0,3,2.5,2200,4692,2.0,0.0,0.0,3,8,2200,0,2005,0,98011,47.7761,-122.169,2440,3833,4,3,2015,N,-240,859
3558900580,9/22/2014,470000.0,3,2.5,2000,8424,1.0,0.0,0.0,4,7,1300,700,1968,0,98034,47.7089,-122.20100000000001,2110,8400,9,22,2014,UNK,-110,24
4046500180,7/24/2014,335000.0,3,1.75,1730,15003,1.0,0.0,0.0,3,7,1150,580,1980,0,98014,47.6923,-121.92,1900,15483,7,24,2014,UNK,-170,-480
6386300120,4/17/2015,270000.0,3,1.5,1300,7907,1.0,0.0,0.0,3,7,900,400,1970,0,98030,47.3737,-122.22399999999999,1630,7600,4,17,2015,UNK,-330,307
3395350210,3/24/2015,810000.0,5,3.25,2950,67475,1.0,0.0,0.0,3,8,2530,420,1981,2004,98072,47.7233,-122.117,2620,39820,3,24,2015,Y,330,27655
9578080040,8/12/2014,589000.0,3,3.0,1720,954,3.0,0.0,0.0,3,8,1460,260,2006,0,98119,47.648,-122.35799999999999,1720,1294,8,12,2014,N,0,-340
5683500085,9/26/2014,415000.0,2,1.0,880,4558,1.0,0.0,0.0,3,7,880,0,1951,0,98115,47.6803,-122.287,1370,5243,9,26,2014,UNK,-490,-685
8645500360,3/11/2015,197000.0,4,2.25,1790,13200,1.0,0.0,0.0,3,7,1220,570,1979,0,98058,47.4672,-122.185,1740,8950,3,11,2015,UNK,50,4250
4222310220,8/25/2014,235500.0,3,1.5,1380,7600,1.0,0.0,0.0,4,7,790,590,1971,0,98003,47.3489,-122.306,1570,7904,8,25,2014,UNK,-190,-304
2394600157,4/7/2015,460000.0,3,2.25,1530,1840,2.0,0.0,0.0,3,8,1240,290,2008,0,98144,47.586999999999996,-122.301,1800,3431,4,7,2015,N,-270,-1591
9238900085,10/29/2014,572500.0,5,1.75,2330,4947,1.0,0.0,0.0,4,8,1380,950,1955,0,98136,47.5352,-122.39200000000001,2120,5605,10,29,2014,UNK,210,-658
2739200040,9/24/2014,302000.0,5,2.0,1540,9629,1.0,0.0,0.0,4,7,1540,0,1960,0,98059,47.4915,-122.14299999999999,2260,9600,9,24,2014,UNK,-720,29
3893100456,8/13/2014,870000.0,3,2.5,3210,8630,2.0,0.0,0.0,4,10,2530,680,1990,0,98033,47.6939,-122.189,2630,8630,8,13,2014,UNK,580,0
1370803940,10/7/2014,485000.0,3,1.0,1130,5758,1.0,0.0,0.0,3,7,960,0,1939,0,98199,47.6413,-122.40100000000001,1510,6000,10,7,2014,UNK,-380,-242
4222200120,2/5/2015,240000.0,3,2.0,1460,7526,1.0,0.0,0.0,3,7,1460,0,1968,0,98003,47.3463,-122.304,1580,7526,2,5,2015,UNK,-120,0
9477000120,10/22/2014,383000.0,3,1.75,1410,7215,1.0,0.0,0.0,3,7,1410,0,1967,0,98034,47.7343,-122.193,1550,7600,10,22,2014,UNK,-140,-385
7228501065,6/26/2014,750000.0,4,2.75,1750,5080,1.5,0.0,0.0,3,8,1750,0,1903,0,98122,47.6143,-122.305,1700,4572,6,26,2014,UNK,50,508
9266701085,6/3/2014,409950.0,2,1.75,1370,5125,1.0,0.0,0.0,5,6,1370,0,1944,0,98103,47.6926,-122.346,1200,5100,6,3,2014,UNK,170,25
985001082,5/21/2014,246000.0,3,1.5,1780,23819,1.0,0.0,0.0,3,7,1780,0,1953,0,98168,47.4912,-122.31200000000001,1130,14450,5,21,2014,UNK,650,9369
8815400410,4/3/2015,860000.0,4,1.75,1890,4500,2.0,0.0,0.0,5,7,1490,400,1937,0,98115,47.6751,-122.289,1890,5000,4,3,2015,UNK,0,-500
2459500210,5/7/2014,339950.0,3,2.25,1630,12295,2.0,0.0,0.0,4,7,1630,0,1985,0,98058,47.4279,-122.161,1730,9948,5,7,2014,UNK,-100,2347
1219000043,5/9/2014,315000.0,5,1.75,2320,8100,1.0,0.0,0.0,4,7,1160,1160,1956,0,98166,47.4631,-122.34100000000001,1410,7271,5,9,2014,UNK,910,829
4379400580,8/13/2014,698000.0,3,2.5,2580,4636,2.0,0.0,0.0,3,9,2580,0,2006,0,98074,47.6201,-122.025,2480,4500,8,13,2014,N,100,136
2159900120,8/22/2014,419000.0,2,2.5,1470,2034,2.0,0.0,0.0,4,8,1470,0,1985,0,98007,47.6213,-122.15299999999999,1510,2055,8,22,2014,UNK,-40,-21
1243100191,1/22/2015,372000.0,3,1.0,2298,10140,1.0,0.0,0.0,3,7,2298,0,1969,0,98052,47.6909,-122.083,2580,24724,1,22,2015,UNK,-282,-14584
7852150530,9/11/2014,425000.0,3,2.5,1960,4709,2.0,0.0,0.0,3,7,1960,0,2003,0,98065,47.5322,-121.87100000000001,1700,4444,9,11,2014,UNK,260,265
7508700085,7/24/2014,386500.0,3,2.25,2950,8036,1.5,0.0,0.0,3,8,1950,1000,1963,0,98125,47.7239,-122.31299999999999,2060,7200,7,24,2014,UNK,890,836
8820903370,11/17/2014,348000.0,2,1.0,670,7312,1.0,0.0,0.0,3,5,670,0,1942,0,98125,47.7145,-122.285,860,8242,11,17,2014,UNK,-190,-930
1923000150,4/24/2015,754000.0,5,3.5,3020,15305,2.0,0.0,0.0,3,10,2230,790,1978,0,98040,47.5627,-122.21600000000001,3680,14486,4,24,2015,UNK,-660,819
3920900220,12/15/2014,269950.0,4,3.0,2390,7309,2.0,0.0,0.0,4,7,2390,0,1944,1981,98002,47.294,-122.21799999999999,930,7308,12,15,2014,Y,1460,1
8835700330,12/11/2014,891500.0,3,2.5,3090,20785,2.0,0.0,0.0,4,10,3090,0,1991,0,98075,47.5602,-122.03,3400,7566,12,11,2014,UNK,-310,13219
7338402160,10/9/2014,349950.0,4,1.75,1780,5000,1.0,0.0,0.0,5,7,890,890,1903,0,98108,47.5329,-122.292,1860,5000,10,9,2014,UNK,-80,0
3223059141,5/9/2014,360000.0,2,1.0,1420,81892,1.0,0.0,0.0,3,7,1180,240,1956,0,98055,47.4342,-122.195,1490,1863,5,9,2014,UNK,-70,80029
524059052,12/9/2014,975000.0,4,2.25,2420,15482,2.0,0.0,0.0,4,8,2420,0,1925,1997,98004,47.5907,-122.196,2870,13905,12,9,2014,Y,-450,1577
6145600865,5/5/2014,449250.0,4,2.0,1480,3844,1.5,0.0,0.0,5,7,1480,0,1928,0,98133,47.7042,-122.352,1480,3844,5,5,2014,UNK,0,0
2325400330,12/1/2014,350000.0,4,2.25,2190,3850,2.0,0.0,0.0,3,7,2190,0,2006,0,98059,47.4854,-122.16,1900,3850,12,1,2014,N,290,0
9530100085,4/1/2015,790000.0,4,1.75,1820,6137,1.5,0.0,3.0,4,7,1690,0,1911,0,98107,47.6681,-122.36,2130,5100,4,1,2015,UNK,-310,1037
3024059044,9/9/2014,990000.0,3,1.75,1810,24586,1.0,0.0,4.0,4,9,930,880,1983,0,98040,47.5314,-122.22200000000001,3540,14200,9,9,2014,UNK,-1730,10386
5015000596,12/1/2014,834000.0,3,2.25,2550,4089,2.0,0.0,0.0,3,9,2550,0,1983,0,98112,47.6272,-122.29700000000001,1680,4089,12,1,2014,UNK,870,0
4443801285,8/14/2014,466950.0,3,1.0,1360,3880,1.0,0.0,0.0,3,7,1060,300,1963,0,98117,47.6837,-122.391,1110,3880,8,14,2014,UNK,250,0
3751606606,7/17/2014,262500.0,3,1.75,2259,26831,1.5,0.0,3.0,5,7,1491,768,1908,0,98001,47.2741,-122.266,1980,15794,7,17,2014,UNK,279,11037
1829300210,5/6/2014,762300.0,4,2.5,3880,14550,2.0,0.0,0.0,3,10,3880,0,1987,0,98074,47.6378,-122.04,3240,14045,5,6,2014,UNK,640,505
2767601085,1/26/2015,733000.0,6,2.75,2730,5000,1.0,0.0,0.0,3,8,1780,950,1962,0,98107,47.6751,-122.38,2090,5000,1,26,2015,UNK,640,0
8832900155,4/14/2015,439000.0,4,2.5,2800,17279,1.0,0.0,2.0,3,7,1560,1240,1957,0,98028,47.7596,-122.26899999999999,3060,13423,4,14,2015,UNK,-260,3856
8805900065,11/12/2014,1160000.0,5,3.25,4290,7019,2.5,0.0,0.0,4,10,3590,700,1927,0,98112,47.6439,-122.302,1920,4000,11,12,2014,UNK,2370,3019
8635760040,10/8/2014,420000.0,3,2.5,1770,3993,2.0,0.0,0.0,3,8,1770,0,1999,0,98074,47.6027,-122.02,1820,4046,10,8,2014,UNK,-50,-53
8651540040,7/18/2014,549000.0,3,2.25,1920,10961,2.0,0.0,0.0,3,8,1920,0,1981,0,98074,47.6432,-122.057,2000,10706,7,18,2014,UNK,-80,255
9818700455,8/26/2014,518000.0,4,2.5,2320,4000,1.5,0.0,0.0,5,8,1510,810,1905,0,98122,47.6048,-122.29799999999999,1490,4500,8,26,2014,UNK,830,-500
924069210,6/3/2014,695000.0,4,2.5,2961,12146,2.0,0.0,0.0,3,9,2961,0,1998,0,98075,47.5839,-122.052,2620,17749,6,3,2014,UNK,341,-5603
1954430180,1/5/2015,485000.0,3,2.5,1680,7385,2.0,0.0,0.0,3,8,1680,0,1988,0,98074,47.6194,-122.041,1970,7470,1,5,2015,UNK,-290,-85
5111400081,6/3/2014,280000.0,3,1.75,1590,27200,1.5,0.0,0.0,4,6,1590,0,1926,0,98038,47.4238,-122.052,1820,74052,6,3,2014,UNK,-230,-46852
5559200065,5/7/2015,306500.0,2,1.0,1420,16400,1.5,0.0,0.0,4,6,1420,0,1943,0,98023,47.3221,-122.344,1900,16400,5,7,2015,UNK,-480,0
1266200120,3/21/2015,720000.0,2,1.0,1370,9460,1.0,0.0,0.0,3,6,1370,0,1950,0,98004,47.6238,-122.191,1690,9930,3,21,2015,UNK,-320,-470
8141310180,11/18/2014,277500.0,3,2.5,2620,4558,2.0,0.0,3.0,3,7,2620,0,2010,0,98022,47.1944,-121.97399999999999,1670,4558,11,18,2014,N,950,0
6102400166,9/5/2014,649000.0,3,2.0,1810,17006,2.0,0.0,4.0,3,8,1810,0,1913,1987,98166,47.4663,-122.369,2180,24911,9,5,2014,Y,-370,-7905
3126059023,3/3/2015,3400000.0,4,3.5,4730,47870,1.0,1.0,4.0,3,10,2940,1790,1954,0,98033,47.6967,-122.21600000000001,3250,49346,3,3,2015,UNK,1480,-1476
408100150,5/14/2014,267800.0,2,1.0,700,6000,1.0,0.0,0.0,4,6,700,0,1949,0,98155,47.7515,-122.316,920,6000,5,14,2014,UNK,-220,0
3905081520,3/25/2015,625000.0,4,2.75,2390,6979,2.0,0.0,0.0,3,8,2390,0,1993,0,98029,47.5703,-121.99600000000001,2090,6321,3,25,2015,UNK,300,658
9324800220,9/17/2014,600000.0,4,2.5,2070,8127,1.5,0.0,0.0,3,9,1590,480,1924,2003,98125,47.7316,-122.289,2050,8131,9,17,2014,Y,20,-4
3996900555,10/17/2014,395000.0,4,2.0,1780,8149,1.5,0.0,0.0,4,7,1780,0,1948,0,98155,47.745,-122.302,1180,8149,10,17,2014,UNK,600,0
9456200450,4/27/2015,212000.0,4,2.5,1900,21780,1.5,0.0,0.0,3,7,1900,0,1940,1987,98198,47.3776,-122.314,1240,9166,4,27,2015,Y,660,12614
9165100330,12/12/2014,425000.0,2,1.0,1040,4040,1.0,0.0,0.0,3,7,940,100,1928,0,98117,47.6829,-122.39299999999999,1420,4040,12,12,2014,UNK,-380,0
2877103615,5/11/2015,870000.0,4,1.75,2370,5000,1.5,0.0,2.0,3,8,1770,600,1919,0,98103,47.6779,-122.35700000000001,2100,4550,5,11,2015,UNK,270,450
7853210210,3/25/2015,420000.0,3,2.5,1970,3667,2.0,0.0,0.0,3,7,1970,0,2004,0,98065,47.5321,-121.851,1970,3739,3,25,2015,N,0,-72
7524950540,4/3/2015,800000.0,4,2.25,2120,9921,2.0,0.0,0.0,3,8,2120,0,1981,0,98027,47.5593,-122.08200000000001,1890,7845,4,3,2015,UNK,230,2076
200500410,5/6/2015,575000.0,3,2.5,1960,9535,2.0,0.0,0.0,3,8,1960,0,1989,0,98011,47.7371,-122.215,2520,9206,5,6,2015,UNK,-560,329
9103000365,6/20/2014,915000.0,3,3.25,2660,4000,2.0,0.0,0.0,3,9,2170,490,2003,0,98122,47.6186,-122.288,2660,4000,6,20,2014,UNK,0,0
6076500220,9/3/2014,400000.0,3,2.25,1180,14258,2.0,0.0,0.0,3,7,1180,0,1987,0,98034,47.7112,-122.238,1860,10390,9,3,2014,UNK,-680,3868
1818800144,5/2/2014,750000.0,3,2.5,2390,6550,1.0,0.0,2.0,4,8,1440,950,1955,0,98116,47.5714,-122.40799999999999,2010,6550,5,2,2014,UNK,380,0
2569600150,11/3/2014,235000.0,3,1.0,1250,7592,1.0,0.0,0.0,5,7,1250,0,1961,0,98042,47.3604,-122.111,1250,7592,11,3,2014,UNK,0,0
3448000344,11/12/2014,599950.0,5,3.0,2600,13674,1.0,0.0,0.0,5,8,1300,1300,1967,0,98125,47.7176,-122.302,2150,7800,11,12,2014,UNK,450,5874
7170200085,3/27/2015,481203.0,2,1.0,940,3800,1.0,0.0,0.0,3,7,940,0,1929,0,98115,47.6798,-122.292,1680,3800,3,27,2015,UNK,-740,0
4094800120,6/19/2014,1820000.0,5,3.0,3880,13000,2.0,0.0,0.0,3,10,3880,0,1972,2003,98040,47.5467,-122.234,3470,13701,6,19,2014,Y,410,-701
2591010180,7/9/2014,379000.0,3,2.5,1530,2913,2.0,0.0,0.0,4,7,1530,0,1986,0,98033,47.6939,-122.184,1370,3783,7,9,2014,UNK,160,-870
3052701135,6/26/2014,626000.0,3,1.75,2430,5000,2.0,0.0,0.0,4,7,1760,670,1945,0,98117,47.6785,-122.37200000000001,1320,4062,6,26,2014,UNK,1110,938
625049281,5/21/2014,535000.0,2,1.0,1030,4841,1.0,0.0,0.0,3,7,920,110,1939,0,98103,47.68600000000001,-122.34100000000001,1530,4944,5,21,2014,UNK,-500,-103
5427110040,6/9/2014,1230000.0,4,2.5,2740,16007,2.0,0.0,0.0,3,9,2740,0,1984,0,98039,47.6353,-122.229,2760,16008,6,9,2014,UNK,-20,-1
9528103443,7/24/2014,410000.0,2,1.5,1180,1034,2.0,0.0,0.0,3,7,1120,60,2001,0,98115,47.678000000000004,-122.322,1137,1034,7,24,2014,UNK,43,0
7855800730,2/10/2015,940000.0,4,2.5,3090,9238,1.0,0.0,3.0,4,8,1680,1410,1967,0,98006,47.5654,-122.163,2690,8500,2,10,2015,UNK,400,738
395300650,7/21/2014,326250.0,3,1.0,1060,9663,1.0,0.0,0.0,3,7,1060,0,1967,0,98034,47.7244,-122.226,1320,10162,7,21,2014,UNK,-260,-499
7812800995,9/5/2014,200000.0,2,1.0,790,5985,1.0,0.0,0.0,3,6,790,0,1944,0,98178,47.4941,-122.24,1030,5985,9,5,2014,UNK,-240,0
9541600355,8/13/2014,880000.0,4,2.5,3070,8250,1.0,0.0,0.0,5,8,2100,970,1958,0,98005,47.5935,-122.17200000000001,2270,8800,8,13,2014,UNK,800,-550
774100355,11/3/2014,370000.0,2,2.0,2100,58488,2.0,0.0,0.0,3,9,2100,0,2005,0,98014,47.72,-121.402,1440,59346,11,3,2014,N,660,-858
2781280150,8/1/2014,190000.0,2,2.5,1100,1737,2.0,0.0,0.0,3,8,1100,0,2006,0,98055,47.4499,-122.189,1610,2563,8,1,2014,N,-510,-826
7338000150,1/29/2015,160000.0,2,1.0,1070,4200,1.0,0.0,0.0,4,6,1070,0,1983,0,98002,47.3336,-122.215,1150,4200,1,29,2015,UNK,-80,0
6977000040,8/23/2014,625000.0,4,3.0,2190,12825,1.0,0.0,0.0,3,9,1520,670,1989,0,98034,47.7107,-122.229,3050,4673,8,23,2014,UNK,-860,8152
9558050230,5/7/2015,590000.0,4,3.5,3450,6873,2.0,0.0,0.0,3,10,2750,700,2004,0,98058,47.458999999999996,-122.118,3450,6873,5,7,2015,N,0,0
1241500155,8/5/2014,575000.0,3,2.5,2070,3599,2.0,0.0,0.0,3,8,2070,0,1999,0,98033,47.6679,-122.165,2070,6844,8,5,2014,UNK,0,-3245
9266700256,10/13/2014,470000.0,2,1.0,1190,5200,1.0,0.0,0.0,5,7,1190,0,1912,0,98103,47.6939,-122.348,1550,5100,10,13,2014,UNK,-360,100
2354300456,3/11/2015,130000.0,2,1.0,600,1500,1.0,0.0,0.0,4,4,600,0,1900,0,98027,47.5289,-122.03299999999999,1130,6000,3,11,2015,UNK,-530,-4500
7789000120,4/21/2015,229000.0,3,1.0,940,8400,1.0,0.0,0.0,3,7,940,0,1958,0,98056,47.5108,-122.165,1190,8400,4,21,2015,UNK,-250,0
3210200395,8/22/2014,279900.0,3,1.0,1280,12928,1.5,0.0,0.0,3,6,1280,0,1942,0,98023,47.3215,-122.399,1610,19467,8,22,2014,UNK,-330,-6539
8658303065,5/19/2014,307000.0,3,1.0,1370,7500,1.0,0.0,0.0,3,7,1370,0,1960,0,98014,47.6499,-121.915,1160,7500,5,19,2014,UNK,210,0
4046601010,10/23/2014,399950.0,3,1.75,2450,15001,1.0,0.0,0.0,3,7,1980,470,1989,0,98014,47.6957,-121.913,1790,15323,10,23,2014,UNK,660,-322
526059183,8/1/2014,405000.0,4,2.25,1970,15743,1.0,0.0,0.0,3,7,1370,600,1962,0,98011,47.7673,-122.20200000000001,2390,11336,8,1,2014,UNK,-420,4407
5056500210,10/7/2014,539950.0,4,2.75,2910,9000,1.0,0.0,0.0,4,8,2130,780,1966,0,98006,47.544,-122.176,1970,9000,10,7,2014,UNK,940,0
6146600175,11/7/2014,129000.0,2,1.0,760,5240,1.0,0.0,0.0,3,6,760,0,1949,0,98032,47.38800000000001,-122.234,980,5080,11,7,2014,UNK,-220,160
6057700120,9/17/2014,340000.0,3,1.75,1270,8422,1.0,0.0,0.0,3,7,1270,0,1967,0,98011,47.7601,-122.197,1470,8500,9,17,2014,UNK,-200,-78
8651442060,6/11/2014,214950.0,3,1.75,1570,4875,1.0,0.0,0.0,4,7,1310,260,1977,0,98042,47.3621,-122.094,1380,5200,6,11,2014,UNK,190,-325
7129301445,6/25/2014,450000.0,4,2.75,2310,5650,1.0,0.0,2.0,3,8,1330,980,1952,0,98118,47.51300000000001,-122.25200000000001,2300,5650,6,25,2014,UNK,10,0
7881500330,3/4/2015,515000.0,3,1.75,1900,5000,1.0,0.0,0.0,4,7,950,950,1925,0,98106,47.5677,-122.363,1420,5000,3,4,2015,UNK,480,0
1336800880,8/22/2014,1400000.0,4,2.25,3780,5160,2.0,0.0,0.0,4,9,2510,1270,1907,0,98112,47.6275,-122.30799999999999,2740,5160,8,22,2014,UNK,1040,0
7147600220,6/26/2014,230000.0,3,1.0,1060,9946,1.0,0.0,0.0,4,7,1060,0,1956,0,98188,47.4432,-122.28200000000001,1310,10619,6,26,2014,UNK,-250,-673
2600030210,7/7/2014,681000.0,3,1.75,1880,10032,1.0,0.0,0.0,4,8,1880,0,1984,0,98006,47.5527,-122.16,2430,9732,7,7,2014,UNK,-550,300
6303400150,9/29/2014,255000.0,3,1.0,1160,8636,1.0,0.0,0.0,3,6,1160,0,1923,0,98146,47.5097,-122.35700000000001,1300,8636,9,29,2014,UNK,-140,0
9136103136,3/13/2015,580000.0,2,1.0,860,4013,1.0,0.0,0.0,3,7,860,0,1925,0,98103,47.6652,-122.338,1490,4013,3,13,2015,UNK,-630,0
8898700880,3/17/2015,295000.0,2,2.0,1590,8000,1.0,0.0,0.0,3,7,910,680,1984,0,98055,47.458999999999996,-122.205,1590,8364,3,17,2015,UNK,0,-364
4318200360,7/30/2014,286000.0,2,1.0,1170,6543,1.0,0.0,0.0,3,7,1170,0,1913,0,98136,47.537,-122.385,1550,7225,7,30,2014,UNK,-380,-682
6798100610,1/8/2015,425000.0,3,1.5,1190,8100,1.0,0.0,0.0,3,7,830,360,1947,0,98125,47.7146,-122.311,1256,8100,1,8,2015,UNK,-66,0
7466900220,12/12/2014,170000.0,2,1.0,1300,11400,1.0,0.0,0.0,3,7,1300,0,1961,0,98003,47.3459,-122.29899999999999,1360,9750,12,12,2014,UNK,-60,1650
7435500085,5/28/2014,380000.0,3,2.0,1660,8281,1.0,0.0,0.0,3,7,1660,0,1949,0,98136,47.5568,-122.382,1660,7559,5,28,2014,UNK,0,722
7977200995,5/6/2015,506000.0,3,2.0,1160,6120,1.0,0.0,0.0,3,7,1160,0,1947,0,98115,47.6853,-122.29299999999999,1150,5100,5,6,2015,UNK,10,1020
1862900360,9/22/2014,315000.0,3,2.5,1950,9618,2.0,0.0,0.0,3,7,1950,0,1992,0,98031,47.4068,-122.18,1890,7133,9,22,2014,UNK,60,2485
7852040210,6/17/2014,449950.0,4,2.5,2470,3811,2.0,0.0,0.0,3,8,2470,0,1999,0,98065,47.5362,-121.87700000000001,2400,4266,6,17,2014,UNK,70,-455
3343901961,3/31/2015,255000.0,3,1.0,1430,12420,1.0,0.0,0.0,3,7,1430,0,1964,0,98056,47.5116,-122.191,1900,10350,3,31,2015,UNK,-470,2070
3874010220,6/24/2014,289000.0,3,2.5,1970,9607,2.0,0.0,0.0,3,7,1090,880,1988,0,98001,47.3462,-122.286,2020,9608,6,24,2014,UNK,-50,-1
2724069103,8/28/2014,389000.0,3,1.75,1400,10018,1.0,0.0,0.0,4,7,1400,0,1962,0,98027,47.5327,-122.03200000000001,1350,9300,8,28,2014,UNK,50,718
1520069052,7/21/2014,327000.0,3,1.5,1510,344124,1.0,0.0,2.0,4,7,1510,0,1964,0,98022,47.2156,-122.029,1750,169884,7,21,2014,UNK,-240,174240
5316101075,9/26/2014,2890000.0,7,3.0,5350,14400,2.5,0.0,0.0,4,10,5020,330,1910,0,98112,47.6295,-122.285,3050,7469,9,26,2014,UNK,2300,6931
8113100150,7/14/2014,210000.0,3,1.0,920,6612,1.0,0.0,0.0,3,6,920,0,1948,0,98118,47.548,-122.28399999999999,1860,8424,7,14,2014,UNK,-940,-1812
3459900230,11/25/2014,1680000.0,4,3.75,7620,29536,2.0,0.0,3.0,3,11,5980,1640,2005,0,98006,47.5571,-122.14,2840,20809,11,25,2014,N,4780,8727
3955900150,12/29/2014,360000.0,4,2.5,2490,4751,2.0,0.0,0.0,3,7,2490,0,2001,0,98056,47.4813,-122.18799999999999,2510,5233,12,29,2014,UNK,-20,-482
7701960210,4/27/2015,875000.0,4,2.5,3030,16000,2.0,0.0,0.0,3,11,3030,0,1990,0,98077,47.7125,-122.081,3670,16641,4,27,2015,UNK,-640,-641
686450210,11/4/2014,550000.0,4,2.25,1650,7200,1.0,0.0,0.0,3,8,1650,0,1967,0,98008,47.6384,-122.116,2180,7950,11,4,2014,UNK,-530,-750
3451000442,7/17/2014,257500.0,3,1.5,1210,12500,1.0,0.0,0.0,3,7,1210,0,1962,0,98146,47.503,-122.351,1210,12500,7,17,2014,UNK,0,0
5700003221,12/10/2014,1080000.0,4,2.75,2990,7389,1.5,0.0,0.0,4,8,2090,900,1923,0,98144,47.5711,-122.28399999999999,2510,6157,12,10,2014,UNK,480,1232
8651402700,10/28/2014,202950.0,2,1.0,1060,5144,1.0,0.0,0.0,5,6,1060,0,1969,0,98042,47.3613,-122.088,1130,5200,10,28,2014,UNK,-70,-56
3526039101,10/30/2014,622000.0,4,1.75,2680,6120,1.0,0.0,0.0,5,8,1340,1340,1959,0,98117,47.6965,-122.39299999999999,2320,6840,10,30,2014,UNK,360,-720
1136100072,2/13/2015,455000.0,4,1.75,1790,45738,1.0,0.0,0.0,3,8,1410,380,1976,0,98072,47.7453,-122.12899999999999,1870,47480,2,13,2015,UNK,-80,-1742
2050100210,11/17/2014,805000.0,3,2.5,2690,17461,2.0,0.0,3.0,3,10,2690,0,1997,0,98074,47.653999999999996,-122.088,3610,16887,11,17,2014,UNK,-920,574
9141100210,9/8/2014,257000.0,2,1.0,770,9497,1.0,0.0,0.0,3,6,770,0,1950,0,98133,47.7407,-122.351,1550,7532,9,8,2014,UNK,-780,1965
1153000150,6/25/2014,744500.0,5,2.5,2700,16570,1.0,0.0,0.0,4,8,1750,950,1967,0,98005,47.6144,-122.167,2570,11840,6,25,2014,UNK,130,4730
1245000438,4/13/2015,885000.0,4,2.5,2620,9157,2.0,0.0,0.0,3,8,2620,0,1996,0,98033,47.6916,-122.20299999999999,2240,7405,4,13,2015,UNK,380,1752
1498300775,6/24/2014,355000.0,2,2.25,930,747,2.0,0.0,0.0,3,8,630,300,2007,0,98144,47.5844,-122.316,940,6000,6,24,2014,N,-10,-5253
4051100230,8/20/2014,240000.0,3,1.0,1340,7000,1.0,0.0,0.0,4,7,1340,0,1978,0,98042,47.3742,-122.149,1850,7904,8,20,2014,UNK,-510,-904
121039038,8/19/2014,169000.0,3,1.5,1470,18459,2.0,0.0,0.0,4,6,1470,0,1916,0,98023,47.3302,-122.36,1750,16074,8,19,2014,UNK,-280,2385
1523550220,3/28/2015,639900.0,3,2.5,2330,4160,2.0,0.0,0.0,4,8,2330,0,1992,0,98052,47.6367,-122.109,2940,4500,3,28,2015,UNK,-610,-340
1622059095,6/4/2014,292000.0,3,1.75,1730,11325,1.0,0.0,0.0,5,7,1730,0,1972,0,98031,47.3921,-122.182,2030,17859,6,4,2014,UNK,-300,-6534
7853220210,9/22/2014,563500.0,4,2.5,2780,7838,2.0,0.0,3.0,3,9,2780,0,2004,0,98065,47.5312,-121.861,3160,7848,9,22,2014,N,-380,-10
8682291510,1/26/2015,389000.0,2,2.0,1200,7131,1.0,0.0,0.0,3,8,1200,0,2006,0,98053,47.7199,-122.022,1670,4601,1,26,2015,N,-470,2530
7397300220,5/29/2014,2750000.0,4,3.25,4430,21000,2.0,0.0,0.0,3,10,4430,0,1952,2007,98039,47.6398,-122.23700000000001,3930,20000,5,29,2014,Y,500,1000
3764500230,8/21/2014,661000.0,3,2.0,1820,4418,2.0,0.0,0.0,4,8,1820,0,1994,0,98033,47.6947,-122.19,1920,13402,8,21,2014,UNK,-100,-8984
8682260870,9/12/2014,344000.0,2,2.0,1300,4659,1.0,0.0,0.0,3,8,1300,0,2005,0,98053,47.7132,-122.03299999999999,1640,4780,9,12,2014,N,-340,-121
369000365,4/22/2015,510000.0,1,1.0,680,6600,1.0,0.0,0.0,3,5,480,200,1916,0,98199,47.6567,-122.39200000000001,1170,5500,4,22,2015,UNK,-490,1100
9238901020,9/16/2014,289000.0,2,1.0,780,4132,1.0,0.0,0.0,3,7,780,0,1942,0,98136,47.5324,-122.387,1100,5100,9,16,2014,UNK,-320,-968
3343901641,8/27/2014,365000.0,3,2.25,2430,7614,1.5,0.0,0.0,3,8,1900,530,1979,0,98056,47.5065,-122.191,1720,11250,8,27,2014,UNK,710,-3636
3024079057,7/30/2014,410000.0,3,1.5,1750,32500,1.0,0.0,0.0,4,7,1750,0,1966,0,98027,47.5316,-121.959,1820,102801,7,30,2014,UNK,-70,-70301
7518507330,7/24/2014,535610.0,3,1.0,1610,5100,1.5,0.0,0.0,5,7,1010,600,1901,0,98117,47.6765,-122.38600000000001,1270,5100,7,24,2014,UNK,340,0
2968801510,11/13/2014,397950.0,4,1.75,2120,7620,2.0,0.0,0.0,3,8,2120,0,1971,2002,98166,47.457,-122.346,1820,7620,11,13,2014,Y,300,0
2822100175,8/27/2014,284000.0,3,1.75,1430,4850,1.0,0.0,0.0,3,7,930,500,1978,0,98108,47.5472,-122.303,1430,4850,8,27,2014,UNK,0,0
3826000385,12/17/2014,201000.0,4,1.5,1360,8100,1.5,0.0,0.0,3,7,1360,0,1962,0,98168,47.4931,-122.305,1300,8100,12,17,2014,UNK,60,0
2301400540,12/15/2014,734000.0,4,2.25,2530,5000,1.5,0.0,0.0,4,7,1690,840,1925,0,98117,47.6806,-122.36,1530,5000,12,15,2014,UNK,1000,0
2111010760,1/8/2015,357500.0,5,3.0,3270,9146,2.0,0.0,0.0,3,7,3270,0,2002,0,98092,47.3342,-122.169,3200,6300,1,8,2015,UNK,70,2846
23500220,10/15/2014,550120.0,5,2.5,2620,8050,1.0,0.0,0.0,3,8,1520,1100,1975,0,98052,47.6919,-122.115,2030,7676,10,15,2014,UNK,590,374
8001600150,3/10/2015,300000.0,3,1.5,1810,8232,1.0,0.0,0.0,3,8,1810,0,1988,0,98001,47.3195,-122.273,2260,8491,3,10,2015,UNK,-450,-259
9149000180,8/19/2014,374950.0,3,2.5,2120,9653,2.0,0.0,0.0,3,8,2120,0,1992,0,98030,47.3843,-122.213,1780,9801,8,19,2014,UNK,340,-148
7525420150,4/13/2015,602500.0,4,1.75,2190,41000,2.0,0.0,0.0,3,8,2190,0,1980,0,98075,47.5755,-122.03299999999999,2590,35370,4,13,2015,UNK,-400,5630
1003000175,12/22/2014,221000.0,3,1.0,980,7606,1.0,0.0,0.0,3,7,980,0,1954,0,98188,47.4356,-122.29,980,8125,12,22,2014,UNK,0,-519
2902200874,4/10/2015,920000.0,5,3.0,2230,4400,2.0,0.0,0.0,3,7,1730,500,1913,0,98102,47.6404,-122.325,1280,1800,4,10,2015,UNK,950,2600
7131300032,3/6/2015,235000.0,4,2.0,1540,9279,1.0,0.0,0.0,3,7,1540,0,1955,0,98118,47.5163,-122.26799999999999,1540,5110,3,6,2015,UNK,0,4169
3581100330,8/4/2014,375000.0,3,1.0,980,7296,1.0,0.0,0.0,3,7,980,0,1967,0,98034,47.7292,-122.23100000000001,1280,7296,8,4,2014,UNK,-300,0
3629970870,8/27/2014,599000.0,4,2.5,2120,3640,2.0,0.0,0.0,3,8,2120,0,2005,0,98029,47.5521,-121.99600000000001,2190,3640,8,27,2014,N,-70,0
2561360210,6/3/2014,562100.0,3,2.25,2090,12112,2.0,0.0,0.0,3,8,2090,0,1983,0,98052,47.7015,-122.13,1760,12112,6,3,2014,UNK,330,0
9828702245,3/16/2015,640000.0,3,2.5,1620,1377,2.0,0.0,0.0,3,8,1100,520,2009,0,98112,47.6195,-122.29899999999999,1620,1251,3,16,2015,N,0,126
8687800150,11/20/2014,294000.0,3,2.0,1650,11256,1.0,0.0,0.0,4,7,1250,400,1957,0,98168,47.4707,-122.26,1860,11256,11,20,2014,UNK,-210,0
3825310760,12/29/2014,714000.0,4,2.5,3230,7766,2.0,0.0,0.0,3,9,3230,0,2005,0,98052,47.7069,-122.131,3740,8344,12,29,2014,N,-510,-578
7284900385,5/21/2014,970000.0,4,3.25,2790,5420,1.0,0.0,3.0,3,9,1130,1660,1963,2013,98177,47.7698,-122.38600000000001,2530,7200,5,21,2014,Y,260,-1780
5702380770,4/28/2015,280000.0,4,2.25,1600,7916,2.0,0.0,0.0,3,7,1600,0,1991,0,98022,47.193999999999996,-121.98100000000001,1540,7242,4,28,2015,UNK,60,674
2095600150,11/12/2014,260000.0,4,2.5,1790,4358,2.0,0.0,0.0,3,7,1790,0,1993,0,98031,47.3994,-122.204,1790,4305,11,12,2014,UNK,0,53
4166600230,11/19/2014,294000.0,3,1.5,2060,15050,1.5,0.0,0.0,4,7,2060,0,1938,0,98023,47.3321,-122.37299999999999,1900,15674,11,19,2014,UNK,160,-624
3521059042,7/28/2014,255500.0,4,1.0,1370,41194,1.5,0.0,2.0,5,5,1370,0,1900,0,98092,47.2716,-122.14399999999999,1590,84070,7,28,2014,UNK,-220,-42876
3625059043,9/4/2014,3300000.0,5,4.75,6200,13873,2.0,1.0,4.0,4,11,4440,1760,1989,0,98008,47.605,-122.11200000000001,2940,13525,9,4,2014,UNK,3260,348
1926069054,5/8/2014,450000.0,3,2.0,1510,43560,1.0,0.0,0.0,3,7,1510,0,1954,0,98077,47.7218,-122.079,2060,67756,5,8,2014,UNK,-550,-24196
9238450150,5/12/2014,368000.0,3,1.0,1280,9898,1.0,0.0,0.0,3,7,1280,0,1968,0,98072,47.7677,-122.163,1290,9625,5,12,2014,UNK,-10,273
8146200150,11/10/2014,830000.0,4,2.25,2180,11056,1.0,0.0,0.0,3,8,1370,810,1963,0,98004,47.6042,-122.193,2090,8747,11,10,2014,UNK,90,2309
3841600220,7/15/2014,282500.0,2,1.75,1440,11210,1.0,0.0,0.0,4,6,1130,310,1935,0,98146,47.49800000000001,-122.35,1250,9381,7,15,2014,UNK,190,1829
943100683,5/2/2014,335000.0,3,2.25,1580,16215,1.0,0.0,0.0,4,7,1580,0,1978,0,98024,47.5643,-121.897,1450,16215,5,2,2014,UNK,130,0
952001765,7/7/2014,558000.0,2,2.0,1580,5750,1.0,0.0,0.0,5,6,790,790,1910,0,98116,47.5668,-122.384,1580,5750,7,7,2014,UNK,0,0
3744600704,2/24/2015,270000.0,4,1.5,1730,8505,1.5,0.0,0.0,4,7,1730,0,1961,0,98146,47.4905,-122.34700000000001,1510,8505,2,24,2015,UNK,220,0
1822059057,7/25/2014,152000.0,2,1.0,700,13500,1.0,0.0,0.0,3,4,700,0,1920,0,98031,47.3882,-122.208,1600,10124,7,25,2014,UNK,-900,3376
2126059219,6/17/2014,493000.0,4,1.75,2030,18295,1.5,0.0,0.0,4,7,2030,0,1975,0,98034,47.7326,-122.179,1970,7307,6,17,2014,UNK,60,10988
4139400910,8/15/2014,740000.0,4,2.5,2500,10330,2.0,0.0,0.0,3,10,2500,0,1992,0,98006,47.5595,-122.11399999999999,2710,8375,8,15,2014,UNK,-210,1955
9808630210,3/13/2015,789800.0,3,2.5,2605,2216,2.0,0.0,2.0,3,9,2090,515,1979,0,98033,47.6536,-122.20299999999999,2605,2300,3,13,2015,UNK,0,-84
2920700220,5/8/2015,275000.0,2,1.0,910,4191,1.0,0.0,0.0,3,6,910,0,1910,0,98117,47.6929,-122.36,1480,6050,5,8,2015,UNK,-570,-1859
1338800365,5/7/2014,1500000.0,6,2.5,3560,6480,2.5,0.0,0.0,4,11,3560,0,1914,0,98112,47.626999999999995,-122.304,2780,6480,5,7,2014,UNK,780,0
1175001135,9/29/2014,424000.0,3,1.75,1140,3395,1.0,0.0,0.0,5,7,620,520,1925,0,98107,47.6712,-122.39299999999999,1480,3500,9,29,2014,UNK,-340,-105
3867400180,3/27/2015,715000.0,2,1.0,1000,3513,1.0,0.0,4.0,4,5,1000,0,1914,0,98116,47.5935,-122.39,1930,4920,3,27,2015,UNK,-930,-1407
7954300220,7/30/2014,600000.0,4,2.5,3010,7953,2.0,0.0,0.0,3,9,3010,0,2000,0,98056,47.522,-122.19,2670,6202,7,30,2014,UNK,340,1751
7784400035,8/13/2014,802000.0,2,1.75,2110,8700,1.0,0.0,4.0,4,9,1760,350,1960,0,98146,47.4912,-122.365,2120,9500,8,13,2014,UNK,-10,-800
4435600330,7/26/2014,165000.0,3,1.0,910,8700,1.0,0.0,0.0,4,6,910,0,1943,0,98188,47.449,-122.29,1090,8700,7,26,2014,UNK,-180,0
5016001285,6/9/2014,750000.0,4,3.25,2050,5000,2.0,0.0,0.0,4,8,1370,680,1987,0,98112,47.6235,-122.29799999999999,1720,5000,6,9,2014,UNK,330,0
6817800330,8/12/2014,405000.0,2,1.0,1090,10481,1.0,0.0,0.0,2,7,780,310,1981,0,98074,47.632,-122.03,1160,10533,8,12,2014,UNK,-70,-52
8680500220,12/3/2014,521900.0,3,2.5,2100,12338,2.0,0.0,0.0,3,9,2100,0,1997,0,98072,47.7412,-122.16799999999999,2320,6257,12,3,2014,UNK,-220,6081
3211600650,7/22/2014,275000.0,3,1.0,1000,8018,1.0,0.0,0.0,3,7,1000,0,1969,0,98034,47.7285,-122.198,1270,8000,7,22,2014,UNK,-270,18
4008400035,10/15/2014,600000.0,5,3.25,4410,58157,2.0,0.0,0.0,4,9,2330,2080,2001,0,98058,47.4395,-122.111,2460,42565,10,15,2014,UNK,1950,15592
2473002060,5/19/2014,442500.0,3,1.75,1800,10200,1.0,0.0,0.0,3,8,1800,0,1967,0,98058,47.4496,-122.146,2140,10128,5,19,2014,UNK,-340,72
4059400515,9/9/2014,229950.0,2,1.0,920,7716,1.0,0.0,0.0,3,6,920,0,1944,0,98178,47.5028,-122.243,1410,7128,9,9,2014,UNK,-490,588
2916610150,1/20/2015,274950.0,3,2.0,1410,7265,1.0,0.0,0.0,4,7,1410,0,1983,0,98042,47.3654,-122.07600000000001,1390,8060,1,20,2015,UNK,20,-795
8887001215,11/7/2014,407185.0,3,1.75,1860,48076,1.5,0.0,0.0,4,8,1860,0,1929,0,98070,47.5051,-122.461,1410,23066,11,7,2014,UNK,450,25010
3876313040,7/9/2014,468000.0,4,2.5,2100,8400,1.0,0.0,0.0,4,7,1240,860,1976,0,98072,47.735,-122.17,1980,8610,7,9,2014,UNK,120,-210
6021501320,9/30/2014,450000.0,2,1.0,1030,4365,1.0,0.0,0.0,3,7,1030,0,1942,0,98117,47.6875,-122.387,1420,4268,9,30,2014,UNK,-390,97
2372800145,10/23/2014,219950.0,2,1.0,940,8997,1.0,0.0,0.0,5,7,940,0,1955,0,98022,47.2005,-121.999,1110,9126,10,23,2014,UNK,-170,-129
7120000210,1/22/2015,275000.0,2,2.5,1340,5995,2.0,0.0,0.0,3,7,1340,0,1989,0,98028,47.7366,-122.23299999999999,1540,6616,1,22,2015,UNK,-200,-621
1180003175,4/10/2015,229950.0,2,1.0,850,6000,1.0,0.0,0.0,3,6,850,0,1924,0,98178,47.4972,-122.22399999999999,1100,6000,4,10,2015,UNK,-250,0
2902200915,11/25/2014,675000.0,3,1.75,2130,4400,1.0,0.0,0.0,3,7,1430,700,1922,0,98102,47.6417,-122.325,1710,3300,11,25,2014,UNK,420,1100
2473530150,3/23/2015,412950.0,4,2.5,2430,6796,2.0,0.0,0.0,3,8,2430,0,1993,0,98058,47.4499,-122.12700000000001,2450,8400,3,23,2015,UNK,-20,-1604
2366400150,4/29/2015,670000.0,5,2.25,2290,39000,2.0,0.0,0.0,3,8,2290,0,1979,0,98052,47.7012,-122.12,2750,39900,4,29,2015,UNK,-460,-900
4040800360,9/23/2014,420000.0,3,1.75,1230,10005,1.0,0.0,0.0,4,7,1230,0,1963,0,98008,47.621,-122.11399999999999,1530,8560,9,23,2014,UNK,-300,1445
1269200150,1/13/2015,358000.0,3,1.5,1150,27319,1.0,0.0,0.0,4,6,1150,0,1976,0,98070,47.3933,-122.454,1700,30691,1,13,2015,UNK,-550,-3372
9510970530,4/24/2015,680000.0,3,2.5,2120,3600,2.0,0.0,0.0,3,9,2120,0,2005,0,98052,47.6649,-122.08200000000001,2540,4592,4,24,2015,N,-420,-992
3856904825,11/4/2014,380000.0,2,1.0,980,3400,1.0,0.0,0.0,3,7,980,0,1923,0,98105,47.6688,-122.323,1200,3420,11,4,2014,UNK,-220,-20
326069101,12/5/2014,515000.0,3,2.5,2130,219978,2.0,0.0,0.0,3,8,2130,0,1986,0,98077,47.7754,-122.03200000000001,3340,217800,12,5,2014,UNK,-1210,2178
254000175,8/19/2014,325000.0,2,1.0,1050,4800,1.0,0.0,0.0,4,7,1050,0,1969,0,98146,47.5128,-122.38799999999999,1230,4800,8,19,2014,UNK,-180,0
8086000201,12/4/2014,875000.0,3,2.5,1820,6848,1.0,0.0,0.0,4,7,1820,0,1953,0,98004,47.6287,-122.20700000000001,2080,11700,12,4,2014,UNK,-260,-4852
9284800085,4/20/2015,426000.0,3,2.5,2210,5750,2.0,0.0,0.0,3,7,1710,500,1914,2000,98106,47.5525,-122.366,1350,5750,4,20,2015,Y,860,0
2287000330,9/15/2014,868500.0,5,2.5,2490,9639,1.0,0.0,0.0,4,8,1610,880,1959,0,98040,47.551,-122.22,2290,9958,9,15,2014,UNK,200,-319
2025760210,6/11/2014,657500.0,4,2.75,4140,24190,2.0,0.0,0.0,3,11,4140,0,2002,0,98092,47.3062,-122.15,3950,24190,6,11,2014,UNK,190,0
3330500085,9/18/2014,366000.0,2,1.0,1210,3090,1.0,0.0,0.0,3,6,860,350,1926,0,98118,47.5532,-122.277,1210,3348,9,18,2014,UNK,0,-258
1231001225,9/16/2014,385000.0,2,1.0,1010,4000,1.0,0.0,0.0,3,6,1010,0,1911,0,98118,47.5536,-122.26700000000001,1040,4000,9,16,2014,UNK,-30,0
984000650,9/8/2014,300000.0,4,2.0,2050,8750,1.0,0.0,0.0,3,7,1300,750,1967,0,98058,47.4324,-122.171,2050,8750,9,8,2014,UNK,0,0
1962200145,3/20/2015,810000.0,3,1.75,2060,3300,2.0,0.0,0.0,4,9,1500,560,1918,0,98102,47.6498,-122.32,1830,3712,3,20,2015,UNK,230,-412
4074300150,4/17/2015,460000.0,4,1.75,1560,7200,1.0,0.0,0.0,3,6,860,700,1943,0,98115,47.7001,-122.279,1420,7200,4,17,2015,UNK,140,0
8665050220,10/21/2014,459000.0,3,2.5,1780,4000,2.0,0.0,0.0,4,8,1780,0,1995,0,98029,47.5677,-122.00299999999999,1730,4000,10,21,2014,UNK,50,0
2212700180,3/19/2015,260000.0,3,1.75,1460,10000,1.0,0.0,0.0,4,8,1460,0,1967,0,98092,47.342,-122.195,1930,14175,3,19,2015,UNK,-470,-4175
8077200360,11/12/2014,557865.0,4,2.5,3030,6813,2.0,0.0,0.0,3,9,3030,0,1987,0,98074,47.6296,-122.029,2310,8682,11,12,2014,UNK,720,-1869
8850000180,4/20/2015,295000.0,4,1.0,980,3000,1.5,0.0,0.0,4,7,980,0,1914,0,98144,47.5892,-122.31200000000001,1525,3000,4,20,2015,UNK,-545,0
1643500072,9/5/2014,375000.0,4,2.25,1450,7245,1.0,0.0,0.0,5,7,1450,0,1950,1983,98133,47.7643,-122.34299999999999,1660,7800,9,5,2014,Y,-210,-555
6065300330,6/20/2014,2110000.0,3,2.25,3230,17833,2.0,0.0,0.0,4,9,3230,0,1973,0,98006,47.5683,-122.18799999999999,3690,17162,6,20,2014,UNK,-460,671
6149700191,8/19/2014,307300.0,2,2.0,1520,1020,3.0,0.0,0.0,3,7,1520,0,1999,0,98133,47.7292,-122.34299999999999,1500,1245,8,19,2014,UNK,20,-225
1555200180,8/27/2014,225000.0,4,1.0,1410,7000,1.5,0.0,0.0,3,7,1410,0,1963,0,98032,47.3767,-122.287,1540,7000,8,27,2014,UNK,-130,0
9407100720,11/7/2014,290000.0,3,1.75,1390,13200,2.0,0.0,0.0,3,7,1390,0,1979,0,98045,47.4429,-121.771,1430,10725,11,7,2014,UNK,-40,2475
5700000515,11/20/2014,690000.0,4,2.0,2230,5000,1.5,0.0,0.0,4,7,1510,720,1922,0,98144,47.5772,-122.292,2140,5000,11,20,2014,UNK,90,0
5451200530,7/5/2014,825000.0,4,2.25,2110,12653,2.0,0.0,0.0,4,8,2110,0,1972,0,98040,47.536,-122.225,2350,10980,7,5,2014,UNK,-240,1673
868000530,7/2/2014,645000.0,3,1.75,2270,11472,1.0,0.0,0.0,4,7,1370,900,1956,0,98177,47.7057,-122.374,2270,8340,7,2,2014,UNK,0,3132
1777600210,2/17/2015,590000.0,4,2.25,2530,10611,1.0,0.0,0.0,5,8,1320,1210,1977,0,98006,47.5698,-122.132,2530,10125,2,17,2015,UNK,0,486
7174800760,7/25/2014,667000.0,5,2.0,1900,5470,1.0,0.0,0.0,3,7,1180,720,1930,1965,98105,47.6666,-122.303,1300,3250,7,25,2014,Y,600,2220
8635750330,9/25/2014,664000.0,4,2.5,2390,8432,2.0,0.0,0.0,3,9,2390,0,1998,0,98074,47.6027,-122.024,2710,7417,9,25,2014,UNK,-320,1015
4058800925,4/28/2015,452100.0,4,2.5,3160,6540,1.0,0.0,3.0,3,8,1580,1580,1959,0,98178,47.5037,-122.24,1990,7090,4,28,2015,UNK,1170,-550
272000620,12/2/2014,290000.0,2,1.0,900,2728,2.0,0.0,0.0,3,7,900,0,1998,0,98144,47.5877,-122.29799999999999,900,2728,12,2,2014,UNK,0,0
7779200355,4/22/2015,950000.0,3,3.0,3610,17483,2.0,0.0,2.0,4,8,3610,0,1954,0,98146,47.4852,-122.35700000000001,2230,12600,4,22,2015,UNK,1380,4883
510000641,1/30/2015,662500.0,3,2.0,2070,4200,1.5,0.0,0.0,4,7,1670,400,1906,0,98103,47.6624,-122.333,1490,4560,1,30,2015,UNK,580,-360
8835200230,7/2/2014,475000.0,4,2.5,1850,5444,2.0,0.0,0.0,5,7,1850,0,1981,0,98034,47.7227,-122.16,1540,5000,7,2,2014,UNK,310,444
8718500555,9/15/2014,450000.0,3,1.5,1440,9711,1.0,0.0,0.0,3,7,1140,300,1956,0,98028,47.7394,-122.25200000000001,1590,9711,9,15,2014,UNK,-150,0
1722049154,7/7/2014,538250.0,3,2.25,2590,15229,2.0,0.0,3.0,3,8,2590,0,1984,0,98198,47.3948,-122.325,2590,15229,7,7,2014,UNK,0,0
6450304130,5/5/2014,329950.0,2,1.0,1140,5250,1.5,0.0,0.0,4,6,1140,0,1949,0,98133,47.731,-122.34100000000001,1450,5250,5,5,2014,UNK,-310,0
6908200155,1/22/2015,1100000.0,4,3.5,2760,5040,2.0,0.0,2.0,3,9,2760,0,1955,2005,98117,47.6756,-122.40100000000001,2370,5760,1,22,2015,Y,390,-720
1773101020,10/20/2014,307000.0,5,1.5,1310,4800,1.5,0.0,0.0,3,6,1110,200,1929,0,98106,47.5545,-122.365,960,4800,10,20,2014,UNK,350,0
1105000571,6/10/2014,433000.0,3,1.75,1870,7189,1.0,0.0,0.0,3,7,1270,600,1959,0,98118,47.5412,-122.27,1780,6200,6,10,2014,UNK,90,989
5153200666,1/14/2015,212000.0,3,2.25,1900,18000,1.0,0.0,0.0,4,7,1280,620,1968,0,98023,47.3251,-122.354,1920,15000,1,14,2015,UNK,-20,3000
7660100085,9/8/2014,750000.0,5,2.75,2860,6000,2.5,0.0,0.0,4,8,2380,480,1902,0,98144,47.5906,-122.316,2240,6000,9,8,2014,UNK,620,0
1843130530,11/25/2014,279000.0,3,2.0,1640,5650,1.0,0.0,0.0,3,7,1640,0,2003,0,98042,47.3736,-122.13,2250,5488,11,25,2014,UNK,-610,162
7010700905,6/11/2014,476000.0,3,1.0,1140,5500,1.5,0.0,0.0,4,6,1140,0,1908,0,98199,47.6606,-122.395,1690,4400,6,11,2014,UNK,-550,1100
6790600790,3/26/2015,368000.0,5,1.75,2590,9394,1.0,0.0,0.0,4,7,1390,1200,1963,0,98198,47.3941,-122.307,2580,9049,3,26,2015,UNK,10,345
8651442520,10/15/2014,228950.0,4,3.0,2160,5200,1.0,0.0,0.0,3,7,1320,840,1978,0,98042,47.3627,-122.09100000000001,1460,5144,10,15,2014,UNK,700,56
2722059010,6/18/2014,568450.0,5,3.5,3260,58806,2.0,0.0,0.0,4,8,3260,0,1969,0,98042,47.3703,-122.15899999999999,1810,17927,6,18,2014,UNK,1450,40879
6884800210,6/5/2014,619000.0,4,1.75,1660,3800,1.5,0.0,0.0,3,7,1660,0,1926,0,98115,47.6883,-122.314,1660,3767,6,5,2014,UNK,0,33
7349600230,7/29/2014,275000.0,3,2.25,1640,6044,2.0,0.0,0.0,3,7,1640,0,1996,0,98002,47.2844,-122.205,1600,7418,7,29,2014,UNK,40,-1374
6699300210,10/27/2014,321500.0,4,2.5,2620,5457,2.0,0.0,0.0,3,8,2620,0,2003,0,98001,47.3148,-122.27,2740,5816,10,27,2014,UNK,-120,-359
7883607520,5/8/2014,230000.0,3,1.75,950,6000,1.0,0.0,0.0,3,6,790,160,1939,0,98108,47.5271,-122.316,1360,6000,5,8,2014,UNK,-410,0
1450000210,1/28/2015,179500.0,3,1.0,900,8100,1.0,0.0,0.0,4,6,900,0,1959,0,98002,47.2866,-122.221,1000,7830,1,28,2015,UNK,-100,270
1387301430,8/18/2014,460000.0,3,2.25,1650,7313,1.0,0.0,0.0,3,7,1220,430,1975,0,98011,47.7375,-122.194,1690,7252,8,18,2014,UNK,-40,61
2517010230,2/26/2015,286000.0,3,2.5,1800,3980,2.0,0.0,0.0,3,7,1800,0,2006,0,98042,47.4006,-122.162,2580,4307,2,26,2015,N,-780,-327
9828201020,10/31/2014,427500.0,3,1.0,1480,4200,1.5,0.0,0.0,3,7,1480,0,1925,0,98122,47.6147,-122.29799999999999,1460,3600,10,31,2014,UNK,20,600
2461900175,5/22/2014,400000.0,3,1.0,1040,6250,1.0,0.0,0.0,3,7,1040,0,1942,0,98136,47.5526,-122.385,1770,6250,5,22,2014,UNK,-730,0
8682250330,6/24/2014,675000.0,3,3.5,2300,5611,1.0,0.0,0.0,3,8,2300,0,2004,0,98053,47.7122,-122.02600000000001,2170,5926,6,24,2014,N,130,-315
3031200230,2/26/2015,350000.0,3,1.0,2480,8906,1.0,0.0,0.0,3,7,1240,1240,1969,0,98118,47.5366,-122.289,1800,8906,2,26,2015,UNK,680,0
3824100166,11/22/2014,385000.0,4,1.75,1970,10358,1.0,0.0,0.0,3,8,1540,430,1977,0,98028,47.7719,-122.255,1900,10358,11,22,2014,UNK,70,0
7011201445,7/2/2014,525000.0,2,1.75,1530,3503,1.0,0.0,1.0,4,7,830,0,1916,0,98119,47.6368,-122.37100000000001,1280,1531,7,2,2014,UNK,250,1972
7262200150,1/21/2015,315000.0,2,1.0,970,18557,1.0,0.0,0.0,3,6,970,0,1939,0,98146,47.5116,-122.37,1150,7200,1,21,2015,UNK,-180,11357
1623069023,7/29/2014,820000.0,4,2.5,2920,252648,2.0,0.0,0.0,3,10,2920,0,2002,0,98027,47.4784,-122.04799999999999,2180,71874,7,29,2014,UNK,740,180774
7523700210,4/15/2015,205000.0,3,1.0,970,7700,1.0,0.0,0.0,4,7,970,0,1959,0,98032,47.3793,-122.304,1160,8250,4,15,2015,UNK,-190,-550
2915200210,12/5/2014,500000.0,2,1.0,680,5250,1.0,0.0,0.0,4,6,680,0,1922,0,98177,47.7013,-122.359,1620,5461,12,5,2014,UNK,-940,-211
3904990210,8/22/2014,599000.0,4,2.5,2640,6738,2.0,0.0,0.0,4,8,2640,0,1989,0,98029,47.5787,-122.0,2180,5782,8,22,2014,UNK,460,956
1333300145,3/4/2015,2230000.0,3,4.0,4200,30120,2.0,0.0,2.0,4,11,3600,600,1933,0,98112,47.6379,-122.311,2760,12200,3,4,2015,UNK,1440,17920
7461400360,4/21/2015,299000.0,1,2.5,1980,7521,1.0,0.0,0.0,4,7,1180,800,1979,0,98055,47.4343,-122.19200000000001,1980,8000,4,21,2015,UNK,0,-479
7631200085,5/12/2014,947500.0,3,2.75,2980,27144,1.5,1.0,2.0,5,8,2180,800,1917,0,98166,47.4522,-122.37799999999999,1890,12514,5,12,2014,UNK,1090,14630
6145600040,6/23/2014,385000.0,3,3.25,1630,1677,3.0,0.0,0.0,3,8,1630,0,2007,0,98133,47.7048,-122.353,1220,1677,6,23,2014,N,410,0
6372000155,8/11/2014,639950.0,2,1.75,1780,4520,1.0,0.0,0.0,5,7,890,890,1925,0,98116,47.5798,-122.404,1560,4520,8,11,2014,UNK,220,0
6821600145,11/10/2014,824000.0,2,1.0,1210,8400,1.0,0.0,0.0,3,8,780,430,2000,0,98199,47.6503,-122.39299999999999,1860,6000,11,10,2014,UNK,-650,2400
7983100150,6/2/2014,199950.0,3,1.0,1010,7245,1.0,0.0,0.0,3,7,1010,0,1969,0,98003,47.3338,-122.306,1300,8236,6,2,2014,UNK,-290,-991
723000150,4/8/2015,1010000.0,3,2.5,2570,5000,1.0,0.0,0.0,4,8,1480,1090,1940,0,98105,47.6578,-122.285,2420,5484,4,8,2015,UNK,150,-484
2493200155,4/3/2015,950000.0,4,2.25,2770,5320,2.0,0.0,1.0,3,9,2440,330,2013,0,98136,47.5283,-122.385,2100,6011,4,3,2015,N,670,-691
2592210150,9/23/2014,822000.0,3,2.5,2290,9158,2.0,0.0,0.0,4,8,2290,0,1984,0,98006,47.5476,-122.14,2210,9588,9,23,2014,UNK,80,-430
2595300210,11/6/2014,473600.0,4,1.5,1780,8400,1.0,0.0,0.0,3,7,1080,700,1969,0,98136,47.5173,-122.385,1660,8400,11,6,2014,UNK,120,0
3902100150,2/2/2015,490000.0,5,2.0,2150,4500,1.5,0.0,0.0,3,8,2150,0,1938,0,98116,47.5582,-122.38799999999999,1300,4500,2,2,2015,UNK,850,0
3329520410,5/5/2014,245000.0,3,1.75,1920,9306,1.0,0.0,0.0,3,7,1000,920,1984,0,98001,47.3319,-122.26700000000001,1860,8458,5,5,2014,UNK,60,848
4013800206,8/28/2014,199000.0,4,1.0,1220,11730,1.0,0.0,0.0,4,7,1220,0,1960,0,98001,47.3229,-122.28299999999999,1270,9520,8,28,2014,UNK,-50,2210
1370803460,5/7/2014,1340000.0,3,3.0,2960,5500,2.0,0.0,2.0,3,10,2440,520,1937,1990,98199,47.6356,-122.402,2960,5876,5,7,2014,Y,0,-376
4046600220,10/17/2014,418000.0,3,1.75,1500,19113,1.0,0.0,0.0,3,7,1500,0,1984,0,98014,47.6976,-121.916,1820,18151,10,17,2014,UNK,-320,962
6190701484,3/11/2015,450000.0,7,3.5,2830,8625,1.0,0.0,0.0,4,8,1830,1000,1957,0,98133,47.7493,-122.355,1570,8400,3,11,2015,UNK,1260,225
8016200530,7/18/2014,280000.0,3,2.5,1580,7000,2.0,0.0,0.0,3,8,1580,0,1992,0,98030,47.3659,-122.17,2110,7062,7,18,2014,UNK,-530,-62
6802210210,3/3/2015,273000.0,3,2.25,1230,11601,1.0,0.0,0.0,4,7,910,320,1992,0,98022,47.1955,-121.991,1820,8465,3,3,2015,UNK,-590,3136
4305600040,5/5/2014,549000.0,4,2.5,2910,6338,2.0,0.0,0.0,3,8,2910,0,2008,0,98059,47.4804,-122.126,2500,5877,5,5,2014,N,410,461
7856570150,6/25/2014,913888.0,5,2.25,2370,15512,2.0,0.0,0.0,4,9,2370,0,1981,0,98006,47.5555,-122.15,2380,15100,6,25,2014,UNK,-10,412
7576200040,7/18/2014,689888.0,4,2.25,1930,3500,1.5,0.0,0.0,5,8,1540,390,1916,0,98122,47.6167,-122.29,1800,5000,7,18,2014,UNK,130,-1500
6300500183,12/12/2014,305000.0,4,2.0,1780,5043,1.0,0.0,0.0,3,7,870,910,1993,0,98133,47.7045,-122.34200000000001,1350,5044,12,12,2014,UNK,430,-1
3204950120,5/29/2014,602500.0,4,2.5,2760,6850,2.0,0.0,0.0,3,9,2760,0,1999,0,98056,47.5346,-122.185,2640,9803,5,29,2014,UNK,120,-2953
7857004225,4/24/2015,355000.0,2,1.75,1620,3640,1.0,0.0,0.0,3,7,900,720,1929,0,98108,47.543,-122.29899999999999,1590,5538,4,24,2015,UNK,30,-1898
7732400360,8/21/2014,756000.0,3,2.5,2160,7525,2.0,0.0,0.0,3,9,2160,0,1986,0,98052,47.6608,-122.145,2470,7941,8,21,2014,UNK,-310,-416
4388000120,4/23/2015,289950.0,4,2.25,2190,6906,1.0,0.0,0.0,4,7,1040,1150,1977,0,98023,47.318999999999996,-122.37299999999999,1250,6440,4,23,2015,UNK,940,466
8653900150,5/5/2014,800000.0,3,2.5,3240,7857,2.0,0.0,0.0,3,10,3240,0,1994,0,98075,47.5857,-122.038,2970,7857,5,5,2014,UNK,270,0
3362400472,12/2/2014,403000.0,2,1.0,720,3255,1.0,0.0,0.0,4,6,720,0,1905,0,98103,47.6823,-122.348,1430,3170,12,2,2014,UNK,-710,85
8857100180,4/13/2015,350000.0,3,2.25,1410,1340,2.0,0.0,0.0,3,8,1370,40,1967,0,98008,47.6108,-122.113,1730,2748,4,13,2015,UNK,-320,-1408
8156600210,3/26/2015,1290000.0,5,3.5,2980,5100,2.0,0.0,0.0,3,10,2370,610,2015,0,98115,47.6782,-122.29899999999999,1780,5100,3,26,2015,N,1200,0
4038700720,9/18/2014,525126.0,5,2.25,1950,8025,1.0,0.0,2.0,3,7,1150,800,1960,0,98008,47.6159,-122.11399999999999,1780,8560,9,18,2014,UNK,170,-535
2634500085,8/12/2014,241450.0,3,1.0,1100,8138,1.0,0.0,0.0,3,7,1100,0,1949,0,98155,47.7393,-122.325,1440,8131,8,12,2014,UNK,-340,7
1077100035,1/22/2015,320000.0,3,1.5,1400,9087,1.0,0.0,0.0,3,7,1400,0,1954,0,98133,47.7711,-122.34,1490,8380,1,22,2015,UNK,-90,707
5466700360,10/23/2014,234000.0,4,2.0,1710,7455,1.0,0.0,0.0,3,7,1030,680,1975,0,98031,47.3965,-122.17299999999999,1710,7350,10,23,2014,UNK,0,105
1250201165,11/21/2014,441000.0,5,2.5,2000,3600,1.0,0.0,0.0,3,6,1150,850,1987,0,98144,47.5971,-122.295,1410,3600,11,21,2014,UNK,590,0
1250201165,3/17/2015,474500.0,5,2.5,2000,3600,1.0,0.0,0.0,3,6,1150,850,1987,0,98144,47.5971,-122.295,1410,3600,3,17,2015,UNK,590,0
4083301120,4/22/2015,705000.0,3,1.0,1440,2618,1.5,0.0,0.0,4,7,1440,0,1906,0,98103,47.6582,-122.336,1850,3990,4,22,2015,UNK,-410,-1372
3905100610,4/9/2015,517500.0,4,2.5,1520,3370,2.0,0.0,0.0,3,8,1520,0,1994,0,98029,47.5696,-122.00399999999999,1860,4486,4,9,2015,UNK,-340,-1116
4330600360,6/17/2014,142500.0,4,0.75,1440,13300,1.0,0.0,0.0,3,6,1440,0,1948,0,98166,47.4761,-122.337,1460,11100,6,17,2014,UNK,-20,2200
345700150,11/6/2014,310000.0,2,1.5,1010,10005,2.0,0.0,0.0,3,7,1010,0,1981,0,98056,47.5118,-122.189,1210,7794,11,6,2014,UNK,-200,2211
7732100150,10/28/2014,749500.0,4,2.5,2440,9727,2.0,0.0,0.0,3,9,2440,0,1987,0,98052,47.6613,-122.132,2370,11503,10,28,2014,UNK,70,-1776
5379800862,4/29/2015,360000.0,5,3.0,2480,7200,1.0,0.0,0.0,3,7,1560,920,1999,0,98188,47.4586,-122.28299999999999,1910,9432,4,29,2015,UNK,570,-2232
4396000180,11/21/2014,267500.0,3,1.0,1090,22080,1.0,0.0,0.0,5,7,1090,0,1967,0,98038,47.3991,-121.964,1590,19457,11,21,2014,UNK,-500,2623
1447600410,10/9/2014,290000.0,3,1.0,1480,32700,1.0,0.0,0.0,4,6,1380,100,1942,0,98168,47.4949,-122.32700000000001,1500,22600,10,9,2014,UNK,-20,10100
3325059177,11/5/2014,850000.0,5,2.5,2800,11325,1.0,0.0,0.0,4,8,1400,1400,1970,0,98005,47.6166,-122.17200000000001,2510,13700,11,5,2014,UNK,290,-2375
2652500155,10/29/2014,815000.0,4,1.75,1820,4500,1.5,0.0,0.0,3,8,1820,0,1921,0,98119,47.6429,-122.36,1870,3600,10,29,2014,UNK,-50,900
824059305,1/8/2015,2200000.0,5,4.0,5840,11652,2.0,0.0,1.0,3,11,4410,1430,1988,0,98004,47.5835,-122.20200000000001,3120,13639,1,8,2015,UNK,2720,-1987
5318101565,7/3/2014,1630000.0,4,3.25,2980,3600,2.0,0.0,0.0,3,9,2150,830,1999,0,98112,47.6352,-122.28399999999999,2980,4800,7,3,2014,UNK,0,-1200
2460600040,6/16/2014,175000.0,3,1.5,1220,7300,1.0,0.0,0.0,3,7,1220,0,1973,0,98001,47.3341,-122.279,1260,7347,6,16,2014,UNK,-40,-47
9527000040,10/2/2014,429950.0,3,1.75,1830,9758,1.0,0.0,0.0,3,8,1300,530,1977,0,98034,47.7107,-122.23,1850,8000,10,2,2014,UNK,-20,1758
2909300150,7/14/2014,675000.0,4,2.5,2900,5505,2.0,0.0,0.0,3,8,2900,0,2002,0,98074,47.6063,-122.02,2970,5251,7,14,2014,UNK,-70,254
8078600330,7/8/2014,580000.0,3,2.25,1940,5980,1.0,0.0,0.0,3,7,1520,420,1987,0,98027,47.5476,-122.075,1910,6309,7,8,2014,UNK,30,-329
4338800720,2/24/2015,240000.0,4,2.0,1750,7800,1.0,0.0,0.0,4,6,1750,0,1944,0,98166,47.4791,-122.34700000000001,1270,7800,2,24,2015,UNK,480,0
4016800120,8/20/2014,374000.0,3,2.5,1850,17808,1.0,0.0,0.0,4,8,1210,640,1982,0,98032,47.3631,-122.271,2260,16754,8,20,2014,UNK,-410,1054
2021201085,12/12/2014,862500.0,4,2.5,3220,4400,2.0,0.0,2.0,3,9,2180,1040,1937,0,98199,47.6325,-122.39399999999999,3000,5000,12,12,2014,UNK,220,-600
1922059010,1/21/2015,140000.0,2,1.0,1080,6052,1.0,0.0,0.0,5,6,1080,0,1908,0,98030,47.3857,-122.215,1810,7830,1,21,2015,UNK,-730,-1778
1133000385,5/30/2014,740000.0,5,3.75,3990,18897,2.0,0.0,0.0,3,8,3090,900,1937,0,98125,47.7228,-122.31,2080,9793,5,30,2014,UNK,1910,9104
2397100155,2/24/2015,589000.0,3,1.75,920,3600,1.0,0.0,0.0,4,6,820,100,1904,0,98119,47.6386,-122.365,1620,3600,2,24,2015,UNK,-700,0
7461420210,2/23/2015,275000.0,3,1.75,1290,9760,1.0,0.0,0.0,3,7,1290,0,1979,0,98058,47.4265,-122.148,1410,8034,2,23,2015,UNK,-120,1726
6204050040,7/11/2014,489900.0,4,2.5,2090,4196,2.0,0.0,0.0,3,8,2090,0,2006,0,98011,47.7453,-122.19200000000001,2640,4503,7,11,2014,N,-550,-307
4099100210,8/13/2014,545000.0,3,2.5,1900,3366,2.0,0.0,0.0,3,9,1900,0,1996,0,98033,47.6679,-122.184,2500,3954,8,13,2014,UNK,-600,-588
316000145,3/25/2015,235000.0,4,1.0,1360,7132,1.5,0.0,0.0,3,6,1360,0,1941,0,98168,47.5054,-122.301,1280,7175,3,25,2015,UNK,80,-43
3331000455,2/17/2015,230000.0,3,1.0,1000,4000,1.5,0.0,0.0,4,6,1000,0,1915,0,98118,47.5523,-122.286,1040,4240,2,17,2015,UNK,-40,-240
9839300775,7/10/2014,655000.0,4,2.25,2170,4080,2.0,0.0,0.0,3,7,1920,250,1980,0,98122,47.6124,-122.29299999999999,1890,4400,7,10,2014,UNK,280,-320
2320069107,8/22/2014,185000.0,2,1.0,820,16030,1.0,0.0,0.0,4,5,820,0,1923,0,98022,47.2039,-122.00299999999999,1880,14046,8,22,2014,UNK,-1060,1984
2599001010,3/26/2015,196000.0,3,1.0,1090,7400,1.0,0.0,0.0,4,7,1090,0,1962,0,98092,47.2923,-122.19,1140,8165,3,26,2015,UNK,-50,-765
2193340120,6/4/2014,572000.0,3,2.25,1830,7897,1.0,0.0,0.0,4,8,1290,540,1986,0,98052,47.6914,-122.103,1990,8306,6,4,2014,UNK,-160,-409
7954310210,4/30/2015,615000.0,4,2.5,3010,6903,2.0,0.0,0.0,3,9,3010,0,2001,0,98056,47.5213,-122.193,2860,6435,4,30,2015,UNK,150,468
2425049107,3/5/2015,1950000.0,4,3.75,4150,17424,1.0,0.0,0.0,3,9,3130,1020,1963,2000,98039,47.638999999999996,-122.236,3930,21420,3,5,2015,Y,220,-3996
1338300555,3/20/2015,1230000.0,6,2.25,2930,4320,2.0,0.0,0.0,3,9,2130,800,1913,0,98112,47.6295,-122.306,2860,4320,3,20,2015,UNK,70,0
8944310330,8/19/2014,375000.0,3,2.5,1520,5649,2.0,0.0,0.0,4,7,1520,0,1989,0,98034,47.7221,-122.162,1540,5000,8,19,2014,UNK,-20,649
2551500180,9/5/2014,295000.0,3,1.75,1250,9486,1.0,0.0,0.0,4,6,1250,0,1971,0,98070,47.4341,-122.446,1270,9600,9,5,2014,UNK,-20,-114
9212900180,6/25/2014,760000.0,4,2.5,2760,6000,2.0,0.0,0.0,5,7,2230,530,1942,0,98115,47.6877,-122.295,1600,6000,6,25,2014,UNK,1160,0
2473460650,4/7/2015,347000.0,3,1.75,1330,7848,1.0,0.0,0.0,3,8,1330,0,1978,0,98058,47.4463,-122.12700000000001,2110,8497,4,7,2015,UNK,-780,-649
2856101755,5/4/2015,712000.0,3,2.0,1700,5100,1.5,0.0,0.0,4,7,1500,200,1924,0,98117,47.678999999999995,-122.39,1700,5100,5,4,2015,UNK,0,0
3080000040,5/15/2014,495000.0,4,2.0,2050,4000,1.5,0.0,0.0,5,7,1210,840,1941,0,98144,47.5799,-122.306,1310,4000,5,15,2014,UNK,740,0
1224049080,6/20/2014,925000.0,4,2.0,3140,10437,1.0,0.0,0.0,4,8,2040,1100,1959,0,98040,47.5786,-122.229,2010,10437,6,20,2014,UNK,1130,0
9547200835,4/2/2015,775000.0,3,1.0,2030,4080,1.5,0.0,0.0,4,7,1840,190,1908,0,98115,47.6765,-122.30799999999999,2030,4080,4,2,2015,UNK,0,0
4363700365,8/1/2014,429000.0,4,2.5,2100,7920,1.5,0.0,0.0,4,6,1400,700,1916,0,98126,47.5293,-122.37100000000001,1230,7920,8,1,2014,UNK,870,0
7683800212,12/18/2014,229000.0,3,1.0,1010,12705,1.0,0.0,0.0,4,7,1010,0,1959,0,98003,47.3348,-122.303,1490,10200,12,18,2014,UNK,-480,2505
1324079054,9/22/2014,400000.0,4,1.5,1980,113691,1.0,0.0,0.0,3,7,1980,0,1962,0,98024,47.5606,-121.853,1980,89298,9,22,2014,UNK,0,24393
2141330360,7/29/2014,625000.0,4,2.25,2100,8290,2.0,0.0,0.0,4,8,2100,0,1978,0,98006,47.5595,-122.12899999999999,2100,8290,7,29,2014,UNK,0,0
6450302546,10/21/2014,130000.0,2,1.0,840,6654,1.0,0.0,0.0,3,7,840,0,1951,0,98133,47.7319,-122.335,1350,5831,10,21,2014,UNK,-510,823
7972600676,11/4/2014,349000.0,3,1.75,1690,5080,1.0,0.0,0.0,3,7,1190,500,1976,0,98106,47.5312,-122.348,1300,5080,11,4,2014,UNK,390,0
922059161,9/22/2014,365000.0,3,2.0,2140,26600,1.0,0.0,0.0,4,7,2140,0,1983,0,98031,47.4066,-122.169,2310,8783,9,22,2014,UNK,-170,17817
2770601461,3/17/2015,487500.0,3,2.5,1810,1988,2.0,0.0,0.0,3,7,1350,460,1997,0,98199,47.6513,-122.385,1600,1525,3,17,2015,UNK,210,463
8079010230,6/3/2014,475000.0,3,2.5,2600,7210,2.0,0.0,0.0,3,8,2600,0,1989,0,98059,47.5123,-122.15100000000001,2350,7225,6,3,2014,UNK,250,-15
5458800620,9/24/2014,685000.0,3,1.75,1650,8400,1.0,0.0,0.0,3,8,1470,180,1959,0,98040,47.5766,-122.236,2020,7777,9,24,2014,UNK,-370,623
5318101075,8/11/2014,960000.0,3,1.75,2460,4800,1.0,0.0,0.0,4,7,1230,1230,1938,0,98112,47.6343,-122.28200000000001,2860,4800,8,11,2014,UNK,-400,0
5430300120,11/13/2014,1100000.0,5,2.25,4320,7620,2.0,0.0,0.0,3,7,2880,1440,1973,2014,98115,47.6824,-122.287,1880,7620,11,13,2014,Y,2440,0
1442700360,3/20/2015,428000.0,3,2.25,2600,15000,2.0,0.0,0.0,3,9,2600,0,1978,0,98038,47.3719,-122.056,2380,15000,3,20,2015,UNK,220,0
5651010150,5/10/2015,435000.0,3,2.5,1930,5790,2.0,0.0,0.0,4,7,1930,0,1988,0,98011,47.7733,-122.17,1790,4901,5,10,2015,UNK,140,889
6908200021,10/28/2014,769950.0,3,2.0,2190,5400,1.0,0.0,2.0,5,7,1260,930,1952,0,98107,47.6737,-122.4,2160,5400,10,28,2014,UNK,30,0
2201500555,9/29/2014,385000.0,3,1.0,1420,10980,1.0,0.0,0.0,4,7,1200,220,1954,0,98006,47.574,-122.13799999999999,1630,9763,9,29,2014,UNK,-210,1217
255550150,11/18/2014,352000.0,3,2.5,2090,3002,2.0,0.0,0.0,3,7,1670,420,2005,0,98019,47.745,-121.984,2090,3163,11,18,2014,N,0,-161
524069011,9/11/2014,622500.0,3,2.5,2290,14374,2.0,0.0,0.0,3,8,2290,0,1983,2012,98075,47.5886,-122.074,2290,33450,9,11,2014,Y,0,-19076
7504010760,2/12/2015,660000.0,3,3.0,2470,11900,2.0,0.0,0.0,3,9,2290,180,1976,0,98074,47.64100000000001,-122.057,2590,11900,2,12,2015,UNK,-120,0
1788800610,9/2/2014,105000.0,3,1.0,840,8400,1.0,0.0,0.0,3,6,840,0,1959,0,98023,47.3277,-122.34299999999999,840,9450,9,2,2014,UNK,0,-1050
7192800145,12/2/2014,420000.0,2,1.0,2100,4480,1.0,0.0,0.0,5,7,1400,700,1908,0,98126,47.574,-122.37200000000001,1570,4400,12,2,2014,UNK,530,80
5566100145,9/3/2014,499950.0,3,1.5,1360,11250,1.0,0.0,0.0,4,7,1360,0,1955,0,98006,47.5697,-122.177,1440,11250,9,3,2014,UNK,-80,0
2024059052,8/14/2014,975000.0,6,3.0,3420,22421,1.0,0.0,0.0,5,9,2270,1150,1948,0,98006,47.5508,-122.189,2430,15560,8,14,2014,UNK,990,6861
2436700540,10/1/2014,665000.0,3,2.75,1930,2960,1.5,0.0,0.0,5,7,1490,440,1929,0,98105,47.6659,-122.287,2080,3760,10,1,2014,UNK,-150,-800
7200001608,7/1/2014,540000.0,4,2.5,2180,10140,1.0,0.0,0.0,4,7,1180,1000,1968,0,98052,47.6822,-122.111,1840,9375,7,1,2014,UNK,340,765
5612100065,5/29/2014,400000.0,4,2.0,1670,12056,1.0,0.0,0.0,3,7,1670,0,1955,0,98028,47.7418,-122.244,1860,12056,5,29,2014,UNK,-190,0
7785380150,12/15/2014,469950.0,4,2.75,2720,6427,1.0,0.0,0.0,3,8,1650,1070,2008,0,98146,47.4931,-122.354,2720,8484,12,15,2014,N,0,-2057
4178310040,10/16/2014,777000.0,4,2.5,3170,9900,2.0,0.0,0.0,4,8,3170,0,1979,0,98007,47.6181,-122.147,2540,12400,10,16,2014,UNK,630,-2500
1708400555,6/25/2014,346500.0,2,1.75,1610,6300,1.0,0.0,0.0,3,7,1010,600,1941,0,98108,47.553999999999995,-122.304,1370,5225,6,25,2014,UNK,240,1075
3629760330,3/11/2015,685000.0,3,2.5,2370,4950,2.0,0.0,0.0,3,8,2370,0,2003,0,98029,47.5465,-122.01299999999999,2230,4950,3,11,2015,UNK,140,0
5469501830,6/24/2014,396500.0,3,2.5,2590,18980,1.0,0.0,0.0,4,10,2590,0,1976,0,98042,47.3839,-122.15299999999999,3110,14652,6,24,2014,UNK,-520,4328
9829201058,5/4/2014,783500.0,3,2.5,2850,7130,2.0,0.0,0.0,3,10,1990,860,1980,0,98122,47.603,-122.289,2280,6459,5,4,2014,UNK,570,671
1931300175,7/2/2014,575000.0,4,2.0,1660,4800,1.5,0.0,0.0,3,7,1660,0,1922,0,98103,47.6556,-122.345,1660,4800,7,2,2014,UNK,0,0
7237500360,11/6/2014,1500000.0,4,4.25,5550,12968,2.0,0.0,0.0,3,11,5550,0,2005,0,98059,47.5305,-122.135,4750,13001,11,6,2014,N,800,-33
923000120,4/8/2015,515000.0,3,1.5,2200,7620,1.0,0.0,0.0,4,7,1130,1070,1942,0,98177,47.7263,-122.363,2170,7672,4,8,2015,UNK,30,-52
1446800995,8/5/2014,300000.0,3,2.5,2020,6628,1.0,0.0,0.0,4,7,1250,770,1963,0,98168,47.4934,-122.33200000000001,1540,9995,8,5,2014,UNK,480,-3367
8732000410,1/14/2015,272000.0,3,1.5,1760,9600,1.0,0.0,0.0,4,7,1760,0,1966,0,98031,47.4085,-122.195,1450,9600,1,14,2015,UNK,310,0
7303100210,5/27/2014,355000.0,4,2.25,1810,4970,2.0,0.0,0.0,3,7,1810,0,2003,0,98059,47.5003,-122.156,1810,4858,5,27,2014,UNK,0,112
3348401622,7/31/2014,223000.0,3,2.0,1310,8440,1.0,0.0,0.0,5,6,1310,0,1951,0,98178,47.5003,-122.26899999999999,1790,10775,7,31,2014,UNK,-480,-2335
3793501400,8/20/2014,397000.0,4,2.5,3000,8584,2.0,0.0,0.0,3,7,3000,0,2003,0,98038,47.369,-122.03200000000001,2610,7570,8,20,2014,UNK,390,1014
2872100385,3/18/2015,460000.0,2,2.0,1080,5000,1.0,0.0,0.0,5,6,1080,0,1923,0,98117,47.6826,-122.39399999999999,1530,5000,3,18,2015,UNK,-450,0
1689400150,2/6/2015,848000.0,3,2.75,2170,2738,1.5,0.0,0.0,4,9,1550,620,1930,0,98109,47.6389,-122.34899999999999,1170,1062,2,6,2015,UNK,1000,1676
2887701251,10/7/2014,392800.0,2,1.0,740,4275,1.0,0.0,0.0,5,6,740,0,1924,0,98115,47.688,-122.30799999999999,1900,4275,10,7,2014,UNK,-1160,0
3528000040,10/1/2014,1690000.0,3,3.25,5290,224442,2.0,0.0,0.0,4,11,4540,750,1988,0,98053,47.6671,-122.051,3750,84936,10,1,2014,UNK,1540,139506
3528000040,3/26/2015,1800000.0,3,3.25,5290,224442,2.0,0.0,0.0,4,11,4540,750,1988,0,98053,47.6671,-122.051,3750,84936,3,26,2015,UNK,1540,139506
3787000120,1/22/2015,577000.0,3,2.25,2370,7878,2.0,0.0,0.0,3,8,2370,0,1985,0,98034,47.7281,-122.16799999999999,1870,7766,1,22,2015,UNK,500,112
5693500760,7/7/2014,570000.0,3,1.0,1890,3330,1.5,0.0,0.0,4,7,1390,500,1901,0,98103,47.6597,-122.352,1530,3330,7,7,2014,UNK,360,0
8892900180,6/17/2014,250000.0,3,1.75,1160,6134,1.0,0.0,0.0,3,7,1160,0,1998,0,98002,47.3414,-122.21799999999999,1330,6301,6,17,2014,UNK,-170,-167
5458800330,9/4/2014,645000.0,4,1.75,1550,7350,1.5,0.0,0.0,4,8,1550,0,1958,0,98040,47.5795,-122.235,1860,7350,9,4,2014,UNK,-310,0
1560930450,10/24/2014,567500.0,3,2.5,3090,67082,2.0,0.0,0.0,3,9,3090,0,1990,0,98038,47.4032,-122.023,3650,62290,10,24,2014,UNK,-560,4792
6699930360,7/22/2014,337000.0,4,2.5,2610,5240,2.0,0.0,0.0,3,8,2610,0,2004,0,98038,47.345,-122.042,2480,5240,7,22,2014,N,130,0
1423900580,6/25/2014,280000.0,3,1.75,1230,8250,1.0,0.0,0.0,3,7,1230,0,1966,0,98058,47.4526,-122.176,1250,8250,6,25,2014,UNK,-20,0
7338000730,7/28/2014,167000.0,3,1.5,1280,5547,2.0,0.0,0.0,4,6,1280,0,1985,0,98002,47.3344,-122.215,1150,4500,7,28,2014,UNK,130,1047
4364700730,5/30/2014,280000.0,2,1.0,1880,7560,1.0,0.0,0.0,3,6,940,940,1919,0,98126,47.5261,-122.374,1280,7560,5,30,2014,UNK,600,0
7305300760,12/22/2014,317500.0,2,1.5,1220,8409,1.0,0.0,0.0,4,6,1220,0,1948,0,98155,47.7534,-122.324,1130,8409,12,22,2014,UNK,90,0
2488200455,7/3/2014,405500.0,2,2.75,1350,1252,2.0,0.0,0.0,3,8,1120,230,2006,0,98136,47.522,-122.39,1410,1265,7,3,2014,N,-60,-13
318900120,1/23/2015,495000.0,4,2.5,2370,15336,2.0,0.0,0.0,3,8,2370,0,1995,0,98024,47.5633,-121.90100000000001,2110,15925,1,23,2015,UNK,260,-589
7504110330,1/28/2015,691000.0,4,3.0,3040,11651,2.0,0.0,0.0,3,10,3040,0,1987,0,98074,47.6348,-122.038,2540,11815,1,28,2015,UNK,500,-164
2222039011,11/3/2014,480000.0,5,1.75,2080,217800,1.0,0.0,0.0,5,7,2080,0,1963,0,98070,47.3884,-122.404,1670,213008,11,3,2014,UNK,410,4792
6021502300,2/11/2015,549010.0,2,1.75,1560,4141,1.0,0.0,0.0,4,7,880,680,1942,0,98117,47.6863,-122.382,1210,4141,2,11,2015,UNK,350,0
3630110360,4/22/2015,750000.0,5,3.5,2980,5809,2.0,0.0,2.0,3,8,2980,0,2005,0,98029,47.5537,-121.99600000000001,2120,3416,4,22,2015,N,860,2393
1529300410,2/24/2015,365000.0,2,1.0,870,5689,1.0,0.0,0.0,4,7,870,0,1948,0,98103,47.6988,-122.351,1100,5711,2,24,2015,UNK,-230,-22
2426049154,3/5/2015,412500.0,3,1.75,1660,10716,1.0,0.0,0.0,3,7,1100,560,1988,0,98034,47.7326,-122.234,1630,7626,3,5,2015,UNK,30,3090
6204420180,6/3/2014,425000.0,3,2.25,1870,9000,1.0,0.0,0.0,3,7,1440,430,1978,0,98011,47.7373,-122.198,1870,8640,6,3,2014,UNK,0,360
8085400410,3/31/2015,920000.0,3,1.0,1410,9656,1.0,0.0,0.0,3,7,960,450,1953,0,98004,47.6354,-122.208,2410,9384,3,31,2015,UNK,-1000,272
8731980880,12/22/2014,340000.0,4,2.25,2180,8000,1.0,0.0,0.0,4,9,1630,550,1975,0,98023,47.317,-122.37799999999999,2310,8000,12,22,2014,UNK,-130,0
626049115,11/5/2014,405000.0,4,2.5,2620,8960,1.0,0.0,0.0,5,7,1520,1100,1955,0,98133,47.7642,-122.335,1880,8960,11,5,2014,UNK,740,0
6388910040,3/24/2015,537100.0,3,2.5,2450,7051,1.0,0.0,0.0,3,8,1870,580,1990,0,98056,47.5308,-122.171,2450,8788,3,24,2015,UNK,0,-1737
1748800120,3/18/2015,353500.0,4,2.5,3250,4650,2.0,0.0,0.0,3,8,3250,0,2007,0,98031,47.4004,-122.20299999999999,2960,4650,3,18,2015,N,290,0
4077800582,9/12/2014,522000.0,3,1.0,1150,7080,1.0,0.0,0.0,3,7,1150,0,1952,0,98125,47.7106,-122.288,1490,7921,9,12,2014,UNK,-340,-841
7202260210,10/10/2014,710000.0,4,2.75,2780,6978,2.0,0.0,0.0,3,8,2780,0,2001,0,98053,47.6881,-122.04,2760,5460,10,10,2014,UNK,20,1518
5095600360,3/12/2015,329950.0,3,1.75,1360,13320,1.0,0.0,0.0,4,7,1360,0,1985,0,98059,47.4625,-122.069,1580,13625,3,12,2015,UNK,-220,-305
2607801120,4/20/2015,830000.0,5,2.5,2810,14207,1.0,0.0,3.0,3,9,1540,1270,1979,0,98008,47.5742,-122.11,3190,14000,4,20,2015,UNK,-380,207
9542200610,2/19/2015,800500.0,4,2.5,1780,11130,1.0,0.0,0.0,5,8,1780,0,1962,0,98005,47.5931,-122.178,2610,11130,2,19,2015,UNK,-830,0
8092000330,5/28/2014,168500.0,3,1.0,1100,10125,1.0,0.0,0.0,3,7,1100,0,1969,0,98042,47.367,-122.10700000000001,1570,10650,5,28,2014,UNK,-470,-525
7852020790,6/27/2014,490000.0,3,2.5,2230,5348,2.0,0.0,0.0,3,8,2230,0,2000,0,98065,47.5347,-121.866,2190,5205,6,27,2014,UNK,40,143
6379500227,10/6/2014,579000.0,3,2.5,1710,1904,2.0,0.0,0.0,3,8,1140,570,2003,0,98116,47.5827,-122.387,1260,1316,10,6,2014,UNK,450,588
6790200180,6/3/2014,600000.0,4,2.5,2620,9873,2.0,0.0,0.0,3,8,2620,0,1987,0,98075,47.5822,-122.051,2520,9935,6,3,2014,UNK,100,-62
1781500155,5/29/2014,445000.0,4,1.75,1990,4725,1.5,0.0,0.0,4,7,1190,800,1944,0,98126,47.5275,-122.38,1240,4961,5,29,2014,UNK,750,-236
3424069154,6/24/2014,362500.0,4,1.75,1450,8450,1.0,0.0,0.0,3,7,1450,0,1960,0,98027,47.5289,-122.02799999999999,1540,8450,6,24,2014,UNK,-90,0
1683500180,5/14/2014,234000.0,4,2.0,1630,9010,1.0,0.0,0.0,4,7,1050,580,1975,0,98092,47.317,-122.196,1670,7820,5,14,2014,UNK,-40,1190
1523300180,7/9/2014,321500.0,1,1.0,730,1942,1.0,0.0,0.0,3,7,730,0,2008,0,98144,47.5939,-122.29899999999999,1020,2183,7,9,2014,N,-290,-241
1868901120,6/6/2014,660000.0,3,1.75,1980,3300,1.5,0.0,0.0,4,7,1140,840,1926,0,98115,47.6733,-122.29799999999999,1590,5000,6,6,2014,UNK,390,-1700
822059101,9/25/2014,319000.0,4,1.0,1730,36356,1.5,0.0,0.0,4,6,1730,0,1954,0,98031,47.4135,-122.199,1380,14060,9,25,2014,UNK,350,22296
3421069020,10/20/2014,314000.0,3,1.75,1350,217852,1.0,0.0,0.0,3,8,1100,250,1953,0,98022,47.2628,-122.03,2190,217800,10,20,2014,UNK,-840,52
2769602710,10/6/2014,517950.0,3,2.0,1410,5000,1.0,0.0,0.0,5,7,740,670,1908,0,98107,47.6752,-122.361,1830,4000,10,6,2014,UNK,-420,1000
6071300180,7/14/2014,525000.0,5,2.5,2360,10081,1.0,0.0,0.0,4,7,1180,1180,1961,0,98006,47.5552,-122.178,2200,10461,7,14,2014,UNK,160,-380
3211101010,2/11/2015,319500.0,3,1.0,1190,8450,1.0,0.0,0.0,5,6,1190,0,1961,0,98059,47.4807,-122.15700000000001,1660,8450,2,11,2015,UNK,-470,0
9471201175,5/6/2014,1580000.0,4,3.25,3760,10920,1.5,0.0,0.0,5,9,2400,1360,1950,0,98105,47.6687,-122.264,3430,11050,5,6,2014,UNK,330,-130
2009003136,8/22/2014,325000.0,1,1.0,1220,12426,1.0,0.0,4.0,4,6,1220,0,1946,0,98198,47.4047,-122.331,2770,22270,8,22,2014,UNK,-1550,-9844
7574910220,7/31/2014,795000.0,4,2.5,2920,32219,2.0,0.0,0.0,5,10,2920,0,1995,0,98077,47.7439,-122.041,3420,37206,7,31,2014,UNK,-500,-4987
1370801465,6/19/2014,850000.0,2,1.75,1590,5136,1.5,0.0,3.0,3,9,1320,270,1927,0,98199,47.6424,-122.411,2520,5243,6,19,2014,UNK,-930,-107
1245500730,12/8/2014,1010000.0,5,3.25,3510,10930,2.0,0.0,0.0,3,9,3510,0,2013,0,98033,47.6914,-122.21,1970,7488,12,8,2014,N,1540,3442
2767603591,8/4/2014,475000.0,3,2.5,1320,1310,3.0,0.0,0.0,3,8,1320,0,2006,0,98107,47.6719,-122.38,1350,1250,8,4,2014,N,-30,60
8718500665,7/24/2014,375000.0,3,1.0,1610,11250,1.0,0.0,0.0,3,7,1090,520,1975,0,98028,47.7391,-122.256,2040,10692,7,24,2014,UNK,-430,558
106000395,6/24/2014,405000.0,3,1.0,1410,8053,1.0,0.0,0.0,4,7,1410,0,1951,0,98177,47.70399999999999,-122.367,1170,8042,6,24,2014,UNK,240,11
5538300120,10/15/2014,420000.0,4,2.5,2170,10500,1.0,0.0,0.0,3,7,1570,600,1962,0,98155,47.7512,-122.295,1850,11127,10,15,2014,UNK,320,-627
9405800040,10/16/2014,775000.0,4,1.75,1890,4800,1.5,0.0,0.0,3,7,1390,500,1906,0,98119,47.6405,-122.367,1890,4800,10,16,2014,UNK,0,0
3630180450,4/7/2015,800000.0,4,2.75,3260,5000,2.0,0.0,0.0,3,9,3260,0,2007,0,98027,47.5395,-121.99700000000001,3450,6218,4,7,2015,N,-190,-1218
8126300610,4/1/2015,436800.0,3,1.75,2080,12714,2.0,0.0,0.0,4,8,1540,540,1984,0,98052,47.7056,-122.162,2080,12107,4,1,2015,UNK,0,607
546000910,12/3/2014,620000.0,3,1.75,2040,4005,1.5,0.0,0.0,4,8,1740,300,1930,0,98117,47.6885,-122.38,1380,4005,12,3,2014,UNK,660,0
2268000180,3/25/2015,230000.0,3,1.0,1250,9035,1.0,0.0,0.0,4,7,1250,0,1970,0,98003,47.275,-122.302,1350,10425,3,25,2015,UNK,-100,-1390
3333002450,7/8/2014,165000.0,1,1.0,850,8050,1.0,0.0,0.0,2,6,850,0,1906,0,98118,47.5427,-122.288,1590,5180,7,8,2014,UNK,-740,2870
3333002450,1/22/2015,490000.0,1,1.0,850,8050,1.0,0.0,0.0,2,6,850,0,1906,0,98118,47.5427,-122.288,1590,5180,1,22,2015,UNK,-740,2870
6072000910,8/6/2014,480000.0,3,1.75,1600,8400,1.0,0.0,0.0,5,8,1600,0,1963,0,98006,47.5479,-122.179,2210,8400,8,6,2014,UNK,-610,0
4113800330,6/6/2014,570000.0,3,2.5,2400,6975,2.0,0.0,0.0,3,9,2400,0,1993,0,98056,47.534,-122.179,2640,11172,6,6,2014,UNK,-240,-4197
3764500180,1/24/2015,615000.0,3,2.25,1870,4894,2.0,0.0,0.0,4,8,1750,120,1992,0,98033,47.6943,-122.19,1920,5988,1,24,2015,UNK,-50,-1094
1326049170,9/24/2014,280000.0,3,1.0,1720,9605,1.0,0.0,0.0,3,7,860,860,1969,0,98028,47.7439,-122.242,1720,9998,9,24,2014,UNK,0,-393
9238450210,6/23/2014,326000.0,3,1.0,1030,9834,1.0,0.0,0.0,3,7,1030,0,1969,0,98072,47.7676,-122.164,1210,9875,6,23,2014,UNK,-180,-41
2436700666,2/16/2015,550700.0,2,2.25,1190,1499,2.0,0.0,0.0,3,9,1100,90,2004,0,98105,47.6666,-122.285,1430,1332,2,16,2015,N,-240,167
3043200035,7/1/2014,600000.0,2,1.0,910,2002,1.5,0.0,0.0,3,6,910,0,1900,0,98112,47.6188,-122.306,1190,1208,7,1,2014,UNK,-280,794
1424069044,9/10/2014,450000.0,3,1.0,1290,47044,1.0,0.0,0.0,3,7,1150,140,1968,0,98029,47.5655,-121.99799999999999,1960,49658,9,10,2014,UNK,-670,-2614
3037200141,3/9/2015,546000.0,2,2.25,1530,1324,2.0,0.0,0.0,3,8,1280,250,2010,0,98122,47.6032,-122.311,1410,1689,3,9,2015,N,120,-365
1323089107,1/21/2015,585000.0,3,2.5,2330,33750,2.0,0.0,0.0,3,9,2330,0,1983,2001,98045,47.4787,-121.723,2270,35000,1,21,2015,Y,60,-1250
8024201714,11/17/2014,489000.0,3,1.75,2090,7667,1.0,0.0,2.0,3,7,1200,890,1952,0,98115,47.7007,-122.31200000000001,1480,7666,11,17,2014,UNK,610,1
9829200325,6/17/2014,765000.0,3,2.0,1570,7000,2.0,0.0,2.0,4,8,1050,520,1971,0,98122,47.6061,-122.286,1990,6675,6,17,2014,UNK,-420,325
723039189,1/2/2015,519000.0,3,1.75,1560,26099,1.0,0.0,3.0,4,8,1560,0,1973,0,98070,47.5023,-122.46700000000001,1760,19687,1,2,2015,UNK,-200,6412
1352300120,5/29/2014,262000.0,2,1.0,1500,4120,1.5,0.0,0.0,3,5,880,620,1928,0,98055,47.4857,-122.2,1300,4120,5,29,2014,UNK,200,0
5101404351,7/2/2014,550000.0,4,2.75,2160,5005,1.0,0.0,0.0,3,7,1430,730,1987,0,98115,47.6971,-122.302,1770,5326,7,2,2014,UNK,390,-321
7211401485,6/6/2014,285000.0,2,1.0,780,5000,1.0,0.0,0.0,4,6,780,0,1943,0,98146,47.5112,-122.35700000000001,1030,5000,6,6,2014,UNK,-250,0
5631500967,2/4/2015,476000.0,4,1.75,2340,17541,1.0,0.0,0.0,4,7,1360,980,1956,0,98028,47.745,-122.229,2250,9212,2,4,2015,UNK,90,8329
2425049061,8/25/2014,2200000.0,3,2.0,3570,30456,1.0,0.0,1.0,3,8,2070,1500,1946,1982,98039,47.6413,-122.24,3570,27418,8,25,2014,Y,0,3038
7518503065,6/23/2014,335000.0,1,1.0,720,5100,1.0,0.0,0.0,3,6,720,0,1907,0,98117,47.6821,-122.38,1320,5100,6,23,2014,UNK,-600,0
1796000120,10/23/2014,510000.0,4,2.0,2990,102366,1.0,0.0,0.0,4,8,2990,0,1974,0,98092,47.3068,-122.088,2820,57140,10,23,2014,UNK,170,45226
1922059197,9/18/2014,291000.0,3,2.25,1860,13939,1.0,0.0,0.0,4,7,1860,0,1961,0,98030,47.3746,-122.21700000000001,1530,10018,9,18,2014,UNK,330,3921
7849201020,8/21/2014,335000.0,4,1.75,1950,13440,1.5,0.0,0.0,4,6,1950,0,1931,0,98065,47.5232,-121.821,1300,7432,8,21,2014,UNK,650,6008
1126049103,8/29/2014,415000.0,3,1.5,1860,9003,1.0,0.0,0.0,3,7,1490,370,1955,0,98028,47.7624,-122.26,2090,11574,8,29,2014,UNK,-230,-2571
65000085,7/8/2014,430000.0,3,2.0,1550,6039,1.0,0.0,0.0,5,7,830,720,1942,0,98126,47.5436,-122.37799999999999,1330,6042,7,8,2014,UNK,220,-3
9211510410,4/7/2015,270000.0,3,1.75,1610,6205,1.0,0.0,0.0,4,7,1210,400,1979,0,98023,47.3004,-122.383,1780,8056,4,7,2015,UNK,-170,-1851
2301400325,4/7/2015,760000.0,3,2.0,1810,4500,1.0,0.0,0.0,4,7,980,830,1906,0,98117,47.681000000000004,-122.359,1800,4500,4,7,2015,UNK,10,0
7132300540,5/8/2015,450000.0,2,2.0,1730,4248,2.0,0.0,0.0,3,7,1730,0,1905,0,98144,47.5933,-122.30799999999999,1380,4000,5,8,2015,UNK,350,248
323059103,4/3/2015,425000.0,3,2.5,1230,23522,1.0,0.0,0.0,4,7,1230,0,1978,0,98059,47.515,-122.162,2340,23522,4,3,2015,UNK,-1110,0
4083306705,11/21/2014,725000.0,4,2.5,2130,3420,1.5,0.0,0.0,4,7,1730,400,1916,0,98103,47.648999999999994,-122.336,1520,3420,11,21,2014,UNK,610,0
1245001216,7/21/2014,700000.0,3,2.75,2190,11060,1.0,0.0,0.0,4,7,1610,580,1973,0,98033,47.6893,-122.208,2020,8588,7,21,2014,UNK,170,2472
293760210,8/26/2014,998000.0,5,4.5,4130,10404,2.0,0.0,0.0,3,10,4130,0,2004,0,98029,47.5556,-122.03,3890,11531,8,26,2014,N,240,-1127
3782400040,5/8/2015,396000.0,3,2.25,1680,9766,2.0,0.0,0.0,3,7,1680,0,1989,0,98019,47.7341,-121.98100000000001,1590,9757,5,8,2015,UNK,90,9
2726049164,6/5/2014,547000.0,3,2.5,1480,8381,1.0,0.0,0.0,4,7,1480,0,1968,0,98125,47.7078,-122.288,1710,8050,6,5,2014,UNK,-230,331
9183701085,4/15/2015,302000.0,4,1.5,1790,10200,1.0,0.0,0.0,4,8,1210,580,1963,0,98030,47.3774,-122.225,1540,6600,4,15,2015,UNK,250,3600
1623300325,10/21/2014,999000.0,5,3.5,2810,2700,2.0,0.0,0.0,5,9,1900,910,1910,0,98117,47.6799,-122.363,1510,3800,10,21,2014,UNK,1300,-1100
7987401010,7/3/2014,633000.0,4,2.5,2360,10000,1.0,0.0,3.0,3,8,1980,380,1977,0,98126,47.573,-122.374,2480,5000,7,3,2014,UNK,-120,5000
2131200065,12/11/2014,265800.0,3,1.75,1460,7361,1.0,0.0,0.0,3,6,1460,0,1982,0,98019,47.7436,-121.979,1460,7505,12,11,2014,UNK,0,-144
6141600065,10/16/2014,530000.0,3,2.25,2160,8114,1.0,0.0,0.0,3,8,1460,700,1960,0,98133,47.7176,-122.35,2160,8000,10,16,2014,UNK,0,114
1562100220,5/1/2015,605000.0,6,2.0,2610,9132,1.0,0.0,0.0,4,8,1320,1290,1965,0,98007,47.622,-122.14,2170,8000,5,1,2015,UNK,440,1132
7853300970,4/21/2015,489000.0,4,2.5,2170,4587,2.0,0.0,0.0,3,7,2170,0,2006,0,98065,47.5396,-121.889,2170,5211,4,21,2015,N,0,-624
8687800065,7/2/2014,305000.0,2,1.0,2160,12960,1.0,0.0,0.0,3,7,1360,800,1968,0,98168,47.4702,-122.26100000000001,2070,12960,7,2,2014,UNK,90,0
1504800097,6/13/2014,513000.0,4,2.75,2020,7070,1.0,0.0,0.0,5,7,1010,1010,1958,0,98126,47.5202,-122.37799999999999,1390,6000,6,13,2014,UNK,630,1070
3630160610,7/16/2014,765000.0,4,2.5,2980,5000,2.0,0.0,0.0,3,10,2980,0,2006,0,98027,47.5431,-121.99700000000001,3140,5500,7,16,2014,N,-160,-500
6852700477,9/16/2014,550000.0,2,1.5,1300,2970,1.0,0.0,0.0,3,7,990,310,1903,0,98102,47.6233,-122.319,1700,3000,9,16,2014,UNK,-400,-30
2592220040,7/24/2014,974350.0,4,2.5,3090,10730,2.0,0.0,0.0,5,8,2420,670,1985,0,98006,47.5458,-122.141,2220,7875,7,24,2014,UNK,870,2855
7524950730,3/27/2015,653675.0,4,2.25,2280,7229,2.0,0.0,0.0,4,8,2280,0,1984,0,98027,47.5609,-122.081,2320,7735,3,27,2015,UNK,-40,-506
1545807920,10/15/2014,245000.0,3,1.75,1260,8614,1.0,0.0,0.0,4,7,1260,0,1985,0,98038,47.3586,-122.056,1600,8614,10,15,2014,UNK,-340,0
3213200180,5/5/2015,700180.0,2,1.75,1530,4387,1.0,0.0,0.0,3,8,1020,510,1952,0,98115,47.6726,-122.264,1870,5029,5,5,2015,UNK,-340,-642
3577300040,4/30/2015,510000.0,3,2.5,1830,8133,1.0,0.0,0.0,3,8,1390,440,1996,0,98028,47.7478,-122.24700000000001,2310,11522,4,30,2015,UNK,-480,-3389
2064800610,10/25/2014,390000.0,3,2.5,1610,10292,1.0,0.0,0.0,4,7,1190,420,1969,0,98056,47.5349,-122.17399999999999,1940,8700,10,25,2014,UNK,-330,1592
7215730120,5/4/2015,606500.0,3,2.5,2170,5500,2.0,0.0,0.0,3,8,2170,0,2000,0,98075,47.5975,-122.01799999999999,2170,5862,5,4,2015,UNK,0,-362
629800540,9/9/2014,1500000.0,4,4.25,5020,26319,2.0,0.0,0.0,3,12,5020,0,1998,0,98074,47.6008,-122.01,4930,26319,9,9,2014,UNK,90,0
7575610760,5/7/2015,290000.0,3,2.25,1620,7772,2.0,0.0,0.0,4,8,1620,0,1988,0,98003,47.3521,-122.302,1710,6455,5,7,2015,UNK,-90,1317
104500730,2/24/2015,115000.0,3,1.75,1080,7942,1.0,0.0,0.0,3,7,1080,0,1981,0,98023,47.3141,-122.355,1380,8244,2,24,2015,UNK,-300,-302
8137500730,5/7/2014,500000.0,3,2.5,1940,37565,1.0,0.0,0.0,4,8,1940,0,1987,0,98027,47.4801,-122.06299999999999,2560,37565,5,7,2014,UNK,-620,0
3543900418,5/15/2014,580050.0,3,2.5,2360,4638,2.0,0.0,3.0,3,9,2360,0,1996,0,98115,47.6837,-122.321,1620,4638,5,15,2014,UNK,740,0
8929000230,3/6/2015,550000.0,3,2.5,2010,2261,2.0,0.0,0.0,3,8,1390,620,2014,0,98029,47.5514,-121.99799999999999,1690,1899,3,6,2015,N,320,362
2856100360,4/9/2015,465000.0,3,1.0,800,3060,1.5,0.0,0.0,4,6,800,0,1903,0,98117,47.6769,-122.389,1180,3060,4,9,2015,UNK,-380,0
6413600276,3/24/2015,354950.0,3,1.0,970,5922,1.5,0.0,0.0,3,7,970,0,1949,0,98125,47.718999999999994,-122.321,1730,6128,3,24,2015,UNK,-760,-206
8562720230,11/7/2014,980000.0,4,3.25,3720,7150,2.0,0.0,2.0,3,11,3720,0,2007,0,98027,47.5359,-122.069,4040,7442,11,7,2014,N,-320,-292
3579000410,9/5/2014,500000.0,3,2.25,2010,7447,2.0,0.0,0.0,3,8,2010,0,1985,0,98028,47.747,-122.24799999999999,2230,7846,9,5,2014,UNK,-220,-399
3856904655,3/29/2015,667750.0,4,1.0,1430,4080,1.5,0.0,0.0,3,7,1430,0,1924,0,98105,47.6696,-122.324,1760,4080,3,29,2015,UNK,-330,0
8832900360,4/28/2015,735000.0,3,1.75,2250,11520,1.0,0.0,1.0,3,8,2250,0,1956,0,98028,47.7619,-122.26799999999999,2730,12445,4,28,2015,UNK,-480,-925
4058200040,9/17/2014,361000.0,3,1.75,2130,8742,1.0,0.0,3.0,3,7,1330,800,1955,0,98178,47.5057,-122.23100000000001,2380,7448,9,17,2014,UNK,-250,1294
4178501020,1/5/2015,276750.0,3,2.0,1620,12482,1.0,0.0,0.0,4,7,1290,330,1989,0,98042,47.3584,-122.086,1560,8499,1,5,2015,UNK,60,3983
8562790730,8/22/2014,760000.0,4,3.25,3140,3680,2.0,0.0,0.0,3,10,2310,830,2009,0,98027,47.5319,-122.07600000000001,2620,2664,8,22,2014,N,520,1016
455000841,8/29/2014,475000.0,2,1.0,870,7975,1.0,0.0,2.0,3,7,870,0,1946,0,98107,47.6698,-122.361,1080,5722,8,29,2014,UNK,-210,2253
2154900330,8/27/2014,234000.0,4,2.5,1820,8217,1.0,0.0,0.0,3,7,1120,700,1987,0,98001,47.26300000000001,-122.242,1310,8217,8,27,2014,UNK,510,0
8159610150,11/17/2014,234950.0,3,2.0,1510,9153,1.0,0.0,0.0,4,7,1510,0,1974,0,98001,47.3412,-122.273,1780,9286,11,17,2014,UNK,-270,-133
1545800730,2/22/2015,269950.0,2,1.75,1320,7540,1.0,0.0,0.0,3,7,1320,0,1968,0,98038,47.3634,-122.052,1570,7540,2,22,2015,UNK,-250,0
3904980360,1/12/2015,495000.0,3,2.5,1800,7318,2.0,0.0,0.0,3,8,1800,0,1989,0,98029,47.5747,-122.008,1800,5414,1,12,2015,UNK,0,1904
5100403321,3/18/2015,438000.0,2,1.0,1120,6380,1.0,0.0,0.0,3,7,1120,0,1942,1994,98115,47.6951,-122.316,1230,6380,3,18,2015,Y,-110,0
1326069151,2/24/2015,260000.0,3,1.75,2160,22702,1.0,0.0,0.0,4,7,2160,0,1981,0,98019,47.7355,-121.98200000000001,1820,22687,2,24,2015,UNK,340,15
629410180,12/8/2014,697000.0,4,2.5,3220,6399,2.0,0.0,0.0,3,9,3220,0,2004,0,98075,47.5883,-121.991,2850,6399,12,8,2014,N,370,0
7452500815,3/10/2015,212625.0,2,1.0,960,5000,1.0,0.0,0.0,3,6,960,0,1951,0,98126,47.5188,-122.37200000000001,930,5000,3,10,2015,UNK,30,0
6840701135,11/10/2014,593000.0,5,2.5,2640,4400,1.5,0.0,0.0,5,7,1840,800,1925,0,98122,47.605,-122.3,1720,4400,11,10,2014,UNK,920,0
5104512060,12/12/2014,410000.0,4,3.0,2430,7243,2.0,0.0,0.0,3,8,2430,0,2003,0,98038,47.3533,-122.016,2430,7084,12,12,2014,UNK,0,159
2917200365,6/10/2014,445434.0,2,1.0,1470,7137,1.0,0.0,0.0,3,7,1020,450,1941,0,98103,47.7008,-122.352,1470,7067,6,10,2014,UNK,0,70
5151600040,9/11/2014,200126.0,3,2.5,2040,15463,1.0,0.0,0.0,3,8,1340,700,1968,0,98003,47.3334,-122.322,2370,12672,9,11,2014,UNK,-330,2791
2025700790,8/11/2014,290700.0,3,2.5,1670,6666,2.0,0.0,0.0,4,7,1670,0,1992,0,98038,47.3488,-122.03299999999999,1370,6170,8,11,2014,UNK,300,496
7686204675,1/29/2015,248000.0,4,1.0,1010,7515,1.0,0.0,0.0,4,6,1010,0,1955,0,98198,47.4174,-122.316,1330,7515,1,29,2015,UNK,-320,0
126039305,10/13/2014,345000.0,1,1.0,540,10125,1.0,0.0,0.0,3,5,540,0,1961,0,98177,47.7739,-122.35799999999999,1840,10125,10,13,2014,UNK,-1300,0
1930300915,8/20/2014,525000.0,3,1.0,1240,4800,1.0,0.0,0.0,3,7,800,440,1951,0,98103,47.6563,-122.353,1440,4800,8,20,2014,UNK,-200,0
9477100330,12/12/2014,400000.0,3,1.75,1510,8385,1.0,0.0,0.0,3,7,1510,0,1968,0,98034,47.7279,-122.195,1570,7480,12,12,2014,UNK,-60,905
513000665,4/8/2015,532000.0,3,1.0,1820,5750,1.0,0.0,0.0,3,7,1120,700,1918,0,98116,47.5773,-122.383,1500,5750,4,8,2015,UNK,320,0
8581400450,10/28/2014,159995.0,2,1.0,1000,5026,1.0,0.0,0.0,5,5,760,240,1915,0,98002,47.297,-122.225,990,5026,10,28,2014,UNK,10,0
1061500360,10/16/2014,287000.0,5,1.5,2040,11772,1.0,0.0,0.0,4,7,1030,1010,1963,0,98056,47.5015,-122.166,1560,9435,10,16,2014,UNK,480,2337
1373800330,4/20/2015,1120000.0,4,2.5,3690,11191,1.0,0.0,3.0,4,10,2190,1500,1951,0,98199,47.6434,-122.412,3460,8160,4,20,2015,UNK,230,3031
2597520790,4/23/2015,765000.0,3,2.5,2310,11993,2.0,0.0,0.0,3,9,2310,0,1988,0,98006,47.5438,-122.139,2830,10031,4,23,2015,UNK,-520,1962
2525300540,11/14/2014,185000.0,3,1.5,1090,9605,1.0,0.0,0.0,4,6,1090,0,1969,0,98038,47.3609,-122.02799999999999,1160,10487,11,14,2014,UNK,-70,-882
3797000035,5/21/2014,430000.0,3,1.0,1150,3000,1.0,0.0,0.0,5,6,1150,0,1906,0,98103,47.6867,-122.345,1460,3200,5,21,2014,UNK,-310,-200
3709600180,5/26/2014,346000.0,4,2.5,2100,3916,2.0,0.0,0.0,3,8,2100,0,2009,0,98058,47.4324,-122.185,2100,3916,5,26,2014,N,0,0
3902300210,7/15/2014,607000.0,4,2.75,2150,16728,1.0,0.0,0.0,4,8,1240,910,1982,0,98033,47.6915,-122.18299999999999,2200,9257,7,15,2014,UNK,-50,7471
2113700620,8/4/2014,417000.0,3,1.5,2500,6000,1.5,0.0,0.0,5,7,1730,770,1941,1984,98106,47.5297,-122.354,1340,5000,8,4,2014,Y,1160,1000
5700003705,6/19/2014,930000.0,5,2.0,3530,9385,1.5,0.0,0.0,3,9,3530,0,1925,0,98144,47.5774,-122.285,4100,9203,6,19,2014,UNK,-570,182
34001540,4/23/2015,573300.0,2,1.75,1290,6600,1.0,0.0,2.0,3,7,870,420,1951,0,98136,47.53100000000001,-122.39,2380,7370,4,23,2015,UNK,-1090,-770
2976800145,4/6/2015,260000.0,4,1.75,2010,10816,1.0,0.0,0.0,3,7,1410,600,1955,0,98178,47.5048,-122.251,1610,9360,4,6,2015,UNK,400,1456
7549801385,6/12/2014,280000.0,1,0.75,420,6720,1.0,0.0,0.0,3,5,420,0,1922,0,98108,47.552,-122.311,1420,6720,6,12,2014,UNK,-1000,0
9103000360,12/18/2014,825000.0,4,2.5,2180,4000,2.0,0.0,0.0,3,8,2180,0,1920,2005,98122,47.6186,-122.288,2660,4000,12,18,2014,Y,-480,0
7304300720,6/10/2014,307000.0,4,1.0,1150,8184,1.5,0.0,0.0,3,6,1150,0,1947,0,98155,47.7431,-122.319,990,8184,6,10,2014,UNK,160,0
1254200835,8/13/2014,595000.0,4,1.75,2000,5100,1.0,0.0,0.0,4,7,1130,870,1949,0,98117,47.6798,-122.391,1540,5100,8,13,2014,UNK,460,0
8562700410,4/15/2015,528000.0,5,1.75,2780,7786,1.0,0.0,0.0,3,8,1390,1390,1966,0,98052,47.6694,-122.15700000000001,2130,7918,4,15,2015,UNK,650,-132
7558800620,8/22/2014,600000.0,2,1.75,1550,7764,1.0,1.0,4.0,4,8,1550,0,1965,1986,98070,47.358000000000004,-122.446,1690,11620,8,22,2014,Y,-140,-3856
2122049038,3/2/2015,275000.0,2,1.0,2180,12875,1.0,0.0,0.0,3,7,1480,700,1959,0,98198,47.3757,-122.303,1800,7447,3,2,2015,UNK,380,5428
2397101075,7/2/2014,782000.0,2,1.5,1570,3600,1.5,0.0,2.0,4,7,1320,250,1906,0,98119,47.6366,-122.363,2140,3600,7,2,2014,UNK,-570,0
7695470120,8/8/2014,610000.0,3,2.5,2260,33042,1.0,0.0,0.0,3,9,1660,600,1986,0,98077,47.7634,-122.086,2600,40115,8,8,2014,UNK,-340,-7073
4083304700,11/25/2014,488000.0,3,1.0,1600,3200,1.5,0.0,0.0,3,7,1600,0,1909,0,98103,47.653,-122.331,1860,3420,11,25,2014,UNK,-260,-220
7857001225,4/3/2015,320000.0,3,1.0,1630,5000,1.0,0.0,0.0,3,7,930,700,1954,0,98108,47.5497,-122.295,1630,5480,4,3,2015,UNK,0,-480
4356200210,3/18/2015,153500.0,3,1.0,890,4810,1.0,0.0,0.0,3,6,890,0,1910,0,98118,47.5153,-122.266,1230,6057,3,18,2015,UNK,-340,-1247
3840700205,3/19/2015,414500.0,3,1.0,1350,9450,1.0,0.0,0.0,3,7,1350,0,1979,0,98034,47.7186,-122.236,1460,9461,3,19,2015,UNK,-110,-11
7739100155,8/4/2014,750000.0,5,1.75,2850,11860,1.0,0.0,0.0,3,9,2850,0,1951,0,98155,47.7503,-122.28,2640,11604,8,4,2014,UNK,210,256
1720069029,3/13/2015,349990.0,3,1.0,1350,165092,1.0,0.0,3.0,5,6,1350,0,1925,0,98022,47.2217,-122.06299999999999,2300,211266,3,13,2015,UNK,-950,-46174
921049141,12/1/2014,645000.0,3,2.25,3280,79279,1.0,0.0,0.0,3,10,3280,0,2001,0,98003,47.3207,-122.29299999999999,1860,24008,12,1,2014,UNK,1420,55271
6909700205,4/6/2015,425000.0,2,1.0,1090,6000,1.0,0.0,0.0,3,7,1090,0,1922,0,98144,47.5886,-122.292,1960,5000,4,6,2015,UNK,-870,1000
2725069164,8/5/2014,785000.0,4,2.5,2990,9374,2.0,0.0,0.0,3,9,2990,0,2003,0,98074,47.6287,-122.024,2440,8711,8,5,2014,UNK,550,663
3523069060,11/7/2014,290000.0,3,1.75,1340,63597,1.0,0.0,0.0,4,7,1340,0,1963,0,98038,47.4379,-122.01100000000001,1950,87120,11,7,2014,UNK,-610,-23523
3523069060,4/1/2015,415000.0,3,1.75,1340,63597,1.0,0.0,0.0,4,7,1340,0,1963,0,98038,47.4379,-122.01100000000001,1950,87120,4,1,2015,UNK,-610,-23523
4302200790,8/14/2014,248500.0,2,1.0,720,5160,1.0,0.0,0.0,3,6,720,0,1949,0,98106,47.5274,-122.35700000000001,990,5160,8,14,2014,UNK,-270,0
8899210610,7/23/2014,325000.0,3,2.5,2330,8627,1.0,0.0,0.0,4,7,1480,850,1980,0,98055,47.4543,-122.21,1940,9607,7,23,2014,UNK,390,-980
5631500905,7/23/2014,272925.0,2,1.0,1280,5728,1.5,0.0,0.0,5,6,1280,0,1941,0,98028,47.7477,-122.23200000000001,2480,9775,7,23,2014,UNK,-1200,-4047
2770601530,8/26/2014,500000.0,2,2.25,1570,1269,2.0,0.0,0.0,3,9,1280,290,2015,0,98199,47.6514,-122.385,1570,6000,8,26,2014,N,0,-4731
7831800411,10/20/2014,250000.0,4,1.75,1510,5500,1.5,0.0,0.0,3,7,1510,0,1920,0,98106,47.535,-122.359,1320,6431,10,20,2014,UNK,190,-931
326049103,9/22/2014,470000.0,4,2.5,2470,8536,2.0,0.0,0.0,3,8,2470,0,2002,0,98155,47.7699,-122.292,1690,8840,9,22,2014,UNK,780,-304
1231001115,10/1/2014,440000.0,2,1.0,1190,3400,1.0,0.0,0.0,4,7,990,200,1917,0,98118,47.5539,-122.26799999999999,1180,4000,10,1,2014,UNK,10,-600
1041440360,1/5/2015,299999.0,4,2.5,1981,4828,2.0,0.0,0.0,3,8,1981,0,2013,0,98092,47.3252,-122.167,1981,3783,1,5,2015,N,0,1045
5001700040,3/27/2015,255000.0,3,1.75,1590,7810,1.0,0.0,0.0,4,7,1590,0,1959,0,98002,47.2932,-122.22,1470,7810,3,27,2015,UNK,120,0
4037200665,8/13/2014,415950.0,3,1.75,1150,7700,1.0,0.0,0.0,3,7,1150,0,1957,0,98008,47.6048,-122.12100000000001,1650,8000,8,13,2014,UNK,-500,-300
5249802520,8/5/2014,402000.0,5,2.75,2160,7200,1.5,0.0,0.0,3,7,1220,940,1955,0,98118,47.5576,-122.273,1900,7200,8,5,2014,UNK,260,0
3585300410,4/24/2015,729000.0,3,1.5,1770,30689,1.0,0.0,4.0,3,9,1770,0,1953,0,98177,47.7648,-122.37,2650,30280,4,24,2015,UNK,-880,409
1624049087,9/17/2014,635000.0,2,2.5,2470,8840,2.0,0.0,0.0,4,8,1780,690,2001,0,98108,47.5693,-122.301,1940,8840,9,17,2014,UNK,530,0
8121200530,10/8/2014,479000.0,3,2.5,1710,8998,2.0,0.0,0.0,3,8,1710,0,1982,0,98052,47.7236,-122.11,1710,9859,10,8,2014,UNK,0,-861
6705120540,12/22/2014,462370.0,2,2.25,1860,2670,2.0,0.0,0.0,4,8,1860,0,1986,0,98006,47.5436,-122.18700000000001,1860,2531,12,22,2014,UNK,0,139
3353402390,5/1/2015,171500.0,3,1.0,1150,6480,1.5,0.0,0.0,4,5,1150,0,1946,0,98001,47.2642,-122.258,1100,7300,5,1,2015,UNK,50,-820
6190000035,7/15/2014,925000.0,5,3.0,3850,9457,2.0,0.0,0.0,4,9,2910,940,1963,0,98177,47.727,-122.36200000000001,2830,9608,7,15,2014,UNK,1020,-151
1313000220,5/13/2014,675000.0,5,3.0,3410,9600,1.0,0.0,0.0,4,8,1870,1540,1968,0,98052,47.6358,-122.103,2390,9679,5,13,2014,UNK,1020,-79
921059161,6/23/2014,320000.0,4,1.5,1890,43560,1.0,0.0,0.0,4,8,1890,0,1974,0,98092,47.3267,-122.166,2376,5820,6,23,2014,UNK,-486,37740
1823069279,5/20/2014,499950.0,5,3.5,3200,43560,2.0,0.0,0.0,3,7,3200,0,1989,0,98059,47.475,-122.09299999999999,2730,43560,5,20,2014,UNK,470,0
826059152,11/17/2014,435000.0,5,1.0,2170,65340,1.5,0.0,0.0,4,7,1670,500,1930,0,98011,47.7555,-122.204,3170,12884,11,17,2014,UNK,-1000,52456
4136930360,6/5/2014,359800.0,4,2.5,2390,6426,2.0,0.0,0.0,3,9,2390,0,1999,0,98092,47.2586,-122.221,2520,6700,6,5,2014,UNK,-130,-274
7697870530,5/7/2014,239900.0,3,2.0,1410,7566,1.0,0.0,0.0,3,7,1410,0,1985,0,98030,47.3674,-122.182,1570,7210,5,7,2014,UNK,-160,356
1024000109,7/10/2014,295000.0,2,1.0,740,4459,1.0,0.0,2.0,3,5,740,0,1915,0,98116,47.5704,-122.40899999999999,1490,4700,7,10,2014,UNK,-750,-241
5112800234,3/4/2015,380000.0,3,2.5,2150,25705,1.5,0.0,0.0,3,6,2150,0,1980,2009,98058,47.4514,-122.089,1850,20160,3,4,2015,Y,300,5545
8122101115,4/21/2015,435000.0,4,2.5,2180,6500,2.0,0.0,0.0,3,7,1410,770,1945,0,98126,47.5365,-122.37,920,6500,4,21,2015,UNK,1260,0
6933600540,8/20/2014,508000.0,2,1.0,820,5040,1.0,0.0,0.0,3,7,820,0,1953,0,98199,47.6498,-122.38799999999999,1730,5760,8,20,2014,UNK,-910,-720
6169900790,6/20/2014,2400000.0,6,4.5,5480,10800,2.0,0.0,3.0,4,9,4430,1050,1999,0,98119,47.6307,-122.367,2970,7200,6,20,2014,UNK,2510,3600
8001210120,9/16/2014,234500.0,4,2.5,1960,7875,1.0,0.0,0.0,3,7,1220,740,1978,0,98001,47.3427,-122.274,2030,7650,9,16,2014,UNK,-70,225
1931300870,5/28/2014,355000.0,2,1.0,1270,3200,1.0,0.0,0.0,4,7,960,310,1920,0,98103,47.6565,-122.348,1410,1320,5,28,2014,UNK,-140,1880
8651441210,8/1/2014,230000.0,3,2.0,1710,5200,1.0,0.0,0.0,5,7,1030,680,1977,0,98042,47.3651,-122.094,1390,5200,8,1,2014,UNK,320,0
1217000481,2/11/2015,345000.0,3,1.75,1930,9000,1.0,0.0,1.0,4,7,1150,780,1951,0,98166,47.4539,-122.348,1590,9000,2,11,2015,UNK,340,0
7925100271,5/20/2014,430000.0,3,1.75,1200,4500,1.0,0.0,0.0,5,7,1200,0,1906,0,98108,47.5553,-122.316,1340,4500,5,20,2014,UNK,-140,0
1233100366,12/15/2014,500000.0,3,1.5,1680,17409,1.0,0.0,0.0,3,7,1680,0,1962,0,98033,47.6766,-122.176,1680,9101,12,15,2014,UNK,0,8308
9250900124,5/5/2015,378000.0,4,1.0,1300,6075,1.0,0.0,0.0,5,7,1300,0,1954,0,98133,47.773,-122.34899999999999,1450,7320,5,5,2015,UNK,-150,-1245
7852050220,8/8/2014,345000.0,3,2.5,1540,3237,2.0,0.0,0.0,3,7,1540,0,1999,0,98065,47.5299,-121.87799999999999,1780,3411,8,8,2014,UNK,-240,-174
9297301520,3/29/2015,410000.0,2,1.75,870,4000,1.0,0.0,0.0,3,6,870,0,1941,0,98126,47.5657,-122.376,1420,4000,3,29,2015,UNK,-550,0
8615800325,8/22/2014,750000.0,2,2.25,1890,5400,2.0,0.0,0.0,5,8,1610,280,1905,0,98105,47.6688,-122.31,2820,4860,8,22,2014,UNK,-930,540
9512500610,1/22/2015,485000.0,4,1.75,2050,8913,1.0,0.0,0.0,3,7,1330,720,1968,0,98052,47.6735,-122.15100000000001,1290,8550,1,22,2015,UNK,760,363
4311700120,3/17/2015,105000.0,3,1.0,880,18109,1.0,0.0,0.0,4,6,880,0,1970,0,98042,47.3634,-122.101,940,11193,3,17,2015,UNK,-60,6916
1930301325,4/23/2015,1030000.0,3,2.75,2780,4000,2.0,0.0,2.0,5,8,1960,820,1904,0,98103,47.6565,-122.355,1490,4800,4,23,2015,UNK,1290,-800
3888100133,10/14/2014,360000.0,3,1.0,1160,10988,1.0,0.0,0.0,3,7,1160,0,1965,0,98033,47.6818,-122.165,1670,51376,10,14,2014,UNK,-510,-40388
9510900610,10/30/2014,294000.0,5,2.75,2300,7600,1.0,0.0,0.0,4,7,1400,900,1969,0,98023,47.3084,-122.37200000000001,1750,8500,10,30,2014,UNK,550,-900
5469502060,10/9/2014,400000.0,4,2.5,3140,12792,2.0,0.0,0.0,4,9,3140,0,1977,0,98042,47.3863,-122.156,2510,12792,10,9,2014,UNK,630,0
2946002914,1/2/2015,325000.0,3,1.75,2300,6200,1.0,0.0,0.0,4,7,1150,1150,1970,0,98198,47.4176,-122.323,1740,6600,1,2,2015,UNK,560,-400
7856640180,9/4/2014,770000.0,3,2.5,2900,23550,1.0,0.0,0.0,3,10,1490,1410,1987,0,98006,47.5708,-122.15299999999999,2900,19604,9,4,2014,UNK,0,3946
6204200180,7/9/2014,443000.0,3,2.25,1920,8223,2.0,0.0,0.0,4,7,1920,0,1989,0,98011,47.735,-122.20100000000001,1940,7274,7,9,2014,UNK,-20,949
5145100180,9/17/2014,325000.0,3,1.0,1150,7486,1.0,0.0,0.0,3,7,1150,0,1970,0,98034,47.7261,-122.219,1510,7486,9,17,2014,UNK,-360,0
3905090410,1/23/2015,760000.0,4,2.5,3120,8792,2.0,0.0,0.0,4,9,3120,0,1992,0,98029,47.5699,-121.993,2150,7688,1,23,2015,UNK,970,1104
5363200180,5/15/2014,640000.0,4,2.0,2560,7798,1.0,0.0,0.0,4,7,1890,670,1947,0,98115,47.6914,-122.296,1330,7798,5,15,2014,UNK,1230,0
8806900040,4/6/2015,415000.0,3,2.0,1410,4303,1.5,0.0,0.0,4,7,1410,0,1900,0,98108,47.5541,-122.31700000000001,1660,4326,4,6,2015,UNK,-250,-23
3674400035,5/12/2014,156000.0,3,1.0,970,8580,1.0,0.0,0.0,3,7,970,0,1959,0,98003,47.3363,-122.311,1430,11907,5,12,2014,UNK,-460,-3327
6648150150,9/22/2014,996000.0,3,3.25,3620,8131,2.0,0.0,0.0,4,10,2730,890,1988,0,98040,47.5776,-122.214,2040,3776,9,22,2014,UNK,1580,4355
9266700175,3/27/2015,415000.0,2,1.0,880,5100,1.0,0.0,0.0,4,7,880,0,1941,0,98103,47.693999999999996,-122.346,980,5100,3,27,2015,UNK,-100,0
3678900450,9/26/2014,615000.0,3,1.75,1900,3783,1.5,0.0,0.0,5,7,1110,790,1927,0,98144,47.5742,-122.315,1530,5098,9,26,2014,UNK,370,-1315
9526600210,10/7/2014,717000.0,4,2.5,2540,4241,2.0,0.0,0.0,3,8,2540,0,2009,0,98052,47.7073,-122.11200000000001,3010,4929,10,7,2014,N,-470,-688
631000040,3/31/2015,548000.0,4,1.75,1690,7794,1.0,0.0,0.0,3,7,1090,600,1968,0,98033,47.6888,-122.20299999999999,1380,7325,3,31,2015,UNK,310,469
2026049122,4/1/2015,425000.0,3,1.5,1120,6653,1.0,0.0,0.0,4,7,1120,0,1937,0,98133,47.7321,-122.334,1580,7355,4,1,2015,UNK,-460,-702
7523850150,10/27/2014,325250.0,4,2.75,2130,9339,1.0,0.0,0.0,3,7,1330,800,1991,0,98198,47.3788,-122.316,2090,7628,10,27,2014,UNK,40,1711
2326059080,8/1/2014,1230000.0,3,2.5,3420,79279,2.0,0.0,0.0,3,11,3420,0,1990,0,98052,47.7225,-122.126,4240,40500,8,1,2014,UNK,-820,38779
3211700035,6/25/2014,557500.0,3,1.75,1900,11165,1.0,0.0,0.0,4,7,1900,0,1959,0,98008,47.5789,-122.118,2030,11165,6,25,2014,UNK,-130,0
9365700385,7/14/2014,1260000.0,4,2.5,3730,16950,2.0,0.0,0.0,3,10,3730,0,1990,0,98040,47.5678,-122.228,3200,16950,7,14,2014,UNK,530,0
2734100736,9/10/2014,249950.0,3,3.0,1790,2003,2.0,0.0,0.0,3,7,1480,310,2006,0,98108,47.5421,-122.321,1220,4000,9,10,2014,N,570,-1997
5029460180,9/16/2014,260000.0,4,2.75,2250,7345,1.0,0.0,0.0,4,8,1320,930,1984,0,98023,47.2895,-122.37,1800,6950,9,16,2014,UNK,450,395
632000065,6/11/2014,1990000.0,3,2.5,2880,13500,1.0,0.0,4.0,5,8,1520,1360,1950,0,98004,47.6281,-122.21600000000001,3710,20486,6,11,2014,UNK,-830,-6986
6821101765,6/21/2014,442900.0,4,1.75,1780,2788,1.0,0.0,0.0,4,6,890,890,1943,0,98199,47.6511,-122.4,1760,5664,6,21,2014,UNK,20,-2876
7525050150,6/13/2014,475000.0,3,2.25,1580,12177,1.0,0.0,0.0,3,7,1200,380,1981,0,98074,47.6254,-122.045,1660,11374,6,13,2014,UNK,-80,803
2591780180,8/13/2014,365000.0,5,2.75,3260,9253,2.0,0.0,0.0,3,8,3260,0,2004,0,98042,47.3674,-122.07,2770,8067,8,13,2014,N,490,1186
4027700666,4/26/2015,780000.0,4,2.5,3180,9603,2.0,0.0,2.0,3,9,3180,0,2002,0,98155,47.7717,-122.277,2440,15261,4,26,2015,UNK,740,-5658
4083300620,2/27/2015,930000.0,3,1.75,2460,4240,1.0,0.0,0.0,4,7,1230,1230,1925,0,98103,47.6593,-122.337,1700,4240,2,27,2015,UNK,760,0
2303900035,6/11/2014,2890000.0,5,6.25,8670,64033,2.0,0.0,4.0,3,13,6120,2550,1965,0,98177,47.7295,-122.37200000000001,4140,81021,6,11,2014,UNK,4530,-16988
6300500515,8/18/2014,350000.0,3,1.0,1020,4980,1.0,0.0,0.0,4,7,850,170,1941,0,98133,47.7039,-122.34,970,4980,8,18,2014,UNK,50,0
6163900952,12/18/2014,357500.0,3,1.75,1630,9403,1.0,0.0,0.0,3,7,1630,0,1983,0,98155,47.757,-122.316,1430,8461,12,18,2014,UNK,200,942
5631500369,5/21/2014,520000.0,4,2.5,3290,11446,2.0,0.0,0.0,3,8,3290,0,1992,0,98028,47.7399,-122.234,2050,11933,5,21,2014,UNK,1240,-487
9558010230,5/9/2014,330000.0,4,2.5,1940,3784,2.0,0.0,0.0,3,8,1940,0,2003,0,98058,47.4513,-122.119,1940,4499,5,9,2014,UNK,0,-715
9407102245,6/4/2014,310000.0,3,2.0,1350,11150,1.0,0.0,0.0,3,7,1110,240,1995,0,98045,47.44600000000001,-121.77600000000001,1290,10043,6,4,2014,UNK,60,1107
1430800191,2/13/2015,279000.0,3,1.0,1110,6060,1.0,0.0,0.0,3,6,1110,0,1949,0,98166,47.4705,-122.352,1480,8100,2,13,2015,UNK,-370,-2040
7635801371,7/25/2014,540000.0,4,1.5,2993,19400,2.0,0.0,0.0,4,7,2233,760,1921,0,98166,47.4692,-122.365,2060,15100,7,25,2014,UNK,933,4300
2215450150,5/30/2014,322000.0,4,2.5,2280,7200,2.0,0.0,0.0,3,8,2280,0,1994,0,98030,47.3829,-122.20700000000001,2250,7200,5,30,2014,UNK,30,0
7146400040,3/12/2015,380000.0,5,3.25,3800,15500,1.0,0.0,0.0,3,7,2490,1310,1965,0,98032,47.3862,-122.28,2000,13980,3,12,2015,UNK,1800,1520
7635800180,4/28/2015,320000.0,2,1.0,850,8400,1.0,0.0,0.0,4,6,850,0,1941,0,98166,47.4696,-122.359,1280,8400,4,28,2015,UNK,-430,0
114100297,9/22/2014,400000.0,3,1.75,1560,8456,1.0,0.0,0.0,5,7,1560,0,1970,0,98028,47.7769,-122.25,2230,13109,9,22,2014,UNK,-670,-4653
6145601510,8/22/2014,412000.0,3,1.0,1000,3844,1.0,0.0,0.0,5,7,900,100,1928,0,98133,47.7031,-122.34899999999999,1000,3920,8,22,2014,UNK,0,-76
9550200155,4/7/2015,887200.0,3,1.0,1400,5100,1.5,0.0,0.0,3,7,1400,0,1900,0,98103,47.6677,-122.333,1740,3060,4,7,2015,UNK,-340,2040
8122100905,6/24/2014,395000.0,4,1.75,1540,5120,1.0,0.0,0.0,5,6,770,770,1943,0,98126,47.5359,-122.37200000000001,1080,5120,6,24,2014,UNK,460,0
2025069025,4/29/2015,895000.0,4,3.0,3570,10273,1.5,0.0,3.0,3,9,2630,940,1935,2007,98074,47.6394,-122.07700000000001,3640,15324,4,29,2015,Y,-70,-5051
5595900210,11/19/2014,195000.0,2,1.0,800,5280,1.0,0.0,0.0,5,6,800,0,1918,0,98022,47.205,-121.995,1240,7670,11,19,2014,UNK,-440,-2390
3157600325,6/20/2014,390000.0,3,1.0,1160,3750,1.5,0.0,0.0,3,7,1160,0,1910,0,98106,47.5652,-122.359,1530,3750,6,20,2014,UNK,-370,0
1432400120,11/11/2014,165000.0,3,1.0,1010,7690,1.0,0.0,0.0,4,6,1010,0,1958,0,98058,47.4501,-122.176,1010,7619,11,11,2014,UNK,0,71
1432400120,5/8/2015,255000.0,3,1.0,1010,7690,1.0,0.0,0.0,4,6,1010,0,1958,0,98058,47.4501,-122.176,1010,7619,5,8,2015,UNK,0,71
3811000230,3/16/2015,589000.0,4,2.25,2390,57599,2.0,0.0,0.0,3,8,2390,0,1981,0,98053,47.6651,-122.06700000000001,2390,38186,3,16,2015,UNK,0,19413
8665050770,6/19/2014,505000.0,3,2.5,1610,4611,2.0,0.0,0.0,3,8,1610,0,1996,0,98029,47.5678,-122.00399999999999,1730,4461,6,19,2014,UNK,-120,150
2976800360,2/23/2015,335750.0,3,3.0,2400,7260,1.0,0.0,0.0,3,7,1440,960,1955,0,98178,47.5045,-122.251,1060,7200,2,23,2015,UNK,1340,60
871001484,1/15/2015,719000.0,3,1.75,1800,5816,1.0,0.0,0.0,5,7,900,900,1947,0,98199,47.6529,-122.40700000000001,1650,5816,1,15,2015,UNK,150,0
9528104910,9/9/2014,796000.0,4,3.25,2110,3000,2.0,0.0,0.0,3,8,2110,0,2001,0,98115,47.6769,-122.32799999999999,1780,4000,9,9,2014,UNK,330,-1000
6929602721,4/8/2015,95000.0,2,1.0,960,7000,1.0,0.0,0.0,3,4,960,0,1918,0,98198,47.3864,-122.307,1850,8120,4,8,2015,UNK,-890,-1120
7203600530,5/29/2014,525000.0,3,3.0,2600,5238,1.5,0.0,3.0,3,9,1890,710,1989,0,98198,47.3448,-122.32700000000001,2220,4853,5,29,2014,UNK,380,385
2206500395,5/15/2014,417000.0,3,1.5,1340,10224,1.0,0.0,0.0,4,7,1340,0,1956,0,98006,47.5752,-122.15700000000001,1340,10440,5,15,2014,UNK,0,-216
9277200180,4/20/2015,410000.0,3,1.0,1410,5000,1.0,0.0,0.0,3,6,980,430,1925,0,98116,47.5769,-122.397,1410,5000,4,20,2015,UNK,0,0
6672900220,1/12/2015,984000.0,4,2.25,2390,12292,1.0,0.0,0.0,5,9,2390,0,1962,0,98040,47.5528,-122.221,2870,12337,1,12,2015,UNK,-480,-45
1139000072,4/3/2015,325000.0,2,1.5,1180,834,3.0,0.0,0.0,3,8,1180,0,2009,0,98133,47.7074,-122.35600000000001,1180,1207,4,3,2015,N,0,-373
7229900975,5/7/2014,314950.0,3,1.0,1040,16986,1.0,0.0,0.0,4,7,1040,0,1968,0,98059,47.4812,-122.09700000000001,1660,16986,5,7,2014,UNK,-620,0
5631500594,9/23/2014,350000.0,3,2.25,1840,9929,1.0,0.0,0.0,3,7,1200,640,1987,0,98028,47.7408,-122.236,1710,9929,9,23,2014,UNK,130,0
6861700156,10/27/2014,1050000.0,4,2.25,2630,4000,2.0,0.0,0.0,5,9,1810,820,1909,0,98102,47.6393,-122.31700000000001,2370,4700,10,27,2014,UNK,260,-700
6388930620,7/10/2014,657000.0,4,2.5,2640,25038,2.0,0.0,0.0,4,8,2640,0,1995,0,98056,47.5277,-122.17399999999999,2630,16668,7,10,2014,UNK,10,8370
2887970040,4/8/2015,234950.0,2,2.5,1720,3132,2.0,0.0,0.0,3,8,1720,0,1999,0,98042,47.3728,-122.15700000000001,1740,4220,4,8,2015,UNK,-20,-1088
726049213,3/20/2015,410000.0,4,1.75,2320,7500,1.0,0.0,0.0,3,7,1220,1100,1955,0,98133,47.7574,-122.34299999999999,2230,7500,3,20,2015,UNK,90,0
442000210,4/17/2015,625000.0,3,1.75,1840,5664,2.0,0.0,0.0,3,7,1270,570,1948,0,98115,47.6899,-122.28299999999999,1480,5664,4,17,2015,UNK,360,0
5525400530,4/23/2015,706000.0,5,2.5,2890,15891,2.0,0.0,0.0,3,9,2890,0,1990,0,98059,47.5286,-122.16,2590,10556,4,23,2015,UNK,300,5335
6093000065,5/19/2014,485000.0,3,1.75,2200,7706,2.0,0.0,2.0,3,7,2200,0,1908,1988,98198,47.3878,-122.32600000000001,1170,70973,5,19,2014,Y,1030,-63267
7519000085,10/2/2014,685000.0,4,2.75,1660,5150,1.5,0.0,0.0,5,7,1280,380,1928,0,98117,47.6835,-122.36200000000001,1490,4017,10,2,2014,UNK,170,1133
2525310220,10/16/2014,242050.0,3,2.5,2170,9900,1.0,0.0,0.0,3,7,1690,480,1980,0,98038,47.3634,-122.031,1420,10614,10,16,2014,UNK,750,-714
3630120970,9/22/2014,770000.0,3,3.25,3310,5000,2.0,0.0,0.0,3,9,3310,0,2006,0,98029,47.5558,-122.001,2670,4907,9,22,2014,N,640,93
1232001985,4/28/2015,557000.0,2,1.5,1450,3840,1.0,0.0,0.0,3,7,950,500,1947,0,98117,47.684,-122.381,1450,3840,4,28,2015,UNK,0,0
3422049158,7/11/2014,246000.0,3,1.75,1440,11325,1.0,0.0,0.0,4,8,1440,0,1966,0,98001,47.3503,-122.279,1440,20000,7,11,2014,UNK,0,-8675
2501600150,3/10/2015,194000.0,4,2.0,1760,7700,1.0,0.0,0.0,4,7,1760,0,1962,0,98003,47.3299,-122.318,1870,7316,3,10,2015,UNK,-110,384
3326059254,11/24/2014,720000.0,3,2.5,3170,7187,2.0,0.0,0.0,3,9,3170,0,2005,0,98033,47.6934,-122.166,2790,7336,11,24,2014,N,380,-149
2624049103,3/25/2015,449000.0,2,1.0,1250,4576,1.0,0.0,0.0,3,6,1040,0,1925,0,98118,47.5387,-122.266,1550,5000,3,25,2015,UNK,-300,-424
1525069095,6/19/2014,925000.0,4,2.5,3280,209088,2.0,0.0,0.0,3,10,3280,0,1994,0,98053,47.6553,-122.023,2460,39498,6,19,2014,UNK,820,169590
4077800455,3/26/2015,570000.0,4,3.0,2460,10401,1.0,0.0,0.0,5,7,1700,760,1947,0,98125,47.7106,-122.285,1470,7727,3,26,2015,UNK,990,2674
968000120,11/12/2014,395000.0,3,2.0,1470,10125,1.0,0.0,0.0,4,7,1470,0,1962,0,98011,47.7751,-122.22200000000001,1440,10125,11,12,2014,UNK,30,0
629000704,7/29/2014,1000000.0,4,2.0,1780,15648,1.5,0.0,0.0,5,8,1780,0,1918,0,98004,47.5849,-122.198,2320,14963,7,29,2014,UNK,-540,685
7129300175,7/1/2014,406000.0,4,1.0,1580,8475,1.5,0.0,2.0,4,7,1580,0,1928,0,98178,47.5104,-122.25399999999999,1700,5650,7,1,2014,UNK,-120,2825
2887703186,10/23/2014,574800.0,3,1.5,1630,2946,1.5,0.0,0.0,4,8,1630,0,1932,0,98115,47.6865,-122.31,1550,3800,10,23,2014,UNK,80,-854
3832500790,4/20/2015,309000.0,4,2.0,2240,9240,1.0,0.0,0.0,3,7,1120,1120,1968,0,98032,47.3666,-122.288,2040,8250,4,20,2015,UNK,200,990
2423069170,6/3/2014,770000.0,3,2.5,2430,54059,2.0,0.0,0.0,3,10,2430,0,1987,0,98027,47.4664,-121.992,2910,49658,6,3,2014,UNK,-480,4401
225039029,3/17/2015,525000.0,3,1.5,1940,5625,1.0,0.0,0.0,4,7,1440,500,1941,0,98117,47.6818,-122.38799999999999,1460,5500,3,17,2015,UNK,480,125
7852180650,7/18/2014,419000.0,3,2.5,1970,4058,2.0,0.0,0.0,3,7,1970,0,2004,0,98065,47.5308,-121.853,2340,4067,7,18,2014,N,-370,-9
5422500220,4/11/2015,479000.0,4,2.5,2050,6705,1.0,0.0,0.0,4,7,1230,820,1973,0,98034,47.7242,-122.21700000000001,1610,7292,4,11,2015,UNK,440,-587
8649400790,1/13/2015,160000.0,3,1.0,1340,18552,1.5,0.0,0.0,4,5,1340,0,1935,0,98014,47.7129,-121.325,960,15141,1,13,2015,UNK,380,3411
2473001210,9/16/2014,333000.0,4,1.75,1880,9880,1.0,0.0,0.0,4,8,1880,0,1967,0,98058,47.4551,-122.15100000000001,1880,9600,9,16,2014,UNK,0,280
9485700175,9/30/2014,310000.0,2,1.0,860,12160,1.0,0.0,0.0,4,6,860,0,1921,0,98106,47.5267,-122.361,1010,7611,9,30,2014,UNK,-150,4549
7694800180,2/5/2015,666000.0,3,2.5,2140,2868,2.0,0.0,0.0,3,8,1770,370,2007,0,98052,47.6668,-122.132,2140,2527,2,5,2015,N,0,341
7936500109,7/25/2014,2230000.0,3,3.0,3620,28064,2.0,1.0,4.0,5,10,2370,1250,1977,0,98136,47.5516,-122.398,2550,34713,7,25,2014,UNK,1070,-6649
104560540,9/17/2014,310000.0,4,2.75,2370,7320,2.0,0.0,0.0,3,7,2370,0,1989,0,98023,47.3071,-122.36,1960,7320,9,17,2014,UNK,410,0
8161000220,12/27/2014,350000.0,3,2.5,1860,21876,2.0,0.0,0.0,3,8,1860,0,1992,0,98014,47.6455,-121.90100000000001,2450,21876,12,27,2014,UNK,-590,0
2487200775,5/12/2014,610000.0,4,3.0,2110,5000,1.5,0.0,2.0,4,7,1640,0,1930,0,98136,47.5195,-122.391,1380,5000,5,12,2014,UNK,730,0
3905030330,10/8/2014,564800.0,3,2.25,1990,8501,2.0,0.0,0.0,3,8,1990,0,1991,0,98029,47.5707,-121.99600000000001,2090,6459,10,8,2014,UNK,-100,2042
2881700522,4/21/2015,438000.0,3,2.25,1820,9150,1.0,0.0,0.0,3,7,1320,500,1961,0,98133,47.736999999999995,-122.334,1780,8055,4,21,2015,UNK,40,1095
7856620870,8/13/2014,855000.0,3,2.0,3120,9400,1.0,0.0,0.0,5,9,1820,1300,1978,0,98006,47.5612,-122.15,2770,9500,8,13,2014,UNK,350,-100
179001046,5/8/2014,229000.0,3,2.5,1190,3000,2.0,0.0,0.0,3,7,1190,0,2002,0,98178,47.4933,-122.275,1190,3000,5,8,2014,UNK,0,0
7562100065,7/25/2014,260000.0,3,2.0,1170,5450,1.0,0.0,0.0,5,6,1170,0,1902,0,98118,47.5276,-122.273,1340,6384,7,25,2014,UNK,-170,-934
6891800360,9/18/2014,609000.0,3,2.5,2630,10131,2.0,0.0,0.0,3,9,2630,0,1989,0,98028,47.7695,-122.259,2800,10123,9,18,2014,UNK,-170,8
7211400760,5/28/2014,277000.0,4,1.0,1450,6250,1.0,0.0,0.0,3,6,990,460,1964,0,98146,47.5131,-122.35700000000001,1440,4000,5,28,2014,UNK,10,2250
123039207,12/9/2014,283000.0,4,2.0,2100,8160,1.0,0.0,0.0,3,7,1200,900,1959,0,98106,47.5145,-122.365,1140,8160,12,9,2014,UNK,960,0
3426049124,3/18/2015,334000.0,2,1.75,1680,8367,1.0,0.0,0.0,3,6,840,840,1914,0,98115,47.6976,-122.288,1830,6720,3,18,2015,UNK,-150,1647
4222500410,2/26/2015,267000.0,4,1.75,2000,7350,1.0,0.0,0.0,3,7,1100,900,1963,0,98003,47.3428,-122.303,1720,7350,2,26,2015,UNK,280,0
6716700325,7/14/2014,385000.0,3,1.0,1030,3000,1.0,0.0,0.0,3,7,830,200,1924,0,98115,47.6813,-122.31700000000001,1830,3000,7,14,2014,UNK,-800,0
431500155,10/24/2014,640000.0,5,1.75,2020,6565,1.0,0.0,0.0,3,8,1120,900,1956,0,98115,47.6821,-122.28299999999999,2020,6552,10,24,2014,UNK,0,13
626059220,5/6/2015,532500.0,4,2.0,2220,23750,1.0,0.0,0.0,3,7,2220,0,1963,0,98011,47.7759,-122.214,2650,21167,5,6,2015,UNK,-430,2583
1328340540,5/23/2014,335000.0,4,2.5,1750,8476,1.0,0.0,0.0,4,7,1240,510,1983,0,98058,47.4447,-122.137,1660,7875,5,23,2014,UNK,90,601
9269200120,10/30/2014,415000.0,3,2.5,1710,4920,2.0,0.0,0.0,3,7,1710,0,1990,0,98126,47.5347,-122.376,1500,4920,10,30,2014,UNK,210,0
2225059170,9/17/2014,1100000.0,6,3.25,3560,107362,1.5,0.0,0.0,4,8,2760,800,1963,0,98005,47.6356,-122.15,3210,35001,9,17,2014,UNK,350,72361
8835900220,8/28/2014,1440000.0,2,2.5,2720,16637,1.0,0.0,3.0,3,10,2160,560,1953,0,98118,47.5499,-122.264,2880,7320,8,28,2014,UNK,-160,9317
3192000085,8/7/2014,180000.0,3,1.0,1010,10215,1.0,0.0,0.0,3,6,1010,0,1955,0,98146,47.4872,-122.345,1320,10245,8,7,2014,UNK,-310,-30
5104520610,7/14/2014,335000.0,4,2.5,1830,4500,2.0,0.0,0.0,3,7,1830,0,2004,0,98038,47.3504,-122.005,2080,5100,7,14,2014,N,-250,-600
3530210180,7/23/2014,835000.0,4,3.0,4480,42717,2.0,0.0,0.0,3,9,4480,0,1987,0,98077,47.7711,-122.088,3140,41632,7,23,2014,UNK,1340,1085
6840701225,10/3/2014,592500.0,4,1.5,2080,4400,1.5,0.0,0.0,3,7,2080,0,1925,0,98122,47.606,-122.29899999999999,1680,4400,10,3,2014,UNK,400,0
7979900210,8/8/2014,418900.0,3,1.5,1470,11112,1.0,0.0,0.0,3,7,1470,0,1954,0,98155,47.7462,-122.294,1460,11407,8,8,2014,UNK,10,-295
3343901183,7/9/2014,340000.0,3,1.0,1600,7324,1.0,0.0,0.0,4,7,1600,0,1958,0,98056,47.5054,-122.19,1430,7249,7,9,2014,UNK,170,75
5249804825,7/2/2014,545000.0,3,2.0,1340,7200,1.5,0.0,0.0,4,7,1340,0,1923,0,98118,47.5601,-122.265,1630,5760,7,2,2014,UNK,-290,1440
1234000704,4/3/2015,1380000.0,5,3.5,3680,8680,2.0,0.0,0.0,3,9,3680,0,2003,0,98033,47.6575,-122.197,2020,8847,4,3,2015,UNK,1660,-167
646910150,3/26/2015,183750.0,3,2.5,1770,3451,2.0,0.0,0.0,3,7,1770,0,2004,0,98055,47.4325,-122.197,1490,2138,3,26,2015,N,280,1313
9407001320,5/22/2014,295000.0,4,2.0,980,10640,1.0,0.0,0.0,5,7,980,0,1978,0,98045,47.4462,-121.773,1230,9750,5,22,2014,UNK,-250,890
9527000180,7/11/2014,625000.0,4,3.0,2530,5625,1.0,0.0,0.0,3,8,1470,1060,1976,0,98034,47.7094,-122.23299999999999,1840,7070,7,11,2014,UNK,690,-1445
7225000155,6/9/2014,290000.0,4,3.0,2390,4500,2.0,0.0,0.0,3,7,2390,0,1974,0,98055,47.4872,-122.204,1320,4500,6,9,2014,UNK,1070,0
3622069103,1/23/2015,760000.0,4,2.5,3600,155509,2.0,0.0,0.0,3,9,3600,0,2004,0,98010,47.3538,-121.986,3410,34412,1,23,2015,N,190,121097
3345100286,2/19/2015,560000.0,4,2.5,3270,24750,1.0,0.0,0.0,4,8,1690,1580,1979,0,98056,47.5221,-122.178,1520,13480,2,19,2015,UNK,1750,11270
203100910,9/23/2014,475000.0,5,2.5,2300,28480,2.0,0.0,0.0,3,6,2300,0,1994,0,98053,47.6403,-121.964,1880,26720,9,23,2014,UNK,420,1760
1257201530,5/13/2014,620000.0,3,1.0,1710,4050,1.5,0.0,0.0,3,7,1710,0,1909,0,98103,47.6732,-122.331,1790,4896,5,13,2014,UNK,-80,-846
3083000365,5/8/2015,330000.0,4,2.0,1170,4000,1.0,0.0,0.0,3,7,1170,0,1955,0,98144,47.5797,-122.305,1720,4000,5,8,2015,UNK,-550,0
1245000865,4/8/2015,620000.0,3,2.25,1990,6256,1.0,0.0,0.0,3,7,1390,600,1960,0,98033,47.6903,-122.206,2080,9300,4,8,2015,UNK,-90,-3044
5104220120,1/7/2015,320000.0,4,1.75,1710,10480,1.5,0.0,0.0,4,6,1710,0,1969,0,98059,47.4743,-122.14299999999999,1750,10480,1,7,2015,UNK,-40,0
9828701608,9/15/2014,525000.0,3,2.5,1740,2350,2.0,0.0,0.0,3,8,1120,620,1996,0,98112,47.6206,-122.29700000000001,1750,3802,9,15,2014,UNK,-10,-1452
98020410,7/21/2014,802500.0,4,3.75,3320,8030,2.0,0.0,0.0,3,10,3320,0,2005,0,98075,47.5818,-121.97200000000001,3740,8030,7,21,2014,N,-420,0
3416601021,9/26/2014,569500.0,4,1.0,1960,3194,2.0,0.0,0.0,3,7,1960,0,1907,0,98144,47.6005,-122.296,1870,4200,9,26,2014,UNK,90,-1006
3052700610,12/16/2014,850000.0,6,3.5,2820,5400,1.0,0.0,0.0,3,8,1620,1200,1958,0,98117,47.6791,-122.374,1560,2276,12,16,2014,UNK,1260,3124
8818400155,4/5/2015,630000.0,3,1.0,1590,4080,1.5,0.0,0.0,3,7,1590,0,1922,0,98105,47.662,-122.32600000000001,1570,4080,4,5,2015,UNK,20,0
8562901830,8/5/2014,454800.0,4,2.25,2490,10720,1.0,0.0,1.0,4,7,1400,1090,1979,0,98074,47.6137,-122.06,3080,10720,8,5,2014,UNK,-590,0
8651430870,3/3/2015,177000.0,3,1.0,870,5200,1.0,0.0,0.0,5,6,870,0,1969,0,98042,47.3695,-122.081,870,5200,3,3,2015,UNK,0,0
721049207,6/19/2014,275000.0,3,1.75,1860,15681,1.0,0.0,0.0,4,7,1860,0,1971,0,98023,47.3191,-122.339,1860,22979,6,19,2014,UNK,0,-7298
3463400330,4/16/2015,460000.0,3,2.0,2930,29136,2.0,0.0,0.0,3,8,2240,690,1990,0,98010,47.3102,-122.042,2110,29362,4,16,2015,UNK,820,-226
6003500995,6/17/2014,729000.0,3,1.0,1580,3840,2.0,0.0,0.0,3,8,1580,0,1908,0,98102,47.6192,-122.319,1680,2624,6,17,2014,UNK,-100,1216
4139430910,10/21/2014,935000.0,4,3.25,4110,15488,2.0,0.0,2.0,3,11,4110,0,1995,0,98006,47.5493,-122.117,4190,14973,10,21,2014,UNK,-80,515
1232000915,5/9/2014,481450.0,3,2.0,1410,4800,1.0,0.0,0.0,3,7,1410,0,1940,0,98117,47.6852,-122.37799999999999,1190,3840,5,9,2014,UNK,220,960
1954700365,3/17/2015,860000.0,3,2.0,2090,4190,1.5,0.0,0.0,4,8,1490,600,1930,0,98122,47.6178,-122.28399999999999,2090,6270,3,17,2015,UNK,0,-2080
8074200175,11/6/2014,274000.0,3,1.75,1400,8364,1.0,0.0,0.0,4,7,1400,0,1958,0,98056,47.4918,-122.178,1210,8160,11,6,2014,UNK,190,204
6821101762,6/5/2014,499000.0,3,3.5,1690,1432,2.0,0.0,0.0,3,7,1360,330,2008,0,98199,47.6513,-122.4,1650,2788,6,5,2014,N,40,-1356
1774230180,9/17/2014,696500.0,5,2.25,3210,61419,1.5,0.0,0.0,3,8,3210,0,1979,0,98077,47.7632,-122.09,2820,48351,9,17,2014,UNK,390,13068
2051200506,4/13/2015,390000.0,3,1.0,1190,85226,1.5,0.0,0.0,5,5,1190,0,1935,0,98070,47.365,-122.462,1360,46960,4,13,2015,UNK,-170,38266
7851200040,12/16/2014,265000.0,3,1.0,960,9748,1.0,0.0,0.0,3,5,960,0,1922,0,98065,47.5259,-121.815,1600,9958,12,16,2014,UNK,-640,-210
4027701326,7/9/2014,470000.0,4,2.25,2380,17199,2.0,0.0,0.0,3,8,1530,850,1979,0,98028,47.7668,-122.27,2280,11529,7,9,2014,UNK,100,5670
923049110,1/29/2015,168500.0,2,1.0,1020,7742,1.0,0.0,0.0,4,6,1020,0,1935,0,98168,47.498999999999995,-122.301,1510,7742,1,29,2015,UNK,-490,0
3329500730,11/11/2014,220000.0,3,1.75,1290,8250,1.0,0.0,0.0,3,7,1290,0,1983,0,98001,47.3353,-122.27,1410,7823,11,11,2014,UNK,-120,427
5476800201,10/20/2014,295000.0,3,2.0,1830,17321,1.0,0.0,0.0,4,7,1100,730,1948,0,98178,47.5072,-122.272,1450,10706,10,20,2014,UNK,380,6615
4139910180,1/14/2015,1480000.0,5,4.0,4770,31570,2.0,0.0,0.0,3,12,4770,0,1990,0,98006,47.5468,-122.12299999999999,4520,32070,1,14,2015,UNK,250,-500
7278100515,8/21/2014,1300000.0,2,2.5,2910,19449,2.0,1.0,4.0,5,9,1940,970,1985,0,98177,47.7729,-122.39299999999999,2540,23598,8,21,2014,UNK,370,-4149
9353300220,4/8/2015,285000.0,3,1.0,950,10723,1.0,0.0,0.0,4,6,950,0,1959,0,98059,47.4899,-122.133,1520,10723,4,8,2015,UNK,-570,0
5253300173,10/22/2014,294950.0,3,1.0,1160,8950,1.0,0.0,0.0,3,7,1160,0,1968,0,98133,47.7499,-122.338,1210,8193,10,22,2014,UNK,-50,757
98000150,1/2/2015,1470000.0,4,4.0,4930,22093,2.0,0.0,3.0,3,12,4930,0,2004,0,98075,47.5874,-121.965,4630,18889,1,2,2015,N,300,3204
8608900205,4/3/2015,565500.0,3,1.75,1780,5850,1.0,0.0,0.0,5,7,980,800,1944,0,98116,47.5589,-122.39200000000001,1550,5850,4,3,2015,UNK,230,0
2895200150,10/13/2014,230000.0,3,2.0,1410,10625,1.0,0.0,0.0,3,7,1410,0,1980,0,98042,47.3649,-122.117,1410,9744,10,13,2014,UNK,0,881
621069057,3/23/2015,569950.0,4,3.5,2700,443440,1.5,0.0,0.0,3,8,2700,0,1948,1997,98042,47.333,-122.098,3210,298182,3,23,2015,Y,-510,145258
8712100760,9/24/2014,721000.0,2,1.5,1790,4250,1.0,0.0,0.0,3,7,920,870,1915,2014,98112,47.6367,-122.301,1910,4250,9,24,2014,Y,-120,0
255520180,12/18/2014,565000.0,3,2.5,4040,8653,2.0,0.0,0.0,3,9,2900,1140,2006,0,98019,47.7378,-121.975,3360,8653,12,18,2014,N,680,0
1025059186,9/17/2014,438000.0,3,1.75,1990,9885,1.0,0.0,0.0,4,7,1030,960,1978,0,98052,47.6722,-122.162,1560,10000,9,17,2014,UNK,430,-115
797000330,4/2/2015,369900.0,3,1.75,2150,19127,1.0,0.0,0.0,3,7,1650,500,1978,0,98168,47.5061,-122.324,1550,15000,4,2,2015,UNK,600,4127
6403510410,9/5/2014,405000.0,4,2.5,1850,9136,2.0,0.0,0.0,3,8,1850,0,1997,0,98059,47.4943,-122.15700000000001,1930,7873,9,5,2014,UNK,-80,1263
4324210120,5/27/2014,282000.0,3,2.5,1680,15711,1.0,0.0,0.0,3,7,1240,440,1994,0,98031,47.423,-122.171,1420,8588,5,27,2014,UNK,260,7123
6381500450,11/4/2014,380950.0,2,1.0,1430,7819,1.0,0.0,0.0,3,7,1110,320,1944,0,98125,47.7307,-122.302,1380,7473,11,4,2014,UNK,50,346
7609700065,6/30/2014,349810.0,3,1.0,960,8855,1.0,0.0,0.0,4,7,960,0,1958,0,98155,47.7689,-122.32799999999999,1250,8855,6,30,2014,UNK,-290,0
6192410760,5/26/2014,690000.0,4,2.5,2700,8810,2.0,0.0,0.0,3,9,2700,0,2004,0,98052,47.7041,-122.116,2730,5100,5,26,2014,N,-30,3710
441000065,5/5/2015,653000.0,2,1.5,1290,5141,1.0,0.0,0.0,4,7,1050,240,1947,0,98115,47.6878,-122.29,1290,5406,5,5,2015,UNK,0,-265
9238510220,10/28/2014,526500.0,3,2.5,1860,43170,2.0,0.0,0.0,3,8,1860,0,1986,0,98072,47.7712,-122.13600000000001,2270,40835,10,28,2014,UNK,-410,2335
293760150,10/17/2014,1040000.0,4,3.5,4320,8490,2.0,0.0,0.0,3,10,3280,1040,2005,0,98029,47.5568,-122.029,4030,11008,10,17,2014,N,290,-2518
3331001765,9/23/2014,335000.0,3,1.0,2130,3825,1.5,0.0,0.0,3,7,2130,0,1917,0,98118,47.5506,-122.281,1780,5150,9,23,2014,UNK,350,-1325
1423069077,9/15/2014,570000.0,2,1.75,2870,102366,2.0,0.0,2.0,4,8,1770,0,1994,0,98027,47.4847,-122.0,2960,108900,9,15,2014,UNK,-90,-6534
8123450450,3/10/2015,1080000.0,5,3.5,3740,11340,2.0,0.0,0.0,3,10,3740,0,2013,0,98052,47.6628,-122.14299999999999,2040,8715,3,10,2015,N,1700,2625
1795910360,9/22/2014,475000.0,3,2.5,2130,8022,2.0,0.0,0.0,3,8,2130,0,1985,0,98052,47.7252,-122.10600000000001,2130,7605,9,22,2014,UNK,0,417
7883603965,2/12/2015,315000.0,4,2.0,1210,4250,1.0,0.0,0.0,4,7,1210,0,1941,0,98108,47.5275,-122.321,1210,6000,2,12,2015,UNK,0,-1750
7937600087,12/9/2014,405000.0,6,2.0,2800,29985,1.0,0.0,0.0,5,7,1400,0,1954,0,98058,47.4398,-122.08,1980,29985,12,9,2014,UNK,820,0
3396820150,5/6/2014,562000.0,5,2.25,3040,8111,2.0,0.0,0.0,3,8,3040,0,1984,0,98052,47.7157,-122.103,2020,8304,5,6,2014,UNK,1020,-193
3654800040,4/24/2015,295000.0,3,2.5,1570,6932,2.0,0.0,0.0,3,7,1570,0,1993,0,98038,47.3902,-122.04899999999999,1570,6271,4,24,2015,UNK,0,661
8039900360,7/8/2014,383000.0,3,2.25,2090,15000,1.0,0.0,0.0,3,7,2090,0,1961,0,98045,47.4885,-121.78299999999999,1690,14400,7,8,2014,UNK,400,600
3876540410,4/13/2015,242000.0,3,2.25,1690,7292,1.0,0.0,0.0,3,7,1250,440,1985,0,98003,47.2639,-122.303,1670,7747,4,13,2015,UNK,20,-455
7230300610,4/3/2015,352500.0,3,1.5,1470,17577,1.0,0.0,0.0,5,7,1470,0,1967,0,98059,47.4695,-122.116,2300,13832,4,3,2015,UNK,-830,3745
1180005280,7/23/2014,239950.0,4,1.0,1460,6000,1.0,0.0,0.0,4,7,730,730,1941,0,98178,47.4952,-122.22399999999999,1190,6000,7,23,2014,UNK,270,0
714000210,9/3/2014,998000.0,4,2.5,3030,6820,2.0,0.0,0.0,3,9,2530,500,1947,2000,98105,47.6695,-122.266,2070,6820,9,3,2014,Y,960,0
3902100205,4/17/2015,515000.0,3,1.75,1190,4500,1.0,0.0,0.0,3,6,1190,0,1922,2012,98116,47.5576,-122.38799999999999,1820,4500,4,17,2015,Y,-630,0
9285800790,4/6/2015,590000.0,5,1.0,1840,6710,1.5,0.0,0.0,3,7,1840,0,1920,0,98126,47.5686,-122.37799999999999,1410,4880,4,6,2015,UNK,430,1830
1922000180,4/2/2015,1160000.0,4,3.75,3560,13959,2.0,0.0,0.0,4,9,3560,0,1972,0,98040,47.5575,-122.211,3320,11834,4,2,2015,UNK,240,2125
6121800065,11/4/2014,289000.0,3,1.75,1580,9750,1.0,0.0,0.0,5,7,1580,0,1954,0,98148,47.427,-122.331,1460,9750,11,4,2014,UNK,120,0
4427100145,3/23/2015,424000.0,3,1.5,1230,7200,1.0,0.0,0.0,3,7,1230,0,1953,0,98125,47.7281,-122.311,1400,6240,3,23,2015,UNK,-170,960
7227800065,10/16/2014,199000.0,4,2.0,1440,9477,1.0,0.0,0.0,3,5,1440,0,1943,0,98056,47.5093,-122.182,1440,9546,10,16,2014,UNK,0,-69
7853220330,10/6/2014,730000.0,4,3.5,4420,7902,2.0,0.0,0.0,3,10,3350,1070,2004,0,98065,47.5327,-121.86,3440,7851,10,6,2014,N,980,51
1430800258,5/27/2014,244000.0,3,1.0,910,5250,1.0,0.0,0.0,4,6,910,0,1971,0,98166,47.4729,-122.352,1650,10442,5,27,2014,UNK,-740,-5192
7454001075,6/18/2014,240000.0,2,1.0,670,10920,1.0,0.0,0.0,3,6,670,0,1942,0,98146,47.5128,-122.37200000000001,900,7425,6,18,2014,UNK,-230,3495
4038500210,4/22/2015,797000.0,4,2.75,2650,8610,2.0,0.0,0.0,3,8,2650,0,1959,2007,98008,47.6155,-122.12100000000001,1680,8316,4,22,2015,Y,970,294
2310040230,5/20/2014,350000.0,4,2.25,2220,6953,2.0,0.0,0.0,4,8,2220,0,1999,0,98038,47.3509,-122.041,2240,6716,5,20,2014,UNK,-20,237
1727500230,11/19/2014,415000.0,3,1.75,1640,6435,1.0,0.0,0.0,3,7,1190,450,1972,0,98034,47.7197,-122.21700000000001,1770,6930,11,19,2014,UNK,-130,-495
3874900205,4/14/2015,378510.0,2,1.0,770,5185,1.0,0.0,0.0,3,7,770,0,1947,0,98126,47.5459,-122.37899999999999,1260,6550,4,14,2015,UNK,-490,-1365
269000085,7/8/2014,1200000.0,4,3.5,3960,6654,2.0,0.0,0.0,3,10,2850,1110,2006,0,98199,47.6461,-122.389,2840,6400,7,8,2014,N,1120,254
7972602510,10/6/2014,379900.0,2,1.5,1140,7620,1.0,0.0,0.0,4,6,1140,0,1925,0,98106,47.5277,-122.351,1300,7620,10,6,2014,UNK,-160,0
7202340720,5/20/2014,620000.0,3,2.5,2480,9041,2.0,0.0,0.0,3,7,2480,0,2004,0,98053,47.6797,-122.035,2480,6500,5,20,2014,N,0,2541
1254201106,8/29/2014,524500.0,3,1.5,1580,3172,1.0,0.0,0.0,4,8,900,680,1946,0,98117,47.6796,-122.39299999999999,1580,5000,8,29,2014,UNK,0,-1828
7349650330,6/9/2014,270000.0,4,2.75,1990,7252,1.0,0.0,0.0,3,7,1270,720,1999,0,98002,47.2839,-122.20200000000001,2100,7535,6,9,2014,UNK,-110,-283
9211520150,5/28/2014,236000.0,4,2.25,1830,9485,1.0,0.0,0.0,4,7,1200,630,1989,0,98023,47.2995,-122.387,1730,10109,5,28,2014,UNK,100,-624
3438501020,11/5/2014,308500.0,2,2.0,840,14564,1.5,0.0,0.0,5,6,840,0,1942,0,98106,47.5499,-122.36,1430,7920,11,5,2014,UNK,-590,6644
5460900120,12/8/2014,989900.0,5,2.25,3320,11350,1.0,0.0,0.0,5,8,1660,1660,1963,0,98040,47.5749,-122.213,3320,11085,12,8,2014,UNK,0,265
7459810210,10/2/2014,299000.0,4,2.25,2050,26000,2.0,0.0,0.0,4,8,2050,0,1977,0,98042,47.3423,-122.06299999999999,2330,31100,10,2,2014,UNK,-280,-5100
4032500035,9/13/2014,295000.0,2,1.75,1560,43748,2.0,0.0,0.0,3,8,1560,0,1967,2000,98065,47.5729,-121.676,1000,24602,9,13,2014,Y,560,19146
8018600880,6/11/2014,110000.0,2,1.0,800,15000,1.0,0.0,0.0,3,6,800,0,1927,0,98168,47.4932,-122.316,1170,15000,6,11,2014,UNK,-370,0
2807100156,7/3/2014,295950.0,2,1.0,1190,6200,1.0,0.0,0.0,3,7,1190,0,1948,0,98133,47.7634,-122.34,1470,7800,7,3,2014,UNK,-280,-1600
2112700845,5/28/2014,270000.0,3,1.75,1300,4127,1.0,0.0,0.0,4,6,650,650,1918,0,98106,47.5353,-122.352,1420,4000,5,28,2014,UNK,-120,127
3022079087,5/21/2014,712000.0,4,2.5,3400,247421,2.0,0.0,0.0,3,9,3400,0,2001,0,98010,47.3623,-121.971,3180,222156,5,21,2014,UNK,220,25265
2767603577,5/6/2015,475000.0,2,1.5,1170,1250,3.0,0.0,0.0,3,8,1170,0,2000,0,98107,47.6719,-122.38,1310,1308,5,6,2015,UNK,-140,-58
3955900220,3/17/2015,410000.0,4,2.5,2510,5258,2.0,0.0,0.0,3,7,2510,0,2001,0,98056,47.4818,-122.18799999999999,2570,5119,3,17,2015,UNK,-60,139
3761100276,3/13/2015,588000.0,4,2.25,2510,19550,1.0,0.0,0.0,4,9,1810,700,1977,0,98034,47.7041,-122.241,2450,19250,3,13,2015,UNK,60,300
6979970150,12/12/2014,420000.0,3,2.5,2390,3903,2.0,0.0,0.0,3,8,1970,420,2006,0,98072,47.7515,-122.17399999999999,2390,3431,12,12,2014,N,0,472
8857640410,1/19/2015,355000.0,4,2.25,2200,3404,2.0,0.0,0.0,3,8,2200,0,2005,0,98038,47.3895,-122.03399999999999,2200,3449,1,19,2015,N,0,-45
6052400175,6/23/2014,446000.0,2,1.0,2550,21675,1.0,0.0,1.0,4,7,1610,940,1958,0,98198,47.4013,-122.319,2030,10591,6,23,2014,UNK,520,11084
2525059077,5/20/2014,765000.0,4,2.25,2560,12100,1.0,0.0,0.0,4,8,1760,800,1976,0,98052,47.631,-122.10799999999999,2240,12100,5,20,2014,UNK,320,0
5040800120,5/27/2014,967500.0,3,3.75,3250,5797,2.0,0.0,2.0,4,8,2370,880,1951,0,98199,47.6481,-122.405,1840,5797,5,27,2014,UNK,1410,0
8682262380,9/5/2014,381000.0,2,2.0,1340,4447,1.0,0.0,0.0,3,8,1340,0,2004,0,98053,47.7175,-122.03299999999999,1350,4458,9,5,2014,N,-10,-11
2521059060,5/1/2015,490000.0,3,2.25,2840,107157,2.0,0.0,0.0,4,9,2840,0,1983,0,98092,47.2848,-122.118,2600,215622,5,1,2015,UNK,240,-108465
7526800040,8/27/2014,716000.0,4,2.25,2480,9780,1.0,0.0,0.0,4,8,1900,580,1975,0,98052,47.6388,-122.09899999999999,2640,9780,8,27,2014,UNK,-160,0
4104900150,4/14/2015,605000.0,5,3.5,3060,8862,2.0,0.0,0.0,3,8,3060,0,1989,0,98056,47.5322,-122.185,2680,8398,4,14,2015,UNK,380,464
5409800120,9/19/2014,312200.0,4,2.5,2910,8596,2.0,0.0,0.0,3,8,2910,0,2004,0,98003,47.2596,-122.304,2770,8602,9,19,2014,N,140,-6
2423039122,7/18/2014,327000.0,4,1.0,1900,9000,1.0,0.0,0.0,4,7,1290,610,1948,0,98166,47.4629,-122.361,1950,10800,7,18,2014,UNK,-50,-1800
6143600555,6/9/2014,229950.0,4,1.75,1300,21000,1.0,0.0,0.0,4,7,1300,0,1969,0,98001,47.3067,-122.285,2120,9920,6,9,2014,UNK,-820,11080
5029451010,7/11/2014,160000.0,3,1.5,1480,7000,1.0,0.0,0.0,3,7,1000,480,1980,0,98023,47.2866,-122.368,1470,7022,7,11,2014,UNK,10,-22
6649500040,8/12/2014,255000.0,3,1.0,1250,9472,1.0,0.0,0.0,4,6,1250,0,1972,0,98059,47.495,-122.154,1590,9600,8,12,2014,UNK,-340,-128
2922700155,11/25/2014,530000.0,4,2.5,2000,4700,1.5,0.0,0.0,4,7,1220,780,1944,0,98117,47.6902,-122.368,1560,4700,11,25,2014,UNK,440,0
422049203,10/24/2014,239000.0,3,1.5,1330,6540,1.0,0.0,0.0,3,7,900,430,1971,0,98188,47.4239,-122.292,1400,11500,10,24,2014,UNK,-70,-4960
5412200180,2/28/2015,285000.0,3,2.25,1840,6214,1.0,0.0,0.0,4,7,1270,570,1983,0,98031,47.4043,-122.185,1840,6214,2,28,2015,UNK,0,0
6338000032,8/27/2014,537000.0,4,2.0,1560,7104,1.5,0.0,0.0,3,7,1140,420,1945,0,98105,47.6714,-122.28,1850,7105,8,27,2014,UNK,-290,-1
8161000210,8/14/2014,530000.0,3,2.5,3150,21893,2.0,0.0,0.0,3,9,3150,0,2006,0,98014,47.6455,-121.90100000000001,2280,21886,8,14,2014,N,870,7
5028600360,7/25/2014,213675.0,3,2.25,1560,6013,2.0,0.0,0.0,3,7,1560,0,1990,0,98023,47.2862,-122.352,1640,6290,7,25,2014,UNK,-80,-277
1952000150,5/6/2014,530000.0,5,2.5,2910,9636,1.0,0.0,0.0,4,7,1690,1220,1964,0,98008,47.5803,-122.119,2830,10385,5,6,2014,UNK,80,-749
9510920040,3/5/2015,780000.0,3,2.5,2940,15875,2.0,0.0,0.0,3,10,2940,0,1994,0,98075,47.5947,-122.016,2980,15875,3,5,2015,UNK,-40,0
9834200411,11/13/2014,390000.0,3,1.0,950,3621,1.0,0.0,0.0,4,6,950,0,1947,0,98144,47.575,-122.289,1540,4080,11,13,2014,UNK,-590,-459
2960900040,5/21/2014,450000.0,2,1.0,1200,4000,1.0,0.0,0.0,3,7,1070,130,1940,0,98126,47.5766,-122.37799999999999,1770,4000,5,21,2014,UNK,-570,0
1112000035,3/11/2015,420000.0,2,1.0,1000,5375,1.0,0.0,0.0,3,7,1000,0,1953,0,98118,47.5404,-122.26799999999999,1380,5000,3,11,2015,UNK,-380,375
1982200790,1/27/2015,550000.0,3,2.0,1490,3880,1.0,0.0,0.0,3,7,1490,0,1959,0,98107,47.662,-122.363,1490,3880,1,27,2015,UNK,0,0
3361401011,2/19/2015,110000.0,2,1.0,600,6120,1.0,0.0,0.0,3,5,600,0,1943,0,98168,47.4997,-122.31700000000001,1060,6120,2,19,2015,UNK,-460,0
1695900150,5/28/2014,700000.0,2,1.75,2320,5500,1.5,0.0,2.0,3,8,1720,600,1925,2000,98144,47.58600000000001,-122.292,2380,5000,5,28,2014,Y,-60,500
1240100065,4/24/2015,807500.0,4,2.5,3190,24170,2.0,0.0,0.0,3,10,3190,0,2002,0,98074,47.6209,-122.052,2110,26321,4,24,2015,UNK,1080,-2151
421049254,10/2/2014,179000.0,2,1.0,990,8760,1.0,0.0,0.0,3,7,990,0,1977,0,98003,47.3302,-122.305,1560,11880,10,2,2014,UNK,-570,-3120
9412400220,7/10/2014,1610000.0,4,2.75,5470,18200,2.0,1.0,4.0,3,11,3730,1740,1992,0,98118,47.5316,-122.26299999999999,3620,15100,7,10,2014,UNK,1850,3100
1726069060,4/9/2015,655000.0,4,2.75,2890,46609,2.0,0.0,0.0,4,9,2890,0,1981,0,98077,47.7454,-122.061,2880,68824,4,9,2015,UNK,10,-22215
6150200040,3/16/2015,472500.0,3,2.0,1790,6800,1.0,0.0,0.0,4,7,1240,550,1964,0,98133,47.728,-122.339,1470,6800,3,16,2015,UNK,320,0
7300400150,10/27/2014,299000.0,4,2.5,2350,6958,2.0,0.0,0.0,3,9,2350,0,1998,0,98092,47.3321,-122.17200000000001,2480,6395,10,27,2014,UNK,-130,563
2621730220,5/14/2014,740000.0,4,2.5,3430,10157,2.0,0.0,0.0,3,10,3430,0,2000,0,98034,47.723,-122.15799999999999,3480,10157,5,14,2014,UNK,-50,0
4122700040,10/10/2014,860000.0,3,1.75,2600,15064,1.0,0.0,0.0,4,8,1700,900,1967,0,98004,47.64,-122.204,2940,14984,10,10,2014,UNK,-340,80
9161100730,7/1/2014,620000.0,4,3.0,2130,6325,1.0,0.0,0.0,5,7,1440,690,1948,0,98116,47.5683,-122.396,1240,6325,7,1,2014,UNK,890,0
9357001010,10/10/2014,410000.0,3,1.75,1660,5987,1.0,0.0,0.0,3,7,960,700,1982,0,98146,47.5107,-122.381,1510,6000,10,10,2014,UNK,150,-13
8643000210,3/4/2015,343000.0,5,3.5,2473,9282,2.0,0.0,1.0,5,7,2473,0,1963,0,98198,47.3966,-122.30799999999999,2040,10920,3,4,2015,UNK,433,-1638
9828701739,6/17/2014,465000.0,2,2.75,1430,1425,2.0,0.0,0.0,3,7,995,435,2006,0,98112,47.621,-122.29799999999999,1500,1749,6,17,2014,N,-70,-324
3204400040,3/4/2015,273950.0,3,2.25,1570,3109,2.0,0.0,0.0,3,8,1570,0,2002,0,98092,47.3258,-122.186,1680,3590,3,4,2015,UNK,-110,-481
3342103282,10/17/2014,825000.0,2,1.0,1240,42247,1.0,0.0,1.0,4,7,1240,0,1915,0,98056,47.5169,-122.20100000000001,1550,12459,10,17,2014,UNK,-310,29788
2420069604,3/30/2015,255000.0,3,2.5,1720,6200,2.0,0.0,0.0,3,7,1720,0,2014,0,98022,47.2137,-121.98899999999999,1710,9520,3,30,2015,N,10,-3320
8078050040,9/8/2014,250000.0,3,2.0,1140,11161,1.0,0.0,0.0,4,7,1140,0,1998,0,98022,47.208999999999996,-122.012,1720,8587,9,8,2014,UNK,-580,2574
7663700150,8/22/2014,635000.0,4,3.25,2690,7200,2.0,0.0,3.0,3,9,1720,970,1978,0,98155,47.7341,-122.288,2400,8845,8,22,2014,UNK,290,-1645
4167700210,8/26/2014,240000.0,3,1.75,1520,9600,1.0,0.0,0.0,3,8,1520,0,1966,0,98023,47.3263,-122.365,2060,9600,8,26,2014,UNK,-540,0
2423020180,5/7/2015,670000.0,4,2.25,2040,7031,2.0,0.0,0.0,3,8,2040,0,2012,0,98033,47.7016,-122.17,1670,7031,5,7,2015,N,370,0
2824600180,10/24/2014,713414.0,3,2.5,2830,6000,1.0,0.0,3.0,3,9,1730,1100,1954,0,98126,47.5751,-122.37799999999999,2040,5300,10,24,2014,UNK,790,700
2013801086,5/13/2015,245000.0,3,1.5,1340,7391,1.0,0.0,0.0,4,7,1340,0,1966,0,98198,47.3837,-122.31700000000001,1300,7391,5,13,2015,UNK,40,0
4022900150,12/9/2014,600000.0,4,2.5,2520,10850,1.0,0.0,0.0,4,8,1680,840,1968,0,98155,47.7751,-122.28399999999999,2590,10800,12,9,2014,UNK,-70,50
3295710150,10/15/2014,270000.0,3,2.5,1660,5550,2.0,0.0,0.0,3,7,1660,0,2002,0,98198,47.375,-122.304,1810,5550,10,15,2014,UNK,-150,0
9476200035,11/20/2014,190000.0,2,1.0,880,6900,1.0,0.0,0.0,3,6,880,0,1943,0,98056,47.4903,-122.191,1060,8000,11,20,2014,UNK,-180,-1100
1937300180,6/6/2014,435000.0,3,2.0,980,5000,1.0,0.0,0.0,3,6,980,0,1940,0,98144,47.595,-122.30799999999999,1970,3025,6,6,2014,UNK,-990,1975
4226900211,10/23/2014,560000.0,4,1.0,1360,5814,1.5,0.0,0.0,2,6,1360,0,1900,0,98122,47.6038,-122.314,1010,5814,10,23,2014,UNK,350,0
424069018,9/5/2014,998000.0,3,3.75,3710,34412,2.0,0.0,0.0,3,10,2910,800,1978,0,98075,47.5888,-122.04,2390,34412,9,5,2014,UNK,1320,0
6684500040,12/2/2014,725000.0,3,1.0,940,8377,1.0,0.0,0.0,4,7,940,0,1952,0,98004,47.5974,-122.2,1710,6900,12,2,2014,UNK,-770,1477
8948500065,11/24/2014,210000.0,2,1.0,970,8874,1.0,0.0,0.0,3,7,970,0,1968,0,98056,47.4943,-122.178,1340,8175,11,24,2014,UNK,-370,699
1972201960,8/25/2014,513000.0,3,2.25,1500,1312,3.0,0.0,0.0,3,8,1500,0,2007,0,98103,47.6534,-122.346,1500,1282,8,25,2014,N,0,30
7436200040,11/5/2014,290000.0,5,2.5,2780,9652,1.0,0.0,0.0,4,8,1390,1390,1967,0,98001,47.3444,-122.271,1790,9652,11,5,2014,UNK,990,0
3835502815,9/25/2014,1260000.0,3,2.5,3110,9930,1.0,0.0,1.0,3,8,1640,1470,1954,0,98039,47.6112,-122.226,3650,14399,9,25,2014,UNK,-540,-4469
8856960540,6/20/2014,330000.0,3,2.25,1860,11227,2.0,0.0,0.0,3,7,1860,0,1995,0,98038,47.3879,-122.031,1820,8800,6,20,2014,UNK,40,2427
1432400065,6/5/2014,189000.0,3,1.0,1010,7560,1.0,0.0,0.0,3,6,1010,0,1958,0,98058,47.4497,-122.176,1170,7560,6,5,2014,UNK,-160,0
4370700065,5/4/2015,907500.0,3,2.25,2850,6281,2.0,0.0,2.0,4,7,1900,950,1947,0,98115,47.6911,-122.32600000000001,1680,7006,5,4,2015,UNK,1170,-725
1725079047,11/4/2014,410000.0,3,2.25,2280,200811,1.0,0.0,0.0,3,7,2280,0,1978,0,98014,47.6522,-121.941,2280,206038,11,4,2014,UNK,0,-5227
7855000325,2/20/2015,1050000.0,4,3.0,3080,10757,2.0,0.0,3.0,5,8,3080,0,1961,0,98006,47.5671,-122.15899999999999,2810,10757,2,20,2015,UNK,270,0
2826049098,12/4/2014,622100.0,4,2.5,2280,14290,1.5,0.0,0.0,4,7,1510,770,1942,0,98125,47.7054,-122.29700000000001,2140,9890,12,4,2014,UNK,140,4400
3750603685,7/23/2014,250000.0,3,1.5,2030,14400,1.0,0.0,0.0,4,7,1310,720,1969,0,98001,47.2639,-122.285,1330,14400,7,23,2014,UNK,700,0
1797500230,8/18/2014,1180000.0,4,3.0,2570,4000,2.0,0.0,0.0,3,8,1750,820,1909,0,98115,47.6743,-122.31299999999999,1970,4000,8,18,2014,UNK,600,0
3459600330,2/9/2015,925000.0,3,2.75,3640,10300,1.0,0.0,0.0,4,9,2060,1580,1979,0,98006,47.5612,-122.146,3110,10625,2,9,2015,UNK,530,-325
546001020,2/18/2015,554000.0,3,2.0,1760,4046,1.0,0.0,0.0,3,7,960,800,1931,0,98117,47.6876,-122.381,1500,4046,2,18,2015,UNK,260,0
7227502507,7/9/2014,545000.0,3,2.5,2760,17377,2.0,0.0,0.0,3,9,2760,0,2002,0,98056,47.4929,-122.18799999999999,1940,8504,7,9,2014,UNK,820,8873
326049060,9/9/2014,660000.0,3,2.5,2650,11250,2.0,0.0,0.0,3,9,2650,0,2005,0,98155,47.7644,-122.29,2200,10013,9,9,2014,N,450,1237
1525059261,5/5/2015,1900000.0,5,4.5,5160,44315,2.0,0.0,0.0,3,12,5160,0,1996,0,98005,47.6568,-122.154,4760,44315,5,5,2015,UNK,400,0
7399300120,5/2/2014,260000.0,4,2.0,1480,8625,1.0,0.0,0.0,4,7,1480,0,1974,0,98055,47.461999999999996,-122.193,2130,8502,5,2,2014,UNK,-650,123
7812801590,10/30/2014,219900.0,3,1.0,860,6664,1.0,0.0,0.0,3,6,860,0,1944,0,98178,47.4931,-122.24700000000001,1150,6857,10,30,2014,UNK,-290,-193
6699930530,3/25/2015,373500.0,4,2.5,2610,4978,2.0,0.0,0.0,3,8,2610,0,2004,0,98038,47.3438,-122.04,2470,5024,3,25,2015,N,140,-46
1523069151,7/11/2014,380000.0,2,1.0,1470,81021,1.0,0.0,0.0,4,6,1470,0,1949,0,98027,47.4771,-122.03,2600,69696,7,11,2014,UNK,-1130,11325
7525950180,7/1/2014,1060000.0,4,2.5,4570,16015,2.0,0.0,2.0,3,11,4570,0,1990,0,98074,47.6246,-122.06700000000001,4490,17668,7,1,2014,UNK,80,-1653
3623500408,3/30/2015,2600000.0,3,3.0,3410,16015,2.0,1.0,4.0,4,10,2220,1190,1973,0,98040,47.5721,-122.23899999999999,3760,16572,3,30,2015,UNK,-350,-557
7312200120,7/23/2014,450000.0,3,2.25,1760,10013,2.0,0.0,0.0,4,8,1760,0,1983,0,98056,47.5336,-122.189,1810,9768,7,23,2014,UNK,-50,245
4123810210,7/16/2014,379950.0,3,1.75,2040,12065,1.0,0.0,0.0,3,8,2040,0,1987,0,98038,47.3756,-122.044,2010,11717,7,16,2014,UNK,30,348
3902600150,8/20/2014,834800.0,3,3.5,3470,4171,3.0,0.0,0.0,3,9,3470,0,2008,0,98034,47.71100000000001,-122.229,3430,4268,8,20,2014,N,40,-97
9126101201,9/16/2014,365000.0,2,1.0,680,4800,1.0,0.0,0.0,3,6,680,0,1917,0,98122,47.6084,-122.304,1610,4800,9,16,2014,UNK,-930,0
2423029009,6/17/2014,465000.0,2,2.0,1494,19271,2.0,1.0,4.0,3,7,1494,0,1943,1997,98070,47.4728,-122.49700000000001,1494,43583,6,17,2014,Y,0,-24312
3300701285,7/30/2014,452000.0,3,1.5,1250,4000,1.0,0.0,0.0,3,7,1250,0,1955,0,98117,47.6916,-122.37899999999999,1030,4000,7,30,2014,UNK,220,0
2391601445,3/4/2015,840000.0,3,3.0,3570,6250,2.0,0.0,2.0,3,10,2710,860,1985,0,98116,47.5624,-122.399,2550,7596,3,4,2015,UNK,1020,-1346
7625701175,11/3/2014,465000.0,4,2.0,2000,6250,1.5,0.0,0.0,3,7,1480,520,1930,0,98136,47.5532,-122.389,1110,6250,11,3,2014,UNK,890,0
1843130360,5/7/2015,295000.0,3,2.5,2030,4867,2.0,0.0,0.0,3,7,2030,0,2003,0,98042,47.3747,-122.12799999999999,2030,5000,5,7,2015,UNK,0,-133
6150700264,2/24/2015,396000.0,3,1.0,1390,6160,1.0,0.0,0.0,4,7,1390,0,1949,0,98133,47.7289,-122.338,1230,6160,2,24,2015,UNK,160,0
3226049080,2/24/2015,397000.0,2,1.0,1030,12350,1.5,0.0,0.0,3,7,1030,0,1942,0,98115,47.6984,-122.324,1790,6900,2,24,2015,UNK,-760,5450
7889602020,8/19/2014,240000.0,3,1.0,1280,9000,1.5,0.0,0.0,4,6,1280,0,1954,0,98146,47.4915,-122.338,1430,4500,8,19,2014,UNK,-150,4500
3613600150,1/5/2015,300523.0,3,2.5,2370,6840,2.0,0.0,0.0,3,9,2370,0,1987,0,98119,47.6503,-122.366,1590,4400,1,5,2015,UNK,780,2440
3599600276,11/6/2014,215500.0,3,2.0,1380,9000,2.0,0.0,0.0,2,7,1380,0,1946,0,98001,47.2613,-122.24799999999999,1460,9732,11,6,2014,UNK,-80,-732
2193320210,8/5/2014,552500.0,5,3.0,2320,7229,1.0,0.0,0.0,4,8,1370,0,1986,0,98052,47.696999999999996,-122.09700000000001,2090,7554,8,5,2014,UNK,230,-325
9117100040,8/28/2014,375000.0,5,1.5,2050,9360,1.0,0.0,0.0,3,7,1520,530,1968,0,98055,47.43600000000001,-122.195,1840,9383,8,28,2014,UNK,210,-23
522039106,6/6/2014,160000.0,3,1.0,1210,103237,1.0,0.0,0.0,2,6,1210,0,1918,1960,98070,47.4208,-122.445,1880,40510,6,6,2014,Y,-670,62727
2424059018,6/12/2014,1070000.0,4,2.5,3270,35445,2.0,0.0,0.0,3,11,3270,0,1989,0,98006,47.548,-122.12100000000001,4180,32130,6,12,2014,UNK,-910,3315
1959700540,11/4/2014,952000.0,3,2.5,2450,4400,2.0,0.0,0.0,4,9,1800,650,1922,0,98102,47.6439,-122.319,2220,5500,11,4,2014,UNK,230,-1100
2767900355,6/27/2014,523460.0,5,1.75,1890,5000,1.5,0.0,0.0,3,7,1090,800,1906,0,98107,47.6711,-122.37200000000001,1610,5000,6,27,2014,UNK,280,0
1310820150,8/12/2014,305950.0,4,2.5,2007,4968,2.0,0.0,0.0,3,9,2007,0,2009,0,98092,47.3301,-122.191,2189,5852,8,12,2014,N,-182,-884
6802200230,2/9/2015,220000.0,3,2.5,1430,9044,2.0,0.0,0.0,3,7,1430,0,1991,0,98022,47.1956,-121.986,1580,8624,2,9,2015,UNK,-150,420
3421049044,4/9/2015,289000.0,2,1.75,2056,52333,1.0,0.0,0.0,4,7,1048,1008,1980,0,98001,47.2592,-122.291,2220,6458,4,9,2015,UNK,-164,45875
4036400040,2/9/2015,648000.0,5,2.5,2210,10772,1.0,0.0,2.0,3,9,1430,780,1964,0,98155,47.7383,-122.288,2720,9858,2,9,2015,UNK,-510,914
1193000450,4/10/2015,825000.0,5,1.75,2330,6000,1.5,0.0,0.0,3,8,2080,250,1937,0,98199,47.6461,-122.39200000000001,2150,6000,4,10,2015,UNK,180,0
3819800580,12/4/2014,400000.0,4,2.0,2070,10800,2.0,0.0,0.0,3,7,2070,0,1982,0,98011,47.7264,-122.23700000000001,1880,10800,12,4,2014,UNK,190,0
6873000120,5/12/2014,420000.0,2,2.5,1480,1369,3.0,0.0,0.0,3,7,1480,0,2009,0,98052,47.676,-122.12100000000001,1390,1337,5,12,2014,N,90,32
9830200230,1/20/2015,389000.0,2,1.75,1160,4848,2.0,0.0,1.0,4,7,1160,0,1949,0,98118,47.542,-122.265,1990,7440,1,20,2015,UNK,-830,-2592
2301400276,9/8/2014,865000.0,4,2.5,2520,4950,2.0,0.0,0.0,3,8,2520,0,1906,2002,98117,47.6814,-122.359,1810,3500,9,8,2014,Y,710,1450
5153200150,12/3/2014,345000.0,2,1.0,1770,16660,1.0,0.0,3.0,3,8,1220,550,1957,0,98023,47.3346,-122.354,2790,20504,12,3,2014,UNK,-1020,-3844
1465400120,3/26/2015,700000.0,3,2.5,3110,123710,2.0,0.0,0.0,3,8,2430,680,1995,0,98038,47.3879,-122.00200000000001,2420,92782,3,26,2015,UNK,690,30928
8121200620,4/16/2015,550000.0,3,2.5,1680,10455,2.0,0.0,0.0,3,8,1680,0,1982,0,98052,47.7229,-122.11,1860,10063,4,16,2015,UNK,-180,392
324000530,7/8/2014,201500.0,3,1.0,1320,5000,1.5,0.0,0.0,3,7,1320,0,1912,0,98116,47.5711,-122.38600000000001,1320,4179,7,8,2014,UNK,0,821
324000530,3/23/2015,459000.0,3,1.0,1320,5000,1.5,0.0,0.0,3,7,1320,0,1912,0,98116,47.5711,-122.38600000000001,1320,4179,3,23,2015,UNK,0,821
1328320760,12/18/2014,327000.0,3,2.5,1810,7350,1.0,0.0,0.0,3,8,1310,500,1984,0,98058,47.4434,-122.125,2240,7350,12,18,2014,UNK,-430,0
3626039268,5/16/2014,540000.0,1,1.0,1140,6700,1.5,0.0,0.0,3,7,1140,0,1920,0,98103,47.6958,-122.35700000000001,1350,6700,5,16,2014,UNK,-210,0
3585900665,6/6/2014,805000.0,5,2.5,4600,19831,1.0,0.0,3.0,3,9,2300,2300,1956,2015,98177,47.7608,-122.37799999999999,2890,19831,6,6,2014,Y,1710,0
7625701830,10/23/2014,521000.0,3,2.0,1840,6000,1.0,0.0,0.0,4,6,1840,0,1908,1944,98136,47.5508,-122.39200000000001,2010,6000,10,23,2014,Y,-170,0
3524049042,5/27/2014,375000.0,3,1.5,2000,7294,1.0,0.0,0.0,3,7,1520,480,1965,0,98118,47.5297,-122.26700000000001,2000,6000,5,27,2014,UNK,0,1294
9211500150,1/17/2015,235000.0,3,1.75,1480,6592,1.0,0.0,0.0,4,7,1080,400,1978,0,98023,47.2982,-122.37799999999999,1660,7150,1,17,2015,UNK,-180,-558
7760400880,9/29/2014,240000.0,4,2.5,2040,11841,2.0,0.0,0.0,3,7,2040,0,1994,0,98042,47.3691,-122.074,1730,8808,9,29,2014,UNK,310,3033
686450330,9/15/2014,575000.0,4,2.25,2060,12155,1.0,0.0,0.0,4,8,2060,0,1968,0,98008,47.6378,-122.117,2360,8625,9,15,2014,UNK,-300,3530
2617900035,12/1/2014,1520000.0,6,3.5,3720,11690,2.0,0.0,0.0,3,10,3720,0,2003,0,98040,47.5699,-122.226,3030,11686,12,1,2014,UNK,690,4
7936800150,7/2/2014,394500.0,4,2.5,3002,6042,2.0,0.0,0.0,3,8,3002,0,2004,0,98055,47.4231,-122.186,2566,6390,7,2,2014,N,436,-348
8651441750,5/15/2014,174950.0,3,1.0,1060,5200,1.0,0.0,0.0,5,6,1060,0,1970,0,98042,47.3636,-122.09299999999999,1380,5200,5,15,2014,UNK,-320,0
3664500133,11/17/2014,383000.0,4,2.0,1830,21183,1.0,0.0,0.0,4,7,1060,770,1966,0,98059,47.4826,-122.12799999999999,1950,6120,11,17,2014,UNK,-120,15063
1823069213,5/5/2014,249950.0,3,2.0,1550,15040,1.0,0.0,0.0,4,6,1550,0,1958,0,98059,47.4873,-122.09899999999999,1510,41416,5,5,2014,UNK,40,-26376
7525211520,3/18/2015,431000.0,3,2.5,1690,2752,2.0,0.0,0.0,3,8,1690,0,1979,0,98052,47.6332,-122.10799999999999,1690,2855,3,18,2015,UNK,0,-103
4034900065,5/30/2014,459900.0,3,1.75,2580,11000,1.0,0.0,0.0,4,7,1290,1290,1951,0,98006,47.5646,-122.181,2280,17643,5,30,2014,UNK,300,-6643
2558690150,7/7/2014,475000.0,5,2.5,2510,8050,1.0,0.0,0.0,4,7,1490,1020,1977,0,98034,47.7212,-122.17200000000001,1840,8471,7,7,2014,UNK,670,-421
5016001325,5/16/2014,605000.0,3,2.25,1290,2500,2.0,0.0,0.0,4,8,1290,0,1987,0,98112,47.6229,-122.29799999999999,1700,3750,5,16,2014,UNK,-410,-1250
1311800220,2/18/2015,234950.0,4,2.0,1450,7560,1.0,0.0,0.0,3,7,1450,0,1967,0,98001,47.3375,-122.27600000000001,1430,7560,2,18,2015,UNK,20,0
4128000020,6/13/2014,419000.0,4,2.5,2690,7947,2.0,0.0,0.0,3,8,2690,0,1993,0,98058,47.4248,-122.15299999999999,2160,8328,6,13,2014,UNK,530,-381
1125059071,5/22/2014,910000.0,4,3.25,3340,10890,1.5,0.0,0.0,3,9,2240,1100,1963,2000,98052,47.6677,-122.13600000000001,2880,9794,5,22,2014,Y,460,1096
3274850130,12/3/2014,392000.0,4,2.5,2600,8921,2.0,0.0,0.0,3,8,2600,0,1991,0,98058,47.4423,-122.178,2550,8683,12,3,2014,UNK,50,238
1925069099,8/25/2014,915000.0,3,2.5,3140,9808,2.0,0.0,0.0,3,9,2500,640,2001,0,98052,47.6383,-122.09700000000001,2370,10014,8,25,2014,UNK,770,-206
3395050050,11/14/2014,630000.0,3,3.25,3800,13995,2.0,0.0,3.0,3,9,3800,0,1983,0,98011,47.7741,-122.20299999999999,2480,8434,11,14,2014,UNK,1320,5561
4058800500,7/10/2014,416100.0,4,1.75,2320,5490,1.0,0.0,3.0,3,8,1160,1160,1956,0,98178,47.5091,-122.241,2240,7200,7,10,2014,UNK,80,-1710
1311600020,8/21/2014,285000.0,4,2.5,2360,7350,1.0,0.0,0.0,4,7,1440,920,1965,0,98001,47.3417,-122.277,1450,7305,8,21,2014,UNK,910,45
8679400130,5/6/2015,353000.0,4,1.5,1100,9600,1.0,0.0,0.0,4,6,1100,0,1960,0,98033,47.7,-122.175,1100,9630,5,6,2015,UNK,0,-30
9485760050,8/26/2014,297950.0,3,2.0,1390,5127,1.0,0.0,0.0,3,8,1390,0,1990,0,98055,47.4504,-122.206,1960,5019,8,26,2014,UNK,-570,108
4055700920,10/7/2014,750000.0,2,2.0,2180,21392,2.0,0.0,0.0,3,8,2180,0,1934,1979,98034,47.7162,-122.24600000000001,2890,22000,10,7,2014,Y,-710,-608
8673400177,4/2/2015,525000.0,3,3.0,1730,1074,3.5,0.0,0.0,3,8,1730,0,2006,0,98107,47.6692,-122.39200000000001,1370,1185,4,2,2015,N,360,-111
3500100089,7/15/2014,495000.0,5,1.75,2760,18112,1.0,0.0,0.0,3,8,1510,1250,1968,0,98155,47.7363,-122.29799999999999,1720,8482,7,15,2014,UNK,1040,9630
8730600050,8/25/2014,710000.0,3,1.75,2430,11448,1.0,0.0,1.0,5,7,1620,810,1949,0,98117,47.6971,-122.391,2140,8144,8,25,2014,UNK,290,3304
3755100005,7/30/2014,310000.0,3,2.0,2010,12950,1.0,0.0,0.0,3,8,2010,0,1953,0,98034,47.7222,-122.229,1490,10181,7,30,2014,UNK,520,2769
8651442880,5/16/2014,205000.0,5,1.75,1730,5200,1.0,0.0,0.0,4,7,1050,680,1978,0,98042,47.3628,-122.089,1350,5200,5,16,2014,UNK,380,0
1720069075,5/8/2015,530000.0,3,3.0,2450,211266,1.5,0.0,3.0,3,8,2450,0,2004,0,98022,47.2215,-122.06700000000001,2300,263492,5,8,2015,N,150,-52226
4309700190,7/24/2014,725000.0,4,2.5,3300,28433,2.0,0.0,0.0,3,9,3300,0,1998,0,98059,47.5072,-122.11200000000001,3550,26386,7,24,2014,UNK,-250,2047
3972300169,11/25/2014,195000.0,2,1.0,720,9520,1.0,0.0,0.0,4,6,720,0,1947,0,98155,47.7678,-122.316,1450,8612,11,25,2014,UNK,-730,908
6817810190,7/1/2014,401000.0,3,2.0,1240,11172,1.0,0.0,0.0,3,7,1000,240,1984,0,98074,47.6364,-122.037,1330,14102,7,1,2014,UNK,-90,-2930
7855400630,9/22/2014,1030000.0,5,2.5,3050,8200,1.0,0.0,4.0,4,8,1650,1400,1962,0,98006,47.5647,-122.155,2970,8792,9,22,2014,UNK,80,-592
1163400020,4/3/2015,251000.0,3,1.5,1590,21600,1.5,0.0,0.0,4,7,1590,0,1971,0,98022,47.2159,-121.96600000000001,1780,21600,4,3,2015,UNK,-190,0
7214400095,10/27/2014,667500.0,3,2.0,2040,4841,1.0,0.0,0.0,4,7,1020,1020,1949,0,98115,47.6778,-122.302,1600,4841,10,27,2014,UNK,440,0
6799300130,6/23/2014,300000.0,4,2.5,1840,5550,2.0,0.0,0.0,3,8,1840,0,2004,0,98031,47.3937,-122.18299999999999,2030,5500,6,23,2014,N,-190,50
4376800010,8/14/2014,610000.0,4,2.25,1960,9021,2.0,0.0,0.0,4,8,1960,0,1973,0,98052,47.6349,-122.096,1960,9975,8,14,2014,UNK,0,-954
2125059163,7/3/2014,1040000.0,4,5.0,4110,43560,2.0,0.0,0.0,4,11,4110,0,1978,0,98005,47.6353,-122.18,3650,43995,7,3,2014,UNK,460,-435
1770000460,12/3/2014,430000.0,3,2.25,1830,19965,1.0,0.0,0.0,3,8,1400,430,1976,0,98072,47.7412,-122.088,1830,17250,12,3,2014,UNK,0,2715
1125079088,4/2/2015,455000.0,2,1.0,1330,92782,1.0,0.0,0.0,2,6,1330,0,1950,0,98014,47.6624,-121.868,1280,168141,4,2,2015,UNK,50,-75359
1842300050,7/2/2014,600000.0,5,2.0,2190,9072,1.0,0.0,0.0,5,7,1110,0,1965,0,98052,47.6696,-122.149,1660,8327,7,2,2014,UNK,530,745
9828702156,2/19/2015,638000.0,3,3.25,1720,1587,2.5,0.0,2.0,3,9,1410,310,2004,0,98122,47.6187,-122.29899999999999,1490,1620,2,19,2015,N,230,-33
7625702155,10/14/2014,561000.0,3,1.75,1710,5000,1.0,0.0,0.0,4,7,1360,350,1918,0,98136,47.5492,-122.389,1490,6250,10,14,2014,UNK,220,-1250
585000095,12/16/2014,625000.0,3,2.5,2180,5000,1.0,0.0,0.0,4,8,1240,940,1977,0,98116,47.5828,-122.396,2000,5000,12,16,2014,UNK,180,0
3903200050,3/24/2015,263950.0,3,1.75,1700,11613,1.0,0.0,0.0,5,7,1180,520,1977,0,98092,47.2874,-122.18700000000001,1500,12377,3,24,2015,UNK,200,-764
8563080020,10/28/2014,740000.0,3,2.5,2960,9350,2.0,0.0,2.0,4,9,2960,0,1978,0,98008,47.6218,-122.094,2960,11745,10,28,2014,UNK,0,-2395
5379805475,6/9/2014,234999.0,3,1.0,1330,8912,1.0,0.0,0.0,3,6,1330,0,1948,0,98188,47.4493,-122.274,1200,8913,6,9,2014,UNK,130,-1
9558050780,4/14/2015,380000.0,4,2.5,1940,3200,2.0,0.0,0.0,3,8,1940,0,2004,0,98058,47.4583,-122.118,1900,3200,4,14,2015,N,40,0
3782400190,8/12/2014,329500.0,3,2.25,1500,9656,1.0,0.0,0.0,3,7,1170,330,1989,0,98019,47.7327,-121.98200000000001,1690,9656,8,12,2014,UNK,-190,0
1423069063,7/11/2014,464950.0,4,2.5,2230,64438,1.0,0.0,0.0,4,7,1230,1000,1978,0,98027,47.4754,-122.007,2230,71002,7,11,2014,UNK,0,-6564
2926049504,4/2/2015,500000.0,3,2.25,1700,9008,1.0,0.0,0.0,3,8,1340,360,1985,0,98125,47.7161,-122.31700000000001,2340,8003,4,2,2015,UNK,-640,1005
126039252,7/9/2014,415000.0,4,1.5,1840,11367,1.5,0.0,0.0,4,7,1840,0,1950,0,98177,47.7656,-122.35799999999999,1690,9800,7,9,2014,UNK,150,1567
2622029073,9/5/2014,437500.0,3,2.25,2100,205603,2.0,0.0,0.0,3,8,2100,0,1983,0,98070,47.3668,-122.505,2396,187308,9,5,2014,UNK,-296,18295
9187200345,7/9/2014,599000.0,7,2.5,2580,5750,1.0,0.0,0.0,4,7,1880,0,1901,0,98122,47.6025,-122.294,2280,5750,7,9,2014,UNK,300,0
2621760480,10/14/2014,367000.0,4,2.5,2350,8182,2.0,0.0,0.0,3,8,2350,0,1997,0,98042,47.3697,-122.10600000000001,2330,7000,10,14,2014,UNK,20,1182
7986401205,4/25/2015,530000.0,2,1.0,760,3000,1.0,0.0,0.0,3,6,760,0,1922,0,98107,47.6633,-122.35700000000001,1630,3600,4,25,2015,UNK,-870,-600
4447300137,6/4/2014,989000.0,5,3.5,3280,4000,2.0,0.0,0.0,3,9,2440,840,2003,0,98117,47.68899999999999,-122.396,1980,4000,6,4,2014,UNK,1300,0
2147300050,8/22/2014,462600.0,3,2.0,1320,4000,1.0,0.0,0.0,4,6,1020,300,1940,0,98118,47.5515,-122.262,2410,6212,8,22,2014,UNK,-1090,-2212
4458300190,4/24/2015,875000.0,3,2.5,1690,10592,1.0,0.0,0.0,3,8,1690,0,1973,2009,98040,47.58,-122.23100000000001,2260,9945,4,24,2015,Y,-570,647
3751606785,7/22/2014,335000.0,3,2.25,2060,47318,1.0,0.0,2.0,4,8,1600,460,1976,0,98001,47.2758,-122.265,1870,19663,7,22,2014,UNK,190,27655
4287400005,7/31/2014,393000.0,4,2.0,1450,5456,1.0,0.0,0.0,5,7,1450,0,1951,0,98108,47.5442,-122.29700000000001,980,6100,7,31,2014,UNK,470,-644
6613000715,7/21/2014,1340000.0,4,3.0,2760,4905,2.0,0.0,1.0,4,9,1840,920,1938,0,98105,47.6591,-122.27,3200,5424,7,21,2014,UNK,-440,-519
7702010050,3/23/2015,590000.0,3,2.5,2830,5788,2.0,0.0,0.0,3,9,2830,0,2001,0,98028,47.7604,-122.235,2500,5802,3,23,2015,UNK,330,-14
2770602360,4/21/2015,671000.0,4,2.75,1890,1475,2.0,0.0,0.0,3,9,1200,690,2015,0,98199,47.6472,-122.383,1650,1682,4,21,2015,N,240,-207
9551201155,7/28/2014,925000.0,3,3.25,2610,4500,1.5,0.0,0.0,4,9,1660,950,1909,0,98103,47.6701,-122.339,2110,4500,7,28,2014,UNK,500,0
1823049242,10/6/2014,245000.0,3,2.25,1900,7250,1.0,0.0,0.0,3,7,1250,650,1967,0,98146,47.4869,-122.344,1560,9420,10,6,2014,UNK,340,-2170
1513800170,4/2/2015,392500.0,3,1.0,930,6572,1.0,0.0,0.0,3,7,930,0,1952,0,98115,47.6889,-122.301,960,5840,4,2,2015,UNK,-30,732
4027700396,8/28/2014,505000.0,4,2.0,2730,12000,1.0,0.0,0.0,4,8,1410,1320,1998,0,98155,47.7733,-122.271,2730,9039,8,28,2014,UNK,0,2961
7203210170,8/19/2014,702000.0,4,2.5,2650,6240,2.0,0.0,0.0,3,8,2650,0,2013,0,98053,47.6885,-122.021,2640,6524,8,19,2014,N,10,-284
3013300895,7/18/2014,337000.0,2,1.0,1010,4000,1.0,0.0,0.0,3,7,1010,0,1947,0,98136,47.5311,-122.382,1480,4366,7,18,2014,UNK,-470,-366
5608010050,12/29/2014,920000.0,4,2.5,3550,10233,2.0,0.0,0.0,3,9,3550,0,1996,0,98027,47.5499,-122.1,3310,9157,12,29,2014,UNK,240,1076
6370000005,8/27/2014,495500.0,3,1.75,2130,6360,1.0,0.0,0.0,3,7,1720,410,1959,0,98125,47.7059,-122.301,1540,6361,8,27,2014,UNK,590,-1
1922059102,9/24/2014,245000.0,2,1.75,1840,7230,1.0,0.0,0.0,3,7,1570,270,1938,0,98030,47.3815,-122.228,1282,6769,9,24,2014,UNK,558,461
6738700005,5/29/2014,395000.0,2,1.0,1320,1824,1.5,0.0,0.0,4,6,1320,0,1909,0,98144,47.585,-122.294,1320,4000,5,29,2014,UNK,0,-2176
1138020020,2/17/2015,335000.0,3,1.0,990,6315,1.0,0.0,0.0,3,7,990,0,1970,0,98034,47.7116,-122.214,1450,6702,2,17,2015,UNK,-460,-387
5437820250,11/10/2014,187000.0,2,1.75,1020,10346,1.0,0.0,0.0,4,6,1020,0,1983,0,98022,47.1958,-122.00200000000001,1160,8610,11,10,2014,UNK,-140,1736
7923700020,11/21/2014,450000.0,4,2.0,1570,7320,1.0,0.0,0.0,4,7,1570,0,1960,0,98007,47.5967,-122.14,1530,8800,11,21,2014,UNK,40,-1480
293600080,6/17/2014,280000.0,4,2.25,1930,7207,1.0,0.0,0.0,4,7,1360,570,1988,0,98030,47.3783,-122.182,1760,7207,6,17,2014,UNK,170,0
3627800050,7/15/2014,1380000.0,5,4.0,3760,22763,1.0,0.0,3.0,4,11,1910,1850,1969,0,98040,47.5333,-122.22,3730,11201,7,15,2014,UNK,30,11562
4047200950,6/9/2014,265000.0,2,1.0,1000,31505,1.0,0.0,0.0,3,6,1000,0,1960,0,98019,47.7659,-121.899,1560,22597,6,9,2014,UNK,-560,8908
5458800425,4/23/2015,795000.0,3,1.75,1930,9600,1.0,0.0,0.0,3,8,1930,0,1958,0,98040,47.5747,-122.23700000000001,2350,9840,4,23,2015,UNK,-420,-240
2887700826,5/29/2014,510000.0,3,1.5,2240,3800,2.0,0.0,0.0,3,8,1370,870,1929,0,98115,47.6887,-122.307,1690,4275,5,29,2014,UNK,550,-475
7856700920,6/28/2014,699900.0,4,2.5,2190,11500,1.0,0.0,0.0,4,8,1430,760,1972,0,98006,47.5668,-122.147,2580,9700,6,28,2014,UNK,-390,1800
627300190,8/12/2014,839000.0,4,2.75,2400,12469,1.0,0.0,2.0,4,8,1760,640,1958,0,98008,47.5861,-122.11200000000001,2400,10400,8,12,2014,UNK,0,2069
5634500182,7/15/2014,396000.0,4,1.75,1970,12409,1.0,0.0,0.0,4,7,1220,750,1968,0,98028,47.7489,-122.236,1690,10720,7,15,2014,UNK,280,1689
2472950170,5/7/2015,365000.0,3,2.25,2860,8458,2.0,0.0,0.0,3,7,2860,0,1983,0,98058,47.4269,-122.148,1760,8458,5,7,2015,UNK,1100,0
9557300190,7/11/2014,440000.0,3,2.25,1900,7225,1.0,0.0,0.0,3,8,1220,680,1970,0,98008,47.6394,-122.113,1900,7399,7,11,2014,UNK,0,-174
2314300170,11/4/2014,405000.0,4,2.5,2090,6667,2.0,0.0,0.0,3,8,2090,0,1997,0,98058,47.4648,-122.15,2250,6165,11,4,2014,UNK,-160,502
7547300050,5/15/2014,295000.0,3,1.5,850,2500,1.0,0.0,0.0,3,7,850,0,1986,0,98106,47.5677,-122.36,850,5000,5,15,2014,UNK,0,-2500
7985400089,5/15/2014,275000.0,4,2.5,1840,1562,2.0,0.0,0.0,3,7,1400,440,2004,0,98106,47.5345,-122.36399999999999,1840,1766,5,15,2014,N,0,-204
322059049,10/3/2014,295000.0,2,1.0,820,288367,1.0,0.0,0.0,3,6,820,0,1930,0,98042,47.4196,-122.165,1580,8154,10,3,2014,UNK,-760,280213
2344300170,8/15/2014,1500000.0,5,3.5,4370,12240,2.0,0.0,0.0,3,11,3270,1100,1990,0,98004,47.582,-122.199,2980,12800,8,15,2014,UNK,1390,-560
11501330,9/2/2014,795000.0,3,3.5,3190,10223,2.0,0.0,0.0,3,10,2560,630,1994,0,98052,47.6968,-122.102,3120,9735,9,2,2014,UNK,70,488
7300200290,5/6/2014,650000.0,5,3.5,3480,36615,2.0,0.0,0.0,4,8,2490,990,1983,0,98075,47.5741,-122.05,2540,35910,5,6,2014,UNK,940,705
4331000595,9/10/2014,260000.0,3,1.0,1690,13184,1.0,0.0,0.0,4,7,1690,0,1959,0,98166,47.476000000000006,-122.34299999999999,1130,13451,9,10,2014,UNK,560,-267
7853340660,8/6/2014,382000.0,2,2.5,1650,2710,2.0,0.0,2.0,3,8,1650,0,2008,0,98065,47.5173,-121.87799999999999,1760,2992,8,6,2014,N,-110,-282
7525570020,4/21/2015,790100.0,4,2.5,2590,9341,2.0,0.0,0.0,3,8,2590,0,1985,0,98052,47.6496,-122.11399999999999,2280,9510,4,21,2015,UNK,310,-169
6306100190,5/21/2014,220000.0,4,2.5,2160,8005,2.0,0.0,0.0,3,7,2160,0,1993,0,98001,47.2668,-122.23100000000001,1790,8016,5,21,2014,UNK,370,-11
1424059142,6/5/2014,799000.0,4,3.5,3500,8547,2.0,0.0,0.0,3,9,2500,1000,1994,0,98006,47.5613,-122.126,2350,10270,6,5,2014,UNK,1150,-1723
5700003810,7/23/2014,1480000.0,4,2.25,3920,7200,2.0,0.0,0.0,3,10,3120,800,1928,0,98144,47.5731,-122.28399999999999,3400,7200,7,23,2014,UNK,520,0
2595650170,6/9/2014,367300.0,4,2.75,2190,14937,2.0,0.0,0.0,3,8,2190,0,1993,0,98001,47.3535,-122.273,1920,11360,6,9,2014,UNK,270,3577
9530100225,4/9/2015,805000.0,4,2.0,1890,4500,1.5,0.0,0.0,3,7,1490,400,1907,1993,98103,47.6684,-122.35600000000001,1640,4010,4,9,2015,Y,250,490
3856901760,12/15/2014,730000.0,2,1.0,1860,3400,1.0,0.0,0.0,3,7,1010,850,1920,0,98105,47.6714,-122.329,1540,3997,12,15,2014,UNK,320,-597
1387301350,11/23/2014,402000.0,3,2.0,1720,7704,1.0,0.0,0.0,4,7,1160,560,1969,0,98011,47.7368,-122.195,1620,7600,11,23,2014,UNK,100,104
7974200822,5/30/2014,750000.0,4,2.75,2600,4674,1.0,0.0,0.0,3,8,1560,1040,1976,0,98115,47.6782,-122.286,2600,6099,5,30,2014,UNK,0,-1425
8039900130,7/30/2014,458000.0,3,1.5,1570,12196,1.0,0.0,0.0,4,7,1570,0,1972,0,98045,47.4866,-121.786,1740,12196,7,30,2014,UNK,-170,0
4139460290,8/28/2014,898000.0,3,2.5,3530,9753,2.0,0.0,0.0,3,10,3530,0,1997,0,98006,47.5539,-122.103,3220,9234,8,28,2014,UNK,310,519
8078520280,3/23/2015,308000.0,4,2.5,1960,5642,2.0,0.0,0.0,3,7,1960,0,1998,0,98092,47.3167,-122.18700000000001,1870,5250,3,23,2015,UNK,90,392
8691510290,5/6/2015,385000.0,3,2.5,2230,8296,2.0,0.0,0.0,3,7,2230,0,2004,0,98058,47.4386,-122.116,2480,5940,5,6,2015,N,-250,2356
4217400680,10/6/2014,1020000.0,4,3.0,2720,4800,1.5,0.0,0.0,5,8,1790,930,1928,0,98105,47.6595,-122.28299999999999,2260,4800,10,6,2014,UNK,460,0
1336800670,12/29/2014,1430000.0,5,3.0,2840,6240,2.0,0.0,0.0,5,9,2440,400,1905,0,98112,47.6285,-122.309,2940,6000,12,29,2014,UNK,-100,240
1545801850,7/23/2014,240000.0,3,1.75,1260,7362,1.0,0.0,0.0,3,7,1260,0,1984,0,98038,47.3602,-122.052,1530,7232,7,23,2014,UNK,-270,130
6386600170,10/1/2014,217000.0,3,1.5,1860,8505,1.0,0.0,0.0,4,7,1860,0,1967,0,98023,47.3106,-122.365,1810,8262,10,1,2014,UNK,50,243
1373800170,6/30/2014,972000.0,4,1.75,2010,6300,1.0,0.0,2.0,5,8,1610,400,1937,0,98199,47.6457,-122.412,3290,6300,6,30,2014,UNK,-1280,0
1394300005,5/7/2014,361280.0,2,1.0,820,6400,1.0,0.0,0.0,4,7,820,0,1944,0,98126,47.55,-122.37899999999999,1490,6400,5,7,2014,UNK,-670,0
7011201087,8/4/2014,385000.0,3,1.75,1220,1450,1.0,0.0,0.0,3,6,620,600,1905,0,98119,47.6361,-122.368,1660,2960,8,4,2014,UNK,-440,-1510
1623069071,11/5/2014,475000.0,3,2.5,2220,60984,2.0,0.0,0.0,4,8,2220,0,1987,0,98027,47.4802,-122.052,1930,55333,11,5,2014,UNK,290,5651
1982200480,4/2/2015,724950.0,4,2.5,2860,3638,1.5,0.0,2.0,5,7,1720,1140,1924,0,98107,47.6631,-122.361,1760,3880,4,2,2015,UNK,1100,-242
8089510170,10/27/2014,935000.0,5,4.5,4230,9701,2.0,0.0,0.0,3,10,4230,0,1999,0,98006,47.5444,-122.131,4130,12253,10,27,2014,UNK,100,-2552
5560000480,9/8/2014,169950.0,3,1.0,840,8470,1.0,0.0,0.0,4,6,840,0,1961,0,98023,47.3275,-122.338,840,8450,9,8,2014,UNK,0,20
6308000010,12/8/2014,585000.0,3,2.5,2290,5089,2.0,0.0,0.0,3,9,2290,0,2001,0,98006,47.5443,-122.17200000000001,2290,7984,12,8,2014,UNK,0,-2895
6308000010,4/23/2015,585000.0,3,2.5,2290,5089,2.0,0.0,0.0,3,9,2290,0,2001,0,98006,47.5443,-122.17200000000001,2290,7984,4,23,2015,UNK,0,-2895
4136960010,3/27/2015,480000.0,5,3.5,3480,12821,2.0,0.0,2.0,3,10,2890,590,2004,0,98092,47.2641,-122.215,3400,9870,3,27,2015,N,80,2951
8665900168,11/5/2014,635000.0,4,2.5,4260,36360,1.5,0.0,0.0,4,8,4100,160,1935,0,98155,47.763999999999996,-122.302,2430,17888,11,5,2014,UNK,1830,18472
8691510170,2/4/2015,368750.0,3,2.5,2230,5717,2.0,0.0,0.0,3,7,2230,0,2004,0,98058,47.4388,-122.117,2230,5194,2,4,2015,N,0,523
9187200095,12/2/2014,432500.0,6,2.0,3080,5500,2.0,0.0,0.0,1,7,3080,0,1900,0,98122,47.6031,-122.296,1830,5000,12,2,2014,UNK,1250,500
4221260050,9/3/2014,589000.0,3,2.5,2250,4337,2.0,0.0,0.0,3,8,2250,0,2004,0,98075,47.5908,-122.01700000000001,2250,4721,9,3,2014,N,0,-384
8562740480,4/14/2015,840000.0,4,3.25,3160,6327,2.0,0.0,0.0,3,9,2280,880,2004,0,98027,47.536,-122.066,3160,5946,4,14,2015,N,0,381
6806100250,3/5/2015,316500.0,3,2.5,1770,3873,2.0,0.0,0.0,3,7,1770,0,2005,0,98058,47.4648,-122.14399999999999,2280,4330,3,5,2015,N,-510,-457
7853300280,2/13/2015,536000.0,4,2.5,2880,8833,2.0,0.0,0.0,3,7,2880,0,2006,0,98065,47.5388,-121.89,2570,5234,2,13,2015,N,310,3599
6446200190,4/20/2015,563750.0,4,2.75,2690,25000,1.0,0.0,0.0,3,8,1750,940,1978,0,98029,47.5537,-122.02600000000001,2640,28250,4,20,2015,UNK,50,-3250
4222310010,12/26/2014,152500.0,4,1.0,1730,7350,1.5,0.0,0.0,4,6,1730,0,1970,0,98003,47.3467,-122.307,1440,7752,12,26,2014,UNK,290,-402
4222310010,4/20/2015,267950.0,4,1.0,1730,7350,1.5,0.0,0.0,4,6,1730,0,1970,0,98003,47.3467,-122.307,1440,7752,4,20,2015,UNK,290,-402
4054550010,4/13/2015,1640000.0,5,4.0,4780,118047,2.0,0.0,0.0,3,11,4780,0,1994,0,98077,47.7243,-122.052,4040,31760,4,13,2015,UNK,740,86287
1440700190,6/23/2014,269950.0,4,2.5,2540,8400,2.0,0.0,0.0,5,7,2540,0,1977,0,98032,47.3754,-122.277,1600,8050,6,23,2014,UNK,940,350
5569620050,7/21/2014,731688.0,4,3.0,2630,5772,2.0,0.0,0.0,3,9,2630,0,2006,0,98052,47.6952,-122.133,3460,6158,7,21,2014,N,-830,-386
1840200080,12/3/2014,240000.0,3,1.5,1890,9000,1.0,0.0,0.0,3,7,1190,700,1959,0,98188,47.4425,-122.272,2060,9000,12,3,2014,UNK,-170,0
9268200585,9/3/2014,555950.0,2,1.0,1220,5040,1.0,0.0,0.0,3,7,1220,0,1961,0,98117,47.6957,-122.36399999999999,1420,5040,9,3,2014,UNK,-200,0
7454000585,4/27/2015,289000.0,2,1.0,710,6300,1.0,0.0,0.0,3,6,710,0,1942,0,98126,47.5155,-122.374,740,6300,4,27,2015,UNK,-30,0
7504021310,5/6/2014,525000.0,3,2.5,2970,11985,1.0,0.0,0.0,3,9,1770,1200,1995,0,98074,47.6359,-122.052,2990,12049,5,6,2014,UNK,-20,-64
7504021310,12/4/2014,745000.0,3,2.5,2970,11985,1.0,0.0,0.0,3,9,1770,1200,1995,0,98074,47.6359,-122.052,2990,12049,12,4,2014,UNK,-20,-64
8024201795,11/17/2014,397000.0,2,1.0,1000,7664,1.0,0.0,2.0,3,7,1000,0,1939,0,98115,47.7001,-122.311,1570,6350,11,17,2014,UNK,-570,1314
8638500170,4/22/2015,233000.0,3,1.0,1980,8505,1.0,0.0,0.0,3,7,1030,950,1965,0,98106,47.538000000000004,-122.353,1830,8505,4,22,2015,UNK,150,0
5437400630,10/16/2014,625000.0,4,2.25,1920,8259,2.0,0.0,0.0,4,8,1920,0,1979,0,98027,47.5616,-122.088,2030,8910,10,16,2014,UNK,-110,-651
9264000010,7/29/2014,535000.0,3,2.0,2740,23505,2.0,0.0,4.0,3,10,2740,0,1988,0,98001,47.318999999999996,-122.26,2800,16400,7,29,2014,UNK,-60,7105
3832600080,5/4/2015,270000.0,3,2.25,1740,7345,1.0,0.0,0.0,3,7,1380,360,1973,0,98032,47.3663,-122.285,1770,8250,5,4,2015,UNK,-30,-905
9477001350,7/22/2014,360000.0,3,1.75,1300,7770,1.0,0.0,0.0,3,7,1300,0,1967,0,98034,47.7347,-122.19200000000001,1520,7600,7,22,2014,UNK,-220,170
809001060,5/13/2014,1110000.0,4,1.5,2740,4000,2.0,0.0,0.0,5,9,1930,0,1905,0,98109,47.6343,-122.352,1680,4000,5,13,2014,UNK,1060,0
2771604120,11/11/2014,970000.0,4,1.75,4060,4000,2.0,0.0,3.0,3,10,2890,1170,1953,1995,98199,47.6375,-122.389,1860,4000,11,11,2014,Y,2200,0
9541800190,10/10/2014,915000.0,5,2.5,3490,18850,1.0,0.0,4.0,4,9,1840,1650,1958,0,98005,47.5955,-122.176,2690,11625,10,10,2014,UNK,800,7225
4038400130,7/11/2014,412000.0,4,1.75,1430,10500,1.0,0.0,0.0,4,7,1130,300,1960,0,98007,47.6083,-122.132,2070,8640,7,11,2014,UNK,-640,1860
1253200290,2/12/2015,265000.0,4,1.75,1860,9112,1.0,0.0,0.0,4,7,1110,750,1963,0,98032,47.3792,-122.28200000000001,1570,9112,2,12,2015,UNK,290,0
2558650130,9/16/2014,426000.0,4,2.25,2120,7700,1.0,0.0,0.0,4,7,1490,630,1976,0,98034,47.7207,-122.165,1890,8203,9,16,2014,UNK,230,-503
8732190170,12/10/2014,266000.0,4,2.25,1860,12693,1.0,0.0,0.0,3,8,1140,720,1978,0,98023,47.3114,-122.395,1950,8740,12,10,2014,UNK,-90,3953
1703400585,12/15/2014,325000.0,3,2.0,2330,4950,1.5,0.0,0.0,3,6,1430,900,1900,0,98118,47.5585,-122.29,1160,5115,12,15,2014,UNK,1170,-165
1250202115,1/20/2015,615000.0,3,1.75,1670,5100,1.0,0.0,2.0,5,7,990,680,1954,0,98144,47.5898,-122.291,2140,4452,1,20,2015,UNK,-470,648
9264911150,4/23/2015,310000.0,3,1.75,2130,7140,1.0,0.0,0.0,3,8,1580,550,1979,0,98023,47.3074,-122.34100000000001,2180,7906,4,23,2015,UNK,-50,-766
7696300080,9/14/2014,340000.0,4,1.75,1900,7313,1.0,0.0,0.0,3,7,1900,0,1973,0,98034,47.7311,-122.23200000000001,1420,7384,9,14,2014,UNK,480,-71
1931300010,5/1/2015,562500.0,2,1.0,1170,2800,1.5,0.0,0.0,4,5,1170,0,1905,0,98103,47.6574,-122.345,1660,4996,5,1,2015,UNK,-490,-2196
2771602425,7/21/2014,447000.0,2,1.0,980,1600,2.0,0.0,0.0,3,8,980,0,2010,0,98119,47.63800000000001,-122.375,1180,1600,7,21,2014,N,-200,0
2210500010,9/30/2014,2450000.0,7,4.25,4670,23115,2.0,0.0,2.0,3,11,4670,0,1992,0,98039,47.6183,-122.227,3240,13912,9,30,2014,UNK,1430,9203
1253200170,5/20/2014,250000.0,4,1.5,2500,6300,1.0,0.0,0.0,4,7,1500,1000,1961,0,98032,47.3781,-122.28399999999999,1720,8925,5,20,2014,UNK,780,-2625
6646200420,1/2/2015,633000.0,4,2.5,2020,8044,2.0,0.0,0.0,3,8,2020,0,1990,0,98074,47.6247,-122.04299999999999,2320,7328,1,2,2015,UNK,-300,716
8822901024,4/23/2015,310000.0,3,2.0,1290,886,3.0,0.0,0.0,3,7,1290,0,2004,0,98125,47.7161,-122.295,1270,1152,4,23,2015,N,20,-266
1323089056,11/10/2014,439000.0,2,1.75,1620,113862,1.5,0.0,0.0,3,7,1620,0,1995,0,98045,47.4821,-121.719,1560,54806,11,10,2014,UNK,60,59056
3629950010,8/20/2014,470000.0,3,3.25,1710,2381,2.0,0.0,0.0,3,8,1360,350,2003,0,98029,47.5477,-122.00399999999999,1420,1163,8,20,2014,UNK,290,1218
7889100020,4/14/2015,270000.0,3,2.5,1720,8550,1.0,0.0,0.0,4,7,1720,0,1968,0,98002,47.2837,-122.20700000000001,1460,8550,4,14,2015,UNK,260,0
7212680020,12/19/2014,299500.0,3,1.75,1820,8813,2.0,0.0,0.0,3,7,1820,0,1994,0,98003,47.2622,-122.303,1780,7349,12,19,2014,UNK,40,1464
2222049108,9/18/2014,227000.0,3,1.0,1130,10018,1.0,0.0,0.0,4,6,1130,0,1954,0,98032,47.3733,-122.275,1770,7700,9,18,2014,UNK,-640,2318
7129303070,8/20/2014,735000.0,4,2.75,3040,2415,2.0,0.0,4.0,3,8,3040,0,1966,0,98118,47.5188,-122.256,2620,2433,8,20,2014,UNK,420,-18
6744700424,6/26/2014,537000.0,3,3.0,2410,7479,2.0,0.0,2.0,3,7,2410,0,1942,1988,98155,47.7394,-122.288,2610,7479,6,26,2014,Y,-200,0
1727000680,12/9/2014,699000.0,4,2.5,2440,14470,1.0,0.0,0.0,4,9,1660,780,1970,0,98005,47.6401,-122.16799999999999,2810,15564,12,9,2014,UNK,-370,-1094
3226049134,9/2/2014,330000.0,2,1.0,800,4533,1.0,0.0,0.0,3,6,600,200,1929,0,98115,47.6979,-122.325,1720,6800,9,2,2014,UNK,-920,-2267
1760600009,8/29/2014,229000.0,3,1.0,1030,7800,1.0,0.0,0.0,3,7,1030,0,1954,0,98168,47.473,-122.324,1630,12664,8,29,2014,UNK,-600,-4864
3352400351,11/21/2014,200000.0,3,1.0,1480,5600,1.0,0.0,0.0,4,6,940,540,1947,0,98178,47.5045,-122.27,1350,11100,11,21,2014,UNK,130,-5500
8563000250,8/12/2014,522500.0,3,1.75,1710,9707,1.0,0.0,0.0,4,8,1710,0,1966,0,98008,47.62300000000001,-122.105,1820,8700,8,12,2014,UNK,-110,1007
1370800680,3/24/2015,1300000.0,3,2.75,3450,5350,1.5,0.0,3.0,4,9,2590,860,1925,0,98199,47.6389,-122.40700000000001,2910,5350,3,24,2015,UNK,540,0
2726049034,11/10/2014,2000000.0,3,3.25,2610,16387,2.0,0.0,4.0,3,9,2610,0,2006,0,98125,47.7175,-122.27799999999999,2590,12958,11,10,2014,N,20,3429
3623059027,10/22/2014,200000.0,2,0.75,780,55764,1.0,0.0,0.0,4,4,780,0,1945,0,98058,47.442,-122.105,1620,30847,10,22,2014,UNK,-840,24917
3205500020,4/8/2015,352000.0,3,1.75,1260,7200,1.0,0.0,0.0,3,7,1260,0,1971,0,98034,47.7189,-122.178,1460,7200,4,8,2015,UNK,-200,0
8924100305,3/25/2015,855000.0,4,3.0,2590,6250,2.0,0.0,2.0,3,9,2240,350,1964,0,98115,47.6774,-122.26700000000001,2260,6780,3,25,2015,UNK,330,-530
7524300020,8/20/2014,267000.0,3,2.5,1580,12250,2.0,0.0,0.0,3,8,1580,0,1993,0,98198,47.3771,-122.315,1560,9900,8,20,2014,UNK,20,2350
2436200715,5/6/2014,484000.0,2,1.75,1660,6000,1.0,0.0,0.0,3,7,1160,500,1942,0,98105,47.6624,-122.291,1660,4000,5,6,2014,UNK,0,2000
5469501850,6/29/2014,402000.0,4,2.75,2950,15540,1.0,0.0,0.0,4,8,2120,830,1974,0,98042,47.3845,-122.152,2840,17136,6,29,2014,UNK,110,-1596
9187200275,4/20/2015,905000.0,4,2.25,2240,5000,2.0,0.0,0.0,3,8,1770,470,1900,2014,98122,47.6027,-122.295,2120,5000,4,20,2015,Y,120,0
274000020,8/8/2014,274000.0,4,1.75,1940,7500,1.0,0.0,0.0,4,7,1720,220,1966,0,98030,47.3736,-122.215,2000,9000,8,8,2014,UNK,-60,-1500
6151800225,4/9/2015,475000.0,3,1.75,1850,26445,1.0,0.0,0.0,4,7,1850,0,1962,1977,98010,47.3412,-122.051,2110,23280,4,9,2015,Y,-260,3165
8924600020,11/14/2014,1540000.0,4,4.5,5770,10050,1.0,0.0,3.0,5,9,3160,2610,1949,0,98115,47.677,-122.275,2950,6700,11,14,2014,UNK,2820,3350
4003000285,5/4/2014,628000.0,4,2.0,2280,6010,1.0,0.0,0.0,3,7,1140,1140,1900,0,98122,47.6034,-122.289,2240,6200,5,4,2014,UNK,40,-190
290000095,6/17/2014,675000.0,6,1.75,2740,6360,1.0,0.0,3.0,3,8,1370,1370,1953,0,98146,47.5062,-122.385,2150,6600,6,17,2014,UNK,590,-240
1565930130,11/4/2014,429900.0,4,3.25,3760,4675,2.0,0.0,0.0,3,8,2740,1020,2007,0,98038,47.3862,-122.04799999999999,3280,4033,11,4,2014,N,480,642
6123000225,6/25/2014,260000.0,3,1.5,1580,8184,1.0,0.0,0.0,3,7,1140,440,1954,0,98148,47.4294,-122.331,1540,9476,6,25,2014,UNK,40,-1292
4385700285,9/3/2014,690000.0,3,1.75,1600,4400,1.0,0.0,0.0,3,7,1030,570,1941,0,98112,47.6348,-122.281,2150,4000,9,3,2014,UNK,-550,400
2469000010,3/23/2015,1080000.0,4,2.25,2100,12172,1.0,0.0,0.0,5,9,2100,0,1961,0,98040,47.5458,-122.227,2400,10713,3,23,2015,UNK,-300,1459
5205000020,4/9/2015,360000.0,4,2.5,2610,7333,2.0,0.0,0.0,3,8,2610,0,1988,0,98003,47.2721,-122.29299999999999,2280,9033,4,9,2015,UNK,330,-1700
461002890,6/19/2014,499000.0,3,1.75,1840,5000,1.0,0.0,0.0,4,7,920,920,1910,0,98117,47.6808,-122.376,1220,5000,6,19,2014,UNK,620,0
1823059030,8/18/2014,159000.0,3,1.0,1320,6534,1.0,0.0,0.0,3,7,1320,0,1952,0,98055,47.4806,-122.223,2140,7405,8,18,2014,UNK,-820,-871
8848400020,3/27/2015,430000.0,3,1.75,1540,8100,1.0,0.0,0.0,4,7,940,600,1947,0,98133,47.748999999999995,-122.351,1840,8100,3,27,2015,UNK,-300,0
4122500095,4/13/2015,1050000.0,5,2.75,2520,18625,1.0,0.0,0.0,3,8,1660,860,1959,0,98004,47.6409,-122.20700000000001,3000,16624,4,13,2015,UNK,-480,2001
2597300020,11/13/2014,725000.0,5,2.5,3780,20000,1.0,0.0,1.0,4,9,1890,1890,1978,0,98155,47.7603,-122.273,2840,19908,11,13,2014,UNK,940,92
2788400020,7/10/2014,150000.0,3,1.0,1200,9527,1.0,0.0,0.0,3,7,1200,0,1959,0,98168,47.5112,-122.316,1510,9457,7,10,2014,UNK,-310,70
7856610130,7/21/2014,840000.0,4,2.25,2720,8712,2.0,0.0,0.0,4,9,2720,0,1976,0,98006,47.5616,-122.15299999999999,2470,8714,7,21,2014,UNK,250,-2
3303860460,4/15/2015,499000.0,4,2.5,3100,5700,2.0,0.0,0.0,3,9,3100,0,2011,0,98038,47.3696,-122.05799999999999,3060,6000,4,15,2015,N,40,-300
2112700920,10/14/2014,285000.0,3,1.75,1630,4000,1.0,0.0,0.0,3,7,1100,530,1968,0,98106,47.5351,-122.353,1300,4000,10,14,2014,UNK,330,0
6880210020,3/8/2015,340000.0,4,2.5,1910,7201,1.0,0.0,0.0,3,7,1210,700,1987,0,98198,47.3908,-122.316,1690,7554,3,8,2015,UNK,220,-353
6139100101,5/5/2015,405100.0,4,2.0,1580,7300,1.0,0.0,0.0,4,7,1580,0,1955,0,98155,47.7598,-122.32799999999999,1180,9450,5,5,2015,UNK,400,-2150
7202330920,8/7/2014,464000.0,3,2.5,1690,4898,2.0,0.0,0.0,3,7,1690,0,2003,0,98053,47.6834,-122.038,2220,4933,8,7,2014,UNK,-530,-35
8146300020,5/29/2014,723000.0,4,2.25,1960,8680,1.0,0.0,0.0,4,8,1290,670,1959,0,98004,47.6076,-122.19200000000001,2160,8680,5,29,2014,UNK,-200,0
7418000130,12/11/2014,430000.0,8,3.25,4300,10441,2.0,0.0,0.0,4,8,2800,1500,1979,0,98059,47.4786,-122.131,1780,10457,12,11,2014,UNK,2520,-16
9276200635,4/30/2015,645000.0,3,1.75,1840,4255,1.0,0.0,0.0,3,7,940,900,1907,2005,98116,47.58,-122.39200000000001,1600,4255,4,30,2015,Y,240,0
251610020,5/8/2015,1580000.0,4,2.75,3480,19991,2.0,0.0,2.0,4,10,2630,850,1979,0,98004,47.6354,-122.214,3770,20271,5,8,2015,UNK,-290,-280
8825900020,8/11/2014,925000.0,5,3.0,2710,4200,2.0,0.0,0.0,3,7,1890,820,1919,0,98115,47.6754,-122.307,2150,4200,8,11,2014,UNK,560,0
3856903495,7/9/2014,759000.0,4,1.75,2100,4750,1.0,0.0,0.0,3,7,1340,760,1975,0,98103,47.6695,-122.333,1700,4125,7,9,2014,UNK,400,625
6382500020,8/5/2014,690000.0,4,2.0,1760,7800,1.0,0.0,0.0,3,8,1760,0,1954,0,98117,47.6945,-122.38,1950,7800,8,5,2014,UNK,-190,0
522059352,3/26/2015,358800.0,4,2.5,2155,8140,2.0,0.0,0.0,3,8,2155,0,1996,0,98031,47.4204,-122.20100000000001,2155,7245,3,26,2015,UNK,0,895
1778500595,4/13/2015,683000.0,5,1.5,1720,4000,1.5,0.0,0.0,3,7,1520,200,1925,0,98112,47.6197,-122.287,2280,4000,4,13,2015,UNK,-560,0
4083300595,12/8/2014,650000.0,3,1.0,1430,4240,1.5,0.0,0.0,3,7,1430,0,1924,0,98103,47.6595,-122.337,1660,4240,12,8,2014,UNK,-230,0
2100200020,12/9/2014,288000.0,5,2.75,2790,4807,1.5,0.0,0.0,4,7,2140,650,1949,0,98002,47.3098,-122.223,1056,4807,12,9,2014,UNK,1734,0
2597500840,7/7/2014,209950.0,3,1.5,1180,7300,1.0,0.0,0.0,4,7,1180,0,1968,0,98002,47.2857,-122.197,2030,8424,7,7,2014,UNK,-850,-1124
7935000595,10/8/2014,939000.0,3,3.5,2450,9248,2.0,0.0,4.0,3,8,1960,490,1933,0,98136,47.5476,-122.397,2620,10207,10,8,2014,UNK,-170,-959
7857003318,8/16/2014,320000.0,3,1.0,1330,5850,1.0,0.0,0.0,3,7,930,400,1954,0,98108,47.5498,-122.29799999999999,1440,5850,8,16,2014,UNK,-110,0
9211520020,8/22/2014,283748.0,3,2.25,1940,9560,2.0,0.0,0.0,3,7,1940,0,1989,0,98023,47.2998,-122.387,1800,9560,8,22,2014,UNK,140,0
1460000080,7/31/2014,370000.0,3,2.25,1600,7620,1.0,0.0,0.0,3,7,1280,320,1987,0,98011,47.773999999999994,-122.208,1600,8215,7,31,2014,UNK,0,-595
3444120130,3/27/2015,399950.0,4,2.75,3210,41689,1.0,0.0,0.0,4,8,1610,1600,1989,0,98042,47.3493,-122.06200000000001,2100,41384,3,27,2015,UNK,1110,305
908000010,12/12/2014,360000.0,5,2.5,2880,6902,1.0,0.0,0.0,3,8,1680,1200,1976,0,98058,47.4332,-122.14399999999999,2080,5586,12,12,2014,UNK,800,1316
3123800080,11/12/2014,365000.0,2,1.5,1160,8060,1.0,0.0,0.0,4,7,1160,0,1950,0,98136,47.5146,-122.38600000000001,1500,8060,11,12,2014,UNK,-340,0
8641500345,12/19/2014,396900.0,3,2.0,1360,3120,2.0,0.0,0.0,3,7,1360,0,1989,0,98115,47.6943,-122.307,1360,3120,12,19,2014,UNK,0,0
3717000250,4/22/2015,321000.0,3,2.5,2014,4500,2.0,0.0,0.0,3,7,2014,0,2005,0,98001,47.3371,-122.256,2014,4500,4,22,2015,N,0,0
7697860130,1/6/2015,245000.0,3,2.0,1440,7008,1.0,0.0,0.0,3,7,1440,0,1985,0,98030,47.3702,-122.182,1680,7200,1,6,2015,UNK,-240,-192
9169100130,10/7/2014,502000.0,2,1.0,1570,4704,1.5,0.0,1.0,3,8,1570,0,1931,0,98136,47.5256,-122.39200000000001,1820,4704,10,7,2014,UNK,-250,0
2944500470,6/5/2014,257000.0,4,2.75,2330,7642,1.0,0.0,0.0,3,8,1800,530,1990,0,98023,47.2946,-122.37,2320,7933,6,5,2014,UNK,10,-291
7424110130,5/15/2014,423000.0,4,1.75,1880,7303,1.0,0.0,0.0,3,7,1010,870,1976,0,98034,47.7129,-122.20299999999999,1710,7200,5,15,2014,UNK,170,103
4037000635,3/27/2015,485000.0,4,2.25,1850,9911,1.0,0.0,0.0,4,7,1850,0,1957,0,98008,47.6019,-122.116,1650,8670,3,27,2015,UNK,200,1241
2141500020,12/17/2014,500000.0,4,2.5,2230,8560,2.0,0.0,0.0,3,8,2230,0,2002,0,98059,47.4877,-122.14299999999999,2400,7756,12,17,2014,UNK,-170,804
952000725,10/21/2014,442000.0,2,1.0,990,4313,1.5,0.0,2.0,4,6,990,0,1917,0,98126,47.5677,-122.38,1480,5750,10,21,2014,UNK,-490,-1437
9550204620,5/12/2015,475000.0,3,1.75,1720,3825,1.5,0.0,0.0,3,7,1720,0,1925,0,98105,47.666000000000004,-122.32700000000001,2000,3825,5,12,2015,UNK,-280,0
6891800250,4/6/2015,625000.0,4,2.25,3230,9935,2.0,0.0,0.0,3,8,3230,0,1986,0,98028,47.7685,-122.257,2820,9722,4,6,2015,UNK,410,213
7812801850,10/15/2014,194000.0,3,1.0,1180,6050,1.0,0.0,0.0,3,6,820,360,1944,0,98178,47.4945,-122.249,1070,6050,10,15,2014,UNK,110,0
7504180170,7/7/2014,410000.0,3,2.25,1450,19206,2.0,0.0,0.0,3,7,1450,0,1989,0,98074,47.62,-122.052,1710,21485,7,7,2014,UNK,-260,-2279
686800080,6/12/2014,1030000.0,4,2.5,2370,10858,2.0,0.0,0.0,3,9,2370,0,2003,0,98004,47.6336,-122.19200000000001,2510,21673,6,12,2014,UNK,-140,-10815
7853300290,3/24/2015,490000.0,4,2.5,2570,6157,2.0,0.0,0.0,3,7,2570,0,2006,0,98065,47.5389,-121.89,2060,5292,3,24,2015,N,510,865
7905380380,12/9/2014,348500.0,4,1.75,1870,7575,1.0,0.0,0.0,3,7,1480,390,1972,0,98034,47.7205,-122.21799999999999,1670,7575,12,9,2014,UNK,200,0
1972202320,4/27/2015,380000.0,3,1.0,1220,3000,1.5,0.0,0.0,3,6,1220,0,1901,0,98103,47.6506,-122.346,1350,3000,4,27,2015,UNK,-130,0
1710400007,12/11/2014,660000.0,3,2.0,1770,2150,3.0,0.0,0.0,3,8,1770,0,1999,0,98122,47.6102,-122.314,2010,3200,12,11,2014,UNK,-240,-1050
2985800225,4/1/2015,525000.0,3,1.0,1500,6800,1.0,0.0,0.0,3,7,1500,0,1943,0,98105,47.6706,-122.26799999999999,1500,6800,4,1,2015,UNK,0,0
1721059069,7/17/2014,235000.0,3,2.0,1110,8724,1.0,0.0,0.0,4,7,1110,0,1990,0,98002,47.3056,-122.206,1390,7750,7,17,2014,UNK,-280,974
7852160170,4/22/2015,1210000.0,4,3.75,4980,18069,2.0,0.0,3.0,3,11,4980,0,2006,0,98065,47.5348,-121.85600000000001,4080,14577,4,22,2015,N,900,3492
626049102,3/24/2015,397950.0,4,1.75,2360,8116,1.0,0.0,0.0,4,7,1180,1180,1916,1970,98133,47.7635,-122.335,1670,8160,3,24,2015,Y,690,-44
7349660050,11/18/2014,268000.0,3,1.75,1600,7711,1.0,0.0,0.0,3,7,1600,0,1999,0,98002,47.284,-122.20200000000001,2100,7711,11,18,2014,UNK,-500,0
1231000660,5/21/2014,525000.0,3,1.0,1450,4000,1.0,0.0,1.0,4,8,950,500,1948,0,98118,47.5554,-122.266,1880,4000,5,21,2014,UNK,-430,0
9558900010,10/6/2014,549950.0,3,2.5,2680,5860,2.0,0.0,0.0,3,8,2680,0,2001,0,98011,47.7557,-122.223,2680,5860,10,6,2014,UNK,0,0
3897100170,8/27/2014,370000.0,3,1.75,1150,6600,1.5,0.0,0.0,4,6,1150,0,1970,0,98033,47.6709,-122.185,1530,6600,8,27,2014,UNK,-380,0
1150700170,9/26/2014,299000.0,4,2.25,1870,6693,2.0,0.0,0.0,3,7,1870,0,1996,0,98003,47.2774,-122.29899999999999,1650,6518,9,26,2014,UNK,220,175
2769600305,1/15/2015,715000.0,6,2.75,3400,5000,2.0,0.0,2.0,3,8,2860,540,1977,0,98107,47.6728,-122.36200000000001,1800,5000,1,15,2015,UNK,1600,0
3876001330,4/24/2015,430000.0,4,1.5,1810,7200,1.0,0.0,0.0,3,7,1810,0,1966,0,98034,47.7207,-122.186,2060,7200,4,24,2015,UNK,-250,0
984220290,2/10/2015,345000.0,3,1.75,1860,7191,1.0,0.0,0.0,4,7,1260,600,1975,0,98058,47.4338,-122.16799999999999,1850,7490,2,10,2015,UNK,10,-299
3616600250,5/27/2014,1600000.0,3,3.25,3790,19000,2.0,0.0,4.0,3,10,3790,0,1985,0,98177,47.724,-122.37299999999999,2740,18628,5,27,2014,UNK,1050,372
1529200480,5/18/2014,534640.0,3,2.5,2130,3500,1.0,0.0,0.0,4,8,1210,920,1994,0,98072,47.736000000000004,-122.15899999999999,2030,3710,5,18,2014,UNK,100,-210
2533300680,10/7/2014,1230000.0,3,2.5,2860,4500,2.0,0.0,2.0,3,8,1980,880,1915,0,98119,47.6463,-122.37100000000001,2310,4500,10,7,2014,UNK,550,0
6752600130,4/13/2015,351000.0,4,2.5,2370,7274,2.0,0.0,0.0,3,7,2370,0,1997,0,98031,47.3982,-122.171,2090,7656,4,13,2015,UNK,280,-382
9332800020,7/15/2014,745000.0,4,2.25,2290,10409,2.0,0.0,0.0,3,8,2290,0,1972,0,98005,47.6351,-122.16799999999999,2040,10409,7,15,2014,UNK,250,0
1121000095,11/5/2014,320000.0,2,1.0,1120,5329,1.0,0.0,1.0,3,6,750,370,1929,0,98126,47.5421,-122.37799999999999,1530,5330,11,5,2014,UNK,-410,-1
6751500285,7/31/2014,555700.0,3,2.0,1810,12420,1.0,0.0,0.0,4,7,1810,0,1957,0,98008,47.5888,-122.12700000000001,2230,12330,7,31,2014,UNK,-420,90
1310370020,7/8/2014,690000.0,4,2.5,3220,35400,2.0,0.0,0.0,3,9,3220,0,1991,0,98072,47.7547,-122.11399999999999,3050,35252,7,8,2014,UNK,170,148
4019300680,12/31/2014,449000.0,3,1.75,1660,9697,1.0,0.0,0.0,4,7,1660,0,1952,0,98155,47.7564,-122.286,2060,20624,12,31,2014,UNK,-400,-10927
4408100095,5/2/2014,308500.0,2,1.0,850,6174,1.0,0.0,0.0,4,7,850,0,1950,0,98155,47.7352,-122.32799999999999,1100,6174,5,2,2014,UNK,-250,0
8944460020,3/5/2015,340000.0,4,2.5,2665,5868,2.0,0.0,0.0,3,9,2665,0,2006,0,98030,47.3831,-122.185,2665,6092,3,5,2015,N,0,-224
8824900020,3/27/2015,937750.0,4,2.75,2580,3560,1.5,0.0,0.0,5,7,1710,870,1917,0,98115,47.6753,-122.304,1980,3800,3,27,2015,UNK,600,-240
7135520780,5/6/2014,725126.0,4,2.5,3200,12369,2.0,0.0,0.0,3,10,3200,0,1998,0,98059,47.5273,-122.14299999999999,3770,12960,5,6,2014,UNK,-570,-591
179001101,1/5/2015,135000.0,3,1.0,840,3000,1.0,0.0,0.0,3,5,840,0,1943,0,98178,47.494,-122.275,1010,6000,1,5,2015,UNK,-170,-3000
4177100005,4/3/2015,635000.0,4,2.5,2970,7961,1.0,0.0,0.0,3,8,2020,950,1969,0,98125,47.7118,-122.29,1410,7959,4,3,2015,UNK,1560,2
910000104,8/6/2014,245500.0,2,1.0,790,7500,1.0,0.0,0.0,3,6,790,0,1950,0,98011,47.7644,-122.198,1970,8970,8,6,2014,UNK,-1180,-1470
3353400840,12/2/2014,230000.0,6,1.5,2140,36509,1.5,0.0,0.0,4,8,2140,0,1903,0,98001,47.2668,-122.25200000000001,1710,12000,12,2,2014,UNK,430,24509
8964800050,3/4/2015,1770000.0,3,2.5,2580,14603,1.0,0.0,2.0,4,9,2580,0,1951,0,98004,47.6199,-122.212,2410,14347,3,4,2015,UNK,170,256
726049217,11/10/2014,425000.0,5,2.5,2180,7875,1.0,0.0,0.0,4,7,1200,980,1955,0,98133,47.7543,-122.34100000000001,1840,5105,11,10,2014,UNK,340,2770
2926049376,4/20/2015,220000.0,2,1.0,1060,10423,1.5,0.0,0.0,3,7,1060,0,1965,0,98125,47.705,-122.31299999999999,2240,10200,4,20,2015,UNK,-1180,223
5589300715,8/29/2014,370000.0,3,2.0,1860,9100,1.5,0.0,0.0,3,8,1860,0,1939,2006,98155,47.7522,-122.304,1620,9519,8,29,2014,Y,240,-419
7229900285,9/17/2014,390000.0,3,2.0,1840,16815,1.0,0.0,0.0,5,7,960,880,1972,0,98059,47.4837,-122.11,1810,16732,9,17,2014,UNK,30,83
2722059215,6/3/2014,239000.0,3,1.75,1340,16480,1.0,0.0,0.0,4,7,1340,0,1968,0,98042,47.364,-122.162,1520,10451,6,3,2014,UNK,-180,6029
2473372040,1/2/2015,345000.0,4,2.25,2320,7350,2.0,0.0,0.0,3,8,2320,0,1973,0,98058,47.4512,-122.131,2170,7350,1,2,2015,UNK,150,0
3546000630,8/26/2014,289000.0,3,2.5,2110,8304,1.0,0.0,0.0,4,7,2110,0,1985,0,98030,47.3558,-122.17299999999999,1680,7508,8,26,2014,UNK,430,796
7888400500,5/8/2015,285000.0,5,1.5,1840,8050,1.5,0.0,0.0,4,7,1840,0,1962,0,98198,47.3668,-122.31200000000001,1690,8151,5,8,2015,UNK,150,-101
1823049182,9/15/2014,147400.0,3,2.0,1080,9225,1.0,0.0,0.0,2,7,1080,0,1955,0,98146,47.4842,-122.346,1410,9840,9,15,2014,UNK,-330,-615
8712100020,1/27/2015,600000.0,2,1.0,1290,4636,1.0,0.0,0.0,3,7,1290,0,1924,0,98112,47.6393,-122.301,1940,4635,1,27,2015,UNK,-650,1
7961500010,8/6/2014,245000.0,3,2.25,2210,10794,1.0,0.0,0.0,3,7,1540,670,1967,0,98178,47.4911,-122.22399999999999,2230,10753,8,6,2014,UNK,-20,41
7961500010,3/4/2015,520000.0,3,2.25,2210,10794,1.0,0.0,0.0,3,7,1540,670,1967,0,98178,47.4911,-122.22399999999999,2230,10753,3,4,2015,UNK,-20,41
2424400130,5/18/2014,352500.0,3,2.25,1410,14110,1.0,0.0,2.0,3,7,1170,240,1987,0,98065,47.5336,-121.76,1560,18336,5,18,2014,UNK,-150,-4226
9406510130,5/5/2015,448000.0,5,3.5,3740,24684,2.0,0.0,0.0,3,9,2760,980,1998,0,98038,47.3832,-122.057,2880,26023,5,5,2015,UNK,860,-1339
3832700250,9/29/2014,270000.0,4,2.75,2440,7150,1.0,0.0,0.0,3,7,1200,1240,1963,1985,98032,47.3662,-122.28200000000001,1790,7150,9,29,2014,Y,650,0
809000525,8/26/2014,872500.0,3,2.5,2040,6000,1.0,0.0,0.0,3,8,1840,200,1951,0,98109,47.6334,-122.35,1820,4920,8,26,2014,UNK,220,1080
1370800225,3/18/2015,2150000.0,4,3.25,3840,6214,1.5,0.0,3.0,4,10,2590,1250,1939,0,98199,47.6388,-122.406,3280,5915,3,18,2015,UNK,560,299
3388100020,8/12/2014,225000.0,3,1.5,1660,7221,1.0,0.0,0.0,3,7,980,680,1962,0,98168,47.4962,-122.32,1770,8083,8,12,2014,UNK,-110,-862
2770604615,11/21/2014,735000.0,4,2.0,1640,6000,1.5,0.0,0.0,4,9,1640,0,1911,0,98119,47.6505,-122.375,1900,6000,11,21,2014,UNK,-260,0
3754700420,4/1/2015,375000.0,3,1.0,1310,8400,1.0,0.0,0.0,3,7,1310,0,1972,1989,98034,47.7253,-122.197,1680,8000,4,1,2015,Y,-370,400
6669020290,10/23/2014,169000.0,3,1.75,1720,9775,1.0,0.0,0.0,3,8,1720,0,1978,0,98032,47.3731,-122.286,1970,8400,10,23,2014,UNK,-250,1375
6669020290,3/4/2015,279950.0,3,1.75,1720,9775,1.0,0.0,0.0,3,8,1720,0,1978,0,98032,47.3731,-122.286,1970,8400,3,4,2015,UNK,-250,1375
5493110020,1/16/2015,1950000.0,4,2.75,4020,18745,2.0,0.0,4.0,4,10,2830,1190,1989,0,98004,47.6042,-122.21,3150,20897,1,16,2015,UNK,870,-2152
6064800470,8/5/2014,310000.0,3,2.25,1960,2345,2.0,0.0,0.0,3,7,1750,210,2003,0,98118,47.5419,-122.288,1760,1958,8,5,2014,UNK,200,387
9304400010,7/30/2014,975000.0,4,2.5,3240,35083,2.0,0.0,0.0,4,9,3240,0,1978,0,98005,47.6337,-122.154,3340,24501,7,30,2014,UNK,-100,10582
5566100170,10/29/2014,650000.0,10,2.0,3610,11914,2.0,0.0,0.0,4,7,3010,600,1958,0,98006,47.5705,-122.175,2040,11914,10,29,2014,UNK,1570,0
3025049028,12/16/2014,930000.0,2,1.5,1800,4500,1.0,0.0,2.0,3,7,1000,800,1942,0,98109,47.6305,-122.34700000000001,2270,3840,12,16,2014,UNK,-470,660
2848700095,4/2/2015,412000.0,4,1.5,1960,5000,1.0,0.0,0.0,3,7,980,980,1912,0,98106,47.5688,-122.363,1300,5000,4,2,2015,UNK,660,0
2172000894,4/17/2015,225000.0,3,1.0,1250,10200,1.0,0.0,0.0,3,6,1250,0,1965,0,98178,47.4902,-122.256,1800,8283,4,17,2015,UNK,-550,1917
3034200660,6/19/2014,507000.0,3,2.5,2120,7201,2.0,0.0,0.0,3,8,2120,0,2003,0,98133,47.7174,-122.337,1930,7206,6,19,2014,UNK,190,-5
3304700130,1/28/2015,1760000.0,4,4.0,3860,67953,2.0,0.0,2.0,4,12,3860,0,1927,0,98177,47.7469,-122.37799999999999,4410,128066,1,28,2015,UNK,-550,-60113
6661200080,11/17/2014,230000.0,3,2.5,1340,3011,2.0,0.0,0.0,3,7,1340,0,1995,0,98038,47.3839,-122.038,1060,3232,11,17,2014,UNK,280,-221
8835800480,2/23/2015,316000.0,1,2.0,1780,188465,2.0,0.0,0.0,3,10,1780,0,2001,0,98045,47.4506,-121.76799999999999,1780,21094,2,23,2015,UNK,0,167371
7853430660,9/10/2014,616200.0,5,3.25,3920,4832,2.0,0.0,0.0,3,9,3030,890,2014,0,98065,47.5202,-121.885,2660,4832,9,10,2014,N,1260,0
7511200020,8/29/2014,509900.0,3,1.75,1690,53578,1.0,0.0,0.0,3,8,1690,0,1984,0,98053,47.6546,-122.04899999999999,2290,52707,8,29,2014,UNK,-600,871
2597670080,3/16/2015,370000.0,4,2.5,2570,7753,2.0,0.0,0.0,3,8,2570,0,1987,0,98058,47.4237,-122.162,2140,7615,3,16,2015,UNK,430,138
2423010130,3/6/2015,619100.0,3,1.75,1870,7030,1.0,0.0,0.0,3,7,1870,0,1977,0,98033,47.6999,-122.17,1820,7500,3,6,2015,UNK,50,-470
2927600415,8/21/2014,805000.0,3,2.25,2860,11250,1.0,0.0,1.0,5,8,2290,570,1956,0,98166,47.4534,-122.37200000000001,2030,11250,8,21,2014,UNK,830,0
2770604665,2/2/2015,612125.0,2,1.5,1670,6000,1.0,0.0,0.0,3,7,1090,580,1950,0,98119,47.6517,-122.374,1670,6000,2,2,2015,UNK,0,0
425049181,9/12/2014,350000.0,2,1.5,1070,937,3.0,0.0,0.0,3,8,1070,0,2003,0,98115,47.6761,-122.3,1100,3200,9,12,2014,UNK,-30,-2263
3223059217,11/4/2014,225000.0,2,1.0,940,15000,1.0,0.0,0.0,3,7,940,0,1960,0,98055,47.4312,-122.195,1450,15000,11,4,2014,UNK,-510,0
6669240130,10/22/2014,335000.0,3,2.5,2588,5701,2.0,0.0,0.0,3,8,2588,0,2008,0,98042,47.3449,-122.15100000000001,2389,5702,10,22,2014,N,199,-1
3303960080,3/31/2015,972800.0,5,3.25,3500,10457,2.0,0.0,0.0,3,11,3500,0,2001,0,98059,47.5198,-122.15700000000001,3500,11734,3,31,2015,UNK,0,-1277
2413910190,2/2/2015,500000.0,3,1.75,1690,48096,1.0,0.0,0.0,3,7,1690,0,1973,0,98053,47.6745,-122.061,2070,35160,2,2,2015,UNK,-380,12936
9185700285,12/23/2014,2200000.0,4,3.75,3790,7200,2.0,0.0,0.0,3,10,2530,1260,1931,0,98112,47.6264,-122.289,3250,7200,12,23,2014,UNK,540,0
4040800050,11/19/2014,415000.0,3,1.5,1090,8400,1.0,0.0,0.0,4,7,1090,0,1966,0,98008,47.6219,-122.115,1320,8400,11,19,2014,UNK,-230,0
3438500742,8/26/2014,399000.0,3,3.0,2240,10479,2.0,0.0,0.0,4,7,1710,530,1950,0,98106,47.5529,-122.35600000000001,1530,5244,8,26,2014,UNK,710,5235
2326300010,5/20/2014,376000.0,2,1.0,1150,4000,1.0,0.0,0.0,3,7,1150,0,1947,0,98199,47.6575,-122.39399999999999,1150,4288,5,20,2014,UNK,0,-288
4322200050,12/17/2014,340000.0,3,2.0,1870,3378,1.0,0.0,0.0,3,7,1120,750,1913,0,98136,47.5371,-122.39299999999999,1870,1872,12,17,2014,UNK,0,1506
6403510130,11/14/2014,490000.0,5,2.75,2990,7200,2.0,0.0,0.0,3,8,2990,0,1997,0,98059,47.4955,-122.16,2710,7620,11,14,2014,UNK,280,-420
4307340130,6/22/2014,374000.0,4,2.5,2580,6260,2.0,0.0,0.0,3,7,2580,0,2004,0,98056,47.4858,-122.185,2160,3600,6,22,2014,N,420,2660
7237600130,3/26/2015,852000.0,4,1.0,2220,3588,1.5,0.0,0.0,4,7,1470,750,1927,0,98115,47.6854,-122.30799999999999,1740,3588,3,26,2015,UNK,480,0
5706300020,11/25/2014,473000.0,3,2.25,1620,12309,2.0,0.0,0.0,3,7,1620,0,1987,0,98074,47.6188,-122.029,2030,13963,11,25,2014,UNK,-410,-1654
6446200050,5/4/2015,540000.0,3,1.75,2590,25992,1.0,0.0,0.0,3,8,1970,620,1968,0,98029,47.5521,-122.03,2590,29250,5,4,2015,UNK,0,-3258
7744500020,8/26/2014,431000.0,2,2.0,1390,12530,1.0,0.0,0.0,3,8,970,420,1959,0,98155,47.7499,-122.29,1940,12530,8,26,2014,UNK,-550,0
3971700635,5/6/2015,435000.0,4,3.0,2270,7245,1.0,0.0,0.0,3,7,1410,860,1979,0,98155,47.7722,-122.315,1740,7571,5,6,2015,UNK,530,-326
3625059109,5/8/2014,1050000.0,4,3.0,2920,33976,1.0,0.0,3.0,5,8,1460,1460,1964,0,98008,47.6164,-122.104,2970,15210,5,8,2014,UNK,-50,18766
6379500216,5/13/2014,450000.0,3,2.75,1250,892,2.0,0.0,0.0,3,8,1040,0,2010,0,98116,47.5826,-122.387,1250,1296,5,13,2014,N,0,-404
1123049027,3/19/2015,157500.0,3,1.0,1100,27008,1.0,0.0,0.0,3,6,960,140,1935,0,98178,47.4963,-122.249,1280,8890,3,19,2015,UNK,-180,18118
1938400010,12/17/2014,244000.0,3,1.75,1500,7475,1.0,0.0,0.0,4,8,1500,0,1976,0,98023,47.3155,-122.365,1940,7475,12,17,2014,UNK,-440,0
3204900010,2/11/2015,550000.0,3,2.5,2800,10603,2.0,0.0,0.0,3,9,2800,0,2001,0,98011,47.7528,-122.195,2580,10603,2,11,2015,UNK,220,0
6979900010,9/5/2014,975000.0,4,2.5,3420,183387,2.0,0.0,0.0,3,10,3420,0,2000,0,98053,47.633,-121.97200000000001,2260,34613,9,5,2014,UNK,1160,148774
1422069069,2/5/2015,426500.0,4,2.75,2100,88426,1.0,0.0,0.0,3,6,2100,0,1990,0,98038,47.398999999999994,-122.01100000000001,2150,63162,2,5,2015,UNK,-50,25264
9834200305,7/16/2014,350000.0,3,1.0,1790,3876,1.5,0.0,0.0,5,7,1090,0,1904,0,98144,47.575,-122.288,1360,4080,7,16,2014,UNK,430,-204
9834200305,2/10/2015,615000.0,3,1.0,1790,3876,1.5,0.0,0.0,5,7,1090,700,1904,0,98144,47.575,-122.288,1360,4080,2,10,2015,UNK,430,-204
3396820010,2/23/2015,542000.0,3,2.25,2220,12056,2.0,0.0,0.0,3,8,2220,0,1985,0,98052,47.7148,-122.101,2320,12025,2,23,2015,UNK,-100,31
1929300415,11/19/2014,710000.0,4,1.75,2000,6000,1.0,0.0,3.0,5,7,1000,1000,1956,0,98109,47.6428,-122.348,2610,4377,11,19,2014,UNK,-610,1623
8001600130,5/1/2015,289950.0,3,2.5,1770,9450,1.0,0.0,0.0,3,8,1770,0,1988,0,98001,47.3196,-122.272,2200,8582,5,1,2015,UNK,-430,868
3835500585,10/16/2014,1900000.0,4,2.75,4280,12668,2.0,0.0,0.0,3,9,3900,380,1947,2008,98004,47.6185,-122.219,3590,12670,10,16,2014,Y,690,-2
7518505910,11/19/2014,528000.0,2,1.0,1260,5100,1.5,0.0,0.0,4,7,1120,140,1925,0,98117,47.6805,-122.384,1260,5100,11,19,2014,UNK,0,0
7518505610,3/25/2015,471000.0,2,1.0,840,5100,1.0,0.0,0.0,4,7,840,0,1949,0,98117,47.6779,-122.384,1550,5100,3,25,2015,UNK,-710,0
5412100920,12/3/2014,250000.0,4,2.75,1830,6643,2.0,0.0,0.0,3,8,1830,0,2001,0,98001,47.2601,-122.286,2400,6472,12,3,2014,UNK,-570,171
2329700440,10/27/2014,155000.0,3,1.5,970,8400,1.0,0.0,0.0,3,7,970,0,1966,0,98003,47.3284,-122.331,1230,8400,10,27,2014,UNK,-260,0
923000413,8/18/2014,515000.0,4,1.5,1740,8160,1.5,0.0,0.0,4,7,1400,340,1946,0,98177,47.7243,-122.363,1600,8160,8,18,2014,UNK,140,0
9406521150,3/5/2015,336600.0,3,2.25,1654,8464,2.0,0.0,0.0,3,7,1654,0,1995,0,98038,47.3618,-122.03299999999999,1975,8515,3,5,2015,UNK,-321,-51
810000080,3/10/2015,915000.0,3,2.25,2390,2750,2.0,0.0,0.0,5,8,1580,810,1925,0,98109,47.6339,-122.354,2200,5160,3,10,2015,UNK,190,-2410
3762900130,7/15/2014,350000.0,2,1.75,1080,7242,2.0,0.0,0.0,4,7,1080,0,1984,0,98034,47.7065,-122.235,1800,7321,7,15,2014,UNK,-720,-79
1651800010,7/2/2014,1300000.0,4,1.75,2610,21600,1.0,0.0,0.0,4,8,2610,0,1966,0,98004,47.6245,-122.227,2920,20330,7,2,2014,UNK,-310,1270
3876500290,3/5/2015,175000.0,3,1.0,1070,6164,1.0,0.0,0.0,3,7,1070,0,1967,0,98001,47.3377,-122.291,1320,7920,3,5,2015,UNK,-250,-1756
4443800545,3/30/2015,545000.0,2,2.0,1430,3880,1.0,0.0,0.0,4,7,1430,0,1949,0,98117,47.6844,-122.39200000000001,1430,3880,3,30,2015,UNK,0,0
9218400050,12/27/2014,475000.0,4,3.0,2400,5400,2.0,0.0,2.0,4,7,1600,800,1965,0,98178,47.5099,-122.26,2400,5400,12,27,2014,UNK,0,0
1023059108,4/30/2015,390000.0,2,1.0,670,11505,1.0,0.0,0.0,3,5,670,0,2003,0,98059,47.498999999999995,-122.15700000000001,2180,11505,4,30,2015,UNK,-1510,0
2787250190,7/17/2014,645000.0,4,2.5,2860,14000,2.0,0.0,0.0,3,8,2860,0,1995,0,98019,47.7306,-121.973,2650,14564,7,17,2014,UNK,210,-564
4019301205,12/2/2014,410000.0,3,1.5,2270,8187,1.0,0.0,0.0,4,8,1420,850,1954,0,98155,47.7573,-122.27799999999999,2020,14092,12,2,2014,UNK,250,-5905
2607760190,3/31/2015,480000.0,4,2.5,2180,9861,2.0,0.0,2.0,3,8,2180,0,1997,0,98045,47.4817,-121.802,2390,9761,3,31,2015,UNK,-210,100
1250203135,7/1/2014,725000.0,3,1.75,1860,6000,2.0,0.0,2.0,4,8,1860,0,1959,0,98144,47.5981,-122.288,3030,7119,7,1,2014,UNK,-1170,-1119
1424069069,5/22/2014,1150000.0,6,4.5,6040,219542,2.0,0.0,0.0,3,11,4100,1940,1996,0,98029,47.5622,-122.00299999999999,2010,32362,5,22,2014,UNK,4030,187180
7304301300,7/2/2014,300000.0,2,1.0,1010,11919,1.0,0.0,0.0,3,6,1010,0,1947,0,98155,47.7461,-122.322,1220,11240,7,2,2014,UNK,-210,679
8835400290,3/9/2015,752000.0,4,2.5,2570,8178,1.0,0.0,2.0,3,8,1710,860,1961,0,98118,47.5483,-122.26100000000001,2050,7500,3,9,2015,UNK,520,678
3630030440,9/23/2014,585000.0,4,2.5,1950,3720,2.0,0.0,0.0,3,8,1950,0,2004,0,98029,47.5503,-121.99700000000001,1720,3720,9,23,2014,N,230,0
1088000050,2/13/2015,678700.0,3,1.75,1970,10548,1.0,0.0,0.0,4,8,1300,670,1973,0,98033,47.6669,-122.179,2500,8548,2,13,2015,UNK,-530,2000
7504010480,4/17/2015,603000.0,4,2.25,2110,11155,2.0,0.0,0.0,3,9,2110,0,1975,0,98074,47.6386,-122.05799999999999,2660,11900,4,17,2015,UNK,-550,-745
8644500010,3/20/2015,715000.0,3,1.75,1650,7276,1.5,0.0,4.0,4,7,1150,500,1928,0,98117,47.6989,-122.399,2300,8088,3,20,2015,UNK,-650,-812
1326059142,10/28/2014,1400000.0,4,3.0,3520,128502,2.0,0.0,2.0,4,10,3520,0,1981,0,98072,47.7448,-122.117,3260,79714,10,28,2014,UNK,260,48788
3754501205,4/29/2015,1090000.0,3,2.5,2840,7500,2.0,0.0,3.0,3,11,2840,0,1997,0,98034,47.7049,-122.22399999999999,2580,5918,4,29,2015,UNK,260,1582
7625701900,2/22/2015,467500.0,2,1.75,1490,4800,1.0,0.0,0.0,4,7,750,740,1918,0,98136,47.5496,-122.391,1400,6000,2,22,2015,UNK,90,-1200
1926049398,10/13/2014,359000.0,3,2.25,1650,7218,1.0,0.0,0.0,3,7,1230,420,1985,0,98133,47.7237,-122.335,1690,7459,10,13,2014,UNK,-40,-241
6372000190,8/26/2014,745000.0,4,2.0,1960,4520,1.0,0.0,0.0,3,8,960,1000,1922,2001,98116,47.58,-122.405,1680,4520,8,26,2014,Y,280,0
3622059088,5/13/2014,450000.0,3,2.25,2450,42180,1.0,0.0,0.0,4,7,2450,0,1978,2000,98042,47.3549,-122.111,1440,42180,5,13,2014,Y,1010,0
809003105,4/8/2015,935000.0,3,2.0,1720,2000,1.5,0.0,0.0,3,8,1060,660,1910,2000,98109,47.6384,-122.35,1590,4000,4,8,2015,Y,130,-2000
8956000250,9/3/2014,615000.0,3,2.5,1980,3128,2.0,0.0,0.0,3,8,1890,90,2009,0,98027,47.5456,-122.016,2160,2240,9,3,2014,N,-180,888
1241500351,9/29/2014,1030000.0,3,2.5,4110,35741,2.0,0.0,0.0,3,7,4110,0,1976,0,98033,47.6642,-122.171,2710,8865,9,29,2014,UNK,1400,26876
7457400250,1/6/2015,283500.0,4,2.5,1990,5577,2.0,0.0,0.0,3,7,1990,0,1999,0,98092,47.3191,-122.191,2020,6400,1,6,2015,UNK,-30,-823
6154900130,12/2/2014,340000.0,2,1.0,860,7102,1.0,0.0,0.0,3,6,860,0,1947,0,98177,47.7042,-122.369,1450,7102,12,2,2014,UNK,-590,0
1853500130,2/25/2015,370000.0,4,2.5,2320,9264,2.0,0.0,0.0,3,8,2320,0,1994,0,98188,47.4449,-122.274,2320,9129,2,25,2015,UNK,0,135
1854750010,8/20/2014,1150000.0,3,2.5,4190,9624,2.0,0.0,0.0,3,10,4190,0,1999,0,98006,47.5642,-122.12700000000001,3650,8321,8,20,2014,UNK,540,1303
9320500080,5/10/2014,265000.0,4,1.0,1940,9533,1.0,0.0,0.0,3,7,1080,860,1962,0,98031,47.4139,-122.208,1940,8839,5,10,2014,UNK,0,694
7228500415,8/26/2014,480000.0,4,2.25,2520,2370,2.0,0.0,0.0,3,8,1690,830,1908,0,98122,47.6109,-122.303,1530,2370,8,26,2014,UNK,990,0
3142600130,6/17/2014,667500.0,3,2.0,1880,3800,1.0,0.0,0.0,5,7,1030,850,1927,0,98115,47.6841,-122.309,1700,3800,6,17,2014,UNK,180,0
629000605,2/27/2015,1400000.0,3,2.5,2910,10044,2.0,0.0,0.0,4,10,2910,0,1989,0,98004,47.5845,-122.199,2420,12287,2,27,2015,UNK,490,-2243
5536100005,8/8/2014,2300000.0,7,4.75,5310,8816,2.0,0.0,0.0,3,10,3650,1660,2013,0,98004,47.6221,-122.208,2920,10610,8,8,2014,N,2390,-1794
3990000050,6/16/2014,465000.0,3,2.25,2670,7500,1.0,0.0,0.0,4,7,1640,1030,1966,0,98166,47.4608,-122.354,1970,9598,6,16,2014,UNK,700,-2098
1320069249,10/20/2014,192500.0,1,1.0,470,63737,1.0,0.0,2.0,5,5,470,0,1924,0,98022,47.2163,-121.984,1350,46762,10,20,2014,UNK,-880,16975
9357000635,3/23/2015,345000.0,3,1.0,1060,5600,1.0,0.0,0.0,4,6,760,300,1943,0,98146,47.5116,-122.37899999999999,1310,5600,3,23,2015,UNK,-250,0
2207200635,6/2/2014,439800.0,3,1.5,1120,6900,1.0,0.0,0.0,5,7,1120,0,1956,0,98007,47.6023,-122.132,1300,7000,6,2,2014,UNK,-180,-100
3798000130,7/25/2014,468000.0,4,1.75,2250,8580,1.0,0.0,0.0,4,7,1330,920,1958,0,98011,47.7633,-122.199,2250,10032,7,25,2014,UNK,0,-1452
2680700010,7/24/2014,775000.0,4,2.5,2070,8473,1.0,0.0,0.0,4,8,1250,820,1976,0,98033,47.6608,-122.19,2070,9499,7,24,2014,UNK,0,-1026
3066200440,6/8/2014,684680.0,4,2.25,2370,9360,2.0,0.0,0.0,4,8,2370,0,1979,0,98052,47.6518,-122.12299999999999,2370,9720,6,8,2014,UNK,0,-360
3293400020,1/16/2015,910000.0,4,3.5,3570,27699,2.0,0.0,0.0,3,11,3570,0,1990,0,98052,47.7173,-122.098,3800,35880,1,16,2015,UNK,-230,-8181
2425049063,9/11/2014,3640000.0,4,3.25,4830,22257,2.0,1.0,4.0,4,11,4830,0,1990,0,98039,47.6409,-122.241,3820,25582,9,11,2014,UNK,1010,-3325
114101426,6/17/2014,375000.0,3,1.75,1160,22470,1.0,0.0,0.0,4,7,1160,0,1976,0,98028,47.7595,-122.23,1940,15999,6,17,2014,UNK,-780,6471
100500020,9/11/2014,250000.0,3,2.5,1610,6600,2.0,0.0,0.0,3,7,1610,0,1994,0,98003,47.2827,-122.302,1660,7689,9,11,2014,UNK,-50,-1089
1732800780,2/12/2015,3070000.0,5,3.0,4150,7500,2.5,0.0,4.0,5,11,3510,640,1909,0,98119,47.6303,-122.36200000000001,2250,4050,2,12,2015,UNK,1900,3450
7955050250,11/25/2014,442500.0,4,2.25,1840,7575,1.0,0.0,0.0,4,7,1390,450,1973,0,98034,47.7328,-122.198,1820,7500,11,25,2014,UNK,20,75
3521059134,5/23/2014,900000.0,3,3.5,4080,217697,1.5,0.0,3.0,3,10,4080,0,2000,0,98092,47.2604,-122.139,2710,217790,5,23,2014,UNK,1370,-93
6908200006,9/19/2014,699000.0,3,2.0,1820,4080,2.0,0.0,2.0,3,8,1820,0,1937,1987,98107,47.6735,-122.40100000000001,2160,5400,9,19,2014,Y,-340,-1320
4012800010,5/6/2014,360000.0,4,2.0,2680,18768,1.0,0.0,0.0,5,8,2680,0,1965,0,98001,47.3182,-122.279,1230,15750,5,6,2014,UNK,1450,3018
629800660,9/9/2014,1680000.0,4,4.75,4790,25412,2.0,0.0,0.0,3,12,4790,0,1999,0,98074,47.603,-122.012,3830,16314,9,9,2014,UNK,960,9098
425059024,1/29/2015,675000.0,5,2.0,2420,21000,1.5,0.0,0.0,3,8,2420,0,1966,0,98033,47.677,-122.165,1940,8085,1,29,2015,UNK,480,12915
8911000425,9/18/2014,345000.0,2,1.0,1130,8081,1.0,0.0,0.0,4,7,1130,0,1921,0,98133,47.7064,-122.355,1220,7800,9,18,2014,UNK,-90,281
3438502066,4/8/2015,229000.0,4,1.0,1320,5000,1.5,0.0,0.0,3,7,1320,0,1928,0,98106,47.5457,-122.363,1640,5164,4,8,2015,UNK,-320,-164
3022039069,3/26/2015,300000.0,3,1.0,1290,12415,1.5,0.0,0.0,3,6,1290,0,1908,0,98070,47.3719,-122.461,1620,12415,3,26,2015,UNK,-330,0
1862400471,8/20/2014,392500.0,3,3.25,1600,1289,3.0,0.0,0.0,3,8,1600,0,1998,0,98117,47.6957,-122.375,1600,1376,8,20,2014,UNK,0,-87
7518505851,6/16/2014,552000.0,3,1.0,1120,2300,1.0,0.0,0.0,4,7,820,300,1912,0,98117,47.6797,-122.384,1430,5100,6,16,2014,UNK,-310,-2800
5101408678,11/20/2014,457000.0,2,1.75,2060,7192,1.0,0.0,0.0,3,7,1420,640,1940,0,98125,47.7038,-122.31700000000001,1860,7140,11,20,2014,UNK,200,52
3296900130,10/7/2014,518000.0,4,2.5,2830,13760,2.0,0.0,0.0,3,8,2830,0,1993,0,98019,47.7334,-121.97,2350,14029,10,7,2014,UNK,480,-269
9513900050,8/12/2014,237000.0,3,2.0,1210,6634,1.0,0.0,0.0,4,7,1210,0,1985,0,98031,47.4097,-122.193,1560,7200,8,12,2014,UNK,-350,-566
2624089022,3/14/2015,399950.0,3,2.25,1560,11997,1.0,0.0,0.0,3,7,1260,300,1988,0,98065,47.5378,-121.742,1820,36590,3,14,2015,UNK,-260,-24593
4024100670,5/6/2015,605000.0,3,2.25,2260,17114,2.0,0.0,0.0,3,7,2260,0,1990,0,98155,47.7537,-122.296,2360,14893,5,6,2015,UNK,-100,2221
1862910050,7/22/2014,295000.0,4,2.5,1850,8198,2.0,0.0,0.0,3,7,1850,0,1993,0,98031,47.4079,-122.186,1850,7924,7,22,2014,UNK,0,274
8651720420,4/28/2015,513000.0,4,2.5,1930,8040,1.0,0.0,0.0,3,7,1380,550,1978,0,98034,47.7283,-122.21799999999999,2080,7200,4,28,2015,UNK,-150,840
2619920170,10/1/2014,772500.0,4,2.5,3230,4290,2.0,0.0,0.0,3,9,3230,0,2004,0,98033,47.6874,-122.161,3220,5083,10,1,2014,N,10,-793
2619920170,12/19/2014,765000.0,4,2.5,3230,4290,2.0,0.0,0.0,3,9,3230,0,2004,0,98033,47.6874,-122.161,3220,5083,12,19,2014,N,10,-793
225039069,10/10/2014,696950.0,4,2.75,2450,5376,1.5,0.0,0.0,4,7,1550,900,1920,0,98117,47.6865,-122.396,1920,5264,10,10,2014,UNK,530,112
3878900525,2/13/2015,329000.0,3,1.0,1200,5650,1.5,0.0,0.0,3,7,1200,0,1928,0,98178,47.5065,-122.249,1610,5650,2,13,2015,UNK,-410,0
7137970130,12/18/2014,339999.0,3,2.5,2360,8093,2.0,0.0,0.0,3,8,2360,0,1995,0,98092,47.3257,-122.17,1860,6762,12,18,2014,UNK,500,1331
6632300122,7/14/2014,364500.0,3,1.0,1060,9506,1.0,0.0,0.0,3,7,1060,0,1959,0,98125,47.7317,-122.31,1520,8469,7,14,2014,UNK,-460,1037
2770602135,5/14/2014,607500.0,5,1.75,2220,6000,1.5,0.0,0.0,3,7,1420,800,1923,0,98199,47.648,-122.384,1550,1715,5,14,2014,UNK,670,4285
3584800010,4/8/2015,550000.0,3,1.0,880,6664,1.0,0.0,0.0,3,6,880,0,1961,0,98033,47.6855,-122.199,1690,6564,4,8,2015,UNK,-810,100
8950500250,4/21/2015,479900.0,4,2.0,2510,9750,1.0,0.0,0.0,3,8,1630,880,1960,0,98028,47.7438,-122.229,1980,9750,4,21,2015,UNK,530,0
7011201306,2/12/2015,1120000.0,4,4.0,2530,1774,3.0,0.0,2.0,3,9,2100,430,2013,0,98119,47.6362,-122.369,2160,2400,2,12,2015,N,370,-626
4438400020,5/12/2014,192000.0,2,1.0,700,10540,1.0,0.0,0.0,3,6,700,0,1953,0,98166,47.438,-122.336,890,10540,5,12,2014,UNK,-190,0
8651440250,4/13/2015,250000.0,3,2.0,1500,5200,1.0,0.0,0.0,3,7,1060,440,1977,0,98042,47.3653,-122.09,1640,5200,4,13,2015,UNK,-140,0
203900920,7/15/2014,340000.0,3,2.0,1130,9879,2.0,0.0,0.0,3,6,1130,0,1996,0,98053,47.635,-121.964,1900,14907,7,15,2014,UNK,-770,-5028
2458400345,10/28/2014,340000.0,3,2.0,1420,6060,1.0,0.0,0.0,5,7,830,0,1942,0,98146,47.5102,-122.37200000000001,1420,6360,10,28,2014,UNK,0,-300
6664000130,10/13/2014,635250.0,3,2.25,2210,22040,1.0,0.0,0.0,5,8,1510,700,1976,0,98004,47.5904,-122.194,2470,14258,10,13,2014,UNK,-260,7782
2685600005,4/7/2015,324800.0,2,1.0,1170,5043,1.0,0.0,0.0,3,6,880,290,1949,0,98108,47.5492,-122.302,1430,5692,4,7,2015,UNK,-260,-649
40000362,5/6/2014,78000.0,2,1.0,780,16344,1.0,0.0,0.0,1,5,780,0,1942,0,98168,47.4739,-122.28,1700,10387,5,6,2014,UNK,-920,5957
3582700130,4/9/2015,400000.0,4,1.75,1770,12875,1.0,0.0,0.0,3,8,1770,0,1988,0,98028,47.7438,-122.24700000000001,2150,12875,4,9,2015,UNK,-380,0
3013300980,5/6/2015,640500.0,3,1.0,1070,4505,1.0,0.0,2.0,4,7,1070,0,1919,0,98136,47.5305,-122.384,1380,4505,5,6,2015,UNK,-310,0
2597000130,4/30/2015,570000.0,3,2.0,1930,10929,1.0,0.0,0.0,3,8,1260,670,1964,0,98155,47.7657,-122.272,2030,8750,4,30,2015,UNK,-100,2179
6169900545,6/25/2014,1330000.0,3,1.5,1940,2885,1.5,0.0,2.0,3,8,1940,0,1900,0,98119,47.6308,-122.369,2550,3600,6,25,2014,UNK,-610,-715
1328340630,4/3/2015,330490.0,3,2.75,1440,7350,1.0,0.0,0.0,4,7,1040,400,1980,0,98058,47.4431,-122.13799999999999,1510,7350,4,3,2015,UNK,-70,0
705730280,8/19/2014,325000.0,3,2.5,1740,5267,2.0,0.0,0.0,3,7,1740,0,1999,0,98038,47.3777,-122.023,2180,5000,8,19,2014,UNK,-440,267
705730280,4/21/2015,335000.0,3,2.5,1740,5267,2.0,0.0,0.0,3,7,1740,0,1999,0,98038,47.3777,-122.023,2180,5000,4,21,2015,UNK,-440,267
5379805910,11/13/2014,314000.0,5,2.75,2210,13500,1.0,0.0,0.0,5,7,1460,750,1963,0,98188,47.4468,-122.28200000000001,1590,10850,11,13,2014,UNK,620,2650
2887700091,9/23/2014,625000.0,4,2.0,2190,3622,1.5,0.0,0.0,5,8,1990,200,1925,0,98115,47.6887,-122.31200000000001,1450,3082,9,23,2014,UNK,740,540
7732410420,6/17/2014,809000.0,3,2.5,2590,7720,2.0,0.0,0.0,3,9,2590,0,1988,0,98007,47.659,-122.146,2600,9490,6,17,2014,UNK,-10,-1770
7806500290,8/18/2014,535000.0,3,2.5,2790,19485,2.0,0.0,0.0,3,9,2790,0,1990,0,98059,47.4688,-122.124,2580,17859,8,18,2014,UNK,210,1626
1565600130,8/21/2014,275000.0,5,1.75,2180,9178,1.0,0.0,0.0,3,7,1140,1040,1963,0,98188,47.4364,-122.28,2140,9261,8,21,2014,UNK,40,-83
2473100280,4/17/2015,358000.0,4,2.75,2580,11900,1.0,0.0,0.0,4,7,1620,960,1967,0,98058,47.4475,-122.15899999999999,1570,9375,4,17,2015,UNK,1010,2525
3826000460,3/13/2015,297975.0,3,2.25,2820,8100,1.0,0.0,0.0,4,7,1720,1100,1947,0,98168,47.4944,-122.304,1040,8100,3,13,2015,UNK,1780,0
1823069088,5/4/2015,492000.0,2,1.75,1300,22239,1.0,0.0,0.0,4,7,1300,0,1945,1986,98059,47.4801,-122.09200000000001,1300,14810,5,4,2015,Y,0,7429
1901600095,6/26/2014,210000.0,2,1.0,720,8040,1.0,0.0,0.0,3,6,720,0,1943,0,98166,47.4662,-122.359,2300,9500,6,26,2014,UNK,-1580,-1460
9285800020,8/27/2014,622500.0,3,2.5,2260,4550,1.5,0.0,0.0,4,7,1380,880,1928,0,98126,47.5714,-122.376,1870,4582,8,27,2014,UNK,390,-32
3383900048,10/22/2014,550000.0,3,2.5,1550,1092,3.0,0.0,0.0,3,8,1390,160,2004,0,98102,47.6355,-122.324,1550,1079,10,22,2014,N,0,13
1423700680,2/26/2015,190000.0,3,1.75,1390,7700,1.0,0.0,0.0,5,7,1390,0,1965,0,98058,47.4559,-122.18299999999999,1260,7700,2,26,2015,UNK,130,0
9264930980,7/28/2014,340000.0,4,2.5,2380,9362,2.0,0.0,0.0,3,8,2380,0,2000,0,98023,47.3148,-122.34899999999999,2190,9840,7,28,2014,UNK,190,-478
3825311190,7/25/2014,678000.0,3,2.5,2640,5964,2.0,0.0,0.0,3,9,2640,0,2003,0,98052,47.7043,-122.12799999999999,2680,5211,7,25,2014,UNK,-40,753
9122500080,4/28/2015,275000.0,5,2.0,2260,11970,1.0,0.0,0.0,4,7,1250,0,1962,0,98031,47.3896,-122.21799999999999,1950,11970,4,28,2015,UNK,310,0
1189000130,9/15/2014,493000.0,3,2.75,1720,6720,1.0,0.0,0.0,4,7,1270,450,1947,0,98122,47.6138,-122.29799999999999,1690,3248,9,15,2014,UNK,30,3472
3347400525,12/16/2014,147000.0,3,1.0,1070,14000,1.0,0.0,0.0,3,7,1070,0,1960,0,98178,47.4971,-122.279,920,12500,12,16,2014,UNK,150,1500
8091411100,2/4/2015,334000.0,3,2.25,2000,7225,2.0,0.0,0.0,4,7,2000,0,1985,0,98030,47.349,-122.167,1950,7464,2,4,2015,UNK,50,-239
4384000020,7/3/2014,605000.0,4,2.5,2800,10786,1.0,0.0,0.0,3,8,1420,1380,1970,0,98008,47.5959,-122.116,2140,10788,7,3,2014,UNK,660,-2
321059132,4/27/2015,365000.0,3,1.75,1450,61419,1.0,0.0,0.0,4,8,1450,0,1976,0,98092,47.3343,-122.16,2256,82328,4,27,2015,UNK,-806,-20909
1016000080,11/25/2014,345000.0,3,1.0,1620,10610,1.0,0.0,0.0,4,6,1620,0,1958,0,98059,47.474,-122.125,1680,10795,11,25,2014,UNK,-60,-185
3585900305,10/30/2014,999000.0,3,2.5,2710,23292,1.0,0.0,4.0,3,9,2080,630,1956,0,98177,47.7608,-122.374,2430,20000,10,30,2014,UNK,280,3292
2922701305,4/2/2015,470000.0,2,1.75,1520,4220,1.0,0.0,0.0,4,7,840,680,1910,0,98117,47.6876,-122.366,1120,5700,4,2,2015,UNK,400,-1480
8123500050,6/24/2014,599000.0,5,2.75,2730,22572,1.0,0.0,0.0,3,7,2080,650,1968,1992,98075,47.5951,-122.037,2260,15458,6,24,2014,Y,470,7114
5547500050,9/17/2014,255000.0,3,2.25,1740,10378,1.0,0.0,0.0,5,7,1740,0,1977,0,98042,47.3815,-122.09,1420,10167,9,17,2014,UNK,320,211
5469700020,2/6/2015,295000.0,4,1.75,1800,28650,1.0,0.0,0.0,4,7,1800,0,1975,0,98031,47.3926,-122.166,1800,5234,2,6,2015,UNK,0,23416
9358400080,6/27/2014,550000.0,4,3.5,4150,16197,2.0,0.0,0.0,3,10,4150,0,2006,0,98003,47.3423,-122.18299999999999,3618,15210,6,27,2014,N,532,987
1257200050,7/31/2014,1310000.0,5,3.5,3270,4080,2.0,0.0,0.0,3,9,2180,0,2011,0,98115,47.6754,-122.32700000000001,1410,4080,7,31,2014,N,1860,0
1180005220,5/5/2015,225000.0,2,1.0,1070,6000,1.0,0.0,0.0,4,5,1070,0,1922,0,98178,47.495,-122.227,1910,6000,5,5,2015,UNK,-840,0
9536600010,12/23/2014,520000.0,4,0.75,1960,8277,1.0,1.0,4.0,4,7,1320,640,1923,1986,98198,47.3648,-122.325,1940,8402,12,23,2014,Y,20,-125
6140100022,8/26/2014,345000.0,3,3.25,1600,1882,2.0,0.0,0.0,3,8,1360,240,2000,0,98133,47.7151,-122.355,1390,1379,8,26,2014,UNK,210,503
6140100095,5/20/2014,475000.0,4,1.75,1650,7775,1.0,0.0,0.0,4,7,1150,500,1950,0,98133,47.715,-122.354,1390,7200,5,20,2014,UNK,260,575
4037800020,10/8/2014,497500.0,5,1.5,2170,8610,1.0,0.0,0.0,4,7,1230,940,1959,0,98008,47.6111,-122.126,1670,8610,10,8,2014,UNK,500,0
322069180,11/20/2014,649500.0,3,3.0,3730,383328,1.5,0.0,0.0,4,9,2230,1500,1990,0,98038,47.4257,-122.03,1940,217800,11,20,2014,UNK,1790,165528
9348700020,8/25/2014,734500.0,4,2.75,3280,6845,2.0,0.0,0.0,3,10,3280,0,2003,0,98052,47.7042,-122.10700000000001,3280,7467,8,25,2014,UNK,0,-622
7414200010,12/18/2014,276000.0,3,1.0,870,8040,1.0,0.0,0.0,3,7,870,0,1953,0,98177,47.7048,-122.368,1440,8040,12,18,2014,UNK,-570,0
7849200635,6/30/2014,235000.0,2,1.0,900,28800,1.0,0.0,0.0,1,6,900,0,1928,0,98065,47.5245,-121.822,1360,7200,6,30,2014,UNK,-460,21600
1524800005,8/12/2014,325000.0,2,1.0,1400,10800,1.0,0.0,0.0,4,7,1400,0,1974,0,98011,47.7726,-122.21,1560,11280,8,12,2014,UNK,-160,-480
8045600130,5/28/2014,425000.0,4,2.75,1680,9545,1.0,0.0,0.0,4,7,1080,600,1979,0,98028,47.739,-122.243,1890,9545,5,28,2014,UNK,-210,0
5559200170,4/30/2015,307000.0,4,2.0,2390,23972,2.0,0.0,0.0,3,7,1720,670,1949,0,98023,47.3197,-122.34299999999999,1950,22750,4,30,2015,UNK,440,1222
5700000275,5/28/2014,635000.0,3,2.5,2300,5500,1.5,0.0,0.0,4,8,2000,300,1921,0,98144,47.5785,-122.29299999999999,2100,5000,5,28,2014,UNK,200,500
3224900130,5/14/2014,223000.0,3,1.75,1340,7473,1.0,0.0,0.0,4,7,1340,0,1973,0,98002,47.3087,-122.206,1510,8240,5,14,2014,UNK,-170,-767
4397010480,4/13/2015,425000.0,3,2.75,2600,10874,2.0,0.0,0.0,3,9,2600,0,1994,0,98042,47.3815,-122.146,2800,11504,4,13,2015,UNK,-200,-630
2310000250,5/6/2015,190000.0,3,2.25,1640,7730,1.0,0.0,0.0,4,7,1220,420,1989,0,98038,47.3576,-122.039,1560,7566,5,6,2015,UNK,80,164
8731902340,9/18/2014,275000.0,4,1.75,1960,6177,1.0,0.0,0.0,4,8,1960,0,1967,0,98023,47.3131,-122.383,2010,8162,9,18,2014,UNK,-50,-1985
3630000080,6/6/2014,450000.0,3,2.5,1480,1961,2.0,0.0,0.0,3,8,1480,0,2005,0,98029,47.5478,-122.0,1400,1138,6,6,2014,N,80,823
4139900050,5/19/2014,1470000.0,4,3.25,5010,34460,2.0,0.0,0.0,3,12,5010,0,1988,0,98006,47.5469,-122.12700000000001,4760,34460,5,19,2014,UNK,250,0
9191200380,12/22/2014,550000.0,4,2.0,1540,5000,1.5,0.0,0.0,4,7,1540,0,1913,0,98105,47.6713,-122.3,1790,4000,12,22,2014,UNK,-250,1000
930000415,12/4/2014,835000.0,4,2.75,4030,10240,2.0,0.0,2.0,3,8,3310,720,1943,0,98177,47.7168,-122.365,2490,7680,12,4,2014,UNK,1540,2560
5450300020,6/18/2014,900000.0,6,3.0,3020,13783,2.0,0.0,0.0,3,8,3020,0,1952,0,98040,47.5722,-122.226,1720,13500,6,18,2014,UNK,1300,283
8898700440,11/24/2014,290000.0,2,2.0,1590,9375,1.0,0.0,0.0,3,7,910,680,1983,0,98055,47.4585,-122.205,1560,8524,11,24,2014,UNK,30,851
1238501188,8/8/2014,1040000.0,4,2.5,2910,9131,2.0,0.0,0.0,3,10,2910,0,2014,0,98033,47.6826,-122.186,1880,11212,8,8,2014,N,1030,-2081
644210020,1/5/2015,780000.0,4,2.5,3020,15164,1.0,0.0,0.0,4,8,1730,1290,1976,0,98004,47.5882,-122.19200000000001,2600,11556,1,5,2015,UNK,420,3608
3066200460,12/18/2014,572500.0,3,2.0,2290,11200,2.0,0.0,0.0,3,9,2290,0,1979,0,98052,47.6517,-122.124,2250,10000,12,18,2014,UNK,40,1200
3422049088,3/24/2015,389000.0,3,1.75,2180,9220,1.0,0.0,0.0,4,7,1090,1090,1938,0,98001,47.3547,-122.285,2050,22400,3,24,2015,UNK,130,-13180
6433000050,8/21/2014,350000.0,4,1.75,2740,10086,1.0,0.0,0.0,3,7,1440,1300,1972,0,98168,47.5112,-122.329,1710,9840,8,21,2014,UNK,1030,246
7215410430,7/28/2014,476000.0,4,2.5,2740,33158,2.0,0.0,0.0,3,9,2740,0,1993,0,98042,47.3333,-122.074,2740,36074,7,28,2014,UNK,0,-2916
5316100255,9/4/2014,1050000.0,2,3.0,2330,3600,2.0,0.0,0.0,5,10,1870,460,1927,1979,98112,47.6316,-122.28200000000001,2950,7200,9,4,2014,Y,-620,-3600
2413300980,12/17/2014,287000.0,3,2.25,2300,7200,1.0,0.0,0.0,4,8,1550,750,1978,0,98003,47.324,-122.32799999999999,2000,7350,12,17,2014,UNK,300,-150
1175000280,11/7/2014,707500.0,4,4.0,1550,6596,1.5,0.0,0.0,5,7,1550,0,1907,0,98107,47.6711,-122.398,1830,4850,11,7,2014,UNK,-280,1746
7304300420,8/1/2014,464500.0,4,2.5,1750,11381,1.0,0.0,0.0,4,7,1610,0,1947,0,98155,47.7425,-122.321,1080,11375,8,1,2014,UNK,670,6
59000250,12/3/2014,720000.0,3,1.5,2180,5000,1.0,0.0,3.0,4,8,1090,1090,1941,0,98116,47.5787,-122.402,2070,5000,12,3,2014,UNK,110,0
1441300130,12/24/2014,319000.0,3,2.5,1610,8544,2.0,0.0,0.0,5,7,1610,0,1994,0,98038,47.3714,-122.054,1840,8190,12,24,2014,UNK,-230,354
1075100050,9/16/2014,330000.0,3,1.0,1570,9136,1.0,0.0,0.0,3,7,1570,0,1953,0,98133,47.7688,-122.337,1380,9127,9,16,2014,UNK,190,9
7972000010,5/20/2014,120750.0,3,1.75,1140,9628,1.0,0.0,0.0,4,7,1140,0,1969,0,98023,47.2933,-122.37200000000001,1510,9633,5,20,2014,UNK,-370,-5
7972000010,10/21/2014,195000.0,3,1.75,1140,9628,1.0,0.0,0.0,4,7,1140,0,1969,0,98023,47.2933,-122.37200000000001,1510,9633,10,21,2014,UNK,-370,-5
5113400364,1/26/2015,650000.0,4,1.5,2480,6383,1.0,0.0,0.0,3,7,1380,1100,1946,0,98119,47.6445,-122.374,1440,6000,1,26,2015,UNK,1040,383
5076900010,5/13/2014,530000.0,3,1.75,1690,8190,1.0,0.0,0.0,4,8,1690,0,1958,0,98005,47.5857,-122.17200000000001,1840,8705,5,13,2014,UNK,-150,-515
3526039193,4/7/2015,825000.0,4,3.0,2910,8027,1.0,0.0,0.0,5,8,1800,1110,1970,0,98117,47.6939,-122.391,2390,7660,4,7,2015,UNK,520,367
7905380280,8/22/2014,436000.0,4,2.0,1600,15044,1.0,0.0,0.0,3,7,1600,0,1972,0,98034,47.72,-122.21600000000001,1660,8102,8,22,2014,UNK,-60,6942
7936500221,1/14/2015,658000.0,2,1.0,1010,14244,1.0,1.0,4.0,1,5,1010,0,1926,0,98136,47.5476,-122.399,1820,15792,1,14,2015,UNK,-810,-1548
5100404761,8/13/2014,547500.0,3,2.0,1850,9570,1.0,0.0,0.0,4,7,950,900,1940,0,98115,47.696999999999996,-122.322,1430,6380,8,13,2014,UNK,420,3190
510000050,12/3/2014,762000.0,3,1.75,2150,2527,2.0,0.0,0.0,4,8,1400,750,1906,0,98103,47.6629,-122.329,1610,3663,12,3,2014,UNK,540,-1136
7148700050,1/26/2015,340000.0,3,1.75,2650,7378,1.0,0.0,0.0,3,7,1460,1190,1952,0,98155,47.7525,-122.315,1600,7616,1,26,2015,UNK,1050,-238
3271800185,11/21/2014,880000.0,4,1.75,2510,5800,1.0,0.0,2.0,4,9,1830,680,1953,0,98199,47.648,-122.41,2190,5800,11,21,2014,UNK,320,0
2652501470,5/21/2014,1220000.0,4,2.5,3240,3600,2.0,0.0,0.0,3,9,2060,1180,2008,0,98109,47.6405,-122.35600000000001,1820,3600,5,21,2014,N,1420,0
1568100920,4/8/2015,1950000.0,4,2.5,3440,14554,2.0,0.0,4.0,3,8,2170,1270,2012,0,98155,47.7364,-122.286,3170,11810,4,8,2015,N,270,2744
7738500185,9/23/2014,382500.0,3,2.0,1150,6249,1.0,0.0,0.0,3,7,1150,0,1952,2006,98155,47.7489,-122.28399999999999,2470,7751,9,23,2014,Y,-1320,-1502
9133600130,1/5/2015,344500.0,3,1.75,1890,9535,1.0,0.0,0.0,3,7,1210,680,1976,0,98055,47.4872,-122.223,2040,11108,1,5,2015,UNK,-150,-1573
3298720010,4/12/2015,375000.0,4,2.75,1430,7403,1.0,0.0,0.0,3,7,1030,400,1982,0,98106,47.5346,-122.344,1480,7663,4,12,2015,UNK,-50,-260
2856101479,7/1/2014,276000.0,1,0.75,370,1801,1.0,0.0,0.0,5,5,370,0,1923,0,98117,47.6778,-122.389,1340,5000,7,1,2014,UNK,-970,-3199
5710610250,7/1/2014,500000.0,5,3.25,3130,12087,2.0,0.0,0.0,3,8,2180,950,1975,0,98027,47.5336,-122.052,2410,10350,7,1,2014,UNK,720,1737
163000010,7/2/2014,330000.0,4,2.5,2105,6093,2.0,0.0,0.0,3,8,2105,0,2003,0,98042,47.3531,-122.147,1930,8022,7,2,2014,UNK,175,-1929
1062100095,8/22/2014,328000.0,3,1.0,890,5965,1.0,0.0,0.0,3,7,890,0,1950,0,98155,47.7518,-122.279,1930,7500,8,22,2014,UNK,-1040,-1535
1437900020,2/25/2015,450000.0,3,1.5,1340,7200,1.0,0.0,0.0,3,7,1340,0,1972,0,98034,47.718,-122.193,1730,8820,2,25,2015,UNK,-390,-1620
8073000585,7/15/2014,840500.0,4,2.25,2290,12174,1.0,1.0,4.0,3,7,1490,800,1948,0,98178,47.5114,-122.245,2290,9379,7,15,2014,UNK,0,2795
3342700491,8/14/2014,679000.0,3,2.5,2770,9350,2.0,0.0,3.0,3,8,2770,0,1957,2000,98056,47.5253,-122.20100000000001,2660,9695,8,14,2014,Y,110,-345
3395800305,6/5/2014,270000.0,3,1.5,1890,9450,1.0,0.0,0.0,3,7,1090,800,1957,0,98146,47.4829,-122.34100000000001,1470,8100,6,5,2014,UNK,420,1350
2923500010,1/14/2015,757500.0,5,2.25,3160,8065,2.0,0.0,0.0,3,8,3160,0,1977,0,98027,47.5678,-122.089,2540,7917,1,14,2015,UNK,620,148
3629970680,11/12/2014,524950.0,2,2.5,1830,2856,2.0,0.0,0.0,3,7,1830,0,2005,0,98029,47.5524,-121.99600000000001,1850,2667,11,12,2014,N,-20,189
2408800130,7/23/2014,424900.0,4,2.75,2950,49658,1.0,0.0,0.0,4,8,2950,0,1960,1998,98010,47.3596,-121.92200000000001,1720,54672,7,23,2014,Y,1230,-5014
2204500480,1/7/2015,551100.0,3,1.0,1430,8640,1.0,0.0,0.0,5,7,1430,0,1954,0,98006,47.571999999999996,-122.147,1430,9840,1,7,2015,UNK,0,-1200
7708000010,11/7/2014,421000.0,3,2.0,1420,12655,1.0,0.0,0.0,5,7,1420,0,1968,0,98056,47.5309,-122.186,2020,9655,11,7,2014,UNK,-600,3000
2639400020,8/1/2014,635000.0,4,1.75,2460,7560,2.0,0.0,0.0,4,8,2460,0,1952,0,98177,47.7256,-122.367,2760,8918,8,1,2014,UNK,-300,-1358
7883604095,12/9/2014,255000.0,3,1.0,1340,6120,1.5,0.0,0.0,4,7,1340,0,1920,0,98108,47.5272,-122.322,1260,6000,12,9,2014,UNK,80,120
3055800020,3/10/2015,419950.0,4,1.0,1530,7920,1.0,0.0,0.0,3,7,1030,500,1955,0,98166,47.4544,-122.36,1690,7920,3,10,2015,UNK,-160,0
7195800009,12/10/2014,325000.0,6,3.0,2650,12870,1.0,0.0,0.0,4,7,2650,0,1977,0,98022,47.2069,-121.98899999999999,1450,8668,12,10,2014,UNK,1200,4202
8946750170,4/21/2015,281000.0,4,2.25,1677,3600,2.0,0.0,0.0,3,7,1677,0,2012,0,98092,47.32,-122.178,1677,3600,4,21,2015,N,0,0
5603700095,6/10/2014,655275.0,3,1.75,2050,11856,1.0,0.0,0.0,3,7,1460,590,1962,0,98006,47.5735,-122.162,2670,11856,6,10,2014,UNK,-620,0
8819900170,8/25/2014,861000.0,3,2.0,2520,3959,1.0,0.0,0.0,5,8,1270,1250,1931,0,98105,47.6693,-122.289,1660,3959,8,25,2014,UNK,860,0
3999300290,10/16/2014,850000.0,3,3.5,2620,11148,2.0,0.0,4.0,4,9,2060,560,1977,0,98008,47.5845,-122.115,2590,10796,10,16,2014,UNK,30,352
2791500280,11/19/2014,246000.0,3,2.5,1650,6675,1.0,0.0,0.0,3,8,1290,360,1990,0,98023,47.2899,-122.37200000000001,1880,6675,11,19,2014,UNK,-230,0
8820903560,12/16/2014,380000.0,2,1.0,700,4836,1.0,0.0,0.0,4,6,700,0,1926,0,98125,47.7139,-122.288,1190,7050,12,16,2014,UNK,-490,-2214
4401200460,10/20/2014,813000.0,4,2.5,3430,7508,2.0,0.0,0.0,3,10,3430,0,1998,0,98052,47.6866,-122.11,3110,8741,10,20,2014,UNK,320,-1233
3394100020,11/20/2014,990000.0,4,2.5,3140,11049,2.0,0.0,0.0,3,10,3140,0,1988,0,98004,47.5817,-122.19200000000001,2750,11049,11,20,2014,UNK,390,0
2880100795,11/5/2014,650000.0,3,2.5,2350,3750,2.0,0.0,0.0,3,7,1740,610,2003,0,98117,47.6767,-122.365,1590,4700,11,5,2014,UNK,760,-950
104560280,5/22/2014,273000.0,4,3.0,1990,6180,2.0,0.0,0.0,3,7,1990,0,1990,0,98023,47.3083,-122.36,1910,6180,5,22,2014,UNK,80,0
2133010290,7/24/2014,398000.0,4,2.5,2050,14724,2.0,0.0,0.0,3,7,2050,0,1989,0,98019,47.73,-121.969,1920,12841,7,24,2014,UNK,130,1883
1723049008,8/22/2014,200000.0,2,1.0,930,8665,1.0,0.0,0.0,4,6,930,0,1938,0,98168,47.4822,-122.318,1630,12375,8,22,2014,UNK,-700,-3710
8146100095,5/15/2014,839000.0,3,1.0,1230,12305,1.0,0.0,0.0,3,7,1230,0,1955,1990,98004,47.6095,-122.195,2100,7960,5,15,2014,Y,-870,4345
7715800430,11/4/2014,502000.0,3,2.5,1870,9135,1.0,0.0,0.0,3,7,1250,620,1984,0,98074,47.6269,-122.06,1550,9100,11,4,2014,UNK,320,35
9510900630,6/17/2014,305000.0,3,2.25,2110,7665,1.0,0.0,0.0,4,7,1360,750,1973,0,98023,47.3082,-122.37200000000001,1660,8436,6,17,2014,UNK,450,-771
9414610020,6/18/2014,574950.0,5,3.25,3160,10000,2.0,0.0,0.0,4,8,3160,0,1980,0,98027,47.52,-122.04700000000001,2130,10000,6,18,2014,UNK,1030,0
1160000255,8/18/2014,311000.0,3,1.0,1120,8631,1.0,0.0,0.0,3,7,1120,0,1942,0,98125,47.7077,-122.314,1350,7714,8,18,2014,UNK,-230,917
777100005,11/22/2014,1650000.0,3,2.25,2750,6203,1.0,1.0,4.0,5,7,1620,1130,1959,0,98074,47.6163,-122.068,2570,7009,11,22,2014,UNK,180,-806
3205100130,5/6/2014,387000.0,3,1.0,1230,9568,1.0,0.0,0.0,5,7,1230,0,1962,0,98056,47.538999999999994,-122.179,1270,9575,5,6,2014,UNK,-40,-7
2929600020,8/5/2014,375000.0,3,1.5,1190,20672,1.5,0.0,3.0,3,7,1190,0,1948,0,98166,47.4459,-122.359,2150,16239,8,5,2014,UNK,-960,4433
2420069242,9/25/2014,175000.0,2,1.0,740,3434,1.0,0.0,0.0,5,6,740,0,1920,0,98022,47.2088,-121.992,1160,6000,9,25,2014,UNK,-420,-2566
5009600010,6/12/2014,248000.0,4,2.5,1770,5855,2.0,0.0,0.0,3,7,1770,0,2003,0,98038,47.3483,-122.053,1790,5679,6,12,2014,UNK,-20,176
2414600255,4/3/2015,336750.0,4,2.25,1720,7803,1.0,0.0,0.0,3,8,1350,370,1955,0,98146,47.5119,-122.337,1720,7803,4,3,2015,UNK,0,0
9359300250,6/4/2014,685000.0,4,2.5,2770,45514,2.0,0.0,0.0,4,9,2770,0,1989,0,98077,47.7751,-122.088,2940,49495,6,4,2014,UNK,-170,-3981
3629980920,7/15/2014,645000.0,4,2.75,2330,3917,2.0,0.0,0.0,3,9,2330,0,2004,0,98029,47.5527,-121.99,2620,4400,7,15,2014,N,-290,-483
6679001060,12/18/2014,279000.0,3,2.5,1660,7388,2.0,0.0,0.0,3,7,1660,0,2003,0,98038,47.3865,-122.027,2240,6228,12,18,2014,UNK,-580,1160
1702900664,4/16/2015,479000.0,2,2.5,1730,1037,3.5,0.0,0.0,3,8,1730,0,2008,0,98118,47.5594,-122.285,1280,1026,4,16,2015,N,450,11
928000020,1/28/2015,466000.0,3,2.25,1880,7279,1.0,0.0,0.0,3,7,1280,600,1962,0,98155,47.7574,-122.322,2020,8274,1,28,2015,UNK,-140,-995
705710290,4/20/2015,361500.0,4,2.75,2190,6740,2.0,0.0,0.0,3,7,2190,0,1995,0,98038,47.3804,-122.027,1950,7150,4,20,2015,UNK,240,-410
8155830020,12/2/2014,404000.0,3,1.75,1720,7202,1.0,0.0,0.0,3,7,1720,0,1995,0,98056,47.5044,-122.19,1720,7625,12,2,2014,UNK,0,-423
9378700190,3/16/2015,319000.0,4,3.25,2360,8344,2.0,0.0,0.0,3,8,2360,0,1990,0,98058,47.4403,-122.126,1860,8410,3,16,2015,UNK,500,-66
5104200420,3/16/2015,320000.0,3,1.5,1490,10132,1.0,0.0,0.0,4,6,1490,0,1969,0,98059,47.4779,-122.145,1720,9915,3,16,2015,UNK,-230,217
9550202140,11/17/2014,1310000.0,4,3.75,3490,5625,2.0,0.0,0.0,3,9,2610,880,2014,0,98103,47.6685,-122.33200000000001,1940,5000,11,17,2014,N,1550,625
7855300460,9/23/2014,1000000.0,3,2.75,2370,8900,1.0,0.0,4.0,4,9,1670,700,1971,0,98006,47.5648,-122.156,2840,8956,9,23,2014,UNK,-470,-56
9346960050,11/7/2014,660000.0,4,2.5,2290,9120,2.0,0.0,0.0,4,8,2290,0,1977,0,98006,47.5613,-122.12799999999999,2290,9120,11,7,2014,UNK,0,0
2254501440,4/21/2015,546000.0,4,3.0,1790,3600,1.5,0.0,0.0,3,8,1790,0,1901,0,98122,47.6117,-122.31299999999999,1770,3119,4,21,2015,UNK,20,481
3732800525,7/9/2014,300000.0,4,1.75,1820,5015,1.0,0.0,0.0,4,6,1190,630,1926,0,98108,47.5569,-122.31,1530,9130,7,9,2014,UNK,290,-4115
2525059134,10/16/2014,500000.0,2,1.5,1760,12000,1.0,0.0,0.0,4,7,1760,0,1964,0,98052,47.6288,-122.109,2200,12088,10,16,2014,UNK,-440,-88
8562891100,9/10/2014,381500.0,4,2.5,2430,5556,2.0,0.0,0.0,4,8,2430,0,2003,0,98042,47.3762,-122.126,2430,5556,9,10,2014,UNK,0,0
4094800380,4/27/2015,990000.0,3,2.25,2630,12899,2.0,0.0,0.0,4,9,2630,0,1966,0,98040,47.5479,-122.23299999999999,3140,15320,4,27,2015,UNK,-510,-2421
5104530680,1/16/2015,278226.0,4,2.5,2390,4639,2.0,0.0,0.0,3,8,2390,0,2006,0,98038,47.3527,-121.999,2390,4521,1,16,2015,N,0,118
2917200675,1/27/2015,340000.0,2,1.75,1500,4158,1.0,0.0,0.0,4,7,1220,280,1947,0,98103,47.7006,-122.35,1270,4081,1,27,2015,UNK,230,77
8732030440,8/13/2014,305000.0,4,2.5,2510,12000,1.0,0.0,0.0,3,8,1520,990,1977,0,98023,47.3086,-122.384,2210,8320,8,13,2014,UNK,300,3680
7779200275,6/13/2014,760000.0,4,2.5,2420,10285,1.0,0.0,4.0,3,8,1700,720,1958,0,98146,47.4871,-122.36,2540,9900,6,13,2014,UNK,-120,385
6121800050,10/29/2014,195000.0,4,1.5,2170,9948,2.0,0.0,0.0,3,7,2170,0,1952,0,98148,47.4263,-122.331,1500,9750,10,29,2014,UNK,670,198
5652601155,4/15/2015,564000.0,4,1.75,1960,6138,1.0,0.0,0.0,4,7,1260,700,1960,0,98115,47.6968,-122.29899999999999,2000,7057,4,15,2015,UNK,-40,-919
3261020080,12/24/2014,539500.0,4,2.25,2280,8550,1.0,0.0,0.0,3,8,1660,620,1977,0,98034,47.701,-122.23100000000001,2590,9500,12,24,2014,UNK,-310,-950
4060000020,9/18/2014,299980.0,4,1.5,1580,10230,1.0,0.0,0.0,3,6,790,790,1945,2008,98178,47.5002,-122.24600000000001,1130,6955,9,18,2014,Y,450,3275
5468730280,10/13/2014,290000.0,4,2.5,1850,5674,2.0,0.0,0.0,3,7,1850,0,1993,0,98042,47.3536,-122.14200000000001,1750,6875,10,13,2014,UNK,100,-1201
7304301045,2/3/2015,257000.0,2,1.0,770,11084,1.0,0.0,0.0,4,6,770,0,1947,0,98155,47.7482,-122.321,1010,11084,2,3,2015,UNK,-240,0
4077800507,8/21/2014,518500.0,4,3.0,2120,5520,1.5,0.0,0.0,3,8,1420,700,1985,0,98125,47.7085,-122.286,2020,8700,8,21,2014,UNK,100,-3180
1041500020,9/8/2014,657000.0,4,2.75,3060,35380,1.0,0.0,0.0,3,9,1810,1250,1982,0,98074,47.6198,-122.038,1980,10425,9,8,2014,UNK,1080,24955
1423089134,8/15/2014,590000.0,3,2.25,2680,41250,2.0,0.0,0.0,3,7,2680,0,1984,0,98045,47.4817,-121.749,1940,47044,8,15,2014,UNK,740,-5794
3992700048,7/18/2014,526000.0,4,1.75,2220,6350,1.0,0.0,0.0,3,7,1110,1110,1959,0,98125,47.7136,-122.29,1950,8100,7,18,2014,UNK,270,-1750
2172000285,3/23/2015,254500.0,2,1.0,1150,11250,1.0,0.0,0.0,3,6,1150,0,1920,0,98178,47.486000000000004,-122.264,1100,11400,3,23,2015,UNK,50,-150
8813400345,4/14/2015,575000.0,2,1.0,980,3663,1.0,0.0,0.0,5,7,980,0,1909,0,98105,47.6645,-122.288,1620,3706,4,14,2015,UNK,-640,-43
5487300020,1/21/2015,464550.0,3,1.5,1690,10500,1.0,0.0,0.0,4,7,1690,0,1967,0,98033,47.7018,-122.165,1570,10500,1,21,2015,UNK,120,0
7201800280,7/15/2014,409950.0,3,1.75,1320,6030,1.0,0.0,0.0,4,7,1320,0,1969,0,98052,47.6993,-122.13,1840,6565,7,15,2014,UNK,-520,-535
8856000545,5/7/2014,100000.0,2,1.0,910,22000,1.0,0.0,0.0,3,6,910,0,1956,0,98001,47.2777,-122.25200000000001,1326,9891,5,7,2014,UNK,-416,12109
567000380,3/2/2015,365000.0,2,1.5,820,1270,2.0,0.0,0.0,3,7,820,0,2009,0,98144,47.5925,-122.295,1130,1201,3,2,2015,N,-310,69
1450100020,2/9/2015,208000.0,3,1.0,1300,7420,1.0,0.0,0.0,4,6,1300,0,1960,0,98002,47.2899,-122.219,1250,7420,2,9,2015,UNK,50,0
7950302995,11/10/2014,497950.0,4,2.5,1950,3000,2.0,0.0,0.0,3,7,1550,400,1998,0,98118,47.565,-122.281,1540,4300,11,10,2014,UNK,410,-1300
1446110020,9/10/2014,405000.0,5,3.5,3672,9742,2.0,0.0,0.0,3,9,3006,666,2006,0,98092,47.3255,-122.19200000000001,2140,9118,9,10,2014,N,1532,624
8914100080,3/11/2015,568000.0,3,2.5,2740,22499,2.0,0.0,0.0,3,9,2740,0,1994,0,98058,47.4597,-122.15299999999999,2710,22499,3,11,2015,UNK,30,0
3333000655,5/11/2015,334000.0,2,1.0,890,6000,1.0,0.0,0.0,3,6,890,0,1941,0,98118,47.5437,-122.281,1090,5900,5,11,2015,UNK,-200,100
8019201061,1/15/2015,235000.0,3,2.0,1090,8400,1.0,0.0,0.0,4,6,1090,0,1961,0,98168,47.4942,-122.322,1100,10850,1,15,2015,UNK,-10,-2450
8570900328,6/3/2014,295000.0,2,1.0,1170,10621,1.0,0.0,0.0,3,7,1170,0,1963,0,98045,47.497,-121.78,1340,9832,6,3,2014,UNK,-170,789
5631500947,1/22/2015,610000.0,4,3.0,2600,29539,1.0,0.0,0.0,3,8,2600,0,1994,0,98028,47.746,-122.23100000000001,1810,11600,1,22,2015,UNK,790,17939
254000020,6/5/2014,453500.0,4,1.75,2000,6032,1.0,0.0,2.0,3,7,1300,700,1959,0,98146,47.5132,-122.389,1930,6032,6,5,2014,UNK,70,0
1929300305,6/23/2014,1220000.0,4,3.75,3520,3944,1.5,0.0,0.0,5,8,2200,1320,1913,0,98109,47.6424,-122.348,2310,4725,6,23,2014,UNK,1210,-781
4202400078,1/28/2015,175000.0,2,1.0,1410,7000,1.0,0.0,0.0,3,7,1410,0,1968,0,98055,47.4908,-122.223,1540,6000,1,28,2015,UNK,-130,1000
4202400078,4/28/2015,335000.0,2,1.0,1410,7000,1.0,0.0,0.0,3,7,1410,0,1968,0,98055,47.4908,-122.223,1540,6000,4,28,2015,UNK,-130,1000
2968800010,9/4/2014,275000.0,3,1.5,1950,7620,1.0,0.0,0.0,4,7,1010,940,1956,0,98166,47.4594,-122.346,1850,7620,9,4,2014,UNK,100,0
2880100675,5/14/2014,400000.0,2,1.0,980,2130,1.0,0.0,0.0,4,6,860,120,1918,0,98117,47.6769,-122.366,980,2800,5,14,2014,UNK,0,-670
1024000050,7/18/2014,915000.0,3,2.75,3390,7000,1.0,0.0,3.0,4,8,1740,1650,1979,0,98116,47.5701,-122.40799999999999,1770,6500,7,18,2014,UNK,1620,500
6072400280,6/19/2014,619850.0,4,2.5,2270,9247,1.0,0.0,0.0,5,8,1500,770,1972,0,98006,47.5602,-122.176,2270,9163,6,19,2014,UNK,0,84
2329600280,2/2/2015,225900.0,3,1.0,1510,8800,1.0,0.0,0.0,4,7,1010,500,1963,0,98003,47.32899999999999,-122.33,1290,8470,2,2,2015,UNK,220,330
6822100050,9/18/2014,525000.0,2,1.5,960,7200,1.0,0.0,0.0,3,7,960,0,1910,1987,98199,47.648999999999994,-122.40299999999999,1550,6000,9,18,2014,Y,-590,1200
1420400130,12/26/2014,215000.0,4,2.25,1900,9600,1.0,0.0,0.0,4,7,1900,0,1967,0,98031,47.4208,-122.2,2040,9600,12,26,2014,UNK,-140,0
7732400280,5/14/2014,802000.0,3,2.5,2580,13096,2.0,0.0,0.0,3,9,2580,0,1986,0,98052,47.6616,-122.14399999999999,2580,7988,5,14,2014,UNK,0,5108
4397000500,6/30/2014,330000.0,4,2.5,2340,11784,2.0,0.0,0.0,3,9,2340,0,1997,0,98042,47.38399999999999,-122.149,2250,10760,6,30,2014,UNK,90,1024
9560700010,8/1/2014,549800.0,3,2.25,1580,11680,1.0,0.0,0.0,4,7,1580,0,1958,0,98005,47.5872,-122.17,2270,10948,8,1,2014,UNK,-690,732
6131600285,10/24/2014,195500.0,4,1.0,1230,8636,1.5,0.0,0.0,4,6,1230,0,1954,0,98002,47.3231,-122.219,1168,8316,10,24,2014,UNK,62,320
8956500020,8/18/2014,338000.0,3,2.5,1590,7819,2.0,0.0,0.0,3,7,1590,0,1992,0,98055,47.4367,-122.199,1790,7733,8,18,2014,UNK,-200,86
624069108,8/12/2014,3200000.0,4,3.25,7000,28206,1.0,1.0,4.0,4,12,3500,3500,1991,0,98075,47.5928,-122.086,4913,14663,8,12,2014,UNK,2087,13543
1727500280,8/20/2014,480000.0,4,2.25,1770,7000,1.0,0.0,0.0,5,7,1770,0,1972,0,98034,47.7193,-122.21799999999999,1780,6500,8,20,2014,UNK,-10,500
4029400080,4/6/2015,383000.0,4,2.5,1850,8310,1.0,0.0,0.0,3,7,1200,650,1962,0,98155,47.7717,-122.29,1840,10080,4,6,2015,UNK,10,-1770
2873000920,3/31/2015,257000.0,3,1.75,1430,7210,1.0,0.0,0.0,3,7,1430,0,1975,0,98031,47.4189,-122.16799999999999,1220,7777,3,31,2015,UNK,210,-567
1402900460,2/23/2015,335000.0,4,2.75,2190,9209,2.0,0.0,0.0,4,8,2190,0,1996,0,98092,47.3341,-122.18799999999999,2430,6687,2,23,2015,UNK,-240,2522
8125200480,5/8/2015,422000.0,4,2.5,2310,6650,2.0,0.0,2.0,3,8,2310,0,2012,0,98166,47.4513,-122.26700000000001,1800,9819,5,8,2015,N,510,-3169
1087900050,6/3/2014,560000.0,3,1.75,2000,10182,1.0,0.0,0.0,5,7,1400,600,1963,0,98033,47.6616,-122.175,2050,10182,6,3,2014,UNK,-50,0
7937900280,4/24/2015,680000.0,4,2.75,3620,35429,2.0,0.0,0.0,3,10,3620,0,2006,0,98058,47.4238,-122.098,3310,54193,4,24,2015,N,310,-18764
1096100010,10/28/2014,320000.0,2,1.0,1210,7040,1.0,0.0,0.0,3,7,1210,0,1952,0,98155,47.745,-122.29700000000001,1210,7205,10,28,2014,UNK,0,-165
2050100250,9/3/2014,665000.0,3,2.5,2330,15536,1.0,0.0,2.0,3,10,2330,0,1996,0,98074,47.655,-122.087,3320,17461,9,3,2014,UNK,-990,-1925
8691370500,3/26/2015,751000.0,3,2.5,2840,6854,2.0,0.0,0.0,3,9,2840,0,2002,0,98075,47.6006,-121.978,2840,7398,3,26,2015,UNK,0,-544
7147600225,11/13/2014,320000.0,6,2.75,2410,10763,1.0,0.0,0.0,5,7,1310,1100,1957,0,98188,47.4429,-122.28200000000001,1310,10746,11,13,2014,UNK,1100,17
4021100095,1/21/2015,290000.0,4,1.75,1820,22043,2.5,0.0,0.0,4,7,1820,0,1918,0,98155,47.7606,-122.28,1880,19961,1,21,2015,UNK,-60,2082
7524000280,10/30/2014,250000.0,4,2.0,1470,7412,1.0,0.0,0.0,3,7,1470,0,1967,0,98198,47.3702,-122.318,1390,7825,10,30,2014,UNK,80,-413
3205200430,4/15/2015,423000.0,3,1.75,1100,10005,1.0,0.0,0.0,5,7,1100,0,1964,0,98056,47.5374,-122.17299999999999,1340,9709,4,15,2015,UNK,-240,296
7922720250,5/6/2015,601002.0,4,2.5,2050,8094,1.0,0.0,0.0,3,8,1050,1000,1976,0,98052,47.6614,-122.13799999999999,1990,9020,5,6,2015,UNK,60,-926
3644100095,2/5/2015,352900.0,2,1.5,1240,1892,2.0,0.0,0.0,3,7,1240,0,2002,0,98144,47.5915,-122.295,1220,1740,2,5,2015,UNK,20,152
3425079088,8/19/2014,509950.0,3,2.5,2210,70567,2.0,0.0,3.0,3,9,2210,0,1995,0,98014,47.6087,-121.895,2000,73616,8,19,2014,UNK,210,-3049
8730000250,2/5/2015,360000.0,2,1.75,1340,1050,3.0,0.0,0.0,3,8,1340,0,2009,0,98133,47.7053,-122.34299999999999,1340,1090,2,5,2015,N,0,-40
2581900235,11/10/2014,1080000.0,4,2.75,2580,8100,2.0,0.0,1.0,4,8,1780,800,1964,0,98040,47.5387,-122.215,2840,10006,11,10,2014,UNK,-260,-1906
3793500920,7/31/2014,349950.0,3,2.5,2390,6441,2.0,0.0,0.0,3,7,2390,0,2002,0,98038,47.3659,-122.029,2180,7346,7,31,2014,UNK,210,-905
2472920780,11/26/2014,395000.0,4,2.5,2250,6840,2.0,0.0,0.0,3,9,2250,0,1987,0,98058,47.4398,-122.15100000000001,2480,7386,11,26,2014,UNK,-230,-546
8860200010,1/7/2015,273500.0,3,1.5,2000,15265,1.0,0.0,0.0,3,8,1540,460,1967,0,98032,47.387,-122.281,1920,15265,1,7,2015,UNK,80,0
6823100225,4/14/2015,700000.0,4,1.75,1870,6000,1.0,0.0,0.0,5,8,1670,200,1949,0,98199,47.6435,-122.399,1710,6000,4,14,2015,UNK,160,0
6669070080,4/17/2015,699000.0,3,2.5,2370,10968,2.0,0.0,0.0,4,9,2370,0,1985,0,98033,47.6679,-122.17200000000001,2380,8144,4,17,2015,UNK,-10,2824
7214810050,4/16/2015,537000.0,4,2.25,2640,8800,1.0,0.0,0.0,3,8,1620,1020,1980,0,98072,47.7552,-122.148,2500,11700,4,16,2015,UNK,140,-2900
3791500050,4/29/2015,405000.0,3,1.5,1240,9975,1.0,0.0,0.0,3,6,1240,0,1977,0,98024,47.5667,-121.905,1390,10735,4,29,2015,UNK,-150,-760
4340610080,8/4/2014,269500.0,2,1.0,800,1200,2.0,0.0,0.0,3,7,800,0,1999,0,98103,47.6969,-122.34700000000001,806,1200,8,4,2014,UNK,-6,0
7686203620,9/25/2014,260000.0,4,2.5,2050,12500,1.0,0.0,0.0,3,7,1300,750,1965,0,98198,47.42,-122.319,1790,7900,9,25,2014,UNK,260,4600
2013800095,9/4/2014,266750.0,3,2.25,1650,10000,2.0,0.0,0.0,3,7,1650,0,1988,0,98198,47.3862,-122.315,1420,10000,9,4,2014,UNK,230,0
4030100005,12/9/2014,1800000.0,5,3.75,4320,39094,2.0,1.0,4.0,3,8,4320,0,1938,0,98155,47.7519,-122.27600000000001,1920,7750,12,9,2014,UNK,2400,31344
8931100095,8/21/2014,779000.0,2,2.25,2130,5920,1.0,0.0,0.0,3,8,1830,300,1950,0,98115,47.6792,-122.275,2130,7192,8,21,2014,UNK,0,-1272
1954630080,6/19/2014,500000.0,3,2.5,2840,48716,1.0,0.0,3.0,3,9,1870,970,1994,0,98014,47.6832,-121.915,2710,43676,6,19,2014,UNK,130,5040
3361402066,4/3/2015,365000.0,4,1.75,3080,32997,1.5,0.0,0.0,4,7,3080,0,1950,0,98168,47.49800000000001,-122.321,1980,5711,4,3,2015,UNK,1100,27286
579000595,9/6/2014,724000.0,2,1.0,1560,5000,1.5,0.0,1.0,4,7,1560,0,1942,0,98117,47.7006,-122.38600000000001,2620,5400,9,6,2014,UNK,-1060,-400
7701960250,8/11/2014,890000.0,4,2.75,3220,15467,2.0,0.0,0.0,3,11,3220,0,1994,0,98077,47.7128,-122.083,3670,16641,8,11,2014,UNK,-450,-1174
1250200595,7/24/2014,431000.0,4,2.5,1450,3600,1.5,0.0,0.0,3,7,1250,200,1902,0,98144,47.5985,-122.29799999999999,1680,3600,7,24,2014,UNK,-230,0
2632000080,7/10/2014,242000.0,2,1.0,960,21850,1.0,0.0,0.0,3,6,960,0,1947,0,98032,47.4122,-122.26700000000001,1020,21850,7,10,2014,UNK,-60,0
9323000010,4/16/2015,415000.0,4,2.5,2670,8279,2.0,0.0,0.0,3,7,2670,0,1999,0,98148,47.4292,-122.32799999999999,2290,7504,4,16,2015,UNK,380,775
3052700225,8/14/2014,727160.0,7,3.75,2310,5000,2.0,0.0,0.0,3,8,2310,0,1984,0,98117,47.6781,-122.376,1360,1552,8,14,2014,UNK,950,3448
3459900305,12/11/2014,1110000.0,4,3.25,3520,19354,1.0,0.0,2.0,4,9,2010,1510,1978,0,98006,47.5572,-122.147,2630,19354,12,11,2014,UNK,890,0
3530410020,1/14/2015,265000.0,2,1.75,1090,3272,1.0,0.0,0.0,5,8,1090,0,1970,0,98198,47.3794,-122.32,1160,5475,1,14,2015,UNK,-70,-2203
461005435,2/2/2015,519000.0,3,1.75,2000,5680,1.0,0.0,0.0,4,7,1080,920,1903,0,98117,47.6805,-122.366,1230,4535,2,2,2015,UNK,770,1145
8851500050,1/12/2015,262000.0,4,1.5,1840,9009,2.0,0.0,0.0,3,7,1840,0,1965,0,98198,47.40600000000001,-122.318,1390,8025,1,12,2015,UNK,450,984
4094800190,6/23/2014,1190000.0,4,2.5,3160,13194,2.0,0.0,0.0,5,10,3160,0,1965,0,98040,47.5472,-122.23299999999999,3490,13194,6,23,2014,UNK,-330,0
2025701190,5/7/2015,295000.0,3,1.75,1520,6559,1.0,0.0,0.0,4,7,1170,350,1992,0,98038,47.35,-122.037,1520,6095,5,7,2015,UNK,0,464
226059120,1/23/2015,615000.0,3,1.75,2110,56192,1.0,0.0,0.0,3,7,1480,630,1978,0,98072,47.7701,-122.13799999999999,2570,46609,1,23,2015,UNK,-460,9583
1818800235,9/5/2014,1100000.0,4,2.75,3410,7750,1.0,0.0,4.0,5,8,1710,1700,1958,0,98116,47.5718,-122.406,3080,8525,9,5,2014,UNK,330,-775
3905080250,9/26/2014,575000.0,4,2.5,2630,6247,2.0,0.0,0.0,3,8,2630,0,1992,0,98029,47.5662,-122.0,2130,4668,9,26,2014,UNK,500,1579
3126049415,4/7/2015,388000.0,3,1.75,1350,2325,3.0,0.0,0.0,3,7,1350,0,1999,0,98103,47.6965,-122.35,1520,1652,4,7,2015,UNK,-170,673
1245000500,11/3/2014,750500.0,4,2.5,2860,9159,1.0,0.0,0.0,4,8,1530,1330,1989,0,98033,47.6923,-122.2,2070,8680,11,3,2014,UNK,790,479
2924069132,5/27/2014,527500.0,3,1.75,2310,78844,1.0,0.0,0.0,3,8,1760,550,1977,0,98027,47.5406,-122.066,2830,6230,5,27,2014,UNK,-520,72614
922069169,5/29/2014,503000.0,3,2.0,2590,108900,2.0,0.0,0.0,3,8,1980,610,1988,0,98038,47.4088,-122.055,3170,108900,5,29,2014,UNK,-580,0
5015000346,11/4/2014,1050000.0,4,3.5,3500,4000,2.0,0.0,0.0,3,10,2560,940,2000,0,98112,47.628,-122.29899999999999,1910,4000,11,4,2014,UNK,1590,0
8122101440,7/8/2014,325000.0,2,1.0,800,7260,1.0,0.0,0.0,3,7,800,0,1953,0,98126,47.5359,-122.367,1010,7440,7,8,2014,UNK,-210,-180
6413600285,8/25/2014,402000.0,3,1.75,1580,6127,1.5,0.0,0.0,5,7,1580,0,1947,0,98125,47.7192,-122.32,1500,6128,8,25,2014,UNK,80,-1
6145601995,9/24/2014,370000.0,3,1.5,1560,6774,1.0,0.0,0.0,4,6,1060,500,1927,0,98133,47.7024,-122.35,1320,3844,9,24,2014,UNK,240,2930
1214000080,6/26/2014,329950.0,3,1.0,1750,7800,1.0,0.0,0.0,4,7,1150,600,1956,0,98166,47.4596,-122.34299999999999,1750,7560,6,26,2014,UNK,0,240
3361400980,5/12/2015,135000.0,2,1.0,600,6120,1.0,0.0,0.0,3,5,600,0,1943,1989,98168,47.5,-122.31700000000001,1090,6120,5,12,2015,Y,-490,0
2826049260,6/20/2014,482500.0,4,3.0,1630,7626,1.0,0.0,0.0,5,7,1110,520,1990,0,98125,47.7168,-122.30799999999999,1630,8082,6,20,2014,UNK,0,-456
1001200050,9/23/2014,259000.0,4,1.5,1260,7248,1.5,0.0,0.0,5,7,1260,0,1955,0,98188,47.433,-122.292,1300,7732,9,23,2014,UNK,-40,-484
8732130680,10/27/2014,210000.0,3,2.25,2140,9775,1.0,0.0,0.0,4,7,1470,670,1978,0,98023,47.306000000000004,-122.37899999999999,2050,8625,10,27,2014,UNK,90,1150
1310430130,10/9/2014,459000.0,4,2.75,2790,6600,2.0,0.0,0.0,3,9,2790,0,2000,0,98058,47.4362,-122.109,2900,6752,10,9,2014,UNK,-110,-152
2380000190,7/1/2014,375000.0,3,1.75,2530,35150,1.0,0.0,0.0,4,7,1800,730,1977,0,98042,47.3913,-122.12100000000001,2460,36386,7,1,2014,UNK,70,-1236
123039626,10/22/2014,295000.0,3,2.25,1330,7200,1.0,0.0,0.0,3,7,900,430,1974,0,98146,47.5102,-122.36399999999999,1380,9570,10,22,2014,UNK,-50,-2370
1257200290,5/12/2014,910000.0,3,2.0,2700,6120,1.0,0.0,0.0,4,8,1350,1350,1962,0,98115,47.6731,-122.32700000000001,1700,4590,5,12,2014,UNK,1000,1530
318900080,10/10/2014,470000.0,4,1.0,1740,37238,1.5,0.0,0.0,4,7,1740,0,1932,0,98024,47.5651,-121.902,1810,18352,10,10,2014,UNK,-70,18886
8118600080,2/20/2015,565000.0,4,2.0,2070,7980,1.5,0.0,0.0,4,7,2070,0,1940,0,98146,47.5092,-122.38600000000001,1600,7980,2,20,2015,UNK,470,0
2023049372,11/7/2014,339950.0,4,2.25,2670,9040,1.0,0.0,0.0,3,8,2170,0,1955,0,98148,47.4666,-122.32600000000001,1880,2648,11,7,2014,UNK,790,6392
126059005,1/15/2015,547000.0,5,3.0,2200,103237,1.0,0.0,0.0,3,7,1160,1040,1971,0,98072,47.7726,-122.111,2300,103237,1,15,2015,UNK,-100,0
6303401150,9/24/2014,125000.0,2,1.0,810,8382,1.0,0.0,0.0,4,5,810,0,1942,0,98146,47.5033,-122.35799999999999,1040,8382,9,24,2014,UNK,-230,0
1732801150,7/1/2014,2300000.0,4,4.75,3970,9778,2.0,0.0,2.0,4,11,3390,580,1928,0,98119,47.6312,-122.366,3970,8460,7,1,2014,UNK,0,1318
7893800250,4/30/2015,348000.0,3,2.5,2370,7500,1.0,0.0,3.0,3,8,1620,750,1979,0,98198,47.4091,-122.331,1960,8062,4,30,2015,UNK,410,-562
1922059298,4/14/2015,175000.0,3,1.0,1460,11880,1.0,0.0,0.0,2,7,1460,0,1961,0,98030,47.3762,-122.219,1310,9315,4,14,2015,UNK,150,2565
2391600950,5/2/2014,439950.0,3,2.5,1770,2875,2.0,0.0,0.0,3,8,1770,0,1990,0,98116,47.5631,-122.397,1770,3833,5,2,2014,UNK,0,-958
3623029034,3/11/2015,230000.0,3,1.0,1120,32250,1.0,0.0,0.0,4,6,1120,0,1934,0,98070,47.446999999999996,-122.48200000000001,1010,335289,3,11,2015,UNK,110,-303039
13001991,9/2/2014,207000.0,3,2.5,1520,2550,2.0,0.0,0.0,3,7,1520,0,2005,0,98108,47.5245,-122.33,1460,2550,9,2,2014,N,60,0
1156000250,6/2/2014,320000.0,5,2.5,3020,21441,1.0,0.0,0.0,4,8,1510,1510,1978,0,98042,47.3392,-122.131,1610,16445,6,2,2014,UNK,1410,4996
1326059182,4/6/2015,1090000.0,5,3.25,5600,107157,2.0,0.0,0.0,3,10,3440,2160,1988,0,98072,47.7341,-122.102,3470,75794,4,6,2015,UNK,2130,31363
3755500080,6/6/2014,510000.0,4,1.5,1320,14250,1.0,0.0,0.0,4,7,1320,0,1954,0,98033,47.7016,-122.199,1720,14250,6,6,2014,UNK,-400,0
5042300095,10/31/2014,730000.0,4,1.0,1870,4992,1.5,0.0,0.0,4,7,1670,200,1940,0,98199,47.6437,-122.396,2160,5239,10,31,2014,UNK,-290,-247
7772800020,8/13/2014,750000.0,3,3.75,2460,7630,1.0,0.0,0.0,5,8,1940,520,1976,0,98177,47.7147,-122.37299999999999,2000,7326,8,13,2014,UNK,460,304
3629000080,4/10/2015,237000.0,3,1.5,960,7400,1.0,0.0,0.0,3,7,960,0,1962,0,98198,47.3798,-122.306,1640,8060,4,10,2015,UNK,-680,-660
5126210280,9/26/2014,560000.0,3,2.5,3440,103672,2.0,0.0,0.0,3,9,3440,0,1990,0,98038,47.3895,-121.986,2710,112820,9,26,2014,UNK,730,-9148
3062600050,7/14/2014,745000.0,3,2.75,3010,12432,1.0,0.0,0.0,4,8,1890,1120,1970,0,98052,47.6392,-122.10799999999999,2500,12432,7,14,2014,UNK,510,0
5493110080,8/15/2014,1830000.0,3,3.75,6030,39317,2.0,0.0,0.0,3,11,4440,1590,1991,0,98004,47.6055,-122.21,4040,12333,8,15,2014,UNK,1990,26984
2560801222,6/18/2014,180000.0,3,2.25,1990,6350,2.0,0.0,0.0,3,7,1990,0,1967,0,98198,47.3822,-122.316,1220,6250,6,18,2014,UNK,770,100
2560801222,11/13/2014,309950.0,3,2.25,1990,6350,2.0,0.0,0.0,3,7,1990,0,1967,0,98198,47.3822,-122.316,1220,6250,11,13,2014,UNK,770,100
2660500095,5/6/2015,715000.0,4,1.0,1710,6050,1.5,0.0,0.0,3,7,1410,300,1913,0,98118,47.5569,-122.288,1560,4950,5,6,2015,UNK,150,1100
4083800345,4/27/2015,620000.0,4,2.25,1890,4300,1.5,0.0,0.0,3,7,1350,540,1918,0,98103,47.6649,-122.337,1830,3800,4,27,2015,UNK,60,500
587800130,12/31/2014,330000.0,3,2.5,1990,9995,2.0,0.0,0.0,3,7,1990,0,1996,0,98198,47.383,-122.305,1680,7511,12,31,2014,UNK,310,2484
8901000585,4/1/2015,525000.0,4,1.75,1600,7400,1.0,0.0,0.0,3,7,1210,390,1973,0,98125,47.7111,-122.309,1640,7500,4,1,2015,UNK,-40,-100
8650000250,6/7/2014,611000.0,6,2.5,3820,53173,1.0,0.0,0.0,4,9,2040,1780,1974,0,98027,47.5209,-122.052,2510,15314,6,7,2014,UNK,1310,37859
4137050130,6/12/2014,294000.0,4,2.5,2210,8465,1.0,0.0,0.0,3,8,1490,720,1990,0,98092,47.2647,-122.221,2210,7917,6,12,2014,UNK,0,548
3288300920,4/21/2015,463000.0,3,1.75,2020,11095,1.0,0.0,0.0,4,7,1480,540,1975,0,98034,47.7351,-122.18299999999999,2030,10710,4,21,2015,UNK,-10,385
3374500290,7/14/2014,320900.0,3,2.0,1770,7251,1.0,0.0,0.0,4,8,1770,0,1990,0,98031,47.4087,-122.17,2560,7210,7,14,2014,UNK,-790,41
1137400420,10/28/2014,369950.0,4,2.5,2050,4502,2.0,0.0,0.0,3,7,2050,0,2005,0,98059,47.5002,-122.15,2480,4504,10,28,2014,N,-430,-2
3222059130,6/16/2014,565000.0,4,2.75,3130,139392,2.0,0.0,0.0,4,9,3130,0,1981,0,98030,47.3535,-122.19,2720,104544,6,16,2014,UNK,410,34848
3959400345,3/11/2015,589500.0,4,1.5,3520,4933,1.5,0.0,0.0,4,8,2270,1250,1929,0,98108,47.5655,-122.315,1710,5400,3,11,2015,UNK,1810,-467
3971701990,8/12/2014,400000.0,4,1.75,1810,9750,2.0,0.0,0.0,4,7,1810,0,1977,0,98155,47.7681,-122.311,1570,10000,8,12,2014,UNK,240,-250
686530170,10/22/2014,458000.0,3,2.25,2150,9900,1.0,0.0,0.0,3,8,1450,700,1977,0,98052,47.6647,-122.149,2170,9500,10,22,2014,UNK,-20,400
808300470,12/2/2014,436000.0,4,2.5,2495,5751,2.0,0.0,0.0,3,7,2495,0,2002,0,98019,47.7243,-121.95700000000001,2490,6300,12,2,2014,UNK,5,-549
7129303180,10/2/2014,310000.0,3,2.0,1290,6150,1.0,0.0,1.0,5,6,1290,0,1950,0,98118,47.5181,-122.257,1960,6150,10,2,2014,UNK,-670,0
8944460290,10/23/2014,398000.0,5,2.5,3004,5700,2.0,0.0,0.0,3,9,3004,0,2006,0,98030,47.3801,-122.185,2665,5700,10,23,2014,N,339,0
2128000050,8/15/2014,625000.0,4,2.25,2070,7200,1.0,0.0,0.0,5,8,1390,680,1977,0,98033,47.696999999999996,-122.169,2110,8400,8,15,2014,UNK,-40,-1200
4139910170,12/16/2014,1010000.0,5,3.25,4050,35600,2.0,0.0,0.0,3,12,4050,0,1990,0,98006,47.5465,-122.12200000000001,4770,33880,12,16,2014,UNK,-720,1720
8122100235,4/13/2015,435000.0,2,1.0,960,6250,1.0,0.0,0.0,4,6,740,220,1940,0,98126,47.5378,-122.375,1090,6000,4,13,2015,UNK,-130,250
1117000050,3/13/2015,250000.0,3,2.25,1900,9990,1.0,0.0,0.0,3,7,1300,600,1961,0,98003,47.3478,-122.29799999999999,1900,9990,3,13,2015,UNK,0,0
5361700020,3/17/2015,430000.0,3,1.5,1450,7316,1.0,0.0,0.0,3,7,1450,0,1961,0,98133,47.7725,-122.34899999999999,1440,7316,3,17,2015,UNK,10,0
1315300095,8/12/2014,790000.0,4,3.5,2720,3000,2.0,0.0,0.0,3,9,2250,470,2014,0,98136,47.5371,-122.38799999999999,1600,4600,8,12,2014,N,1120,-1600
5093300280,7/9/2014,1680000.0,5,5.25,4830,18707,2.0,0.0,1.0,5,9,3930,900,1952,1998,98040,47.5858,-122.24700000000001,2880,10520,7,9,2014,Y,1950,8187
3438503214,4/7/2015,250000.0,4,2.75,1920,7102,1.0,0.0,0.0,3,7,1130,790,1992,0,98106,47.538999999999994,-122.35600000000001,1830,6440,4,7,2015,UNK,90,662
2346800461,6/13/2014,1120000.0,5,1.5,2540,6660,2.0,0.0,3.0,4,8,2340,200,1954,0,98136,47.5144,-122.39299999999999,2460,9000,6,13,2014,UNK,80,-2340
1826049408,4/27/2015,383900.0,3,1.5,1600,8040,1.0,0.0,0.0,4,7,1050,550,1965,0,98133,47.7471,-122.337,1810,7819,4,27,2015,UNK,-210,221
5468780020,3/26/2015,330000.0,4,2.5,2210,5929,2.0,0.0,0.0,3,8,2210,0,2004,0,98042,47.35,-122.139,2200,5901,3,26,2015,N,10,28
1126059091,9/15/2014,624000.0,3,2.5,2510,47044,1.0,0.0,0.0,4,7,1910,600,1975,0,98072,47.7531,-122.14,2510,42803,9,15,2014,UNK,0,4241
3010300415,2/11/2015,383000.0,5,2.0,2280,5750,1.0,0.0,0.0,4,8,1140,1140,1951,0,98116,47.5672,-122.39,1780,5750,2,11,2015,UNK,500,0
619079016,6/2/2014,687000.0,4,3.25,4400,186846,2.0,0.0,0.0,4,9,4400,0,1993,0,98022,47.1593,-121.95700000000001,2280,186846,6,2,2014,UNK,2120,0
3449800010,3/9/2015,558000.0,4,3.25,3160,8876,2.0,0.0,0.0,3,9,2460,700,1997,0,98056,47.5153,-122.178,2900,10000,3,9,2015,UNK,260,-1124
1231000500,9/5/2014,275000.0,3,2.0,1380,3500,2.0,0.0,0.0,3,7,1380,0,1971,0,98118,47.5558,-122.27,1620,3900,9,5,2014,UNK,-240,-400
4191500130,7/28/2014,687500.0,5,2.75,3320,10500,1.0,0.0,0.0,4,7,2020,1300,1963,0,98033,47.692,-122.166,1840,10425,7,28,2014,UNK,1480,75
104550660,7/28/2014,275000.0,3,2.5,1870,6821,2.0,0.0,0.0,3,7,1870,0,1989,0,98023,47.3065,-122.35799999999999,1970,6821,7,28,2014,UNK,-100,0
1769600066,12/11/2014,700000.0,3,3.5,3030,11550,2.0,0.0,2.0,3,8,3030,0,1971,0,98146,47.5051,-122.381,2340,10560,12,11,2014,UNK,690,990
3762900020,6/24/2014,342500.0,2,1.75,1210,7507,1.0,0.0,0.0,3,7,1210,0,1982,0,98034,47.7078,-122.234,1840,7500,6,24,2014,UNK,-630,7
1626069253,5/6/2014,483500.0,4,2.5,2740,45732,2.0,0.0,0.0,3,8,2740,0,1995,0,98077,47.74,-122.04799999999999,2080,43560,5,6,2014,UNK,660,2172
3904100089,8/1/2014,190000.0,3,1.75,1350,7370,1.0,0.0,0.0,4,6,1350,0,1912,0,98118,47.5336,-122.27799999999999,1440,6000,8,1,2014,UNK,-90,1370
3904100089,3/18/2015,300000.0,3,1.75,1350,7370,1.0,0.0,0.0,4,6,1350,0,1912,0,98118,47.5336,-122.27799999999999,1440,6000,3,18,2015,UNK,-90,1370
1797500780,5/21/2014,540000.0,3,2.0,1470,1691,2.0,0.0,0.0,3,8,1000,0,2007,0,98115,47.6743,-122.316,1660,4000,5,21,2014,N,-190,-2309
7614100080,2/11/2015,140000.0,3,1.75,1270,8991,2.0,0.0,0.0,3,7,1270,0,1981,0,98042,47.3563,-122.149,1270,8993,2,11,2015,UNK,0,-2
87000006,4/13/2015,275000.0,4,1.75,1680,19405,1.0,0.0,0.0,4,7,1560,120,1959,0,98055,47.4552,-122.20200000000001,2000,12900,4,13,2015,UNK,-320,6505
8074200185,8/25/2014,370000.0,3,2.75,2120,7650,1.0,0.0,0.0,4,7,2120,0,1958,0,98056,47.4923,-122.178,1180,7650,8,25,2014,UNK,940,0
9310300185,3/25/2015,227000.0,2,1.0,1040,9100,1.0,0.0,0.0,4,7,1040,0,1937,0,98133,47.7407,-122.34700000000001,1950,13228,3,25,2015,UNK,-910,-4128
1433100010,1/28/2015,312000.0,4,1.0,1730,8706,1.0,0.0,0.0,4,7,1010,720,1962,0,98058,47.4586,-122.175,1369,8418,1,28,2015,UNK,361,288
7129302555,10/3/2014,260000.0,2,1.0,1410,5650,1.5,0.0,0.0,3,6,1410,0,1918,0,98118,47.5159,-122.258,1430,5650,10,3,2014,UNK,-20,0
809002705,7/10/2014,797000.0,3,2.5,1370,1911,2.0,0.0,0.0,3,9,1370,0,1907,2011,98109,47.6375,-122.354,1630,2090,7,10,2014,Y,-260,-179
3026079005,10/17/2014,640000.0,6,2.0,2840,228690,1.5,0.0,0.0,3,6,2720,120,1948,0,98019,47.7158,-121.96600000000001,2330,228690,10,17,2014,UNK,510,0
2413910050,2/13/2015,605000.0,4,1.75,3280,35160,1.0,0.0,0.0,3,7,2080,1200,1976,0,98053,47.6728,-122.061,2510,31331,2,13,2015,UNK,770,3829
8078550190,3/2/2015,329950.0,3,2.25,2070,7995,1.0,0.0,0.0,3,7,1350,720,1987,0,98031,47.403,-122.175,1620,6799,3,2,2015,UNK,450,1196
2225079030,12/12/2014,180000.0,2,1.0,960,87991,1.5,0.0,0.0,3,5,960,0,1946,0,98014,47.63,-121.9,1940,392040,12,12,2014,UNK,-980,-304049
2019200480,8/13/2014,220000.0,3,2.25,1470,7518,1.0,0.0,0.0,3,7,1160,310,1985,0,98003,47.2725,-122.3,1720,8300,8,13,2014,UNK,-250,-782
9274202005,7/2/2014,723000.0,4,2.25,2430,4748,1.5,0.0,0.0,3,8,1630,800,1928,0,98116,47.5904,-122.389,2430,4748,7,2,2014,UNK,0,0
3834500170,1/16/2015,375000.0,3,1.75,1430,8412,1.0,0.0,0.0,4,7,1070,360,1928,0,98125,47.7218,-122.29899999999999,1490,8410,1,16,2015,UNK,-60,2
1223039242,1/26/2015,388000.0,3,1.75,1760,9277,1.0,0.0,0.0,4,7,1760,0,1962,0,98146,47.4977,-122.35799999999999,1760,7650,1,26,2015,UNK,0,1627
7657600005,10/31/2014,249950.0,5,2.0,1730,7375,1.0,0.0,0.0,4,6,1730,0,1944,0,98178,47.4953,-122.238,1550,7125,10,31,2014,UNK,180,250
8963300005,11/6/2014,390000.0,5,1.75,2290,7900,1.0,0.0,0.0,4,7,1190,1100,1965,0,98133,47.7577,-122.35799999999999,1870,8250,11,6,2014,UNK,420,-350
2287000280,9/17/2014,705000.0,4,1.75,1690,11739,1.0,0.0,0.0,4,8,1690,0,1959,0,98040,47.552,-122.219,2300,11600,9,17,2014,UNK,-610,139
686300420,6/23/2014,590000.0,4,2.5,3220,7875,1.5,0.0,0.0,4,8,3220,0,1966,0,98008,47.62600000000001,-122.12,1600,7875,6,23,2014,UNK,1620,0
9335400005,10/10/2014,292000.0,4,1.75,2130,11097,1.0,0.0,0.0,3,7,1370,760,1952,0,98166,47.4629,-122.35600000000001,1850,11097,10,10,2014,UNK,280,0
2321059093,8/5/2014,506000.0,3,2.5,2100,213008,1.0,0.0,0.0,3,8,2100,0,1990,0,98092,47.2984,-122.14399999999999,1330,214315,8,5,2014,UNK,770,-1307
7732410380,6/4/2014,907500.0,4,2.5,2770,8642,2.0,0.0,0.0,4,9,2770,0,1987,0,98007,47.6599,-122.146,2670,9000,6,4,2014,UNK,100,-358
3625049088,7/2/2014,2270000.0,4,3.25,4040,18916,1.0,0.0,0.0,4,9,4040,0,1954,0,98039,47.6155,-122.238,3000,18831,7,2,2014,UNK,1040,85
13001795,10/14/2014,319500.0,4,2.75,2500,5100,1.5,0.0,0.0,4,7,1420,1080,1907,0,98108,47.523,-122.33200000000001,1430,5100,10,14,2014,UNK,1070,0
1604602195,2/23/2015,265000.0,5,1.75,1580,5292,1.0,0.0,0.0,3,6,980,600,1913,0,98118,47.5677,-122.29,1600,2976,2,23,2015,UNK,-20,2316
1003400250,6/5/2014,237000.0,3,1.0,1130,10650,1.0,0.0,0.0,3,7,1130,0,1954,0,98188,47.4363,-122.286,1320,10650,6,5,2014,UNK,-190,0
42000006,9/10/2014,235000.0,5,1.0,1500,9282,1.5,0.0,0.0,5,6,1500,0,1966,0,98168,47.4702,-122.281,1520,9639,9,10,2014,UNK,-20,-357
1193000380,3/30/2015,740000.0,4,2.25,2230,6000,1.5,0.0,2.0,3,8,1810,420,1928,0,98199,47.6464,-122.391,2840,6000,3,30,2015,UNK,-610,0
6300500545,7/9/2014,359000.0,3,1.5,1550,4980,1.0,0.0,0.0,3,7,1080,470,1978,0,98133,47.7035,-122.34,940,4980,7,9,2014,UNK,610,0
538000190,2/13/2015,334950.0,4,2.5,2230,5500,2.0,0.0,0.0,3,7,2230,0,1999,0,98038,47.3533,-122.023,1910,5500,2,13,2015,UNK,320,0
2826049091,9/29/2014,259950.0,2,1.0,790,8100,1.0,0.0,0.0,3,6,790,0,1947,0,98125,47.7159,-122.305,1420,8100,9,29,2014,UNK,-630,0
6147650170,5/14/2014,253000.0,4,2.5,2230,4541,2.0,0.0,0.0,3,7,2230,0,2006,0,98042,47.3848,-122.1,2800,4860,5,14,2014,N,-570,-319
3630030500,6/12/2014,561000.0,3,2.25,1710,4140,2.0,0.0,0.0,3,8,1710,0,2004,0,98029,47.5498,-121.99700000000001,1730,3680,6,12,2014,N,-20,460
6844701680,3/25/2015,455000.0,2,1.5,1260,5100,1.0,0.0,0.0,3,7,1260,0,1941,0,98115,47.6914,-122.288,1640,5100,3,25,2015,UNK,-380,0
9542000275,4/6/2015,675000.0,4,2.5,2420,18470,1.0,0.0,0.0,3,8,920,1500,1968,0,98005,47.6001,-122.176,2690,13800,4,6,2015,UNK,-270,4670
1423600020,6/26/2014,267000.0,3,1.5,1090,8160,1.0,0.0,0.0,3,7,1090,0,1967,0,98058,47.4551,-122.175,1260,7560,6,26,2014,UNK,-170,600
8944460170,11/6/2014,368000.0,4,2.5,2689,5724,2.0,0.0,0.0,3,9,2689,0,2006,0,98030,47.3799,-122.184,2665,5700,11,6,2014,N,24,24
6431000005,11/23/2014,599995.0,3,1.0,1620,3000,1.5,0.0,0.0,5,7,1620,0,1928,0,98103,47.6888,-122.34700000000001,1420,3060,11,23,2014,UNK,200,-60
3755000020,9/17/2014,342500.0,3,1.0,940,10500,1.0,0.0,0.0,4,7,940,0,1966,0,98034,47.7268,-122.229,1660,10500,9,17,2014,UNK,-720,0
1503200050,11/18/2014,252000.0,4,1.75,1940,13370,1.0,0.0,0.0,4,8,1940,0,1974,0,98023,47.3215,-122.369,2405,11769,11,18,2014,UNK,-465,1601
2599000130,7/16/2014,247200.0,3,1.0,1590,11200,1.0,0.0,0.0,4,7,1590,0,1961,0,98092,47.2894,-122.18799999999999,1560,9750,7,16,2014,UNK,30,1450
871001980,5/6/2014,910000.0,3,3.5,3020,4082,2.0,0.0,0.0,3,9,2080,940,1954,2004,98199,47.651,-122.40899999999999,2060,5102,5,6,2014,Y,960,-1020
1774000170,1/5/2015,419950.0,4,1.75,1870,16549,1.0,0.0,0.0,3,8,1870,0,1969,0,98072,47.7482,-122.083,1870,10804,1,5,2015,UNK,0,5745
8945300290,2/26/2015,160000.0,3,1.0,880,8976,1.0,0.0,0.0,4,6,880,0,1966,0,98023,47.3056,-122.368,990,8760,2,26,2015,UNK,-110,216
9433000480,9/22/2014,799950.0,4,3.5,3030,5494,3.0,0.0,0.0,3,9,3030,0,2014,0,98052,47.7103,-122.109,2910,5314,9,22,2014,N,120,180
6672920050,6/17/2014,400000.0,3,2.25,2140,11266,2.0,0.0,0.0,3,7,2140,0,1986,0,98019,47.7267,-121.96600000000001,2000,14174,6,17,2014,UNK,140,-2908
7893805650,5/5/2014,210000.0,5,2.0,2050,10200,1.0,0.0,0.0,3,6,1430,620,1956,0,98198,47.4136,-122.333,1940,8625,5,5,2014,UNK,110,1575
7893805650,3/13/2015,475000.0,5,2.0,2050,10200,1.0,0.0,0.0,3,6,1430,620,1956,0,98198,47.4136,-122.333,1940,8625,3,13,2015,UNK,110,1575
9542830480,5/4/2015,355900.0,3,2.5,2090,3821,2.0,0.0,0.0,3,7,2090,0,2008,0,98038,47.3655,-122.01700000000001,2040,4200,5,4,2015,N,50,-379
3824100364,1/20/2015,420000.0,3,2.25,2520,26943,1.0,0.0,0.0,3,7,1760,760,1977,0,98028,47.7728,-122.25,2300,10004,1,20,2015,UNK,220,16939
9542850290,8/25/2014,710000.0,4,2.5,2630,8580,1.0,0.0,0.0,4,9,1700,930,1977,0,98005,47.5916,-122.166,2430,10240,8,25,2014,UNK,200,-1660
5726500130,4/7/2015,518000.0,4,1.75,2560,15000,1.0,0.0,0.0,3,7,1880,680,1974,0,98075,47.5952,-122.053,2210,15150,4,7,2015,UNK,350,-150
1862400285,10/16/2014,375000.0,3,1.0,1200,5404,1.0,0.0,0.0,3,6,1200,0,1937,0,98117,47.6969,-122.368,1200,5987,10,16,2014,UNK,0,-583
6123600285,11/7/2014,185000.0,3,1.5,1010,7755,1.0,0.0,0.0,3,6,1010,0,1953,0,98148,47.4238,-122.33200000000001,1270,8350,11,7,2014,UNK,-260,-595
6838000170,8/29/2014,402000.0,3,2.5,1520,3425,2.0,0.0,0.0,3,7,1520,0,1986,0,98052,47.6801,-122.161,1640,3425,8,29,2014,UNK,-120,0
2922069134,8/29/2014,585000.0,3,1.75,2170,153767,1.0,0.0,0.0,3,7,2170,0,1976,0,98042,47.3694,-122.065,2840,49500,8,29,2014,UNK,-670,104267
2767603165,1/22/2015,500000.0,4,2.0,1980,4500,2.0,0.0,0.0,4,7,1980,0,1910,0,98107,47.6728,-122.37899999999999,1550,2541,1,22,2015,UNK,430,1959
1118001835,12/23/2014,1720000.0,4,2.5,3070,7207,2.0,0.0,0.0,4,10,2670,400,1927,0,98112,47.6325,-122.29,3190,7523,12,23,2014,UNK,-120,-316
4030100290,10/1/2014,1680000.0,5,3.5,5170,7197,3.0,1.0,4.0,3,11,3520,1650,1998,0,98155,47.7561,-122.271,3020,12880,10,1,2014,UNK,2150,-5683
9828702335,2/12/2015,570000.0,2,2.0,1140,690,2.0,0.0,0.0,3,8,760,0,2014,0,98112,47.6205,-122.3,1480,1171,2,12,2015,N,-340,-481
8141200080,8/14/2014,680000.0,8,2.75,2530,4800,2.0,0.0,0.0,4,7,1390,1140,1901,0,98112,47.6241,-122.305,1540,4800,8,14,2014,UNK,990,0
9407101850,12/9/2014,345000.0,3,2.25,1690,14615,2.0,0.0,0.0,4,7,1690,0,1979,0,98045,47.4492,-121.78,1390,11360,12,9,2014,UNK,300,3255
9542830050,4/22/2015,355000.0,4,2.5,2150,3600,2.0,0.0,0.0,3,7,2150,0,2010,0,98038,47.3658,-122.01899999999999,2220,3915,4,22,2015,N,-70,-315
4038300010,9/22/2014,390000.0,3,1.5,1180,7700,1.0,0.0,0.0,4,7,1180,0,1959,0,98007,47.6133,-122.133,1510,8800,9,22,2014,UNK,-330,-1100
1898700050,4/28/2015,128000.0,3,1.0,1400,9690,1.0,0.0,0.0,3,7,1400,0,1969,0,98023,47.3201,-122.398,1280,9600,4,28,2015,UNK,120,90
826000480,8/26/2014,448500.0,3,1.75,1300,4800,2.0,0.0,1.0,4,7,1300,0,1912,0,98136,47.5457,-122.383,1300,4800,8,26,2014,UNK,0,0
6163901150,11/9/2014,346000.0,3,1.75,1590,9636,1.5,0.0,0.0,4,6,1590,0,1953,0,98155,47.754,-122.321,1800,9975,11,9,2014,UNK,-210,-339
3956900480,9/3/2014,779000.0,3,1.75,1990,5600,1.0,0.0,1.0,3,8,1330,660,1941,0,98199,47.65,-122.415,2630,6780,9,3,2014,UNK,-640,-1180
3824100020,2/3/2015,335000.0,3,1.75,1510,9720,1.0,0.0,0.0,3,7,1510,0,1948,0,98028,47.7728,-122.258,1520,10037,2,3,2015,UNK,-10,-317
5026900235,9/11/2014,1850000.0,4,3.25,2910,1880,2.0,0.0,3.0,5,9,1830,1080,1914,0,98122,47.61600000000001,-122.28200000000001,3100,8200,9,11,2014,UNK,-190,-6320
1330850130,2/18/2015,799990.0,3,2.5,2850,21780,2.0,0.0,0.0,3,10,2850,0,1994,0,98053,47.6455,-122.04,3020,21798,2,18,2015,UNK,-170,-18
1726059134,10/10/2014,1080000.0,3,2.5,2830,56628,2.0,0.0,0.0,3,11,2830,0,2001,0,98011,47.7409,-122.198,2830,16430,10,10,2014,UNK,0,40198
2767604551,8/22/2014,371000.0,2,1.5,1110,1189,3.0,0.0,0.0,3,8,1110,0,2000,0,98107,47.6711,-122.37700000000001,1420,1311,8,22,2014,UNK,-310,-122
7424600020,10/27/2014,620000.0,4,2.5,1900,9775,1.0,0.0,0.0,5,7,1900,0,1967,0,98033,47.6856,-122.16799999999999,1990,10500,10,27,2014,UNK,-90,-725
8731000010,5/15/2014,343000.0,4,1.75,2290,10290,1.0,0.0,0.0,3,7,1340,950,1960,0,98146,47.5045,-122.369,1800,7605,5,15,2014,UNK,490,2685
5104200380,10/14/2014,265000.0,3,1.0,1010,14948,1.0,0.0,0.0,5,6,1010,0,1969,0,98059,47.4772,-122.14399999999999,1510,9600,10,14,2014,UNK,-500,5348
1311030430,8/4/2014,1000000.0,5,2.5,4670,15857,2.0,0.0,0.0,3,11,4670,0,1998,0,98074,47.63,-122.01100000000001,3810,14824,8,4,2014,UNK,860,1033
3585900190,10/6/2014,825000.0,3,2.5,3400,38400,1.0,0.0,4.0,3,8,1870,1530,1955,2015,98177,47.7611,-122.37200000000001,3400,24338,10,6,2014,Y,0,14062
98020630,4/14/2015,889000.0,4,3.5,4070,10976,2.0,0.0,0.0,3,10,4070,0,2004,0,98075,47.5805,-121.97,4080,10106,4,14,2015,N,-10,870
3826500470,4/15/2015,305000.0,3,2.25,1630,10962,1.0,0.0,0.0,4,8,1100,530,1977,0,98030,47.3801,-122.166,1830,8470,4,15,2015,UNK,-200,2492
5422560660,10/30/2014,407000.0,2,2.5,1700,6635,2.0,0.0,0.0,4,8,1700,0,1976,0,98052,47.6655,-122.13,1700,6635,10,30,2014,UNK,0,0
267000130,6/3/2014,613000.0,5,2.5,2070,12000,1.0,0.0,0.0,4,7,1340,730,1967,0,98008,47.62600000000001,-122.104,2090,12000,6,3,2014,UNK,-20,0
6117502230,12/1/2014,1640000.0,3,3.5,4660,21164,2.0,1.0,4.0,3,12,4660,0,1975,1990,98166,47.4418,-122.354,3140,24274,12,1,2014,Y,1520,-3110
2402100675,2/10/2015,645000.0,3,3.75,2050,6000,2.0,0.0,0.0,5,7,1550,500,1910,0,98103,47.6873,-122.33200000000001,1780,4000,2,10,2015,UNK,270,2000
1624059224,6/18/2014,1160000.0,4,3.5,4680,9700,2.0,0.0,0.0,3,10,3360,1320,2005,0,98006,47.5703,-122.165,2800,12343,6,18,2014,N,1880,-2643
3811000250,9/29/2014,610000.0,3,2.25,2320,38186,2.0,0.0,0.0,3,8,2320,0,1980,0,98053,47.6645,-122.068,2875,37523,9,29,2014,UNK,-555,663
8029520250,3/18/2015,450000.0,3,2.5,3800,13071,2.0,0.0,0.0,3,10,2730,1070,1994,0,98023,47.3076,-122.397,2980,11110,3,18,2015,UNK,820,1961
3438501150,7/28/2014,300000.0,3,2.0,720,7598,1.0,0.0,0.0,5,6,720,0,1947,0,98106,47.5483,-122.36,1080,7209,7,28,2014,UNK,-360,389
3582900280,6/6/2014,1120000.0,5,2.75,4400,18500,1.0,0.0,3.0,5,9,2250,2150,1963,0,98028,47.7424,-122.26299999999999,3290,19257,6,6,2014,UNK,1110,-757
3521069142,2/24/2015,418200.0,3,2.5,2260,74297,2.0,0.0,0.0,3,9,2260,0,1992,0,98022,47.2704,-122.01299999999999,3110,98000,2,24,2015,UNK,-850,-23703
646910020,8/28/2014,250000.0,3,2.5,1650,2802,2.0,0.0,0.0,3,7,1650,0,2004,0,98055,47.4328,-122.196,1490,2084,8,28,2014,N,160,718
1026069134,8/25/2014,619000.0,3,2.5,2560,43608,2.0,0.0,0.0,3,9,2560,0,2002,0,98077,47.7614,-122.02600000000001,3000,54088,8,25,2014,UNK,-440,-10480
5230000020,6/30/2014,500000.0,4,3.0,3720,15048,3.0,0.0,0.0,3,7,3720,0,1979,2014,98059,47.5116,-122.14399999999999,2020,15180,6,30,2014,Y,1700,-132
1442740010,11/7/2014,465000.0,4,2.5,2590,16437,2.0,0.0,0.0,3,8,2590,0,1986,0,98038,47.3714,-122.059,2320,15625,11,7,2014,UNK,270,812
7937600010,12/12/2014,322000.0,4,1.0,1750,68841,1.0,0.0,0.0,3,7,1750,0,1942,0,98058,47.4442,-122.081,1550,32799,12,12,2014,UNK,200,36042
1545801410,1/28/2015,276900.0,3,2.5,1620,7320,2.0,0.0,0.0,3,7,1620,0,1989,0,98038,47.3617,-122.054,1550,7686,1,28,2015,UNK,70,-366
1235700073,3/18/2015,660000.0,3,2.25,1700,12615,1.0,0.0,0.0,4,7,1300,400,1990,0,98033,47.6965,-122.197,1950,13163,3,18,2015,UNK,-250,-548
7806450050,10/29/2014,480000.0,3,2.5,2450,28185,2.0,0.0,0.0,3,9,2450,0,1990,0,98058,47.4665,-122.12200000000001,2440,33541,10,29,2014,UNK,10,-5356
3250500103,4/8/2015,925000.0,3,1.75,1610,10796,1.0,0.0,0.0,3,7,1070,540,1951,0,98004,47.6272,-122.208,1940,10796,4,8,2015,UNK,-330,0
2624300080,7/24/2014,825000.0,3,3.0,3730,35900,1.0,0.0,0.0,3,9,2960,770,1979,0,98008,47.5814,-122.12200000000001,2280,16026,7,24,2014,UNK,1450,19874
7568700525,3/18/2015,326000.0,2,1.0,1210,7440,1.0,0.0,0.0,3,6,780,430,1940,0,98155,47.7376,-122.322,1070,7440,3,18,2015,UNK,140,0
7683800010,4/21/2015,205000.0,3,1.0,1300,9880,1.0,0.0,0.0,4,7,1300,0,1959,0,98003,47.3352,-122.29700000000001,2140,9600,4,21,2015,UNK,-840,280
3089000005,7/24/2014,150000.0,2,1.0,850,54000,1.5,0.0,0.0,1,4,850,0,1950,0,98023,47.2959,-122.37700000000001,1550,14440,7,24,2014,UNK,-700,39560
9510970010,4/29/2015,593567.0,3,2.5,1770,3205,2.0,0.0,0.0,3,9,1770,0,2005,0,98052,47.6658,-122.084,2120,4134,4,29,2015,N,-350,-929
9560800290,8/14/2014,440000.0,3,2.5,2060,11231,2.0,0.0,0.0,3,8,2060,0,1987,0,98072,47.7571,-122.141,2140,10224,8,14,2014,UNK,-80,1007
1385100050,7/16/2014,751000.0,3,2.5,3090,13316,2.0,0.0,0.0,3,10,3090,0,1992,0,98075,47.588,-122.079,2980,14437,7,16,2014,UNK,110,-1121
3294700101,9/9/2014,295000.0,2,1.75,1050,6500,1.5,0.0,2.0,4,6,1050,0,1925,0,98055,47.4727,-122.2,1320,10075,9,9,2014,UNK,-270,-3575
8021700725,9/4/2014,422500.0,3,2.0,1300,2250,2.0,0.0,0.0,3,7,1300,0,1988,0,98103,47.6923,-122.33200000000001,1300,4500,9,4,2014,UNK,0,-2250
4038200480,12/1/2014,480000.0,3,1.0,1160,8800,1.0,0.0,0.0,4,7,1160,0,1959,0,98008,47.6112,-122.12799999999999,1750,8400,12,1,2014,UNK,-590,400
3630180380,7/25/2014,890900.0,4,2.5,3420,6233,2.0,0.0,0.0,3,9,3420,0,2006,0,98027,47.5416,-121.99799999999999,3350,5000,7,25,2014,N,70,1233
2782100280,5/29/2014,672500.0,4,2.75,2620,6707,2.0,0.0,0.0,3,9,2620,0,2000,0,98075,47.5965,-122.038,2590,6530,5,29,2014,UNK,30,177
3797002575,10/10/2014,605000.0,4,1.5,1880,3500,1.0,0.0,0.0,4,7,1080,800,1926,0,98103,47.6835,-122.34700000000001,1690,3500,10,10,2014,UNK,190,0
9315600050,3/17/2015,1680000.0,5,3.25,4560,19080,1.0,0.0,0.0,5,9,2490,2070,1963,0,98004,47.6291,-122.226,3390,20140,3,17,2015,UNK,1170,-1060
1939110080,9/26/2014,565000.0,4,2.5,2330,7936,2.0,0.0,0.0,3,9,2330,0,1987,0,98074,47.6269,-122.03,2460,8137,9,26,2014,UNK,-130,-201
5423030380,5/6/2015,725000.0,4,1.75,2350,7574,1.0,0.0,0.0,3,8,1720,630,1979,0,98027,47.5634,-122.087,2220,8496,5,6,2015,UNK,130,-922
5693501100,7/31/2014,640000.0,3,3.0,1560,1466,3.0,0.0,0.0,3,8,1560,0,2006,0,98103,47.6604,-122.352,1530,2975,7,31,2014,N,30,-1509
1612500170,2/26/2015,253750.0,4,1.0,1380,7110,1.5,0.0,0.0,3,6,1380,0,1939,0,98030,47.3846,-122.226,1430,7110,2,26,2015,UNK,-50,0
6116500290,7/14/2014,799950.0,6,2.75,3040,36721,1.0,0.0,3.0,4,9,1760,1280,1958,0,98166,47.4488,-122.35600000000001,2420,21075,7,14,2014,UNK,620,15646
2450000275,7/16/2014,595000.0,4,1.5,1350,8113,1.0,0.0,0.0,4,7,1350,0,1959,0,98004,47.5807,-122.196,1930,8113,7,16,2014,UNK,-580,0
2194100050,9/29/2014,850000.0,4,2.5,3180,11652,2.0,0.0,1.0,3,9,3180,0,1977,0,98040,47.567,-122.212,3110,15183,9,29,2014,UNK,70,-3531
3782760280,10/2/2014,366000.0,3,2.5,1790,4065,2.0,0.0,0.0,3,8,1790,0,2009,0,98019,47.7344,-121.965,2480,4252,10,2,2014,N,-690,-187
4320200020,9/22/2014,715000.0,4,3.0,1986,6000,2.0,0.0,2.0,4,8,1746,240,1922,0,98136,47.5374,-122.39,1930,6200,9,22,2014,UNK,56,-200
2944500420,12/11/2014,300000.0,4,2.5,2400,7215,2.0,0.0,0.0,3,8,2400,0,1992,0,98023,47.2944,-122.37100000000001,2220,7760,12,11,2014,UNK,180,-545
3616600231,6/3/2014,960000.0,4,3.0,4590,9150,2.0,0.0,0.0,3,10,3490,1100,1981,0,98177,47.7234,-122.37200000000001,2910,12348,6,3,2014,UNK,1680,-3198
6758700050,4/1/2015,812000.0,3,2.0,1970,3420,2.0,0.0,3.0,5,8,1970,0,1913,0,98103,47.6762,-122.354,1770,3420,4,1,2015,UNK,200,0
2545900050,5/9/2014,234950.0,3,1.0,1360,9948,1.0,0.0,0.0,3,6,1360,0,1977,0,98010,47.3422,-122.053,1670,8475,5,9,2014,UNK,-310,1473
8824900050,6/12/2014,656500.0,4,2.0,2710,4750,1.0,0.0,0.0,4,7,1460,1250,1919,0,98115,47.6756,-122.305,1700,3800,6,12,2014,UNK,1010,950
6300000213,7/3/2014,255000.0,2,1.5,920,1598,2.0,0.0,0.0,3,7,920,0,1995,0,98133,47.7081,-122.34200000000001,1110,1598,7,3,2014,UNK,-190,0
2211700290,12/4/2014,538000.0,3,2.75,2000,7204,1.0,0.0,0.0,5,7,1250,750,1960,0,98006,47.565,-122.116,2480,17633,12,4,2014,UNK,-480,-10429
739500050,7/1/2014,260000.0,3,2.25,1920,9680,1.0,0.0,0.0,4,7,1300,620,1961,0,98031,47.412,-122.195,1500,9516,7,1,2014,UNK,420,164
6190500380,10/27/2014,546200.0,3,2.5,2678,6607,2.0,0.0,0.0,3,9,2678,0,1998,0,98028,47.738,-122.235,2780,6607,10,27,2014,UNK,-102,0
5129000006,4/19/2015,280500.0,3,1.0,1220,4541,1.0,0.0,0.0,3,7,890,330,1952,0,98108,47.5387,-122.294,1670,3429,4,19,2015,UNK,-450,1112
2112700280,8/11/2014,295000.0,3,1.75,1440,4000,1.0,0.0,0.0,4,7,1050,390,1979,0,98106,47.5329,-122.354,1560,4000,8,11,2014,UNK,-120,0
9828702895,10/22/2014,700000.0,4,1.75,2420,520,1.5,0.0,0.0,3,7,2420,0,1900,0,98112,47.6209,-122.302,1200,1170,10,22,2014,UNK,1220,-650
2026059181,11/20/2014,560000.0,3,2.0,2090,15790,1.0,0.0,0.0,3,9,2090,0,1992,0,98034,47.7296,-122.199,1820,8770,11,20,2014,UNK,270,7020
3295610080,4/1/2015,912000.0,4,2.75,4030,10888,2.0,0.0,0.0,3,10,4030,0,1997,0,98075,47.5651,-122.03399999999999,3720,10756,4,1,2015,UNK,310,132
1474000050,5/8/2014,437000.0,3,1.75,1310,9282,1.0,0.0,0.0,4,7,1310,0,1976,0,98052,47.6844,-122.111,1310,8748,5,8,2014,UNK,0,534
2896400170,3/16/2015,447000.0,3,2.5,1800,3074,2.0,0.0,0.0,3,7,1800,0,2003,0,98072,47.7631,-122.149,1610,2929,3,16,2015,UNK,190,145
3342103281,10/20/2014,500000.0,4,1.0,1160,20100,1.0,0.0,0.0,4,6,820,340,1913,0,98056,47.5175,-122.20100000000001,1670,10200,10,20,2014,UNK,-510,9900
7172200080,3/19/2015,508300.0,3,1.0,1160,5969,1.0,0.0,0.0,3,7,880,280,1930,0,98115,47.6844,-122.306,1550,5120,3,19,2015,UNK,-390,849
5209200010,7/31/2014,485000.0,3,1.5,1870,7853,1.0,0.0,0.0,3,7,1300,570,1962,0,98125,47.7045,-122.281,1870,8300,7,31,2014,UNK,0,-447
6744700427,5/7/2014,540000.0,7,5.75,3700,7647,2.0,0.0,1.0,3,8,3700,0,1948,1984,98155,47.7393,-122.289,2510,7479,5,7,2014,Y,1190,168
1328310440,9/16/2014,356000.0,3,2.25,2280,8765,2.0,0.0,0.0,3,8,2280,0,1977,0,98058,47.4419,-122.133,1920,8265,9,16,2014,UNK,360,500
2710600080,8/25/2014,525000.0,4,2.0,1720,6099,1.0,0.0,0.0,4,7,860,860,1949,0,98115,47.6765,-122.287,1100,5671,8,25,2014,UNK,620,428
8651611980,3/24/2015,962800.0,4,2.75,3630,11775,2.0,0.0,0.0,3,10,3630,0,1999,0,98074,47.6378,-122.066,3800,12451,3,24,2015,UNK,-170,-676
1541700010,10/1/2014,315000.0,4,2.5,2040,6300,2.0,0.0,0.0,3,8,2040,0,2003,0,98031,47.3918,-122.185,2260,5877,10,1,2014,UNK,-220,423
477000019,6/20/2014,525000.0,3,2.25,1750,1879,3.0,0.0,0.0,3,8,1750,0,2001,0,98107,47.6722,-122.391,1750,3155,6,20,2014,UNK,0,-1276
8165501700,4/30/2015,325000.0,2,2.25,1550,2285,2.0,0.0,0.0,3,8,1550,0,2007,0,98106,47.5398,-122.369,1550,2135,4,30,2015,N,0,150
9534400010,4/23/2015,965800.0,4,1.75,2500,8725,1.0,0.0,0.0,4,8,1500,1000,1966,0,98004,47.6304,-122.205,1900,8998,4,23,2015,UNK,600,-273
7577700185,7/9/2014,550000.0,4,1.0,1440,3600,1.5,0.0,0.0,4,7,1440,0,1924,0,98116,47.5694,-122.385,1010,5175,7,9,2014,UNK,430,-1575
257000263,10/21/2014,182200.0,4,1.0,1130,13927,1.5,0.0,0.0,3,6,1130,0,1929,0,98168,47.4939,-122.3,1800,8274,10,21,2014,UNK,-670,5653
8638500020,9/11/2014,315000.0,3,1.0,1210,8505,1.5,0.0,0.0,3,7,1210,0,1958,0,98106,47.5389,-122.353,1430,8505,9,11,2014,UNK,-220,0
452001310,8/25/2014,500000.0,2,1.0,960,5000,1.0,0.0,0.0,4,7,960,0,1900,0,98107,47.6755,-122.367,1330,5000,8,25,2014,UNK,-370,0
7852000500,7/2/2014,480000.0,5,2.5,2160,7737,2.0,0.0,0.0,3,7,2160,0,1998,0,98065,47.5381,-121.87200000000001,2460,7737,7,2,2014,UNK,-300,0
4219401236,5/20/2014,1690000.0,3,1.75,3400,8965,1.0,0.0,2.0,5,9,1820,1580,1957,0,98105,47.6569,-122.273,3200,8500,5,20,2014,UNK,200,465
1622069127,11/18/2014,525000.0,5,3.25,3960,321908,2.0,0.0,0.0,4,9,2690,1270,1989,0,98038,47.3984,-122.055,2360,96703,11,18,2014,UNK,1600,225205
2644300005,4/12/2015,407500.0,4,2.5,1900,9075,2.0,0.0,0.0,3,7,1900,0,1988,0,98133,47.7776,-122.352,1800,8460,4,12,2015,UNK,100,615
3211260290,3/9/2015,443000.0,4,3.0,2620,35124,2.0,0.0,0.0,3,9,2620,0,1987,0,98092,47.3067,-122.116,2920,35807,3,9,2015,UNK,-300,-683
3625500130,5/30/2014,1260000.0,4,2.5,3150,13700,2.0,0.0,0.0,4,9,3150,0,1966,0,98040,47.5309,-122.22399999999999,3200,11900,5,30,2014,UNK,-50,1800
6819100380,8/30/2014,642000.0,3,1.0,1040,4480,1.0,0.0,0.0,3,7,870,170,1924,0,98109,47.6461,-122.35600000000001,1730,4200,8,30,2014,UNK,-690,280
8562600500,1/9/2015,520000.0,3,1.75,1540,7558,1.0,0.0,0.0,3,8,1540,0,1964,0,98052,47.6707,-122.156,1540,7863,1,9,2015,UNK,0,-305
9279200280,6/23/2014,750000.0,3,2.0,1820,5000,1.5,0.0,0.0,4,8,1720,100,1941,0,98116,47.5845,-122.395,2220,7200,6,23,2014,UNK,-400,-2200
6788201440,4/7/2015,855000.0,5,1.5,1930,4500,1.5,0.0,0.0,3,8,1930,0,1929,0,98112,47.6401,-122.303,2083,4500,4,7,2015,UNK,-153,0
2624089026,10/2/2014,275000.0,4,1.0,1430,27153,1.5,0.0,0.0,4,5,1430,0,1934,0,98065,47.5372,-121.744,1880,27153,10,2,2014,UNK,-450,0
8698600080,9/10/2014,265000.0,5,2.75,2920,5250,1.5,0.0,0.0,5,7,1800,1120,1911,0,98002,47.3072,-122.221,1220,5250,9,10,2014,UNK,1700,0
425069136,4/10/2015,894400.0,3,2.5,3100,45738,2.0,0.0,0.0,3,10,3100,0,1991,0,98053,47.6854,-122.04799999999999,3340,45738,4,10,2015,UNK,-240,0
5528600050,2/11/2015,546000.0,2,1.0,1200,12856,1.0,0.0,0.0,4,6,1200,0,1948,0,98027,47.5321,-122.03399999999999,1740,6098,2,11,2015,UNK,-540,6758
8682290660,11/26/2014,699950.0,2,2.5,2390,7489,1.0,0.0,0.0,3,8,2390,0,2007,0,98053,47.7243,-122.03200000000001,2170,7489,11,26,2014,N,220,0
1839920050,4/14/2015,435000.0,3,2.0,1270,10713,1.0,0.0,0.0,4,7,1270,0,1969,0,98034,47.7247,-122.181,1620,8250,4,14,2015,UNK,-350,2463
6624010010,5/6/2015,259500.0,4,1.5,1300,7200,1.0,0.0,0.0,4,7,1300,0,1970,0,98031,47.4179,-122.181,1420,7200,5,6,2015,UNK,-120,0
9406590010,10/29/2014,359950.0,4,3.25,2290,4785,2.0,0.0,0.0,3,9,2290,0,2007,0,98038,47.3833,-122.037,2290,4785,10,29,2014,N,0,0
3575305362,12/15/2014,517000.0,3,1.75,1740,10000,1.0,0.0,0.0,3,7,1740,0,1976,2009,98074,47.617,-122.05799999999999,1350,7500,12,15,2014,Y,390,2500
8835900010,8/4/2014,579000.0,3,1.0,1590,5400,1.0,0.0,1.0,3,8,1280,310,1948,0,98118,47.5509,-122.26100000000001,2140,7161,8,4,2014,UNK,-550,-1761
7199000290,9/5/2014,525000.0,4,2.0,2420,10735,1.5,0.0,0.0,3,7,2420,0,1967,0,98052,47.6899,-122.12200000000001,1570,9540,9,5,2014,UNK,850,1195
6669150280,4/14/2015,320000.0,4,2.5,2130,9653,1.0,0.0,0.0,3,7,1500,630,1978,0,98031,47.4068,-122.175,2000,7988,4,14,2015,UNK,130,1665
2619600010,5/13/2014,635000.0,4,1.75,1950,13320,1.0,0.0,0.0,4,8,1370,580,1969,0,98007,47.6196,-122.139,2120,12051,5,13,2014,UNK,-170,1269
2314300420,9/16/2014,400000.0,4,2.5,2150,5397,2.0,0.0,0.0,3,8,2150,0,1998,0,98058,47.4644,-122.15100000000001,2260,5080,9,16,2014,UNK,-110,317
9512500380,10/10/2014,455000.0,3,1.75,1270,7700,1.0,0.0,0.0,4,7,1270,0,1968,0,98052,47.6711,-122.148,1510,7700,10,10,2014,UNK,-240,0
8653600050,2/25/2015,572000.0,3,1.75,1850,22767,1.5,0.0,4.0,5,6,1850,0,1908,0,98074,47.6144,-122.06700000000001,2700,17906,2,25,2015,UNK,-850,4861
4045900020,4/13/2015,650000.0,2,1.5,1440,136778,1.0,0.0,0.0,4,8,1140,300,1956,0,98072,47.7608,-122.118,1740,21600,4,13,2015,UNK,-300,115178
1311800130,1/23/2015,162500.0,3,1.5,1390,7417,1.0,0.0,0.0,3,7,1390,0,1967,0,98001,47.3369,-122.275,1390,7665,1,23,2015,UNK,0,-248
9542890010,11/13/2014,400000.0,2,2.5,1340,1240,2.0,0.0,0.0,3,8,1150,190,2008,0,98052,47.6858,-122.102,1280,1312,11,13,2014,N,60,-72
4027700795,3/18/2015,268300.0,3,1.0,1190,9000,1.0,0.0,0.0,3,7,1190,0,1968,0,98028,47.77,-122.264,1960,7200,3,18,2015,UNK,-770,1800
7013200280,7/2/2014,989000.0,6,4.5,3830,4800,3.0,0.0,0.0,3,9,3050,780,1919,2004,98119,47.6404,-122.361,1990,4800,7,2,2014,Y,1840,0
2460700430,6/27/2014,342000.0,3,1.75,1780,10409,1.0,0.0,0.0,3,7,1280,500,1981,0,98058,47.4627,-122.16799999999999,1780,7415,6,27,2014,UNK,0,2994
6147650280,3/25/2015,315000.0,4,2.5,3130,5999,2.0,0.0,0.0,3,7,3130,0,2006,0,98042,47.3837,-122.09899999999999,3020,5997,3,25,2015,N,110,2
3574800010,4/28/2015,485000.0,4,2.75,1830,8384,1.0,0.0,0.0,3,7,1320,510,1979,0,98034,47.733000000000004,-122.22,2190,7695,4,28,2015,UNK,-360,689
8731981640,12/4/2014,277500.0,4,2.5,2550,7500,1.0,0.0,0.0,3,8,1750,800,1976,0,98023,47.3165,-122.38600000000001,2260,8800,12,4,2014,UNK,290,-1300
1525069134,3/12/2015,1300000.0,4,3.5,3790,90169,2.0,0.0,0.0,3,11,3790,0,1998,0,98053,47.6587,-122.022,3410,46951,3,12,2015,UNK,380,43218
2824069180,8/6/2014,385000.0,4,1.75,1800,10890,1.5,0.0,0.0,4,6,1800,0,1912,0,98027,47.5312,-122.04,1530,9818,8,6,2014,UNK,270,1072
751000080,11/17/2014,426000.0,2,1.0,1630,7680,1.0,0.0,0.0,3,7,830,800,1947,0,98125,47.7092,-122.291,1250,7740,11,17,2014,UNK,380,-60
2044500213,6/17/2014,310000.0,4,2.0,1870,6000,1.5,0.0,0.0,3,7,1870,0,1956,0,98125,47.7155,-122.315,1520,7169,6,17,2014,UNK,350,-1169
2044500213,1/26/2015,449000.0,4,2.0,1870,6000,1.5,0.0,0.0,3,7,1870,0,1956,0,98125,47.7155,-122.315,1520,7169,1,26,2015,UNK,350,-1169
1703400470,12/19/2014,375000.0,2,1.0,980,3915,1.0,0.0,0.0,4,7,980,0,1919,0,98118,47.5589,-122.29,1425,1576,12,19,2014,UNK,-445,2339
7363600185,3/30/2015,1190000.0,3,2.25,2860,10625,1.0,0.0,4.0,3,10,1920,940,1976,0,98115,47.6915,-122.273,2860,8075,3,30,2015,UNK,0,2550
3904901300,4/14/2015,468000.0,3,2.25,1470,5597,2.0,0.0,0.0,3,7,1470,0,1985,0,98029,47.5674,-122.01899999999999,1610,5217,4,14,2015,UNK,-140,380
7548300425,4/3/2015,336000.0,1,1.0,1160,5000,2.0,0.0,0.0,3,7,1160,0,2000,0,98144,47.5883,-122.311,2060,5000,4,3,2015,UNK,-900,0
4123830480,6/10/2014,392000.0,4,2.75,1940,6555,2.0,0.0,0.0,3,8,1940,0,1990,0,98038,47.3701,-122.041,1840,6912,6,10,2014,UNK,100,-357
9477000280,8/7/2014,412500.0,4,2.25,1630,7969,1.0,0.0,0.0,3,7,1100,530,1977,0,98034,47.7336,-122.19,1580,7440,8,7,2014,UNK,50,529
8567450080,3/25/2015,545000.0,4,2.5,2755,11612,2.0,0.0,0.0,3,8,2755,0,2001,0,98019,47.7394,-121.965,2820,12831,3,25,2015,UNK,-65,-1219
7129304540,12/20/2014,133000.0,5,2.0,1430,5600,1.5,0.0,0.0,3,6,1430,0,1947,0,98118,47.5192,-122.266,1860,5980,12,20,2014,UNK,-430,-380
7129304540,5/14/2015,440000.0,5,2.0,1430,5600,1.5,0.0,0.0,3,6,1430,0,1947,0,98118,47.5192,-122.266,1860,5980,5,14,2015,UNK,-430,-380
2250000010,12/5/2014,294450.0,4,2.25,1400,7341,1.0,0.0,0.0,3,7,1300,100,1961,0,98155,47.7565,-122.305,2090,7410,12,5,2014,UNK,-690,-69
5162100660,8/26/2014,335000.0,4,2.5,2520,7205,2.0,0.0,0.0,3,8,2520,0,1987,0,98003,47.343,-122.316,2350,7632,8,26,2014,UNK,170,-427
4140500050,9/8/2014,362000.0,3,1.0,1290,10125,1.0,0.0,0.0,4,7,1290,0,1956,0,98028,47.7641,-122.265,1760,14460,9,8,2014,UNK,-470,-4335
2129700525,10/28/2014,322000.0,3,1.75,1400,18002,1.0,0.0,0.0,3,6,1400,0,1977,0,98019,47.725,-121.96700000000001,2240,14068,10,28,2014,UNK,-840,3934
4337000275,3/17/2015,230500.0,2,1.0,740,8853,1.0,0.0,0.0,3,6,740,0,1943,0,98166,47.4793,-122.336,850,8775,3,17,2015,UNK,-110,78
3942900010,3/5/2015,380000.0,4,2.0,1710,9996,1.0,0.0,0.0,3,7,1710,0,1950,0,98108,47.5472,-122.3,1550,6768,3,5,2015,UNK,160,3228
8699100321,6/11/2014,292000.0,4,2.75,2414,7693,2.0,0.0,0.0,3,8,2414,0,2006,0,98002,47.3046,-122.22200000000001,1500,7177,6,11,2014,N,914,516
7686203180,8/12/2014,172500.0,3,1.0,1040,7500,1.0,0.0,0.0,4,6,1040,0,1954,0,98198,47.4206,-122.316,1270,8000,8,12,2014,UNK,-230,-500
1193000480,7/24/2014,784000.0,4,2.75,3540,7091,1.5,0.0,1.0,4,8,1970,1570,1947,0,98199,47.6467,-122.39399999999999,2200,6000,7,24,2014,UNK,1340,1091
1234000630,10/2/2014,525000.0,4,2.75,2530,11549,1.0,0.0,0.0,3,7,1700,830,1942,0,98033,47.6557,-122.197,2530,10000,10,2,2014,UNK,0,1549
8562750250,7/4/2014,600000.0,3,2.5,2320,7609,2.0,0.0,0.0,3,8,2320,0,2003,0,98027,47.5391,-122.069,2590,4000,7,4,2014,UNK,-270,3609
5088500170,10/27/2014,435000.0,3,2.5,2530,16102,2.0,0.0,0.0,3,9,2530,0,1989,0,98038,47.371,-122.055,2370,14957,10,27,2014,UNK,160,1145
1061500630,2/5/2015,359900.0,5,2.75,2790,7600,1.5,0.0,0.0,4,7,2790,0,1965,0,98056,47.4999,-122.165,1480,7600,2,5,2015,UNK,1310,0
8073000491,12/11/2014,700000.0,4,1.75,1950,7139,1.0,1.0,4.0,3,7,1150,800,1957,0,98178,47.5121,-122.24799999999999,1600,13122,12,11,2014,UNK,350,-5983
3277801448,3/12/2015,280000.0,3,2.0,1020,889,2.0,0.0,0.0,3,7,720,300,2009,0,98126,47.5434,-122.375,1130,972,3,12,2015,N,-110,-83
1656600280,10/2/2014,655000.0,4,2.5,3110,24466,2.0,0.0,0.0,3,9,3110,0,1997,0,98059,47.4898,-122.12700000000001,3080,22185,10,2,2014,UNK,30,2281
4139420190,5/12/2015,2480000.0,4,5.0,5310,16909,1.0,0.0,4.0,3,12,3090,2220,1992,0,98006,47.5515,-122.113,5220,15701,5,12,2015,UNK,90,1208
5360200052,2/24/2015,499950.0,3,2.5,2580,23925,2.0,0.0,0.0,3,9,2580,0,2001,0,98023,47.2978,-122.376,1660,8460,2,24,2015,UNK,920,15465
7234601025,8/5/2014,540000.0,3,2.5,1380,1021,2.0,0.0,0.0,3,8,1160,220,2008,0,98122,47.6148,-122.309,1440,1021,8,5,2014,N,-60,0
8001470480,3/6/2015,970000.0,4,2.75,3980,9209,2.0,0.0,0.0,3,11,3980,0,2002,0,98074,47.6286,-122.064,3800,9333,3,6,2015,UNK,180,-124
2597670470,8/13/2014,330000.0,4,2.5,2080,7000,1.0,0.0,0.0,4,8,1400,680,1989,0,98058,47.4252,-122.163,2090,7082,8,13,2014,UNK,-10,-82
7199330130,7/3/2014,474000.0,3,1.75,1530,8000,2.0,0.0,0.0,3,7,1530,0,1978,0,98052,47.6971,-122.13,1530,7500,7,3,2014,UNK,0,500
4039700080,3/17/2015,670000.0,4,1.75,1930,9310,1.0,0.0,0.0,4,9,1930,0,1968,0,98008,47.6158,-122.10799999999999,2110,10290,3,17,2015,UNK,-180,-980
5317100780,5/12/2014,1300000.0,4,3.25,2330,9687,2.0,0.0,3.0,3,9,2330,0,1918,0,98112,47.6264,-122.28299999999999,3880,9017,5,12,2014,UNK,-1550,670
2597450250,7/30/2014,1160000.0,4,2.5,3860,10361,2.0,0.0,2.0,4,10,2940,920,1985,0,98006,47.5517,-122.147,3720,13155,7,30,2014,UNK,140,-2794
2472920680,1/12/2015,440000.0,4,2.5,2880,8061,2.0,0.0,0.0,3,9,2880,0,1988,0,98058,47.43899999999999,-122.152,2650,7660,1,12,2015,UNK,230,401
7436300170,7/28/2014,411000.0,2,2.5,1590,2088,2.0,0.0,0.0,3,9,1590,0,1997,0,98033,47.6897,-122.175,2320,3174,7,28,2014,UNK,-730,-1086
3964400470,7/25/2014,500000.0,3,1.5,2150,4000,1.5,0.0,0.0,3,7,1470,680,1928,0,98144,47.5733,-122.31200000000001,1750,4000,7,25,2014,UNK,400,0
7351200050,12/18/2014,1340000.0,4,1.75,2300,13342,1.5,1.0,4.0,3,7,2300,0,1934,1958,98125,47.7308,-122.28200000000001,2500,13342,12,18,2014,Y,-200,0
1377800277,12/15/2014,696000.0,6,3.25,2900,6400,2.0,0.0,0.0,4,8,2300,600,1977,0,98199,47.6464,-122.40100000000001,2480,6400,12,15,2014,UNK,420,0
3862400050,5/6/2014,465000.0,3,2.25,1970,11088,1.0,0.0,0.0,4,8,1180,790,1967,0,98155,47.7651,-122.277,1970,10470,5,6,2014,UNK,0,618
7199310170,6/16/2014,518000.0,4,2.5,1740,7500,1.0,0.0,0.0,4,7,1220,520,1976,0,98052,47.6927,-122.124,1790,7350,6,16,2014,UNK,-50,150
8039900086,5/9/2014,251000.0,3,1.75,1220,7250,1.0,0.0,0.0,3,7,1220,0,1962,0,98045,47.4887,-121.78399999999999,1700,15251,5,9,2014,UNK,-480,-8001
1137600190,4/30/2015,255000.0,3,2.0,1290,13282,1.0,0.0,0.0,3,7,1290,0,1978,0,98030,47.3787,-122.169,1290,12357,4,30,2015,UNK,0,925
1566100130,8/20/2014,319000.0,2,1.0,780,8271,1.0,0.0,0.0,4,6,780,0,1924,0,98115,47.7,-122.3,2220,8271,8,20,2014,UNK,-1440,0
9547205610,9/29/2014,719000.0,4,2.75,2210,3400,1.5,0.0,0.0,5,7,1470,0,1926,0,98115,47.6826,-122.311,1500,3400,9,29,2014,UNK,710,0
5608000190,7/14/2014,1520000.0,5,3.5,5930,13288,2.0,0.0,2.0,3,11,3920,2010,1996,0,98027,47.5542,-122.09700000000001,3860,12062,7,14,2014,UNK,2070,1226
3295450050,1/9/2015,322000.0,4,2.5,1950,4553,2.0,0.0,0.0,3,7,1950,0,2000,0,98056,47.5066,-122.175,1780,4598,1,9,2015,UNK,170,-45
3751602249,3/5/2015,205000.0,4,1.0,1340,7920,1.0,0.0,0.0,4,7,1340,0,1970,0,98001,47.2845,-122.26700000000001,1090,9600,3,5,2015,UNK,250,-1680
7889600190,1/13/2015,229000.0,3,1.0,1590,6240,1.0,0.0,0.0,3,7,1060,530,1956,0,98146,47.4936,-122.337,1410,6240,1,13,2015,UNK,180,0
217700050,10/30/2014,395000.0,3,2.25,1780,9672,1.0,0.0,0.0,3,8,1350,430,1960,0,98133,47.7774,-122.35,1860,10080,10,30,2014,UNK,-80,-408
7943000020,3/26/2015,183000.0,2,1.0,760,7272,1.0,0.0,0.0,4,7,760,0,1980,0,98003,47.3205,-122.33,1370,7866,3,26,2015,UNK,-610,-594
7199310290,9/5/2014,583500.0,3,1.75,1720,7800,1.0,0.0,0.0,4,7,1170,550,1978,0,98052,47.6928,-122.125,1760,7276,9,5,2014,UNK,-40,524
192700080,2/13/2015,312000.0,3,2.5,2070,25710,1.0,0.0,0.0,5,6,2070,0,1917,0,98022,47.2032,-121.964,1350,17998,2,13,2015,UNK,720,7712
23520380,9/9/2014,539000.0,3,1.75,1790,9860,1.0,0.0,0.0,4,7,1410,380,1978,0,98052,47.6989,-122.12,1820,9555,9,9,2014,UNK,-30,305
8961950050,3/20/2015,409000.0,4,2.75,3230,12651,2.0,0.0,0.0,4,8,3230,0,2002,0,98001,47.3157,-122.251,2550,12081,3,20,2015,UNK,680,570
3300701365,5/28/2014,510250.0,3,1.75,1400,4000,1.0,0.0,0.0,3,7,870,530,1951,0,98117,47.6913,-122.381,1400,4000,5,28,2014,UNK,0,0
871000170,12/2/2014,535000.0,2,2.0,1370,3827,1.0,0.0,0.0,3,7,1020,350,1952,0,98199,47.652,-122.404,1550,5102,12,2,2014,UNK,-180,-1275
9407150250,9/24/2014,280000.0,3,2.5,1600,7936,2.0,0.0,0.0,3,7,1600,0,1996,0,98038,47.3673,-122.01700000000001,1830,7936,9,24,2014,UNK,-230,0
7789000235,4/9/2015,286000.0,3,1.0,950,8400,1.0,0.0,0.0,3,7,950,0,1958,0,98056,47.5104,-122.166,1250,8400,4,9,2015,UNK,-300,0
8587400050,3/25/2015,710000.0,3,2.75,2210,7660,1.0,0.0,1.0,4,7,1460,750,1968,0,98116,47.5619,-122.4,2110,8750,3,25,2015,UNK,100,-1090
5100401315,7/9/2014,395000.0,2,1.0,930,6380,1.0,0.0,0.0,4,7,930,0,1940,0,98115,47.6915,-122.321,1180,6380,7,9,2014,UNK,-250,0
2634500005,9/8/2014,237500.0,2,1.0,810,8494,1.0,0.0,0.0,3,6,810,0,1949,0,98155,47.7389,-122.324,1050,7975,9,8,2014,UNK,-240,519
6332000050,1/21/2015,464000.0,3,2.0,1630,6550,1.0,0.0,0.0,5,7,850,780,1912,0,98126,47.5452,-122.37899999999999,1440,6550,1,21,2015,UNK,190,0
2126049265,10/21/2014,495000.0,3,1.75,1770,10080,1.0,0.0,0.0,3,8,1770,0,1968,0,98125,47.7218,-122.306,1860,10456,10,21,2014,UNK,-90,-376
7950304095,2/17/2015,257500.0,1,1.0,710,6060,1.0,0.0,0.0,4,6,710,0,1916,0,98118,47.5621,-122.28299999999999,1440,4545,2,17,2015,UNK,-730,1515
587550010,1/16/2015,570000.0,4,3.5,3990,23544,1.0,0.0,2.0,3,10,2300,1690,1999,0,98023,47.3245,-122.38,3410,15932,1,16,2015,UNK,580,7612
1402630190,11/11/2014,362000.0,3,2.5,2310,7485,2.0,0.0,0.0,3,8,2310,0,1986,0,98058,47.43899999999999,-122.135,2310,8142,11,11,2014,UNK,0,-657
2402100895,6/25/2014,640000.0,33,1.75,1620,6000,1.0,0.0,0.0,5,7,1040,580,1947,0,98103,47.6878,-122.331,1330,4700,6,25,2014,UNK,290,1300
3750604417,5/26/2014,172500.0,3,1.0,1140,8800,1.0,0.0,0.0,3,7,1140,0,1972,0,98001,47.2629,-122.275,1270,13560,5,26,2014,UNK,-130,-4760
9547202890,1/20/2015,596000.0,2,1.0,1040,4880,1.0,0.0,0.0,3,7,1040,0,1910,1975,98115,47.6809,-122.311,1500,4590,1,20,2015,Y,-460,290
2600110250,4/30/2015,840000.0,4,2.5,2170,9796,1.0,0.0,0.0,4,8,1650,520,1980,0,98006,47.5505,-122.152,2350,9796,4,30,2015,UNK,-180,0
7403200050,11/13/2014,1600000.0,3,2.25,3370,23065,1.0,1.0,4.0,3,10,1920,1450,1980,0,98028,47.7434,-122.26299999999999,3410,19688,11,13,2014,UNK,-40,3377
9528104360,9/12/2014,435000.0,2,1.5,901,1245,3.0,0.0,0.0,3,7,901,0,2001,0,98115,47.6774,-122.325,1138,1137,9,12,2014,UNK,-237,108
2634500050,9/10/2014,251000.0,2,1.0,840,7870,1.0,0.0,0.0,3,6,840,0,1949,0,98155,47.7389,-122.32600000000001,1442,8131,9,10,2014,UNK,-602,-261
268500020,11/6/2014,282500.0,4,1.0,1650,9750,1.0,0.0,0.0,4,7,1650,0,1964,0,98059,47.4991,-122.164,1650,10112,11,6,2014,UNK,0,-362
1796361100,10/17/2014,265000.0,3,2.25,1380,7226,1.0,0.0,0.0,4,7,1140,240,1987,0,98042,47.3677,-122.09100000000001,1640,7823,10,17,2014,UNK,-260,-597
8807300130,12/17/2014,330000.0,3,1.0,910,10240,1.0,0.0,0.0,4,6,910,0,1969,0,98053,47.6729,-122.064,1140,10720,12,17,2014,UNK,-230,-480
7170200080,6/17/2014,435000.0,2,1.0,1230,3800,1.0,0.0,0.0,3,7,1230,0,1928,0,98115,47.6797,-122.292,1610,3800,6,17,2014,UNK,-380,0
1877500005,12/1/2014,827235.0,3,1.75,1740,8560,1.0,0.0,0.0,3,8,1500,240,1948,0,98199,47.6475,-122.40899999999999,2240,5800,12,1,2014,UNK,-500,2760
7211400525,5/30/2014,249950.0,4,1.0,1290,5000,1.5,0.0,0.0,3,7,1290,0,1957,0,98146,47.51300000000001,-122.35799999999999,1440,2500,5,30,2014,UNK,-150,2500
2549000020,3/24/2015,400000.0,3,2.5,1950,18533,2.0,0.0,0.0,3,8,1950,0,1988,0,98024,47.5647,-121.90299999999999,1810,18401,3,24,2015,UNK,140,132
4137040250,10/21/2014,300499.0,4,2.5,2150,7944,2.0,0.0,0.0,3,8,2150,0,1990,0,98092,47.25899999999999,-122.215,2170,8319,10,21,2014,UNK,-20,-375
5101400461,4/17/2015,449000.0,4,2.0,1560,5220,1.0,0.0,0.0,3,7,1560,0,1959,0,98115,47.6905,-122.305,1300,5220,4,17,2015,UNK,260,0
2306400010,10/17/2014,500000.0,2,1.0,1120,3220,1.0,0.0,0.0,4,7,1120,0,1923,0,98103,47.6588,-122.344,1440,3220,10,17,2014,UNK,-320,0
8861000095,9/30/2014,865000.0,3,1.5,1790,7526,1.0,0.0,0.0,3,7,1790,0,1953,2014,98004,47.6387,-122.20700000000001,2080,10943,9,30,2014,Y,-290,-3417
3754500010,6/16/2014,899950.0,4,3.5,3290,5414,2.0,0.0,1.0,3,9,2360,930,2006,0,98034,47.7074,-122.219,1820,9609,6,16,2014,N,1470,-4195
4326000190,8/28/2014,370000.0,4,1.0,1540,9541,1.5,0.0,0.0,4,7,1540,0,1961,0,98034,47.7104,-122.213,1290,9541,8,28,2014,UNK,250,0
1525069088,5/4/2015,442500.0,5,3.25,4240,226097,2.0,0.0,0.0,3,8,3410,830,1980,0,98053,47.6472,-122.01700000000001,2980,217800,5,4,2015,UNK,1260,8297
9474700020,5/3/2014,310000.0,3,1.0,1010,9945,1.0,0.0,0.0,4,6,1010,0,1973,0,98065,47.5324,-121.76299999999999,1390,12710,5,3,2014,UNK,-380,-2765
4389200876,7/1/2014,1570000.0,4,2.75,2970,12750,1.5,0.0,1.0,4,7,2130,840,1918,0,98004,47.6135,-122.213,1980,15300,7,1,2014,UNK,990,-2550
6084600420,9/5/2014,245000.0,4,2.25,2190,9113,2.0,0.0,0.0,3,7,2190,0,1986,0,98001,47.3241,-122.275,1570,8306,9,5,2014,UNK,620,807
6668900010,11/17/2014,254950.0,2,1.0,700,8100,1.0,0.0,0.0,3,6,700,0,1949,0,98155,47.7492,-122.311,1230,8100,11,17,2014,UNK,-530,0
125059178,7/22/2014,510000.0,6,4.5,3300,7480,2.0,0.0,0.0,3,8,3300,0,1980,0,98052,47.6796,-122.104,2470,7561,7,22,2014,UNK,830,-81
2131701410,4/27/2015,299950.0,3,2.25,1370,5000,2.0,0.0,0.0,3,7,1370,0,1990,0,98019,47.7372,-121.98100000000001,1600,7724,4,27,2015,UNK,-230,-2724
3158500130,8/21/2014,379950.0,4,2.5,2680,4500,2.0,0.0,0.0,3,8,2680,0,2011,0,98038,47.3561,-122.056,2010,4500,8,21,2014,N,670,0
6300500275,8/7/2014,350000.0,3,1.0,1390,4820,1.0,0.0,0.0,4,7,910,480,1926,0,98133,47.70399999999999,-122.34299999999999,1320,4820,8,7,2014,UNK,70,0
3395040920,6/18/2014,300000.0,3,2.5,1700,3575,2.0,0.0,0.0,3,7,1700,0,2000,0,98108,47.5418,-122.295,1590,3380,6,18,2014,UNK,110,195
1193000280,5/27/2014,994000.0,3,2.25,2510,6339,1.5,0.0,2.0,5,8,1810,700,1932,0,98199,47.6496,-122.391,1820,5741,5,27,2014,UNK,690,598
8022900005,11/19/2014,315000.0,3,1.5,1700,8067,1.0,0.0,0.0,3,7,1250,450,1956,0,98155,47.7384,-122.324,1340,7869,11,19,2014,UNK,360,198
1774000050,5/7/2014,480500.0,4,2.5,2180,11200,1.0,0.0,0.0,4,8,2180,0,1968,0,98072,47.7476,-122.086,1790,11200,5,7,2014,UNK,390,0
1725800280,6/16/2014,373000.0,3,1.0,1770,5720,1.5,0.0,0.0,4,7,1140,630,1926,0,98126,47.5546,-122.37700000000001,1500,4406,6,16,2014,UNK,270,1314
8691390980,9/2/2014,728000.0,4,2.5,3290,5951,2.0,0.0,0.0,3,9,3290,0,2003,0,98075,47.5999,-121.976,3240,6159,9,2,2014,UNK,50,-208
1180008370,9/25/2014,415000.0,4,3.5,3040,7125,2.0,0.0,1.0,3,8,2240,800,2002,0,98178,47.492,-122.225,2220,7800,9,25,2014,UNK,820,-675
9558020460,6/4/2014,427500.0,4,2.5,2460,5091,2.0,0.0,0.0,3,9,2460,0,2003,0,98058,47.45,-122.12100000000001,2490,4750,6,4,2014,UNK,-30,341
3575302880,11/10/2014,339300.0,3,2.0,970,10000,1.0,0.0,0.0,5,7,970,0,1972,0,98074,47.6205,-122.06299999999999,1230,7500,11,10,2014,UNK,-260,2500
6671900095,5/27/2014,313000.0,3,1.75,1320,6205,1.0,0.0,0.0,5,7,1320,0,1948,0,98133,47.7412,-122.34299999999999,1210,6205,5,27,2014,UNK,110,0
5637500094,5/22/2014,431500.0,3,3.5,1900,1612,2.0,0.0,0.0,3,8,1430,470,2008,0,98136,47.544,-122.385,1780,1525,5,22,2014,N,120,87
4310701330,3/9/2015,415000.0,3,1.5,1220,835,1.5,0.0,0.0,4,6,1220,0,1950,0,98103,47.6981,-122.34100000000001,1360,1251,3,9,2015,UNK,-140,-416
23520190,3/16/2015,490000.0,3,1.75,1470,9750,1.0,0.0,0.0,4,7,1470,0,1978,0,98052,47.6975,-122.12,1800,9600,3,16,2015,UNK,-330,150
98000130,3/24/2015,1430000.0,4,5.0,4630,24054,2.0,0.0,3.0,3,11,4630,0,2005,0,98075,47.586999999999996,-121.96600000000001,4630,17584,3,24,2015,N,0,6470
6829900080,3/30/2015,275000.0,3,1.5,1400,9750,1.0,0.0,0.0,4,6,1400,0,1964,0,98030,47.3768,-122.17,1160,9750,3,30,2015,UNK,240,0
5370200170,2/17/2015,325000.0,2,1.0,1070,5080,1.0,0.0,0.0,5,6,1070,0,1942,0,98106,47.5224,-122.35,900,5080,2,17,2015,UNK,170,0
3885805896,6/10/2014,1180000.0,5,3.75,3630,6000,1.5,0.0,0.0,3,9,2470,1160,2004,0,98033,47.6816,-122.199,2560,7560,6,10,2014,N,1070,-1560
9550200470,10/1/2014,690000.0,4,1.5,1970,4590,2.5,0.0,0.0,3,7,1970,0,1909,0,98103,47.666000000000004,-122.33200000000001,1900,4590,10,1,2014,UNK,70,0
6111400020,3/30/2015,410000.0,4,2.0,2010,9474,2.0,0.0,0.0,3,7,2010,0,1953,2003,98166,47.4234,-122.34200000000001,2140,10164,3,30,2015,Y,-130,-690
5135000050,8/1/2014,960000.0,4,2.5,2820,5934,1.0,0.0,3.0,5,9,1770,1050,1952,0,98116,47.5706,-122.40299999999999,2230,6000,8,1,2014,UNK,590,-66
8029510010,10/30/2014,299250.0,3,2.5,2530,8669,2.0,0.0,0.0,3,9,2530,0,1990,0,98023,47.3073,-122.395,2530,9469,10,30,2014,UNK,0,-800
4438400050,7/14/2014,239000.0,2,1.0,710,14000,1.0,0.0,0.0,4,6,710,0,1953,0,98166,47.4379,-122.337,1500,10540,7,14,2014,UNK,-790,3460
7831800460,5/2/2014,235000.0,2,1.0,1210,9400,1.0,0.0,0.0,2,6,1210,0,1949,0,98106,47.5342,-122.36,1580,6026,5,2,2014,UNK,-370,3374
2425069069,5/27/2014,587000.0,3,2.25,2370,217800,2.0,0.0,0.0,3,7,2370,0,1979,0,98053,47.6364,-121.984,3100,86248,5,27,2014,UNK,-730,131552
8029550020,7/1/2014,431000.0,4,2.5,2300,6087,2.0,0.0,0.0,3,7,2300,0,2001,0,98056,47.5125,-122.19200000000001,1770,5907,7,1,2014,UNK,530,180
7533800170,7/7/2014,1640000.0,3,2.5,3110,6765,2.0,0.0,1.0,4,9,2550,560,1946,0,98115,47.6886,-122.27600000000001,2630,7626,7,7,2014,UNK,480,-861
9460000010,12/3/2014,285000.0,3,1.75,1990,6500,1.0,0.0,0.0,3,7,1090,900,1961,0,98055,47.488,-122.221,2150,6500,12,3,2014,UNK,-160,0
2600130020,11/6/2014,778000.0,3,3.0,2630,10156,1.0,0.0,0.0,4,9,2630,0,1987,0,98006,47.5481,-122.156,2660,10455,11,6,2014,UNK,-30,-299
4037700285,7/31/2014,415000.0,3,1.0,1300,7975,1.0,0.0,0.0,4,7,1300,0,1958,0,98008,47.611000000000004,-122.12200000000001,1570,9075,7,31,2014,UNK,-270,-1100
8682261190,1/12/2015,550285.0,2,1.75,1680,4500,1.0,0.0,0.0,3,8,1680,0,2004,0,98053,47.7132,-122.03200000000001,1670,4500,1,12,2015,N,10,0
5453700020,8/25/2014,910000.0,3,2.25,2180,9865,1.0,0.0,0.0,4,8,1660,0,1966,0,98040,47.5358,-122.235,2600,10034,8,25,2014,UNK,-420,-169
4139400630,5/29/2014,860000.0,3,2.5,2770,9136,2.0,0.0,0.0,3,10,2770,0,1991,0,98006,47.5605,-122.115,2890,8442,5,29,2014,UNK,-120,694
9550201495,10/3/2014,765000.0,3,1.75,2120,5000,2.0,0.0,0.0,3,7,1980,140,1920,2010,98103,47.6666,-122.331,2020,5000,10,3,2014,Y,100,0
9808610190,5/9/2014,782000.0,4,2.5,2830,20345,2.0,0.0,0.0,3,10,1980,850,1979,0,98004,47.6462,-122.191,2830,13732,5,9,2014,UNK,0,6613
7443000514,3/10/2015,525000.0,3,3.5,1370,1764,2.0,0.0,0.0,3,8,1180,190,2000,0,98119,47.6511,-122.368,1400,1398,3,10,2015,UNK,-30,366
1823099056,12/22/2014,745000.0,3,2.5,2810,435600,2.0,0.0,0.0,3,9,2810,0,1995,0,98045,47.4816,-121.70100000000001,2380,92007,12,22,2014,UNK,430,343593
6055000010,7/25/2014,470000.0,3,3.5,3520,35512,2.0,0.0,2.0,3,8,2760,760,2005,0,98022,47.2416,-121.979,2860,39614,7,25,2014,N,660,-4102
3878900225,6/2/2014,345000.0,3,1.75,1990,5650,1.0,0.0,1.0,3,7,1320,670,1963,0,98178,47.5086,-122.25200000000001,2130,5650,6,2,2014,UNK,-140,0
4222700130,3/4/2015,279000.0,3,2.25,2070,7800,1.0,0.0,0.0,3,7,1170,900,1964,0,98003,47.3431,-122.305,1570,8400,3,4,2015,UNK,500,-600
1124000010,7/11/2014,500000.0,3,1.5,1320,8100,1.0,0.0,0.0,4,7,1320,0,1951,0,98177,47.7194,-122.37100000000001,1480,8100,7,11,2014,UNK,-160,0
428000225,6/20/2014,237000.0,3,1.0,1300,8160,1.0,0.0,0.0,4,7,1300,0,1960,0,98056,47.511,-122.17200000000001,1290,8970,6,20,2014,UNK,10,-810
8133300050,6/26/2014,200500.0,3,1.75,1260,9346,1.0,0.0,0.0,4,7,1260,0,1963,0,98030,47.3713,-122.186,1800,9705,6,26,2014,UNK,-540,-359
2423039134,3/24/2015,387500.0,4,1.75,2400,9900,1.0,0.0,0.0,3,7,1250,1150,1957,0,98166,47.4631,-122.36200000000001,1960,9900,3,24,2015,UNK,440,0
2726049150,7/17/2014,392500.0,4,2.0,1950,8040,1.0,0.0,0.0,3,7,1950,0,1961,0,98125,47.7074,-122.29,1950,8092,7,17,2014,UNK,0,-52
8074200080,2/13/2015,305000.0,3,2.0,1430,12430,1.0,0.0,0.0,4,7,1430,0,1957,0,98056,47.4903,-122.178,1200,8250,2,13,2015,UNK,230,4180
7856600170,9/24/2014,981000.0,4,2.5,2110,10100,1.0,0.0,2.0,3,8,2110,0,1968,2005,98006,47.567,-122.15100000000001,2230,10100,9,24,2014,Y,-120,0
8649900440,12/9/2014,680000.0,4,2.5,2980,8770,2.0,0.0,0.0,3,10,2980,0,1990,0,98075,47.5814,-122.029,2940,9238,12,9,2014,UNK,40,-468
7696630170,6/5/2014,276000.0,4,2.5,2068,7242,2.0,0.0,0.0,4,7,2068,0,1976,0,98001,47.3318,-122.281,1560,7524,6,5,2014,UNK,508,-282
226039075,5/6/2014,655500.0,4,3.5,3380,8330,2.0,0.0,0.0,3,8,3380,0,2000,0,98177,47.7741,-122.37899999999999,2220,8330,5,6,2014,UNK,1160,0
3296000170,12/29/2014,555000.0,5,2.75,2810,13144,1.0,0.0,0.0,3,8,1440,1370,1964,0,98007,47.6199,-122.141,2480,13144,12,29,2014,UNK,330,0
3223049073,4/13/2015,235000.0,2,1.0,930,10505,1.0,0.0,0.0,3,6,930,0,1930,0,98148,47.4337,-122.329,1520,8881,4,13,2015,UNK,-590,1624
7300700050,2/19/2015,325000.0,3,1.0,1300,8879,1.0,0.0,0.0,3,7,920,380,1950,0,98155,47.7465,-122.32600000000001,1530,6960,2,19,2015,UNK,-230,1919
9900000190,10/30/2014,268950.0,3,1.0,1320,8100,1.0,0.0,0.0,3,6,880,440,1943,0,98166,47.4697,-122.351,1000,8100,10,30,2014,UNK,320,0
3751600635,11/10/2014,264500.0,3,1.5,1580,14040,1.0,0.0,0.0,3,7,1050,530,1980,0,98001,47.2932,-122.26700000000001,2240,12000,11,10,2014,UNK,-660,2040
7575600430,11/10/2014,240000.0,3,2.5,1620,5250,2.0,0.0,0.0,3,8,1620,0,1987,0,98003,47.3538,-122.301,1650,5250,11,10,2014,UNK,-30,0
3223039109,2/20/2015,819000.0,3,2.5,2750,226512,2.0,0.0,0.0,3,9,2750,0,2000,0,98070,47.4376,-122.456,1250,211266,2,20,2015,UNK,1500,15246
7151700190,3/31/2015,850000.0,2,1.5,2210,5000,1.0,0.0,2.0,3,8,1530,680,1951,0,98122,47.6122,-122.288,2700,5000,3,31,2015,UNK,-490,0
2076400050,10/22/2014,294950.0,4,2.25,1740,9600,1.0,0.0,2.0,3,7,1160,580,1957,0,98188,47.431999999999995,-122.27600000000001,1630,9600,10,22,2014,UNK,110,0
2162000190,12/15/2014,693000.0,3,2.25,2120,13644,2.0,0.0,0.0,4,9,1420,700,1973,0,98040,47.5574,-122.214,2950,17060,12,15,2014,UNK,-830,-3416
5226500250,10/15/2014,478000.0,4,2.5,2780,7290,2.0,0.0,0.0,3,8,2780,0,1989,0,98059,47.50899999999999,-122.15700000000001,2450,7738,10,15,2014,UNK,330,-448
1787600294,2/5/2015,222000.0,2,1.0,830,6893,1.0,0.0,0.0,3,7,830,0,1950,0,98125,47.7234,-122.32799999999999,1470,7200,2,5,2015,UNK,-640,-307
6388930170,4/8/2015,635000.0,4,2.5,2070,11286,2.0,0.0,0.0,3,8,2070,0,1996,0,98056,47.5284,-122.17299999999999,2440,10826,4,8,2015,UNK,-370,460
2767704332,9/30/2014,469000.0,3,3.25,1390,1278,2.0,0.0,0.0,3,8,1140,250,2005,0,98107,47.6735,-122.375,1390,1256,9,30,2014,N,0,22
6699940250,7/25/2014,350000.0,4,2.5,2610,5866,2.0,0.0,0.0,3,8,2610,0,2005,0,98038,47.3441,-122.04,2480,5188,7,25,2014,N,130,678
8151601190,12/3/2014,180000.0,5,1.0,1460,11726,1.5,0.0,0.0,3,6,1290,170,1936,0,98146,47.5039,-122.361,1460,10450,12,3,2014,UNK,0,1276
5561000420,4/8/2015,490000.0,4,2.25,3390,39356,1.0,0.0,0.0,4,8,1640,1750,1964,0,98027,47.46100000000001,-121.992,2160,38061,4,8,2015,UNK,1230,1295
3797001900,9/22/2014,360000.0,3,1.5,1360,6000,1.0,0.0,0.0,3,6,860,500,1911,0,98103,47.6846,-122.345,1560,3000,9,22,2014,UNK,-200,3000
6641020050,6/18/2014,630000.0,4,2.5,2807,9430,2.0,0.0,0.0,3,8,2807,0,1996,0,98028,47.7449,-122.223,2028,11056,6,18,2014,UNK,779,-1626
3232200095,4/14/2015,615000.0,4,1.0,1340,2006,1.5,0.0,0.0,3,7,1340,0,1931,0,98119,47.6357,-122.37299999999999,2040,3625,4,14,2015,UNK,-700,-1619
2310000440,10/27/2014,279950.0,3,2.25,1340,7202,2.0,0.0,0.0,4,7,1340,0,1989,0,98038,47.3563,-122.039,1470,7395,10,27,2014,UNK,-130,-193
6414600321,6/11/2014,317000.0,3,1.0,1160,8813,1.0,0.0,0.0,3,7,1160,0,1952,0,98125,47.7257,-122.329,1200,7615,6,11,2014,UNK,-40,1198
7199320190,10/16/2014,618000.0,4,2.25,2470,7350,1.0,0.0,0.0,3,7,1600,870,1978,0,98052,47.6936,-122.12799999999999,1970,7700,10,16,2014,UNK,500,-350
7922800190,3/11/2015,620000.0,5,1.75,2000,8713,1.0,0.0,2.0,3,7,1000,1000,1962,0,98008,47.5882,-122.117,2040,8449,3,11,2015,UNK,-40,264
9553200052,5/6/2014,345000.0,3,1.0,1110,6250,1.0,0.0,0.0,3,7,1110,0,1956,0,98115,47.6977,-122.292,2010,6944,5,6,2014,UNK,-900,-694
4083802425,10/10/2014,608000.0,3,1.5,2240,3750,1.0,0.0,0.0,3,7,1220,1020,1952,0,98103,47.6624,-122.336,1570,3400,10,10,2014,UNK,670,350
984000130,12/23/2014,325000.0,4,2.25,1920,11603,2.0,0.0,0.0,4,7,1920,0,1967,0,98058,47.4315,-122.169,1840,7350,12,23,2014,UNK,80,4253
2473002500,11/12/2014,475000.0,3,1.75,2270,13000,1.0,0.0,0.0,5,8,2270,0,1968,0,98058,47.4474,-122.14399999999999,2440,10000,11,12,2014,UNK,-170,3000
3356403304,10/16/2014,154000.0,3,3.0,1530,9997,1.0,0.0,0.0,3,6,1020,510,1992,0,98001,47.2861,-122.25200000000001,1410,9997,10,16,2014,UNK,120,0
8651200080,6/19/2014,1190000.0,5,3.0,3330,19126,2.0,0.0,0.0,4,11,2610,720,1977,0,98040,47.5485,-122.214,3330,16893,6,19,2014,UNK,0,2233
1329300480,10/23/2014,376950.0,4,2.5,2643,5750,2.0,0.0,0.0,3,8,2643,0,2012,0,98030,47.3519,-122.17299999999999,2406,5772,10,23,2014,N,237,-22
1972201305,7/29/2014,500000.0,2,2.0,1250,3360,1.0,0.0,0.0,3,7,1250,0,1957,0,98103,47.6526,-122.34899999999999,1250,3360,7,29,2014,UNK,0,0
425079001,4/23/2015,499950.0,3,2.5,3230,129578,1.0,0.0,0.0,4,8,2100,1130,1964,0,98014,47.681999999999995,-121.913,2760,62059,4,23,2015,UNK,470,67519
9347900020,1/27/2015,230000.0,3,1.0,880,9035,1.0,0.0,0.0,4,6,880,0,1967,0,98059,47.476000000000006,-122.15100000000001,1440,10350,1,27,2015,UNK,-560,-1315
1015000050,1/6/2015,652600.0,4,2.5,2220,5900,2.0,0.0,0.0,3,8,2220,0,2014,0,98117,47.6956,-122.36,1620,5900,1,6,2015,N,600,0
9542802000,12/29/2014,185000.0,3,1.75,1130,7000,1.0,0.0,0.0,3,7,1130,0,1978,0,98023,47.306999999999995,-122.37200000000001,1830,8880,12,29,2014,UNK,-700,-1880
8088600080,6/2/2014,274950.0,3,1.0,1450,8820,1.0,0.0,0.0,3,6,1050,400,1958,0,98168,47.4698,-122.264,1510,8820,6,2,2014,UNK,-60,0
5637500250,2/10/2015,447000.0,2,1.0,760,6035,1.0,0.0,0.0,3,6,760,0,1920,0,98136,47.5443,-122.382,2110,6046,2,10,2015,UNK,-1350,-11
87000213,6/13/2014,129000.0,2,1.0,1150,30184,1.0,0.0,0.0,3,6,1150,0,1950,0,98055,47.4492,-122.2,1670,19684,6,13,2014,UNK,-520,10500
5104200470,3/25/2015,436000.0,5,3.0,2720,9856,2.0,0.0,0.0,4,8,2720,0,1969,0,98059,47.4778,-122.146,1420,9685,3,25,2015,UNK,1300,171
455000190,10/6/2014,825000.0,3,1.75,2080,5000,2.0,0.0,0.0,5,8,2080,0,1906,0,98103,47.6717,-122.35600000000001,1820,5000,10,6,2014,UNK,260,0
3356403140,10/10/2014,225000.0,3,1.0,1080,16000,1.0,0.0,0.0,3,6,1080,0,1952,0,98001,47.2873,-122.251,1610,10007,10,10,2014,UNK,-530,5993
4472000050,3/9/2015,265000.0,3,2.5,1890,6088,2.0,0.0,0.0,3,7,1890,0,1996,0,98002,47.2886,-122.21799999999999,1700,6600,3,9,2015,UNK,190,-512
5350200425,3/9/2015,765000.0,3,1.5,1500,5111,2.0,0.0,0.0,5,8,1500,0,1984,0,98122,47.6118,-122.28399999999999,2380,4519,3,9,2015,UNK,-880,592
3975400190,11/4/2014,509000.0,4,2.0,1960,2166,1.5,0.0,0.0,4,7,1260,700,1926,0,98103,47.6545,-122.344,1670,4000,11,4,2014,UNK,290,-1834
9541600255,3/10/2015,762450.0,4,1.75,2570,8640,1.0,0.0,0.0,4,8,2570,0,1958,0,98005,47.5956,-122.17200000000001,2520,8800,3,10,2015,UNK,50,-160
5538300460,12/10/2014,465000.0,5,1.5,1830,9000,1.0,0.0,2.0,3,7,1030,800,1955,0,98155,47.7488,-122.292,2610,11175,12,10,2014,UNK,-780,-2175
7625700305,6/5/2014,564000.0,3,1.75,1980,6250,1.0,0.0,1.0,5,7,1090,890,1910,0,98136,47.553999999999995,-122.385,1980,6250,6,5,2014,UNK,0,0
2895600420,4/21/2015,384500.0,2,1.0,1130,5236,1.0,0.0,0.0,4,6,1130,0,1942,0,98146,47.5103,-122.38600000000001,1010,5320,4,21,2015,UNK,120,-84
2320069260,10/27/2014,415000.0,3,2.0,2010,33090,1.5,0.0,2.0,5,8,2010,0,1986,0,98022,47.2133,-122.007,1840,22620,10,27,2014,UNK,170,10470
7305300470,12/1/2014,345000.0,2,1.75,1820,8409,1.0,0.0,0.0,4,6,910,910,1948,0,98155,47.7538,-122.32700000000001,1300,8409,12,1,2014,UNK,520,0
9477940440,6/17/2014,465950.0,4,2.5,2340,6896,2.0,0.0,0.0,3,7,2340,0,2001,0,98059,47.4896,-122.14,2950,6775,6,17,2014,UNK,-610,121
2561340020,8/4/2014,325000.0,3,1.75,1780,11096,1.0,0.0,0.0,3,7,1210,570,1979,0,98074,47.617,-122.051,1780,10640,8,4,2014,UNK,0,456
2561340020,2/17/2015,500000.0,3,1.75,1780,11096,1.0,0.0,0.0,3,7,1210,570,1979,0,98074,47.617,-122.051,1780,10640,2,17,2015,UNK,0,456
524069075,10/24/2014,450000.0,4,2.5,2450,20348,1.0,0.0,0.0,3,8,1410,1040,1978,0,98075,47.5887,-122.064,2450,50094,10,24,2014,UNK,0,-29746
2296700050,10/10/2014,475000.0,4,3.0,2410,8284,1.0,0.0,0.0,5,7,1210,1200,1969,0,98034,47.7202,-122.22,2050,7940,10,10,2014,UNK,360,344
4122900190,5/12/2014,1350000.0,5,1.75,3380,20021,1.0,0.0,0.0,4,8,1690,1690,1963,0,98004,47.6395,-122.211,3260,19809,5,12,2014,UNK,120,212
2754700095,3/16/2015,747000.0,3,1.5,1710,5120,2.0,0.0,0.0,4,7,1710,0,1920,0,98115,47.6801,-122.305,1530,5170,3,16,2015,UNK,180,-50
9265700005,8/22/2014,395000.0,3,1.75,1740,6220,1.0,0.0,0.0,4,6,1740,0,1954,0,98177,47.762,-122.36200000000001,1630,8418,8,22,2014,UNK,110,-2198
9826700726,10/6/2014,505000.0,3,2.5,1995,1483,3.0,0.0,0.0,3,8,1760,235,2005,0,98102,47.6025,-122.31,1520,1173,10,6,2014,N,475,310
321049193,10/17/2014,215000.0,3,2.0,1760,9282,1.0,0.0,0.0,5,7,1100,660,1947,0,98001,47.3413,-122.29,1730,7500,10,17,2014,UNK,30,1782
1923099034,1/16/2015,775000.0,4,3.5,3970,210830,2.0,0.0,0.0,3,9,3970,0,2000,0,98045,47.4614,-121.713,1680,42665,1,16,2015,UNK,2290,168165
4305600250,10/27/2014,540000.0,4,2.5,3000,5471,2.0,0.0,0.0,3,8,3000,0,2013,0,98059,47.4797,-122.126,2730,5471,10,27,2014,N,270,0
6648100010,11/19/2014,392500.0,3,1.75,1540,8925,1.0,0.0,0.0,4,7,1540,0,1957,0,98133,47.7762,-122.337,1620,10397,11,19,2014,UNK,-80,-1472
5536100020,12/15/2014,987000.0,3,2.0,2160,15788,1.0,0.0,0.0,3,8,2160,0,1951,0,98004,47.6227,-122.20700000000001,2260,9787,12,15,2014,UNK,-100,6001
5536100020,5/12/2015,1190000.0,3,2.0,2160,15788,1.0,0.0,0.0,3,8,2160,0,1951,0,98004,47.6227,-122.20700000000001,2260,9787,5,12,2015,UNK,-100,6001
5104450440,11/13/2014,252500.0,3,2.0,1810,10684,2.0,0.0,0.0,3,8,1810,0,1987,0,98058,47.4619,-122.15299999999999,2140,9657,11,13,2014,UNK,-330,1027
7560000050,4/23/2015,730000.0,3,3.5,2440,3502,2.0,0.0,0.0,3,7,1970,470,2000,0,98005,47.589,-122.165,2440,3417,4,23,2015,UNK,0,85
7784400130,5/5/2014,497300.0,6,2.75,3200,9200,1.0,0.0,2.0,4,8,1600,1600,1953,0,98146,47.492,-122.36399999999999,2220,9500,5,5,2014,UNK,980,-300
7298900010,9/24/2014,640000.0,4,2.5,2970,34981,2.0,0.0,0.0,3,9,2970,0,1998,0,98077,47.7365,-122.037,3170,30277,9,24,2014,UNK,-200,4704
259601100,5/13/2014,580000.0,5,2.0,2290,7125,1.0,0.0,0.0,3,7,1190,1100,1964,0,98008,47.63399999999999,-122.119,1460,7920,5,13,2014,UNK,830,-795
8041100010,8/18/2014,377000.0,3,1.75,1820,34800,1.0,0.0,0.0,4,6,1820,0,1967,0,98027,47.4616,-121.98,2570,52707,8,18,2014,UNK,-750,-17907
5318100840,6/6/2014,1280000.0,4,3.5,3010,3600,2.0,0.0,0.0,3,9,2370,640,1999,0,98112,47.6341,-122.28399999999999,2650,4200,6,6,2014,UNK,360,-600
2771101964,8/12/2014,396500.0,3,1.5,1360,1488,2.0,0.0,0.0,3,7,1120,240,2003,0,98199,47.6526,-122.384,1360,1573,8,12,2014,UNK,0,-85
1560870470,7/31/2014,300000.0,4,2.5,2080,2999,2.0,0.0,0.0,3,8,2080,0,1998,0,98059,47.4909,-122.15700000000001,1630,3148,7,31,2014,UNK,450,-149
1232000950,3/12/2015,532000.0,3,1.0,1110,4800,1.5,0.0,0.0,3,7,1110,0,1946,0,98117,47.6857,-122.37799999999999,1510,4320,3,12,2015,UNK,-400,480
8682261440,1/13/2015,579000.0,2,1.75,1560,4500,1.0,0.0,0.0,3,8,1560,0,2004,0,98053,47.7128,-122.03200000000001,1860,4500,1,13,2015,N,-300,0
1370801440,3/25/2015,1400000.0,4,2.5,3520,7815,2.0,0.0,3.0,3,10,3140,380,1929,0,98199,47.6429,-122.412,2790,6644,3,25,2015,UNK,730,1171
7680400050,10/22/2014,571000.0,5,1.75,2280,43560,1.0,0.0,1.0,4,8,1380,900,1949,0,98166,47.4558,-122.36200000000001,1940,17664,10,22,2014,UNK,340,25896
6928000440,7/18/2014,301950.0,3,1.75,1370,9288,1.0,0.0,0.0,4,7,1370,0,1988,0,98059,47.4824,-122.152,1500,9864,7,18,2014,UNK,-130,-576
3797000290,6/12/2014,660000.0,3,3.0,2340,2970,2.0,0.0,0.0,5,8,2160,180,1925,0,98103,47.6868,-122.348,1370,4000,6,12,2014,UNK,970,-1030
9264030470,6/11/2014,455000.0,4,2.5,3170,10688,2.0,0.0,2.0,3,9,3170,0,2001,0,98001,47.3179,-122.257,3100,12610,6,11,2014,UNK,70,-1922
6300000396,12/16/2014,375000.0,3,1.75,1380,5060,1.0,0.0,0.0,3,7,1380,0,1986,0,98133,47.7059,-122.34100000000001,1030,5060,12,16,2014,UNK,350,0
1786700080,1/15/2015,470000.0,4,2.5,2700,6769,2.0,0.0,0.0,3,9,2700,0,1999,0,98042,47.3753,-122.155,2880,7968,1,15,2015,UNK,-180,-1199
5116000170,3/31/2015,374990.0,3,2.5,1300,10484,2.0,0.0,0.0,3,8,1300,0,1983,0,98028,47.7768,-122.26799999999999,1380,7868,3,31,2015,UNK,-80,2616
8682282210,4/17/2015,541500.0,2,2.5,1900,3690,2.0,0.0,0.0,3,8,1900,0,2006,0,98053,47.7082,-122.01899999999999,1900,5153,4,17,2015,N,0,-1463
8651611640,4/24/2015,782500.0,3,2.5,3750,7821,2.0,0.0,0.0,3,9,3750,0,2001,0,98074,47.6325,-122.064,3210,8405,4,24,2015,UNK,540,-584
8946750020,5/7/2015,264000.0,3,2.25,1552,3677,2.0,0.0,0.0,3,7,1552,0,2012,0,98092,47.3205,-122.178,1677,3677,5,7,2015,N,-125,0
1939130420,7/15/2014,640000.0,4,2.5,2500,7417,2.0,0.0,0.0,3,9,2500,0,1991,0,98074,47.6251,-122.02600000000001,2770,8188,7,15,2014,UNK,-270,-771
7640400190,2/13/2015,660000.0,3,2.0,1770,8141,1.0,0.0,0.0,5,8,1770,0,1952,0,98177,47.7232,-122.37100000000001,1770,8100,2,13,2015,UNK,0,41
4139420430,6/11/2014,1370000.0,5,3.5,4210,17258,2.0,0.0,3.0,3,12,4210,0,1995,0,98006,47.553000000000004,-122.11399999999999,4630,17909,6,11,2014,UNK,-420,-651
1509500080,3/17/2015,389950.0,3,2.5,2170,8140,2.0,0.0,0.0,3,9,2170,0,1994,0,98030,47.385,-122.169,2390,8100,3,17,2015,UNK,-220,40
6341000020,3/4/2015,226000.0,2,1.0,1510,19874,1.0,0.0,0.0,3,7,1510,0,1951,0,98146,47.4924,-122.34,1540,10000,3,4,2015,UNK,-30,9874
1022069071,8/8/2014,390000.0,3,1.75,1870,40250,1.0,0.0,0.0,5,7,1870,0,1959,0,98038,47.4038,-122.036,1870,40250,8,8,2014,UNK,0,0
8078400020,2/23/2015,485000.0,3,2.25,1570,8111,2.0,0.0,0.0,3,8,1570,0,1984,0,98074,47.6324,-122.02799999999999,1990,7875,2,23,2015,UNK,-420,236
9113200250,4/13/2015,840000.0,4,2.5,2480,4602,2.0,0.0,0.0,3,9,2480,0,2000,0,98052,47.6835,-122.161,3480,5739,4,13,2015,UNK,-1000,-1137
1592300010,9/26/2014,600000.0,5,3.5,3580,21343,1.5,0.0,0.0,4,8,2140,1440,1937,0,98155,47.7646,-122.302,2430,21343,9,26,2014,UNK,1150,0
9250900095,8/19/2014,331000.0,2,1.0,1480,6210,1.0,0.0,0.0,3,7,1080,400,1950,0,98133,47.773999999999994,-122.351,1290,7509,8,19,2014,UNK,190,-1299
8815400670,10/16/2014,780000.0,3,2.0,2610,6000,1.0,0.0,0.0,5,7,1310,1300,1941,0,98115,47.675,-122.289,2330,4800,10,16,2014,UNK,280,1200
7212680080,10/15/2014,300000.0,3,1.75,1700,8481,2.0,0.0,0.0,3,7,1700,0,1993,0,98003,47.2623,-122.305,1830,6600,10,15,2014,UNK,-130,1881
2968801315,9/17/2014,361810.0,3,1.75,1240,7620,1.0,0.0,0.0,3,7,1240,0,1968,2014,98166,47.4576,-122.348,1150,7620,9,17,2014,Y,90,0
6141100255,5/15/2014,467000.0,3,1.0,1660,6582,1.0,0.0,0.0,5,7,1000,660,1946,0,98133,47.7169,-122.353,1110,6584,5,15,2014,UNK,550,-2
8068000440,12/26/2014,399000.0,3,1.75,1620,10000,1.5,0.0,0.0,5,6,1620,0,1918,0,98178,47.5091,-122.262,1880,10000,12,26,2014,UNK,-260,0
7883605900,10/15/2014,315450.0,3,1.75,1130,7500,1.5,0.0,0.0,4,7,1130,0,1908,0,98108,47.5254,-122.318,1240,6000,10,15,2014,UNK,-110,1500
9521101315,5/1/2015,600000.0,3,1.0,1310,5000,1.5,0.0,0.0,3,7,1310,0,1906,0,98103,47.6624,-122.34700000000001,1530,4800,5,1,2015,UNK,-220,200
8651442910,3/25/2015,247500.0,4,2.0,1710,5200,1.0,0.0,0.0,4,7,910,800,1977,0,98042,47.3634,-122.09,1560,5200,3,25,2015,UNK,150,0
8113101233,1/30/2015,330000.0,3,1.0,2140,5037,1.0,0.0,0.0,3,7,2140,0,1957,0,98118,47.5494,-122.274,1630,6054,1,30,2015,UNK,510,-1017
7016200460,8/26/2014,500000.0,4,2.25,2350,7210,1.5,0.0,0.0,4,7,2350,0,1972,0,98011,47.7407,-122.18299999999999,1930,7519,8,26,2014,UNK,420,-309
4189800020,8/20/2014,367500.0,3,1.0,1570,10050,1.0,0.0,0.0,3,7,1570,0,1963,0,98028,47.736000000000004,-122.23100000000001,2540,9940,8,20,2014,UNK,-970,110
5506500170,9/12/2014,560000.0,3,2.5,2780,32880,1.0,0.0,0.0,3,9,2780,0,1993,0,98045,47.4798,-121.727,2780,40091,9,12,2014,UNK,0,-7211
5135000170,8/6/2014,655000.0,4,1.75,2540,7620,1.0,0.0,3.0,3,8,1320,1220,1948,0,98116,47.5709,-122.406,2540,8613,8,6,2014,UNK,0,-993
8155500020,10/18/2014,530000.0,5,2.75,2500,7140,1.0,0.0,0.0,4,7,1250,1250,1968,0,98008,47.6225,-122.10799999999999,2230,8400,10,18,2014,UNK,270,-1260
2597501190,5/12/2015,270000.0,3,2.25,2080,26574,1.0,0.0,2.0,3,7,1380,700,1993,0,98002,47.2846,-122.19200000000001,1770,8140,5,12,2015,UNK,310,18434
5288200225,11/25/2014,437500.0,3,2.0,1760,2875,2.0,0.0,2.0,3,7,1290,470,1988,0,98126,47.5602,-122.37799999999999,1760,4830,11,25,2014,UNK,0,-1955
6189200050,2/3/2015,575000.0,3,1.75,1760,10349,1.0,0.0,0.0,3,8,1760,0,1957,0,98005,47.6347,-122.17299999999999,1970,10933,2,3,2015,UNK,-210,-584
6664900470,11/7/2014,278000.0,4,2.5,1940,6887,2.0,0.0,0.0,3,7,1940,0,1990,0,98023,47.2911,-122.353,1870,6144,11,7,2014,UNK,70,743
7954300460,9/4/2014,568500.0,4,2.5,3010,6181,2.0,0.0,0.0,3,9,3010,0,2000,0,98056,47.5212,-122.19200000000001,2960,6515,9,4,2014,UNK,50,-334
8018600655,3/26/2015,280000.0,4,3.0,2460,9606,1.0,0.0,0.0,3,8,2460,0,2012,0,98168,47.4889,-122.31700000000001,1730,7500,3,26,2015,N,730,2106
2508000020,8/19/2014,250000.0,2,1.0,750,6350,1.0,0.0,0.0,3,5,750,0,1920,0,98103,47.6938,-122.35600000000001,920,6350,8,19,2014,UNK,-170,0
1424059130,3/18/2015,247500.0,3,0.75,1300,72309,1.0,0.0,0.0,3,6,680,620,1950,1987,98006,47.567,-122.124,3080,8395,3,18,2015,Y,-1780,63914
7856660130,12/4/2014,1250000.0,5,2.75,3710,13874,1.5,0.0,3.0,4,9,2340,1370,1977,0,98006,47.5686,-122.154,3370,13874,12,4,2014,UNK,340,0
5302400080,10/15/2014,535000.0,4,2.5,2360,15008,1.0,0.0,0.0,3,9,1920,440,1986,0,98028,47.7363,-122.25399999999999,2680,15344,10,15,2014,UNK,-320,-336
3026059368,7/11/2014,814842.0,3,2.5,3190,6899,2.0,0.0,0.0,3,9,3190,0,2014,0,98034,47.7153,-122.221,3190,6899,7,11,2014,N,0,0
3275910020,2/13/2015,340000.0,4,2.5,2181,5521,2.0,0.0,0.0,3,8,2181,0,2006,0,98001,47.3503,-122.291,2333,5143,2,13,2015,N,-152,378
2229900020,6/10/2014,359950.0,3,1.75,1890,9100,2.0,0.0,0.0,4,7,1890,0,1952,0,98133,47.7676,-122.339,1640,9100,6,10,2014,UNK,250,0
7748000020,6/21/2014,750000.0,3,1.75,2610,5544,1.5,0.0,0.0,3,8,1680,930,1934,0,98117,47.684,-122.376,1330,5074,6,21,2014,UNK,1280,470
7457000005,9/26/2014,1220000.0,4,2.0,3090,8125,2.5,0.0,0.0,5,8,3090,0,1918,0,98117,47.6851,-122.395,1560,6250,9,26,2014,UNK,1530,1875
9268200285,7/3/2014,370000.0,2,1.0,860,5040,1.0,0.0,0.0,3,7,860,0,1956,0,98117,47.6977,-122.365,1570,5040,7,3,2014,UNK,-710,0
1328330780,4/15/2015,329950.0,3,1.0,1000,9170,1.0,0.0,0.0,3,7,1000,0,1980,0,98058,47.4405,-122.134,1610,9170,4,15,2015,UNK,-610,0
7806450190,1/2/2015,500000.0,3,2.5,2760,35171,2.0,0.0,0.0,3,9,2760,0,1990,0,98058,47.465,-122.12299999999999,2720,35171,1,2,2015,UNK,40,0
626400020,9/18/2014,734000.0,4,2.5,3490,18521,2.0,0.0,0.0,4,9,3490,0,1990,0,98077,47.7406,-122.07,2850,18521,9,18,2014,UNK,640,0
5416510920,6/16/2014,385000.0,4,2.5,2960,5054,2.0,0.0,0.0,3,9,2960,0,2006,0,98038,47.3601,-122.035,2960,5000,6,16,2014,N,0,54
3330500345,4/20/2015,230000.0,2,1.0,1280,4635,1.0,0.0,0.0,3,6,840,440,1917,0,98118,47.5532,-122.28,1660,6180,4,20,2015,UNK,-380,-1545
3885801190,7/30/2014,1390000.0,4,3.5,3230,7200,1.0,0.0,1.0,3,10,1640,1590,2000,0,98033,47.6838,-122.212,2660,7200,7,30,2014,UNK,570,0
1035000007,12/18/2014,210000.0,3,2.0,1830,4992,1.0,0.0,0.0,3,7,1230,600,1953,0,98118,47.5145,-122.27,2050,7740,12,18,2014,UNK,-220,-2748
1471701470,7/31/2014,293000.0,3,1.75,1420,13187,1.0,0.0,0.0,4,7,1420,0,1974,0,98059,47.4608,-122.065,1620,13824,7,31,2014,UNK,-200,-637
7519000225,10/30/2014,465000.0,3,1.0,1580,3774,1.5,0.0,0.0,3,6,1580,0,1900,0,98117,47.6839,-122.361,1580,3860,10,30,2014,UNK,0,-86
1433290010,1/12/2015,449000.0,3,2.25,1960,44634,1.0,0.0,0.0,3,7,1130,830,1984,0,98028,47.7769,-122.25299999999999,1970,44634,1,12,2015,UNK,-10,0
1223049150,4/14/2015,325000.0,2,1.75,1670,10725,1.0,0.0,0.0,3,7,1670,0,1965,0,98178,47.4893,-122.229,1600,10725,4,14,2015,UNK,70,0
5198600010,8/19/2014,180000.0,3,2.0,1670,7056,1.0,0.0,0.0,4,7,1670,0,1958,0,98002,47.3139,-122.212,1330,8415,8,19,2014,UNK,340,-1359
4310703070,4/13/2015,650000.0,6,3.0,2960,5000,1.0,0.0,0.0,3,8,1790,1170,1968,0,98103,47.6971,-122.34100000000001,1280,1251,4,13,2015,UNK,1680,3749
6154900005,9/24/2014,665000.0,4,2.75,2420,7102,1.0,0.0,0.0,5,7,1670,750,1946,0,98177,47.7042,-122.37100000000001,1620,7102,9,24,2014,UNK,800,0
3541700170,10/17/2014,324450.0,3,2.0,1420,16000,1.0,0.0,0.0,3,7,1420,0,1966,0,98166,47.478,-122.35799999999999,1900,12630,10,17,2014,UNK,-480,3370
952001495,3/6/2015,588000.0,4,1.75,2170,5750,1.0,0.0,2.0,3,7,1370,800,1975,0,98116,47.5668,-122.383,1450,5750,3,6,2015,UNK,720,0
8122600020,5/21/2014,200000.0,4,1.0,1310,5200,1.5,0.0,0.0,3,6,1160,150,1945,0,98126,47.5384,-122.37,1090,5180,5,21,2014,UNK,220,20
3579700080,9/5/2014,383000.0,4,1.75,1830,11090,1.0,0.0,0.0,3,7,1060,770,1962,0,98028,47.7333,-122.24600000000001,1990,10917,9,5,2014,UNK,-160,173
2769602140,12/15/2014,499950.0,3,2.0,1360,2500,1.0,0.0,0.0,3,7,730,630,1986,0,98107,47.6753,-122.363,1630,5000,12,15,2014,UNK,-270,-2500
5152920170,4/21/2015,549000.0,5,2.5,3440,12350,1.0,0.0,2.0,4,9,1760,1680,1976,0,98003,47.3427,-122.325,3440,12763,4,21,2015,UNK,0,-413
3226049530,1/22/2015,465000.0,5,3.0,2010,7264,1.0,0.0,0.0,3,7,1290,720,1990,0,98103,47.6945,-122.33,1510,7326,1,22,2015,UNK,500,-62
4017050020,8/14/2014,450000.0,3,2.5,2450,19744,2.0,0.0,0.0,3,10,2450,0,1990,0,98038,47.3746,-122.02600000000001,2650,19597,8,14,2014,UNK,-200,147
3982700250,4/23/2015,799900.0,4,2.5,3030,7800,2.0,0.0,0.0,3,9,1580,1450,1991,0,98033,47.68899999999999,-122.196,2840,7435,4,23,2015,UNK,190,365
2523069134,4/6/2015,495000.0,4,2.5,2480,91911,1.0,0.0,2.0,4,7,1470,1010,1973,0,98027,47.4579,-121.98100000000001,2540,91911,4,6,2015,UNK,-60,0
7281300010,8/22/2014,1200000.0,3,3.5,4310,10842,2.0,0.0,2.0,3,10,3140,1170,1988,0,98177,47.7735,-122.38600000000001,2280,11106,8,22,2014,UNK,2030,-264
3396800280,2/23/2015,637000.0,4,2.5,2120,15000,2.0,0.0,0.0,4,8,2120,0,1983,0,98052,47.7159,-122.1,2170,15000,2,23,2015,UNK,-50,0
7234600851,12/16/2014,589000.0,4,1.0,2210,4366,2.0,0.0,0.0,3,8,2210,0,1901,0,98122,47.6105,-122.309,1740,1745,12,16,2014,UNK,470,2621
7418000020,7/24/2014,305000.0,3,1.75,1400,10350,1.0,0.0,0.0,4,7,1400,0,1976,0,98059,47.479,-122.132,1780,10457,7,24,2014,UNK,-380,-107
7548300170,3/31/2015,600000.0,4,2.25,2760,5200,2.0,0.0,0.0,3,7,1790,970,1910,2003,98144,47.589,-122.31299999999999,1310,2059,3,31,2015,Y,1450,3141
1446300020,5/31/2014,587000.0,4,2.5,2550,6256,2.0,0.0,0.0,3,9,2550,0,1992,0,98072,47.7742,-122.166,2460,8256,5,31,2014,UNK,90,-2000
4385700425,5/5/2014,1430000.0,2,2.5,2220,4000,2.0,0.0,0.0,3,9,2220,0,2000,0,98112,47.6364,-122.28,1870,4000,5,5,2014,UNK,350,0
16000545,3/12/2015,250000.0,4,1.0,1320,11212,1.0,0.0,0.0,5,6,1320,0,1914,0,98002,47.3098,-122.209,1060,6766,3,12,2015,UNK,260,4446
7996720050,4/24/2015,515000.0,3,3.0,2440,3202,2.0,0.0,0.0,4,8,1640,800,1982,0,98133,47.7152,-122.34200000000001,2440,3200,4,24,2015,UNK,0,2
8691310840,5/9/2014,833000.0,4,2.75,3780,10308,2.0,0.0,0.0,3,10,3780,0,1999,0,98075,47.589,-121.98299999999999,3500,10740,5,9,2014,UNK,280,-432
4309700130,6/4/2014,860000.0,3,3.25,4720,32467,2.0,0.0,2.0,3,10,3190,1530,1998,0,98059,47.508,-122.113,3260,26386,6,4,2014,UNK,1460,6081
5100401060,9/8/2014,550000.0,4,3.0,2360,6678,1.0,0.0,0.0,3,8,1760,600,1949,0,98115,47.6919,-122.31299999999999,1640,6380,9,8,2014,UNK,720,298
1180002580,3/19/2015,180000.0,2,1.0,890,6000,1.0,0.0,0.0,2,6,890,0,1919,0,98178,47.4976,-122.225,1100,6000,3,19,2015,UNK,-210,0
3379100130,6/18/2014,507000.0,4,1.75,1770,9375,1.0,0.0,0.0,4,7,1170,600,1968,0,98052,47.6935,-122.11200000000001,1540,9375,6,18,2014,UNK,230,0
8645900080,8/27/2014,427000.0,3,2.0,1720,128066,1.0,0.0,0.0,3,7,1720,0,1994,0,98027,47.4487,-121.98100000000001,2360,111078,8,27,2014,UNK,-640,16988
7569500010,11/20/2014,616950.0,3,3.5,2490,2722,2.0,0.0,0.0,3,8,2020,470,1999,0,98005,47.5893,-122.165,2490,2755,11,20,2014,UNK,0,-33
8026200080,7/15/2014,372000.0,4,1.75,1890,10550,1.0,0.0,0.0,5,7,1010,880,1969,0,98056,47.5147,-122.193,1930,7291,7,15,2014,UNK,-40,3259
5101404555,10/6/2014,290000.0,2,1.0,1020,6380,1.0,0.0,0.0,3,7,1020,0,1930,1973,98115,47.6971,-122.31700000000001,1380,6380,10,6,2014,Y,-360,0
9432900250,3/9/2015,329990.0,4,2.75,2420,8438,2.0,0.0,0.0,3,8,2420,0,1997,0,98022,47.2089,-122.01100000000001,2270,8770,3,9,2015,UNK,150,-332
3995700250,10/13/2014,393500.0,3,1.75,1600,8156,1.0,0.0,0.0,5,7,1600,0,1948,0,98155,47.7397,-122.3,1200,8156,10,13,2014,UNK,400,0
2574900080,5/13/2014,1550000.0,5,3.25,3370,17458,1.0,0.0,2.0,5,10,2000,1370,1982,0,98040,47.5591,-122.229,4240,15202,5,13,2014,UNK,-870,2256
8731982630,5/22/2014,240000.0,4,2.25,1720,8300,1.0,0.0,0.0,4,8,1720,0,1973,0,98023,47.3192,-122.385,2010,8000,5,22,2014,UNK,-290,300
2968800660,5/13/2014,285000.0,3,1.0,1090,8640,1.0,0.0,0.0,4,6,1090,0,1973,0,98166,47.458999999999996,-122.355,1260,8400,5,13,2014,UNK,-170,240
2872900010,4/14/2015,382500.0,3,1.5,1090,9862,1.0,0.0,0.0,3,8,1090,0,1987,0,98074,47.6256,-122.036,1710,9862,4,14,2015,UNK,-620,0
1118000080,3/31/2015,1930000.0,4,3.75,3600,16101,1.0,0.0,0.0,3,9,3600,0,1951,0,98112,47.6308,-122.287,3650,9506,3,31,2015,UNK,-50,6595
8923600185,8/29/2014,800000.0,3,2.5,2760,9471,1.0,0.0,2.0,3,8,1760,1000,1956,0,98115,47.676,-122.272,3040,6765,8,29,2014,UNK,-280,2706
1725059252,4/2/2015,550000.0,4,3.5,2770,24140,2.0,0.0,0.0,3,8,2770,0,1967,0,98033,47.6585,-122.186,1720,16011,4,2,2015,UNK,1050,8129
3818700190,12/15/2014,387846.0,4,1.75,2520,15205,1.0,0.0,0.0,4,7,2040,480,1954,0,98028,47.7642,-122.264,1680,10000,12,15,2014,UNK,840,5205
5125400305,8/21/2014,367500.0,4,2.0,1960,16015,1.0,0.0,0.0,3,7,1960,0,1980,0,98002,47.33,-122.22,1960,16015,8,21,2014,UNK,0,0
4232400010,8/4/2014,780500.0,5,1.0,1760,4264,2.0,0.0,0.0,3,8,1760,0,1902,0,98112,47.6246,-122.31200000000001,2130,4264,8,4,2014,UNK,-370,0
5100402606,5/5/2015,680000.0,3,1.75,1090,6775,1.0,0.0,0.0,4,7,850,240,1950,0,98115,47.6934,-122.321,1580,5760,5,5,2015,UNK,-490,1015
3876300080,12/24/2014,434400.0,5,1.75,1960,7875,1.0,0.0,0.0,4,7,1960,0,1968,0,98034,47.7256,-122.18,1800,7764,12,24,2014,UNK,160,111
1246700050,6/12/2014,370000.0,2,1.0,1220,17172,1.0,0.0,0.0,4,6,1220,0,1947,0,98033,47.6934,-122.163,1510,12915,6,12,2014,UNK,-290,4257
1837010010,3/13/2015,465000.0,3,1.75,1730,8073,1.0,0.0,0.0,3,8,1350,380,1971,0,98177,47.7694,-122.367,2500,8073,3,13,2015,UNK,-770,0
1328320280,3/27/2015,323000.0,3,2.0,1830,6925,1.0,0.0,0.0,4,8,1830,0,1979,0,98058,47.4445,-122.12299999999999,2010,7350,3,27,2015,UNK,-180,-425
5468760050,1/5/2015,270000.0,4,2.5,1600,9921,2.0,0.0,0.0,3,7,1600,0,2009,0,98042,47.3678,-122.124,2140,5806,1,5,2015,N,-540,4115
5556300114,12/19/2014,1320000.0,3,1.75,2040,42693,1.0,0.0,2.0,3,10,2040,0,1980,0,98052,47.6479,-122.12,2640,11957,12,19,2014,UNK,-600,30736
2316800020,6/27/2014,560000.0,4,2.5,2710,6583,2.0,0.0,0.0,3,9,2710,0,2003,0,98059,47.4922,-122.141,2710,6583,6,27,2014,UNK,0,0
7133300675,4/28/2015,450000.0,3,1.0,1140,4500,1.0,0.0,0.0,3,6,840,300,1907,0,98144,47.5897,-122.314,1150,3000,4,28,2015,UNK,-10,1500
751000020,6/26/2014,290000.0,2,1.0,930,7740,1.0,0.0,0.0,3,6,930,0,1924,0,98125,47.7091,-122.292,1250,7740,6,26,2014,UNK,-320,0
3578400670,9/24/2014,354000.0,3,2.0,1010,21340,1.0,0.0,0.0,3,8,1010,0,1980,0,98074,47.6223,-122.04299999999999,1700,13045,9,24,2014,UNK,-690,8295
2767603890,3/4/2015,705000.0,5,3.0,2380,5000,2.0,0.0,0.0,5,7,2380,0,1909,0,98107,47.6722,-122.389,1800,4650,3,4,2015,UNK,580,350
9477000190,8/8/2014,445000.0,3,2.25,1860,7200,1.0,0.0,0.0,4,7,1240,620,1977,0,98034,47.7332,-122.19200000000001,1560,7630,8,8,2014,UNK,300,-430
2268000500,7/21/2014,229900.0,3,1.0,1440,11925,1.0,0.0,0.0,3,7,1440,0,1968,0,98003,47.2738,-122.3,1440,10425,7,21,2014,UNK,0,1500
7202271060,3/10/2015,610000.0,4,2.5,2980,5896,2.0,0.0,0.0,3,8,2980,0,2001,0,98053,47.6872,-122.036,2900,5712,3,10,2015,UNK,80,184
7852020080,12/10/2014,535000.0,3,3.25,2670,5108,2.0,0.0,2.0,3,9,2670,0,2000,0,98065,47.5342,-121.866,2670,6500,12,10,2014,UNK,0,-1392
3298400470,2/4/2015,437400.0,3,1.75,2150,8925,1.0,0.0,0.0,4,7,2150,0,1960,0,98008,47.6253,-122.119,1100,7875,2,4,2015,UNK,1050,1050
8854000010,8/12/2014,540000.0,5,2.75,3160,10059,2.0,0.0,0.0,3,10,1740,1420,1978,0,98011,47.7477,-122.21700000000001,3120,11557,8,12,2014,UNK,40,-1498
1624059093,6/30/2014,570000.0,3,2.0,1890,29185,1.0,0.0,0.0,3,7,1470,420,1949,2013,98006,47.5621,-122.16799999999999,2580,11600,6,30,2014,Y,-690,17585
8564950280,10/9/2014,533000.0,3,2.5,2810,4607,2.0,0.0,0.0,3,8,2810,0,2004,0,98011,47.7735,-122.227,2540,4871,10,9,2014,N,270,-264
7853230460,4/3/2015,555000.0,3,2.5,2690,4819,2.0,0.0,0.0,3,7,2690,0,2004,0,98065,47.5302,-121.84899999999999,2360,4829,4,3,2015,N,330,-10
1796350080,6/23/2014,239950.0,3,1.75,1230,9600,1.0,0.0,0.0,4,7,1230,0,1984,0,98042,47.3675,-122.095,1330,8250,6,23,2014,UNK,-100,1350
9477200460,1/8/2015,350000.0,3,1.0,950,9451,1.0,0.0,0.0,4,7,950,0,1977,0,98034,47.7308,-122.19,1480,8352,1,8,2015,UNK,-530,1099
7972601995,6/16/2014,245000.0,2,1.0,1200,4880,1.0,0.0,0.0,3,6,980,220,1943,0,98106,47.5276,-122.346,1040,4880,6,16,2014,UNK,160,0
1454100440,6/5/2014,456000.0,4,1.75,1670,9886,1.0,0.0,0.0,5,7,1670,0,1947,0,98125,47.7249,-122.287,2590,9997,6,5,2014,UNK,-920,-111
2558690130,8/13/2014,465000.0,4,2.25,2140,7701,1.0,0.0,0.0,4,7,1470,670,1977,0,98034,47.7213,-122.171,2130,8050,8,13,2014,UNK,10,-349
8682310470,1/7/2015,445000.0,2,1.75,1440,4660,1.0,0.0,2.0,3,8,1440,0,2008,0,98053,47.7092,-122.015,1680,4989,1,7,2015,N,-240,-329
3876000440,7/28/2014,517850.0,5,2.75,3050,7500,1.0,0.0,0.0,4,8,1800,1250,1966,0,98034,47.7249,-122.18700000000001,2060,7848,7,28,2014,UNK,990,-348
4137070440,9/30/2014,329000.0,5,2.75,2570,7260,2.0,0.0,0.0,3,8,2570,0,1996,0,98092,47.2622,-122.212,2200,7421,9,30,2014,UNK,370,-161
2391602500,5/15/2014,512500.0,3,2.5,1840,2875,2.0,0.0,0.0,4,7,1840,0,1997,0,98116,47.562,-122.39299999999999,1240,5750,5,15,2014,UNK,600,-2875
8632100010,6/4/2014,365000.0,2,1.0,1250,8100,1.0,0.0,0.0,4,7,1250,0,1947,0,98125,47.7294,-122.329,1710,8100,6,4,2014,UNK,-460,0
3034200426,3/20/2015,450500.0,3,1.0,1410,9384,1.0,0.0,0.0,3,7,1410,0,1948,0,98133,47.7161,-122.33,1990,9384,3,20,2015,UNK,-580,0
5078400190,10/16/2014,915000.0,3,1.0,1560,8232,1.0,0.0,0.0,3,7,1560,0,1952,0,98004,47.62300000000001,-122.205,1930,8286,10,16,2014,UNK,-370,-54
1450100420,6/20/2014,205000.0,3,1.0,960,7314,1.0,0.0,0.0,5,6,960,0,1960,0,98002,47.2891,-122.221,990,7314,6,20,2014,UNK,-30,0
1853500290,8/11/2014,314000.0,4,2.5,1870,8449,2.0,0.0,0.0,3,8,1870,0,1992,0,98188,47.4435,-122.274,2160,8113,8,11,2014,UNK,-290,336
8133700020,7/2/2014,496000.0,2,1.0,900,9260,1.0,0.0,0.0,3,7,900,0,1946,0,98107,47.6695,-122.36,1230,6913,7,2,2014,UNK,-330,2347
723059073,4/16/2015,329950.0,4,1.0,2050,7590,1.0,0.0,0.0,3,7,1280,770,1957,0,98178,47.4916,-122.22399999999999,2050,7800,4,16,2015,UNK,0,-210
2374200005,6/16/2014,375000.0,4,2.0,2400,6000,2.0,0.0,0.0,3,6,2400,0,1913,1945,98011,47.7607,-122.209,1780,8732,6,16,2014,Y,620,-2732
7420200050,6/20/2014,623000.0,3,2.5,1850,7777,2.0,0.0,0.0,5,8,1850,0,1989,0,98033,47.6908,-122.169,1850,8482,6,20,2014,UNK,0,-705
7211350130,6/19/2014,310000.0,4,1.5,1220,9600,1.0,0.0,0.0,3,6,1220,0,1980,0,98014,47.6462,-121.90899999999999,1180,9000,6,19,2014,UNK,40,600
7802900500,3/4/2015,532500.0,3,3.25,3140,37120,1.0,0.0,0.0,3,9,1760,0,1984,0,98065,47.5244,-121.84200000000001,2100,13500,3,4,2015,UNK,1040,23620
8081900101,5/28/2014,960000.0,4,2.25,2410,4560,2.0,0.0,2.0,5,9,1800,610,1929,0,98117,47.6796,-122.402,2150,5100,5,28,2014,UNK,260,-540
9510300130,6/28/2014,598000.0,4,2.5,3130,40918,2.0,0.0,0.0,3,9,3130,0,1994,0,98045,47.4761,-121.723,2760,35440,6,28,2014,UNK,370,5478
8582010290,8/14/2014,683000.0,3,2.5,2300,9218,2.0,0.0,2.0,3,9,2300,0,1998,0,98027,47.5504,-122.07700000000001,2730,9930,8,14,2014,UNK,-430,-712
4023500352,2/17/2015,425000.0,5,2.5,2840,9425,1.0,0.0,0.0,4,7,1590,1250,1962,0,98155,47.7609,-122.29700000000001,1900,11600,2,17,2015,UNK,940,-2175
9482700440,5/6/2014,533000.0,5,2.75,1800,3780,1.5,0.0,0.0,3,7,1400,400,1926,0,98103,47.6831,-122.34299999999999,1400,3780,5,6,2014,UNK,400,0
6117502455,5/13/2014,375000.0,3,1.0,1190,9486,1.0,0.0,0.0,4,7,1190,0,1953,0,98166,47.4319,-122.339,2100,10400,5,13,2014,UNK,-910,-914
2791500020,6/4/2014,250500.0,3,2.0,1710,7225,2.0,0.0,0.0,4,7,1710,0,1988,0,98023,47.2917,-122.37299999999999,1710,7225,6,4,2014,UNK,0,0
5643600351,8/6/2014,257000.0,4,1.75,1900,22896,1.5,0.0,0.0,3,7,1360,540,1922,1990,98010,47.3102,-122.023,1300,8960,8,6,2014,Y,600,13936
4059400585,6/24/2014,218000.0,3,1.0,880,18205,1.0,0.0,0.0,4,6,880,0,1945,0,98178,47.5013,-122.244,1110,16115,6,24,2014,UNK,-230,2090
9285800585,6/11/2014,460000.0,3,2.0,2060,4437,1.0,0.0,0.0,3,7,1030,1030,1929,0,98126,47.5705,-122.376,1750,4452,6,11,2014,UNK,310,-15
5727500561,4/14/2015,255544.0,3,1.0,1360,6186,1.5,0.0,0.0,4,6,760,600,1941,0,98133,47.7503,-122.334,1610,7453,4,14,2015,UNK,-250,-1267
8682310430,9/14/2014,560000.0,2,2.0,1680,4647,1.0,0.0,0.0,3,8,1680,0,2008,0,98053,47.7088,-122.015,1680,4950,9,14,2014,N,0,-303
3782760170,2/11/2015,480000.0,4,2.5,2980,4074,2.0,0.0,0.0,3,8,2980,0,2011,0,98019,47.733999999999995,-121.965,2320,4255,2,11,2015,N,660,-181
1925059073,10/10/2014,1300000.0,5,1.75,2130,19180,1.0,0.0,0.0,3,8,1500,630,1968,0,98004,47.63800000000001,-122.213,3650,19180,10,10,2014,UNK,-1520,0
6891800500,4/26/2015,580000.0,3,2.75,2650,9752,1.0,0.0,0.0,3,9,2650,0,1989,0,98028,47.768,-122.259,3030,9910,4,26,2015,UNK,-380,-158
4319200605,6/28/2014,475000.0,3,2.5,1700,9100,1.0,0.0,0.0,3,8,1160,540,1998,0,98126,47.5369,-122.37799999999999,1590,8374,6,28,2014,UNK,110,726
6117500460,6/30/2014,1310000.0,4,2.5,2680,12215,1.0,1.0,4.0,3,9,1590,1090,1956,0,98166,47.4396,-122.353,2960,19964,6,30,2014,UNK,-280,-7749
522079022,3/27/2015,700000.0,3,2.5,2530,623779,1.0,0.0,0.0,4,8,2530,0,1980,0,98038,47.4188,-121.949,2120,100623,3,27,2015,UNK,410,523156
3066410080,9/17/2014,590000.0,3,2.5,2520,10223,2.0,0.0,0.0,3,10,2520,0,1988,0,98074,47.631,-122.042,2630,10091,9,17,2014,UNK,-110,132
4137000280,2/22/2015,264500.0,3,2.5,1630,8346,1.0,0.0,0.0,3,8,1630,0,1990,0,98092,47.2622,-122.219,2110,8619,2,22,2015,UNK,-480,-273
2767600920,10/27/2014,465000.0,2,1.0,730,2600,1.0,0.0,0.0,4,6,730,0,1918,0,98107,47.6751,-122.37899999999999,1480,3900,10,27,2014,UNK,-750,-1300
7972601680,3/23/2015,290000.0,3,1.0,910,7620,1.0,0.0,2.0,3,7,910,0,1971,0,98106,47.5278,-122.34299999999999,1660,7620,3,23,2015,UNK,-750,0
1725059136,11/21/2014,1820000.0,4,4.5,4510,12873,2.0,0.0,2.0,3,12,4510,0,1998,0,98033,47.6491,-122.20100000000001,2200,8528,11,21,2014,UNK,2310,4345
4037000080,6/15/2014,416000.0,3,1.0,1110,12150,1.0,0.0,0.0,4,7,1110,0,1957,0,98008,47.6034,-122.12200000000001,1490,8200,6,15,2014,UNK,-380,3950
3580900290,1/28/2015,360000.0,4,2.0,1450,8940,1.0,0.0,0.0,3,7,1450,0,1962,0,98034,47.7304,-122.24,1310,8914,1,28,2015,UNK,140,26
7527410080,6/2/2014,585083.0,5,2.75,2910,36250,1.0,0.0,0.0,3,8,1590,1320,1977,0,98075,47.5916,-122.07600000000001,2910,37376,6,2,2014,UNK,0,-1126
2653000005,5/12/2014,840000.0,4,2.75,2600,2750,1.5,0.0,0.0,3,7,1620,980,1936,0,98119,47.6413,-122.35700000000001,1960,3705,5,12,2014,UNK,640,-955
3028200080,3/24/2015,81000.0,2,1.0,730,9975,1.0,0.0,0.0,1,5,730,0,1943,0,98168,47.4808,-122.315,860,9000,3,24,2015,UNK,-130,975
4218400005,1/30/2015,1290000.0,3,2.25,2440,9200,1.0,0.0,1.0,4,8,2440,0,1950,0,98105,47.6629,-122.26899999999999,2750,6211,1,30,2015,UNK,-310,2989
4058802335,11/25/2014,326000.0,4,1.75,2290,7380,1.0,0.0,0.0,3,7,1390,900,1963,0,98178,47.5034,-122.245,1170,7381,11,25,2014,UNK,1120,-1
2487200680,2/24/2015,447000.0,2,1.0,720,7500,1.0,0.0,2.0,3,6,720,0,1925,0,98136,47.5185,-122.39200000000001,1390,5000,2,24,2015,UNK,-670,2500
1950900005,10/3/2014,185000.0,3,1.0,940,7125,1.5,0.0,0.0,4,7,940,0,1958,0,98032,47.3756,-122.29700000000001,1170,7125,10,3,2014,UNK,-230,0
6647400250,7/23/2014,439950.0,3,2.5,1540,7773,2.0,0.0,0.0,4,8,1540,0,1982,0,98034,47.722,-122.194,1630,7340,7,23,2014,UNK,-90,433
9407000920,10/1/2014,234000.0,3,1.5,1140,10300,1.5,0.0,0.0,4,6,1140,0,1967,0,98045,47.4452,-121.77,1250,9975,10,1,2014,UNK,-110,325
8617000020,12/31/2014,485000.0,4,2.5,2100,8886,2.0,0.0,0.0,4,7,2100,0,1964,0,98007,47.5947,-122.134,1840,9058,12,31,2014,UNK,260,-172
1193000190,7/15/2014,750000.0,4,1.75,2670,6250,2.0,0.0,0.0,4,8,2020,650,1941,0,98199,47.6499,-122.391,1820,6250,7,15,2014,UNK,850,0
7443000480,5/7/2015,865000.0,4,2.0,2750,5527,2.0,0.0,0.0,3,8,2130,620,1901,1987,98119,47.6513,-122.368,1290,1764,5,7,2015,Y,1460,3763
2557000380,6/18/2014,287500.0,4,2.5,2570,9000,1.0,0.0,0.0,4,8,1590,980,1979,0,98023,47.2986,-122.37200000000001,2120,8571,6,18,2014,UNK,450,429
4450700010,7/8/2014,375000.0,3,1.75,1660,9673,1.0,0.0,0.0,3,7,1130,530,1976,0,98072,47.7628,-122.162,1260,9681,7,8,2014,UNK,400,-8
1236300307,9/5/2014,565000.0,3,2.25,1700,8800,1.0,0.0,0.0,5,7,850,850,1969,0,98033,47.6863,-122.189,2180,8960,9,5,2014,UNK,-480,-160
3422059249,2/19/2015,260000.0,4,3.0,1530,8306,2.0,0.0,0.0,3,7,1530,0,2010,0,98042,47.3528,-122.146,1930,6925,2,19,2015,N,-400,1381
9476200290,10/17/2014,190000.0,3,1.0,1260,10900,1.0,0.0,0.0,4,6,1260,0,1943,0,98056,47.49100000000001,-122.18799999999999,1090,8137,10,17,2014,UNK,170,2763
3812400898,9/9/2014,399950.0,5,2.0,2760,6420,1.0,0.0,0.0,5,7,1380,1380,1964,0,98118,47.5396,-122.27600000000001,1400,7112,9,9,2014,UNK,1360,-692
5422420470,3/26/2015,275000.0,3,2.5,1830,7062,2.0,0.0,0.0,3,7,1830,0,1990,0,98023,47.2895,-122.352,1820,6434,3,26,2015,UNK,10,628
2492200280,12/2/2014,528000.0,3,2.75,2160,4086,1.0,0.0,0.0,3,7,1380,780,1987,0,98126,47.5352,-122.38,1300,4080,12,2,2014,UNK,860,6
4331000130,10/17/2014,315000.0,3,2.0,1770,9685,1.0,0.0,0.0,3,5,1770,0,1948,0,98166,47.4753,-122.34200000000001,1520,11122,10,17,2014,UNK,250,-1437
6073500190,8/21/2014,614306.0,2,2.25,2210,5500,1.0,0.0,0.0,4,8,1410,800,1968,0,98117,47.696999999999996,-122.39,2140,6600,8,21,2014,UNK,70,-1100
9522300010,3/31/2015,1490000.0,3,3.5,4560,14608,2.0,0.0,2.0,3,12,4560,0,1990,0,98034,47.6995,-122.228,4050,14226,3,31,2015,UNK,510,382
3629910470,7/29/2014,590000.0,3,2.5,2110,3870,2.0,0.0,0.0,3,9,2110,0,2004,0,98029,47.5513,-121.994,2300,3870,7,29,2014,N,-190,0
1250200285,3/17/2015,261500.0,3,1.0,1130,3600,1.0,0.0,0.0,3,6,1130,0,1908,0,98144,47.5978,-122.29899999999999,1710,2231,3,17,2015,UNK,-580,1369
1509700050,5/23/2014,300000.0,4,2.5,1960,9898,2.0,0.0,0.0,3,8,1960,0,2001,0,98030,47.3834,-122.16799999999999,2130,7662,5,23,2014,UNK,-170,2236
2045800006,9/4/2014,439000.0,3,2.25,2230,4551,1.5,0.0,2.0,5,8,1450,780,1928,0,98178,47.5078,-122.236,2060,7200,9,4,2014,UNK,170,-2649
2171400199,9/4/2014,277554.0,5,2.25,2350,13000,1.0,0.0,0.0,3,7,2350,0,1961,0,98178,47.4939,-122.256,1570,11440,9,4,2014,UNK,780,1560
2123049502,6/23/2014,215000.0,3,2.0,1340,8505,1.0,0.0,0.0,3,6,1340,0,1931,0,98168,47.4727,-122.29700000000001,1370,9000,6,23,2014,UNK,-30,-495
284000095,9/22/2014,1200000.0,2,2.25,2160,17861,2.0,1.0,4.0,4,9,2160,0,1956,0,98146,47.501999999999995,-122.385,2660,18530,9,22,2014,UNK,-500,-669
5652600427,2/24/2015,420000.0,4,2.0,1700,6375,1.0,0.0,0.0,4,7,850,850,1950,0,98115,47.6973,-122.295,1470,8360,2,24,2015,UNK,230,-1985
7202330470,4/8/2015,485000.0,3,2.5,1650,3436,2.0,0.0,0.0,3,7,1650,0,2003,0,98053,47.6819,-122.036,1680,3446,4,8,2015,UNK,-30,-10
6131600255,12/22/2014,202500.0,3,2.0,1540,8316,1.0,0.0,0.0,5,6,1540,0,1954,0,98002,47.323,-122.21600000000001,1250,8316,12,22,2014,UNK,290,0
7853301660,2/23/2015,710000.0,5,3.25,3920,8572,2.0,0.0,0.0,3,9,3920,0,2007,0,98065,47.5427,-121.887,3335,7258,2,23,2015,N,585,1314
9211010440,4/30/2015,535000.0,4,2.5,3250,6933,2.0,0.0,0.0,3,8,3250,0,2009,0,98059,47.4956,-122.15100000000001,3030,5308,4,30,2015,N,220,1625
1423900080,12/18/2014,260000.0,4,1.75,1360,7700,1.0,0.0,0.0,4,7,1360,0,1966,0,98058,47.4558,-122.177,1321,7756,12,18,2014,UNK,39,-56
2215901190,5/28/2014,254000.0,3,2.0,1480,7480,1.0,0.0,0.0,4,7,1480,0,1992,0,98038,47.3542,-122.055,1680,7146,5,28,2014,UNK,-200,334
251100020,5/21/2014,600000.0,4,2.5,2360,5226,2.0,0.0,0.0,3,8,2360,0,2001,0,98034,47.711999999999996,-122.229,2440,5156,5,21,2014,UNK,-80,70
3395041206,9/25/2014,285000.0,3,2.5,1800,2516,2.0,0.0,0.0,3,7,1800,0,2001,0,98108,47.5401,-122.29299999999999,1800,2562,9,25,2014,UNK,0,-46
224069169,10/23/2014,800000.0,4,3.75,2540,20662,2.0,0.0,0.0,3,10,2540,0,1998,0,98075,47.5882,-122.01,2490,37731,10,23,2014,UNK,50,-17069
3365901435,6/23/2014,165000.0,3,1.0,1200,13100,1.0,0.0,0.0,3,6,1200,0,1943,0,98168,47.475,-122.258,1960,11285,6,23,2014,UNK,-760,1815
7689600630,11/6/2014,216500.0,2,1.0,710,6960,1.0,0.0,0.0,4,6,710,0,1943,0,98178,47.4886,-122.24600000000001,940,7680,11,6,2014,UNK,-230,-720
3158500290,9/19/2014,387990.0,4,2.5,2640,5595,2.0,0.0,0.0,3,8,2640,0,2011,0,98038,47.3551,-122.054,1840,5011,9,19,2014,N,800,584
7189800095,11/4/2014,500000.0,4,2.5,3010,5040,2.0,0.0,0.0,3,8,3010,0,2006,0,98133,47.708999999999996,-122.35,1090,5040,11,4,2014,N,1920,0
7202270440,10/23/2014,650000.0,4,2.5,2770,5612,2.0,0.0,0.0,3,7,2770,0,2001,0,98053,47.68600000000001,-122.036,2770,5177,10,23,2014,UNK,0,435
3501600114,6/19/2014,646000.0,4,2.5,2310,4079,2.0,0.0,0.0,3,8,2310,0,2008,0,98117,47.6937,-122.361,1220,4800,6,19,2014,N,1090,-721
8097000250,1/30/2015,323400.0,4,3.0,2060,9138,1.0,0.0,0.0,3,8,1430,630,1992,0,98092,47.32100000000001,-122.185,2250,7820,1,30,2015,UNK,-190,1318
9542830430,8/6/2014,300000.0,3,2.5,1880,4200,2.0,0.0,0.0,3,7,1880,0,2007,0,98038,47.36600000000001,-122.01700000000001,2090,4200,8,6,2014,N,-210,0
6012500170,10/7/2014,712500.0,5,2.0,2280,5400,1.5,0.0,0.0,4,7,1340,940,1947,0,98105,47.6674,-122.279,1770,5000,10,7,2014,UNK,510,400
7217400895,6/9/2014,550000.0,3,1.75,1380,3402,1.5,0.0,0.0,3,7,1380,0,1900,2000,98122,47.6109,-122.302,1500,5496,6,9,2014,Y,-120,-2094
2651100050,2/17/2015,400000.0,3,1.0,1180,7537,1.0,0.0,0.0,3,7,1180,0,1969,0,98034,47.7233,-122.221,1220,7425,2,17,2015,UNK,-40,112
2212200050,10/28/2014,255000.0,4,1.75,1650,7200,1.0,0.0,0.0,3,7,1100,550,1977,0,98031,47.3944,-122.18700000000001,1620,7374,10,28,2014,UNK,30,-174
7922900460,12/5/2014,660000.0,3,1.75,2030,9032,2.0,0.0,2.0,4,7,2030,0,1963,0,98008,47.58600000000001,-122.117,2350,8937,12,5,2014,UNK,-320,95
8925100440,3/23/2015,925000.0,4,2.25,2110,6375,1.0,0.0,2.0,4,8,1600,0,1941,0,98115,47.6819,-122.272,2760,6375,3,23,2015,UNK,-650,0
259800680,8/5/2014,534000.0,4,2.25,2130,7210,1.0,0.0,0.0,5,7,1330,800,1965,0,98008,47.629,-122.117,1310,7896,8,5,2014,UNK,820,-686
271200130,11/19/2014,215000.0,3,1.0,1690,7700,1.0,0.0,0.0,4,7,1690,0,1969,0,98003,47.3444,-122.304,1590,7700,11,19,2014,UNK,100,0
3760500280,10/14/2014,1950000.0,3,2.5,2510,12779,1.5,0.0,4.0,3,10,2510,0,1968,0,98034,47.6982,-122.23100000000001,2810,12225,10,14,2014,UNK,-300,554
5315100277,5/13/2014,1400000.0,5,4.25,3530,7924,2.0,0.0,0.0,3,10,3530,0,2001,0,98040,47.5894,-122.243,1750,9226,5,13,2014,UNK,1780,-1302
9265410010,2/3/2015,212000.0,3,1.75,1470,8350,1.0,0.0,0.0,3,7,1470,0,1990,0,98001,47.2587,-122.25299999999999,1590,8182,2,3,2015,UNK,-120,168
8731800840,6/19/2014,265000.0,3,1.75,1840,7300,1.0,0.0,0.0,3,8,1840,0,1966,0,98023,47.3122,-122.369,1920,8010,6,19,2014,UNK,-80,-710
7579200715,12/5/2014,400000.0,3,1.75,1860,5750,1.5,0.0,0.0,5,6,1300,560,1918,0,98116,47.5586,-122.383,1550,5750,12,5,2014,UNK,310,0
9485300010,2/13/2015,311500.0,4,2.5,1940,10133,2.0,0.0,0.0,3,8,1940,0,1992,0,98031,47.3877,-122.171,1940,7265,2,13,2015,UNK,0,2868
1652500010,3/26/2015,2330000.0,4,3.5,4420,20759,2.0,0.0,0.0,3,11,4420,0,2003,0,98004,47.6354,-122.221,3020,20666,3,26,2015,UNK,1400,93
4059400190,10/17/2014,225000.0,2,1.0,800,6050,1.0,0.0,0.0,4,6,800,0,1944,0,98178,47.5001,-122.242,880,6050,10,17,2014,UNK,-80,0
8965510190,6/10/2014,1250000.0,4,2.5,3700,21755,1.0,0.0,4.0,3,11,2620,1080,1988,0,98006,47.5662,-122.10799999999999,3480,13786,6,10,2014,UNK,220,7969
7100000250,2/11/2015,380000.0,3,1.0,1400,8710,1.0,0.0,0.0,4,7,1400,0,1948,0,98146,47.5066,-122.37700000000001,1460,8710,2,11,2015,UNK,-60,0
2541100010,7/8/2014,600000.0,4,2.5,2250,11370,2.0,0.0,0.0,3,8,2250,0,1991,0,98034,47.7115,-122.23899999999999,2190,9611,7,8,2014,UNK,60,1759
7732410130,5/21/2014,600000.0,3,2.25,2230,9053,2.0,0.0,0.0,4,9,2230,0,1987,0,98007,47.6594,-122.14399999999999,2390,8038,5,21,2014,UNK,-160,1015
7889600285,12/18/2014,315000.0,3,2.5,1950,3000,2.0,0.0,0.0,3,7,1950,0,2001,0,98146,47.4938,-122.337,1620,6000,12,18,2014,UNK,330,-3000
1556200005,6/3/2014,847000.0,5,1.0,2550,4623,2.5,0.0,0.0,4,9,2550,0,1905,0,98122,47.6092,-122.294,1570,3875,6,3,2014,UNK,980,748
8691310980,4/9/2015,730000.0,4,2.5,2750,10351,2.0,0.0,0.0,3,10,2750,0,1998,0,98075,47.5894,-121.98,3370,10351,4,9,2015,UNK,-620,0
1561600095,5/14/2014,1060000.0,4,2.0,2290,11137,1.0,0.0,0.0,4,8,2290,0,1955,0,98004,47.5887,-122.20100000000001,2300,10463,5,14,2014,UNK,-10,674
3025300250,5/13/2015,1620000.0,4,2.25,2350,17709,2.0,0.0,0.0,4,9,2350,0,1977,0,98039,47.6232,-122.236,3360,19855,5,13,2015,UNK,-1010,-2146
5297200089,4/15/2015,664000.0,2,1.75,1720,5785,1.0,0.0,0.0,3,6,860,860,1948,2002,98118,47.5554,-122.274,1680,5184,4,15,2015,Y,40,601
3303860630,4/27/2015,454450.0,4,3.0,2810,6000,2.0,0.0,0.0,3,9,2810,0,2007,0,98038,47.3689,-122.057,2790,6000,4,27,2015,N,20,0
6430500086,1/16/2015,341000.0,3,1.0,940,4200,1.0,0.0,0.0,3,7,940,0,1955,0,98103,47.6878,-122.35,1380,4080,1,16,2015,UNK,-440,120
4025300285,10/29/2014,276693.0,4,1.0,1190,8875,1.5,0.0,0.0,4,7,1190,0,1946,0,98155,47.7487,-122.303,1190,8875,10,29,2014,UNK,0,0
923049400,11/19/2014,185000.0,2,1.0,1390,11340,1.0,0.0,0.0,4,7,1390,0,1969,0,98168,47.4969,-122.3,1200,10224,11,19,2014,UNK,190,1116
5466300130,9/17/2014,160000.0,2,2.5,1660,2258,2.0,0.0,0.0,3,7,1660,0,1981,0,98042,47.3793,-122.146,1740,2390,9,17,2014,UNK,-80,-132
4136900250,6/2/2014,270000.0,4,2.5,1920,8497,2.0,0.0,0.0,3,8,1920,0,1998,0,98092,47.2608,-122.209,1940,8436,6,2,2014,UNK,-20,61
7635800313,7/18/2014,300000.0,4,1.5,1460,8760,1.0,0.0,0.0,3,7,1460,0,1958,0,98166,47.4698,-122.36,1610,9375,7,18,2014,UNK,-150,-615
2938100005,8/29/2014,264950.0,3,1.5,1370,10115,1.0,0.0,0.0,4,7,1370,0,1957,0,98022,47.2027,-122.0,1450,9282,8,29,2014,UNK,-80,833
796000235,4/1/2015,209950.0,2,1.0,1050,6250,1.0,0.0,0.0,4,6,840,210,1943,0,98168,47.5024,-122.333,1310,12500,4,1,2015,UNK,-260,-6250
8682280170,3/30/2015,850000.0,3,2.5,3360,8708,2.0,0.0,0.0,3,9,3360,0,2006,0,98053,47.7037,-122.016,1810,4764,3,30,2015,N,1550,3944
7504110780,5/16/2014,645000.0,4,2.5,3160,11380,2.0,0.0,0.0,3,9,3160,0,1983,0,98074,47.6318,-122.039,2970,10385,5,16,2014,UNK,190,995
1445500010,1/13/2015,855000.0,4,2.25,2480,36974,2.0,0.0,0.0,4,9,2480,0,1973,0,98005,47.6441,-122.154,3160,35070,1,13,2015,UNK,-680,1904
7574910420,12/1/2014,632500.0,4,1.5,2720,37258,2.0,0.0,0.0,3,10,2720,0,1994,0,98077,47.7402,-122.035,3270,39714,12,1,2014,UNK,-550,-2456
2115720130,8/21/2014,289950.0,3,2.5,2070,5013,2.0,0.0,0.0,3,8,2070,0,1987,0,98023,47.3202,-122.395,1670,5013,8,21,2014,UNK,400,0
3586500630,9/24/2014,850000.0,2,1.75,2170,25732,1.0,0.0,2.0,4,8,2170,0,1952,0,98177,47.7542,-122.37200000000001,3020,23135,9,24,2014,UNK,-850,2597
9475960050,6/20/2014,565000.0,4,2.75,3260,4900,2.0,0.0,0.0,3,9,3260,0,2013,0,98059,47.4812,-122.12299999999999,3260,6132,6,20,2014,N,0,-1232
7527000020,4/25/2015,792000.0,3,2.5,2250,19270,2.0,0.0,0.0,3,8,2250,0,1999,0,98074,47.6569,-122.088,2940,19541,4,25,2015,UNK,-690,-271
3668000500,12/22/2014,260000.0,3,2.25,1950,9600,1.0,0.0,0.0,4,7,1200,750,1987,0,98092,47.2762,-122.148,1760,8850,12,22,2014,UNK,190,750
1549500585,4/27/2015,585000.0,3,2.0,2220,209523,1.0,0.0,0.0,3,7,2220,0,1991,0,98019,47.7586,-121.911,1600,210830,4,27,2015,UNK,620,-1307
8898700680,7/30/2014,295500.0,3,1.75,1330,10523,1.0,0.0,0.0,3,7,1000,330,1981,0,98055,47.4605,-122.206,1320,8775,7,30,2014,UNK,10,1748
6163901061,12/11/2014,329000.0,4,2.0,1190,7877,1.5,0.0,0.0,5,7,1190,0,1946,0,98155,47.7538,-122.322,1480,9975,12,11,2014,UNK,-290,-2098
7855600080,3/30/2015,750000.0,3,1.75,2770,15232,1.0,0.0,0.0,3,8,1570,1200,1976,0,98006,47.5706,-122.16,2340,11400,3,30,2015,UNK,430,3832
4024100807,2/25/2015,495000.0,4,2.5,2310,7555,2.0,0.0,0.0,3,9,2310,0,1997,0,98155,47.7544,-122.303,1980,8416,2,25,2015,UNK,330,-861
5037300130,5/4/2015,672500.0,3,1.75,1580,5750,1.0,0.0,2.0,4,8,1330,250,1947,0,98199,47.6339,-122.39200000000001,2480,5750,5,4,2015,UNK,-900,0
3528900086,5/8/2014,1310000.0,5,3.25,2800,3200,1.5,0.0,0.0,5,10,1910,890,1932,2002,98109,47.6421,-122.35,2450,3500,5,8,2014,Y,350,-300
1552520010,8/1/2014,405000.0,3,2.5,1500,9636,2.0,0.0,0.0,3,7,1500,0,1994,0,98011,47.75,-122.176,1700,9656,8,1,2014,UNK,-200,-20
5113400168,1/16/2015,620000.0,3,1.75,2140,5808,1.0,0.0,1.0,3,7,1070,1070,1947,0,98119,47.6435,-122.37299999999999,1930,5808,1,16,2015,UNK,210,0
9346900170,9/22/2014,615000.0,4,2.25,2330,7020,1.0,0.0,0.0,4,8,1450,880,1973,0,98006,47.562,-122.139,2330,8500,9,22,2014,UNK,0,-1480
3999300080,9/4/2014,887000.0,6,2.25,3830,11180,1.0,0.0,2.0,5,9,2440,1390,1962,0,98008,47.5849,-122.113,2500,10400,9,4,2014,UNK,1330,780
472000895,9/22/2014,1060000.0,4,2.75,4510,5000,2.5,0.0,2.0,3,8,3270,1240,1941,2000,98117,47.6852,-122.4,2010,5000,9,22,2014,Y,2500,0
687600010,8/5/2014,753000.0,4,1.75,2160,39430,1.0,0.0,0.0,4,8,1660,500,1974,0,98005,47.6378,-122.185,2430,35329,8,5,2014,UNK,-270,4101
1130000005,7/15/2014,1600000.0,3,2.25,3170,5000,2.0,0.0,0.0,5,10,2230,940,1975,0,98102,47.6349,-122.318,3170,5400,7,15,2014,UNK,0,-400
7397300170,5/30/2014,3710000.0,4,3.5,5550,28078,2.0,0.0,2.0,4,12,3350,2200,2000,0,98039,47.6395,-122.234,2980,19602,5,30,2014,UNK,2570,8476
1077100020,12/31/2014,365000.0,3,1.5,1520,8519,1.0,0.0,0.0,3,7,1520,0,1954,0,98133,47.7712,-122.339,1570,9000,12,31,2014,UNK,-50,-481
7856570190,8/22/2014,870000.0,4,2.75,3410,23000,2.0,0.0,0.0,4,10,3410,0,1982,0,98006,47.5559,-122.149,2490,15512,8,22,2014,UNK,920,7488
5104510010,7/1/2014,321000.0,4,2.5,1830,9601,2.0,0.0,0.0,3,7,1830,0,2003,0,98038,47.3541,-122.015,1830,5892,7,1,2014,UNK,0,3709
2895550050,5/7/2015,280000.0,3,2.5,1550,4486,2.0,0.0,0.0,3,7,1550,0,2000,0,98001,47.3299,-122.26899999999999,1700,4487,5,7,2015,UNK,-150,-1
4142450480,7/3/2014,288000.0,3,2.5,1520,3593,2.0,0.0,0.0,3,7,1520,0,2004,0,98038,47.3842,-122.042,1610,3612,7,3,2014,N,-90,-19
5559200020,2/27/2015,248500.0,3,2.0,1240,12285,1.0,0.0,0.0,3,7,620,620,1939,1991,98023,47.3219,-122.34100000000001,1560,11564,2,27,2015,Y,-320,721
5381000352,6/22/2014,330000.0,4,2.5,2380,13550,2.0,0.0,0.0,3,7,2380,0,1999,0,98188,47.4486,-122.288,1230,9450,6,22,2014,UNK,1150,4100
2474300050,7/22/2014,740000.0,5,3.5,2720,11454,2.0,0.0,0.0,3,9,1830,890,1988,0,98052,47.6466,-122.119,2920,11310,7,22,2014,UNK,-200,144
7787110680,9/23/2014,445000.0,3,2.5,2210,8010,2.0,0.0,0.0,3,8,2210,0,1998,0,98045,47.4845,-121.775,2430,9600,9,23,2014,UNK,-220,-1590
1788700185,3/6/2015,198500.0,2,1.0,1050,9600,1.0,0.0,0.0,4,6,1050,0,1959,0,98023,47.3274,-122.346,990,8880,3,6,2015,UNK,60,720
2887950020,6/25/2014,280000.0,7,2.5,1940,5458,2.0,0.0,0.0,3,7,1940,0,1994,0,98092,47.3191,-122.177,1710,5688,6,25,2014,UNK,230,-230
8835210480,7/10/2014,336500.0,3,2.25,1420,3433,2.0,0.0,0.0,4,7,1420,0,1981,0,98034,47.7245,-122.163,1150,3432,7,10,2014,UNK,270,1
844000225,2/11/2015,267000.0,3,2.5,1690,10336,2.0,0.0,0.0,4,7,1690,0,1989,0,98010,47.31100000000001,-122.00299999999999,1580,7700,2,11,2015,UNK,110,2636
1771000430,5/2/2014,315000.0,3,1.0,1160,9180,1.0,0.0,0.0,3,7,1160,0,1968,0,98077,47.7427,-122.072,1160,10282,5,2,2014,UNK,0,-1102
8078430480,8/6/2014,545000.0,4,2.5,2040,7412,2.0,0.0,0.0,3,8,2040,0,1988,0,98074,47.6347,-122.02600000000001,2050,7830,8,6,2014,UNK,-10,-418
8001450170,8/4/2014,274950.0,3,1.75,1840,16679,1.0,0.0,0.0,3,8,1840,0,1989,0,98001,47.3207,-122.275,1910,15571,8,4,2014,UNK,-70,1108
8924100430,12/24/2014,500000.0,2,1.0,1440,7130,1.0,0.0,2.0,3,7,1210,230,1948,0,98115,47.6778,-122.26700000000001,1970,7130,12,24,2014,UNK,-530,0
7418700050,5/28/2014,299000.0,3,1.0,1390,9624,1.5,0.0,0.0,4,7,1390,0,1954,0,98155,47.7758,-122.301,1440,9624,5,28,2014,UNK,-50,0
3630020430,5/5/2015,420000.0,3,2.5,1470,1445,2.0,0.0,0.0,3,8,1160,310,2005,0,98029,47.5468,-121.99799999999999,1470,1525,5,5,2015,N,0,-80
1972200725,4/7/2015,620000.0,3,2.5,1776,1248,3.0,0.0,0.0,3,8,1604,172,2006,0,98103,47.6539,-122.352,1780,1248,4,7,2015,N,-4,0
267000170,12/10/2014,575950.0,3,2.25,1640,12000,1.0,0.0,0.0,3,7,1180,460,1967,0,98008,47.6252,-122.104,1620,12000,12,10,2014,UNK,20,0
8961980290,9/4/2014,666500.0,4,2.5,2860,6600,2.0,0.0,0.0,3,9,2860,0,2000,0,98074,47.6067,-122.01700000000001,2790,6723,9,4,2014,UNK,70,-123
1551500130,5/22/2014,180000.0,4,1.5,1740,7292,1.0,0.0,0.0,3,7,1020,720,1962,0,98168,47.4787,-122.302,1740,7573,5,22,2014,UNK,0,-281
5557800010,6/23/2014,261350.0,3,1.75,1390,18200,1.0,0.0,0.0,4,7,1390,0,1962,0,98023,47.3208,-122.337,1810,9675,6,23,2014,UNK,-420,8525
3776300010,2/24/2015,1030000.0,4,3.5,2730,5607,1.0,0.0,0.0,5,9,1660,1070,1948,0,98199,47.6387,-122.396,1720,5400,2,24,2015,UNK,1010,207
2473000680,4/29/2015,390000.0,3,1.75,1435,8960,1.0,0.0,0.0,4,8,1435,0,1969,0,98058,47.4525,-122.149,2030,9450,4,29,2015,UNK,-595,-490
7984400005,6/26/2014,253500.0,3,1.0,1640,12384,1.0,0.0,0.0,4,7,1090,550,1954,0,98003,47.3256,-122.29799999999999,1550,11200,6,26,2014,UNK,90,1184
9238430680,5/21/2014,625000.0,4,2.5,2630,48706,2.0,0.0,0.0,3,8,2630,0,1986,0,98072,47.775,-122.125,2680,48706,5,21,2014,UNK,-50,0
3211000170,9/22/2014,255000.0,4,2.5,1580,7800,1.0,0.0,0.0,4,7,1580,0,1959,0,98059,47.481,-122.163,1320,7800,9,22,2014,UNK,260,0
7338220280,10/10/2014,257000.0,3,2.5,1740,3721,2.0,0.0,0.0,3,8,1740,0,2009,0,98002,47.3363,-122.213,2030,3794,10,10,2014,N,-290,-73
8073000480,7/22/2014,869000.0,2,1.75,1900,13122,1.0,1.0,4.0,3,7,1100,800,1954,0,98178,47.5121,-122.24799999999999,1650,13160,7,22,2014,UNK,250,-38
7525530670,11/12/2014,745000.0,4,2.5,3130,10860,2.0,0.0,0.0,3,10,3130,0,1990,0,98075,47.56,-122.04,3130,10860,11,12,2014,UNK,0,0
191100275,9/26/2014,1350000.0,4,3.5,3500,9525,2.0,0.0,0.0,3,10,3500,0,1999,0,98040,47.5641,-122.221,2630,9525,9,26,2014,UNK,870,0
1214000050,10/20/2014,350000.0,3,1.75,2130,7500,1.0,0.0,0.0,4,7,1090,1040,1956,0,98166,47.4593,-122.34299999999999,1590,7500,10,20,2014,UNK,540,0
6852700279,6/19/2014,475000.0,3,2.5,950,1110,2.0,0.0,0.0,3,8,950,0,2003,0,98102,47.6226,-122.319,1230,1215,6,19,2014,UNK,-280,-105
5423600080,9/18/2014,540000.0,3,2.5,1720,11656,2.0,0.0,0.0,3,8,1720,0,1987,1999,98052,47.6791,-122.113,1890,10336,9,18,2014,Y,-170,1320
6661200050,5/28/2014,175000.0,2,1.0,830,2699,1.0,0.0,0.0,3,7,830,0,1996,0,98038,47.3839,-122.038,1030,3574,5,28,2014,UNK,-200,-875
6146600170,7/3/2014,100000.0,2,0.75,660,5240,1.0,0.0,0.0,4,4,660,0,1912,0,98032,47.3881,-122.234,850,5080,7,3,2014,UNK,-190,160
366000095,10/9/2014,890000.0,5,1.0,2590,4652,2.0,0.0,0.0,4,8,2310,280,1907,0,98122,47.6038,-122.294,2360,4650,10,9,2014,UNK,230,2
2895550280,5/7/2014,280000.0,3,2.5,1600,4271,2.0,0.0,0.0,3,7,1600,0,2000,0,98001,47.3303,-122.26899999999999,1700,4746,5,7,2014,UNK,-100,-475
293760050,6/27/2014,1050000.0,4,4.25,4390,13833,2.0,0.0,3.0,3,10,3320,1070,2003,0,98029,47.5566,-122.02600000000001,3850,11652,6,27,2014,UNK,540,2181
7298040500,7/9/2014,486000.0,4,2.5,3560,12047,2.0,0.0,0.0,3,10,3560,0,1988,0,98023,47.3019,-122.34100000000001,3420,11250,7,9,2014,UNK,140,797
7802900224,7/7/2014,670000.0,5,2.5,2860,68519,2.0,0.0,0.0,5,8,2860,0,1958,0,98065,47.5265,-121.835,1670,35910,7,7,2014,UNK,1190,32609
3904910010,7/23/2014,480000.0,3,2.5,1640,7847,2.0,0.0,0.0,3,8,1640,0,1987,0,98029,47.5684,-122.01799999999999,1870,6079,7,23,2014,UNK,-230,1768
8121100255,5/7/2014,440000.0,3,1.75,1500,6180,1.0,0.0,0.0,4,6,1060,440,1947,0,98118,47.5689,-122.28399999999999,1740,6180,5,7,2014,UNK,-240,0
5700004040,9/5/2014,1500000.0,3,3.25,3990,8505,2.0,0.0,2.0,3,9,2870,1120,1922,1999,98144,47.5744,-122.28299999999999,3640,8505,9,5,2014,Y,350,0
3528000290,6/9/2014,743700.0,4,2.5,2610,33206,2.0,0.0,0.0,3,10,2610,0,1988,0,98053,47.6662,-122.057,2870,28295,6,9,2014,UNK,-260,4911
9268200050,8/14/2014,449950.0,3,1.75,1470,7590,1.0,0.0,0.0,3,7,1470,0,1988,0,98117,47.6964,-122.36200000000001,1700,5080,8,14,2014,UNK,-230,2510
6132600221,5/19/2014,367000.0,2,1.0,700,2334,1.0,0.0,0.0,3,7,700,0,1945,0,98117,47.701,-122.39,2300,5000,5,19,2014,UNK,-1600,-2666
3303980470,12/1/2014,1190000.0,4,3.25,3960,12895,2.0,0.0,0.0,3,11,3960,0,2001,0,98059,47.5211,-122.15100000000001,3870,12040,12,1,2014,UNK,90,855
1450000050,5/1/2015,201000.0,3,1.0,900,7576,1.0,0.0,0.0,4,6,900,0,1959,0,98002,47.2881,-122.22,1220,7452,5,1,2015,UNK,-320,124
6788200605,12/23/2014,575000.0,3,1.75,2010,3800,2.0,0.0,0.0,2,7,2010,0,1922,0,98112,47.6408,-122.307,1540,3800,12,23,2014,UNK,470,0
2214800170,4/15/2015,295000.0,3,2.5,1940,10350,1.0,0.0,0.0,3,7,1420,520,1979,0,98001,47.3385,-122.256,1810,7800,4,15,2015,UNK,130,2550
7116000225,2/20/2015,190000.0,3,1.0,1510,8760,1.0,0.0,0.0,4,6,1510,0,1946,0,98002,47.3015,-122.21600000000001,1040,7828,2,20,2015,UNK,470,932
2767600635,5/7/2015,742500.0,2,3.0,2020,5000,1.0,0.0,0.0,3,8,1350,670,1952,0,98117,47.6758,-122.375,1160,1118,5,7,2015,UNK,860,3882
1644500050,3/12/2015,875000.0,6,3.5,4430,11453,2.0,0.0,0.0,3,9,3000,1430,2001,0,98056,47.5156,-122.204,2730,5661,3,12,2015,UNK,1700,5792
2579500101,4/21/2015,1390000.0,4,3.5,4010,10880,2.0,0.0,3.0,4,11,3150,860,1990,0,98040,47.5359,-122.213,3530,17310,4,21,2015,UNK,480,-6430
3876311650,6/19/2014,600000.0,4,2.25,3070,8400,2.0,0.0,0.0,4,8,3070,0,1970,0,98034,47.7316,-122.169,1880,8000,6,19,2014,UNK,1190,400
7984400050,9/22/2014,207000.0,3,1.5,1460,11100,1.0,0.0,0.0,3,7,1460,0,1956,0,98003,47.3253,-122.29799999999999,1460,11100,9,22,2014,UNK,0,0
7852170130,4/21/2015,650000.0,4,2.75,3260,5335,2.0,0.0,0.0,3,9,3260,0,2003,0,98065,47.5414,-121.86399999999999,3180,5438,4,21,2015,UNK,80,-103
9358000780,5/12/2015,275000.0,2,1.0,830,5610,1.0,0.0,0.0,3,6,830,0,1922,0,98126,47.5674,-122.367,1310,2793,5,12,2015,UNK,-480,2817
2663000345,4/8/2015,1200000.0,4,2.5,2390,4200,2.0,0.0,0.0,3,9,2150,240,1924,0,98102,47.6272,-122.318,2800,5250,4,8,2015,UNK,-410,-1050
4338800500,10/14/2014,262500.0,3,2.0,1130,7200,1.0,0.0,0.0,4,6,1130,0,1944,0,98166,47.4779,-122.34200000000001,1270,7500,10,14,2014,UNK,-140,-300
5101407350,9/25/2014,399000.0,2,1.0,1120,8661,1.0,0.0,0.0,3,7,1120,0,1946,0,98125,47.7034,-122.307,1470,7205,9,25,2014,UNK,-350,1456
3512100050,2/24/2015,139000.0,4,1.5,1410,10648,1.0,0.0,0.0,4,7,1410,0,1966,0,98030,47.3736,-122.18799999999999,1410,10522,2,24,2015,UNK,0,126
6633900050,8/26/2014,575000.0,3,2.5,1750,4797,2.0,0.0,0.0,4,7,1750,0,1991,0,98033,47.6954,-122.199,1750,4293,8,26,2014,UNK,0,504
4083301950,11/20/2014,580000.0,2,1.0,1040,3200,1.0,0.0,0.0,3,7,1040,0,1926,0,98103,47.6558,-122.334,1890,4000,11,20,2014,UNK,-850,-800
7202350010,7/25/2014,468000.0,3,2.25,1630,2490,2.0,0.0,0.0,3,7,1630,0,2004,0,98053,47.6807,-122.031,1630,2680,7,25,2014,N,0,-190
4168100130,3/10/2015,230000.0,3,1.0,1380,10112,1.0,0.0,0.0,4,7,940,440,1963,0,98023,47.3196,-122.351,1240,10112,3,10,2015,UNK,140,0
8155850010,5/7/2014,675000.0,4,4.0,3680,18804,2.0,0.0,0.0,3,10,3680,0,1990,0,98074,47.6193,-122.014,3200,15954,5,7,2014,UNK,480,2850
7955030010,10/10/2014,318000.0,3,1.0,1250,20040,1.0,0.0,0.0,3,7,1250,0,1970,0,98072,47.7514,-122.10799999999999,1640,19840,10,10,2014,UNK,-390,200
4136870020,10/8/2014,332100.0,5,3.5,2660,6978,2.0,0.0,0.0,3,8,1980,680,1996,0,98092,47.2631,-122.212,2220,7294,10,8,2014,UNK,440,-316
1446401190,3/17/2015,175000.0,2,1.0,620,6600,1.0,0.0,0.0,3,6,620,0,1963,0,98168,47.4862,-122.33,1050,6600,3,17,2015,UNK,-430,0
9323600380,8/5/2014,817000.0,4,2.25,2600,10660,2.0,0.0,0.0,4,8,2600,0,1979,0,98006,47.5533,-122.156,3150,10660,8,5,2014,UNK,-550,0
3262300920,4/8/2015,1200000.0,4,3.0,2150,8119,2.0,0.0,0.0,3,8,2150,0,1953,2004,98039,47.6335,-122.236,1590,8119,4,8,2015,Y,560,0
6332000130,4/20/2015,525000.0,3,1.75,1470,6550,1.0,0.0,2.0,3,7,1070,400,1916,0,98126,47.5463,-122.381,1440,6550,4,20,2015,UNK,30,0
9150100020,2/11/2015,189000.0,3,1.0,1380,7282,1.5,0.0,0.0,5,6,1380,0,1915,0,98002,47.3006,-122.223,860,4826,2,11,2015,UNK,520,2456
2770604081,3/5/2015,629950.0,3,2.5,1680,1683,2.0,0.0,0.0,3,9,1120,560,2014,0,98119,47.6425,-122.374,1610,1618,3,5,2015,N,70,65
6329000050,3/10/2015,641500.0,1,1.0,1000,9084,1.0,0.0,3.0,3,7,1000,0,1950,0,98146,47.5007,-122.382,1090,6536,3,10,2015,UNK,-90,2548
2125400010,9/12/2014,490000.0,3,2.25,1630,7573,1.0,0.0,2.0,3,7,1230,400,1983,0,98034,47.7273,-122.211,1550,7695,9,12,2014,UNK,80,-122
3876313260,2/18/2015,415000.0,3,1.75,1790,15142,1.0,0.0,0.0,3,7,1360,430,1976,0,98072,47.7362,-122.17200000000001,1910,7500,2,18,2015,UNK,-120,7642
5101400561,10/15/2014,250000.0,2,1.0,890,6380,1.0,0.0,0.0,3,6,890,0,1951,0,98115,47.691,-122.303,990,6380,10,15,2014,UNK,-100,0
9533100080,8/20/2014,781000.0,3,1.5,1290,8175,1.0,0.0,0.0,4,7,820,470,1952,0,98004,47.6296,-122.205,2130,8577,8,20,2014,UNK,-840,-402
9561100080,6/20/2014,400000.0,4,2.25,2420,7927,1.0,0.0,0.0,4,7,1400,1020,1973,0,98133,47.7583,-122.34299999999999,2120,7693,6,20,2014,UNK,300,234
5101402618,8/20/2014,935000.0,4,3.0,3680,7105,2.0,0.0,2.0,3,10,2890,790,2008,0,98115,47.6956,-122.311,1580,6815,8,20,2014,N,2100,290
4027700009,5/15/2014,575000.0,4,2.5,3020,17810,1.0,0.0,0.0,3,9,1600,1420,1979,0,98155,47.7735,-122.281,2500,15815,5,15,2014,UNK,520,1995
9544200277,10/15/2014,1660000.0,4,3.25,4240,11189,2.0,0.0,2.0,3,10,4240,0,2006,0,98033,47.6526,-122.191,3390,12540,10,15,2014,N,850,-1351
8731960050,12/29/2014,302300.0,5,2.75,3130,9450,1.0,0.0,0.0,4,8,1580,1550,1973,0,98023,47.3099,-122.384,1900,9000,12,29,2014,UNK,1230,450
1393800005,5/7/2015,355000.0,2,1.0,900,6656,1.0,0.0,0.0,3,7,900,0,1940,0,98126,47.5467,-122.37700000000001,1230,6400,5,7,2015,UNK,-330,256
3896100130,6/17/2014,1540000.0,3,2.25,2880,7599,1.0,0.0,2.0,3,9,1710,1170,1958,2002,98033,47.6938,-122.215,2920,12401,6,17,2014,Y,-40,-4802
7785000130,3/30/2015,926250.0,4,1.75,2390,17717,1.0,0.0,0.0,4,8,2390,0,1964,0,98040,47.5755,-122.21799999999999,2390,10730,3,30,2015,UNK,0,6987
2968800825,3/23/2015,300000.0,3,1.75,1450,7620,1.0,0.0,0.0,4,7,1050,400,1955,0,98166,47.4569,-122.354,1380,7620,3,23,2015,UNK,70,0
7199330480,7/21/2014,361500.0,3,1.75,1070,9000,1.0,0.0,0.0,4,7,1070,0,1978,0,98052,47.6984,-122.132,1700,8400,7,21,2014,UNK,-630,600
5458800415,11/5/2014,616000.0,3,1.5,1740,9840,1.0,0.0,0.0,4,8,1740,0,1963,0,98040,47.5748,-122.23700000000001,1930,9840,11,5,2014,UNK,-190,0
8929000250,4/13/2015,395000.0,2,1.75,1210,1161,2.0,0.0,0.0,3,8,1210,0,2014,0,98029,47.5513,-121.99799999999999,1700,2285,4,13,2015,N,-490,-1124
7893206305,10/6/2014,245000.0,3,1.5,2100,10000,1.0,0.0,0.0,4,7,2100,0,1954,0,98198,47.4222,-122.331,1300,7500,10,6,2014,UNK,800,2500
7956300020,6/3/2014,206000.0,3,1.0,1060,9600,1.0,0.0,0.0,4,6,1060,0,1962,0,98023,47.2878,-122.35799999999999,1060,9604,6,3,2014,UNK,0,-4
240000130,10/13/2014,706000.0,4,2.5,3280,16575,1.0,0.0,0.0,3,9,2190,1090,1972,0,98188,47.426,-122.285,1570,13209,10,13,2014,UNK,1710,3366
1370803730,1/26/2015,578000.0,3,1.5,1660,6000,1.5,0.0,0.0,3,7,1660,0,1937,0,98199,47.6409,-122.40100000000001,1640,6000,1,26,2015,UNK,20,0
4299000130,7/28/2014,341950.0,5,3.0,3070,5252,2.0,0.0,0.0,3,8,3070,0,2005,0,98042,47.3666,-122.12799999999999,2760,5203,7,28,2014,N,310,49
1233100351,12/11/2014,305000.0,3,1.0,1150,9048,1.0,0.0,0.0,2,7,1150,0,1922,0,98033,47.6755,-122.177,1550,8207,12,11,2014,UNK,-400,841
2652500225,10/10/2014,575000.0,3,2.75,1710,3600,1.0,0.0,0.0,3,7,1590,120,1909,0,98119,47.641999999999996,-122.36,1710,3600,10,10,2014,UNK,0,0
3224069026,5/20/2014,330000.0,3,1.0,1180,43124,1.0,0.0,0.0,4,6,1180,0,1959,0,98027,47.5278,-122.06299999999999,1410,43560,5,20,2014,UNK,-230,-436
2592400250,1/7/2015,445000.0,4,2.25,2130,7200,2.0,0.0,0.0,3,7,2130,0,1972,0,98034,47.7152,-122.16799999999999,1990,7200,1,7,2015,UNK,140,0
4364700595,8/18/2014,333000.0,3,1.0,1050,7560,1.0,0.0,0.0,3,7,1050,0,1951,0,98126,47.525,-122.37100000000001,1490,7560,8,18,2014,UNK,-440,0
8562750660,8/7/2014,598500.0,4,2.5,2520,3980,2.0,0.0,0.0,3,8,2520,0,2005,0,98027,47.5401,-122.07,2610,3980,8,7,2014,N,-90,0
7231600098,10/14/2014,225000.0,2,1.0,700,6000,1.0,0.0,0.0,3,6,700,0,1943,0,98055,47.4671,-122.212,1320,6000,10,14,2014,UNK,-620,0
8635750980,7/14/2014,570000.0,4,2.5,2640,4200,2.0,0.0,0.0,3,8,2640,0,1998,0,98074,47.6038,-122.02,2460,4200,7,14,2014,UNK,180,0
5652600605,8/7/2014,630000.0,5,2.0,2330,6783,1.0,0.0,0.0,3,7,1310,1020,1956,0,98115,47.6955,-122.295,1930,6783,8,7,2014,UNK,400,0
2141310020,4/16/2015,779000.0,5,2.25,2830,7738,2.0,0.0,0.0,4,8,2830,0,1977,0,98006,47.5582,-122.13600000000001,2300,9840,4,16,2015,UNK,530,-2102
7852160080,1/21/2015,760000.0,4,3.5,3720,13591,2.0,0.0,3.0,3,10,3720,0,2004,0,98065,47.536,-121.85799999999999,4210,14282,1,21,2015,N,-490,-691
3649100346,1/9/2015,322968.0,5,1.75,1890,9600,1.0,0.0,0.0,4,7,1890,0,1960,0,98028,47.7391,-122.241,2350,5308,1,9,2015,UNK,-460,4292
7852010840,7/29/2014,595000.0,4,2.5,2910,7287,2.0,0.0,0.0,3,8,2910,0,1998,0,98065,47.5354,-121.869,2420,6180,7,29,2014,UNK,490,1107
823059145,10/13/2014,321000.0,4,1.0,1300,18836,1.0,0.0,0.0,4,7,1300,0,1941,0,98056,47.5029,-122.18799999999999,1540,8498,10,13,2014,UNK,-240,10338
9238430660,3/26/2015,653000.0,3,2.25,2770,57745,2.0,0.0,0.0,3,8,2770,0,1985,0,98072,47.775,-122.124,2720,46765,3,26,2015,UNK,50,10980
6329000190,7/29/2014,750000.0,4,1.75,2520,21834,1.0,1.0,4.0,3,8,1420,1100,1960,0,98146,47.4996,-122.37799999999999,1700,8100,7,29,2014,UNK,820,13734
8818900250,5/7/2014,530000.0,3,1.0,1340,4284,1.0,0.0,0.0,3,7,1080,260,1910,0,98105,47.6633,-122.324,1960,4080,5,7,2014,UNK,-620,204
1250200415,6/9/2014,352750.0,2,1.75,1060,1241,2.0,0.0,0.0,3,7,960,100,2008,0,98144,47.5999,-122.3,1170,1400,6,9,2014,N,-110,-159
3303951150,2/4/2015,424950.0,4,2.5,2480,8563,2.0,0.0,0.0,3,8,2480,0,1992,0,98038,47.381,-122.03299999999999,2460,8660,2,4,2015,UNK,20,-97
3083000048,5/30/2014,427000.0,5,2.75,2220,4000,1.0,0.0,0.0,3,7,1230,990,1973,0,98144,47.5754,-122.305,1580,4000,5,30,2014,UNK,640,0
1102000095,8/5/2014,558000.0,4,2.5,3220,5120,2.0,0.0,0.0,3,9,2420,800,2000,0,98118,47.5434,-122.27,1770,7680,8,5,2014,UNK,1450,-2560
3426049153,11/10/2014,438200.0,2,2.0,1600,5643,1.0,0.0,0.0,3,7,1600,0,1954,0,98115,47.6968,-122.279,1600,5746,11,10,2014,UNK,0,-103
7625700020,9/29/2014,340000.0,1,1.0,640,4800,1.0,0.0,0.0,3,6,640,0,1918,0,98136,47.5551,-122.382,1250,2847,9,29,2014,UNK,-610,1953
586000020,8/28/2014,830005.0,4,3.75,3610,7904,3.0,0.0,0.0,3,11,3290,320,1994,0,98117,47.6992,-122.385,2460,7300,8,28,2014,UNK,1150,604
8724300010,9/9/2014,548000.0,4,3.25,3420,5012,2.0,0.0,0.0,3,10,2330,1090,2008,0,98019,47.732,-121.98200000000001,2320,5465,9,9,2014,N,1100,-453
2741100741,6/4/2014,411715.0,3,1.75,1840,5101,1.0,0.0,0.0,5,7,1040,800,1952,0,98108,47.5585,-122.31700000000001,1340,5000,6,4,2014,UNK,500,101
3425059173,10/28/2014,865000.0,4,4.0,2790,16117,2.0,0.0,0.0,4,9,2790,0,1999,0,98005,47.6033,-122.155,2740,25369,10,28,2014,UNK,50,-9252
715010130,2/2/2015,1750000.0,6,4.25,5860,13928,2.0,0.0,3.0,3,10,4150,1710,2013,0,98006,47.5382,-122.11399999999999,5790,13928,2,2,2015,N,70,0
7504100920,6/18/2014,688000.0,3,3.0,3450,16200,2.0,0.0,0.0,3,10,3450,0,1983,0,98074,47.6319,-122.041,3130,12150,6,18,2014,UNK,320,4050
5104520460,3/17/2015,399950.0,4,2.5,2350,5100,2.0,0.0,0.0,3,8,2350,0,2003,0,98038,47.3507,-122.007,2190,5100,3,17,2015,UNK,160,0
1257200020,3/27/2015,555000.0,3,1.0,1250,4590,1.5,0.0,0.0,3,6,970,280,1903,0,98115,47.6757,-122.32700000000001,1830,4080,3,27,2015,UNK,-580,510
4452300130,5/22/2014,677000.0,3,2.0,2000,3207,1.0,0.0,0.0,4,7,1100,900,1916,0,98103,47.6561,-122.34100000000001,1460,3200,5,22,2014,UNK,540,7
8651520420,6/6/2014,539000.0,3,2.0,2260,9568,1.0,0.0,0.0,3,8,1780,480,1985,0,98074,47.6457,-122.05799999999999,2250,9744,6,6,2014,UNK,10,-176
6401700010,8/19/2014,410000.0,3,1.75,1510,6597,1.0,0.0,0.0,4,6,950,560,1939,0,98144,47.5938,-122.315,1460,5320,8,19,2014,UNK,50,1277
8857320130,3/10/2015,472000.0,2,2.25,1800,2748,2.0,0.0,0.0,4,9,1800,0,1979,0,98008,47.6104,-122.113,1800,2755,3,10,2015,UNK,0,-7
1102000759,10/26/2014,755000.0,3,2.5,2420,8856,1.0,0.0,3.0,3,9,1620,800,1957,0,98118,47.5405,-122.26299999999999,2650,9750,10,26,2014,UNK,-230,-894
6457000080,8/5/2014,269900.0,5,1.75,1750,8325,1.0,0.0,0.0,5,7,1750,0,1966,0,98031,47.4007,-122.198,1430,8325,8,5,2014,UNK,320,0
1126059022,7/22/2014,667400.0,4,2.5,2660,40312,2.0,0.0,0.0,4,8,2660,0,1977,0,98072,47.7532,-122.139,2650,45302,7,22,2014,UNK,10,-4990
4340000010,10/30/2014,1220000.0,3,2.25,2640,7544,1.0,0.0,0.0,3,10,2640,0,1995,0,98004,47.6224,-122.195,2650,7904,10,30,2014,UNK,-10,-360
3052700460,6/30/2014,544000.0,3,2.5,1460,1613,2.0,0.0,0.0,3,8,1180,280,2007,0,98117,47.6781,-122.375,1460,1403,6,30,2014,N,0,210
567000020,4/28/2015,800000.0,2,1.0,1570,5000,1.5,0.0,3.0,4,8,1570,0,1924,0,98144,47.5955,-122.294,1760,3000,4,28,2015,UNK,-190,2000
3575304017,8/22/2014,315000.0,3,1.0,1010,7500,1.0,0.0,0.0,4,7,1010,0,1975,0,98074,47.6172,-122.061,1250,10000,8,22,2014,UNK,-240,-2500
7812801700,6/10/2014,227000.0,4,1.0,1200,7200,1.5,0.0,0.0,3,6,1200,0,1944,0,98178,47.4951,-122.24799999999999,1070,6050,6,10,2014,UNK,130,1150
5103300020,10/20/2014,765000.0,4,2.5,4040,25752,2.0,0.0,0.0,3,10,4040,0,2000,0,98038,47.4579,-122.068,3230,22247,10,20,2014,UNK,810,3505
9578080130,7/2/2014,625000.0,3,3.0,1820,1641,3.0,0.0,0.0,3,8,1540,280,2006,0,98119,47.6482,-122.35799999999999,1720,1501,7,2,2014,N,100,140
3885803044,9/2/2014,1880000.0,4,5.0,5810,7440,2.0,0.0,0.0,3,10,3790,2020,2004,0,98033,47.6878,-122.212,3010,7200,9,2,2014,N,2800,240
9323600280,2/11/2015,822600.0,4,2.5,3010,9600,1.0,0.0,2.0,3,9,1510,1500,1979,0,98006,47.5519,-122.156,2780,10000,2,11,2015,UNK,230,-400
7016100380,4/23/2015,515000.0,4,2.5,1910,8947,1.0,0.0,0.0,4,8,1160,750,1970,0,98011,47.7374,-122.18299999999999,1920,7350,4,23,2015,UNK,-10,1597
3438500114,5/12/2015,377000.0,4,2.0,1640,5014,1.0,0.0,0.0,4,7,930,710,1982,0,98106,47.5545,-122.35600000000001,1600,5452,5,12,2015,UNK,40,-438
2597800010,3/4/2015,600000.0,3,1.0,1480,17360,1.0,0.0,1.0,3,8,1480,0,1954,0,98136,47.5179,-122.387,2250,8720,3,4,2015,UNK,-770,8640
8018000020,11/14/2014,525300.0,4,1.75,2520,7770,1.0,0.0,0.0,3,8,1680,840,1965,0,98177,47.7721,-122.37200000000001,2340,7770,11,14,2014,UNK,180,0
4055700167,8/14/2014,760000.0,4,3.0,2840,13554,1.0,0.0,2.0,4,9,1990,850,1974,0,98034,47.7153,-122.257,2840,16940,8,14,2014,UNK,0,-3386
1863900190,12/29/2014,202000.0,2,1.0,840,7200,1.0,0.0,0.0,4,5,840,0,1907,0,98032,47.3769,-122.23700000000001,1030,7200,12,29,2014,UNK,-190,0
522079027,6/19/2014,470000.0,3,2.0,1730,38884,1.0,0.0,0.0,3,8,1730,0,1997,0,98038,47.4164,-121.95100000000001,2130,91040,6,19,2014,UNK,-400,-52156
7525530470,7/25/2014,810000.0,3,2.5,3140,10983,2.0,0.0,0.0,3,10,3140,0,1991,0,98075,47.5595,-122.04,3140,10983,7,25,2014,UNK,0,0
8858100020,3/16/2015,175000.0,3,1.0,1480,8415,1.0,0.0,0.0,3,7,1080,400,1967,0,98188,47.4585,-122.28299999999999,1780,8512,3,16,2015,UNK,-300,-97
6414100231,10/15/2014,440000.0,4,1.75,1920,7986,1.0,0.0,0.0,3,7,960,960,1952,0,98125,47.7209,-122.318,1700,7452,10,15,2014,UNK,220,534
6303400460,3/30/2015,197000.0,2,1.0,770,8636,1.0,0.0,0.0,2,6,770,0,1951,0,98146,47.5075,-122.35799999999999,1110,8636,3,30,2015,UNK,-340,0
9476200020,3/6/2015,254000.0,3,1.0,1010,7384,1.0,0.0,2.0,5,6,1010,0,1943,0,98056,47.4905,-122.191,1010,8000,3,6,2015,UNK,0,-616
3575302938,6/20/2014,405000.0,3,1.0,1460,10000,1.5,0.0,0.0,3,7,1460,0,2002,0,98074,47.6214,-122.06299999999999,1910,10000,6,20,2014,UNK,-450,0
2695600190,3/27/2015,416000.0,2,1.0,940,4264,1.0,0.0,0.0,5,7,940,0,1949,0,98126,47.5314,-122.37799999999999,1630,4472,3,27,2015,UNK,-690,-208
9433000470,9/19/2014,779950.0,4,2.75,2840,4864,3.0,0.0,0.0,3,9,2840,0,2014,0,98052,47.7103,-122.10799999999999,2990,5314,9,19,2014,N,-150,-450
7140200250,1/12/2015,200000.0,4,2.75,1910,7210,1.0,0.0,0.0,4,7,1430,480,1980,0,98030,47.3693,-122.169,1750,7446,1,12,2015,UNK,160,-236
3905090130,7/17/2014,658100.0,4,2.5,2430,8509,2.0,0.0,0.0,3,9,2430,0,1992,0,98029,47.5714,-121.991,2760,8509,7,17,2014,UNK,-330,0
3335000050,7/14/2014,397000.0,2,1.75,1610,4104,1.0,0.0,0.0,3,7,950,660,1996,0,98118,47.5565,-122.275,1510,5284,7,14,2014,UNK,100,-1180
4397650080,10/15/2014,815000.0,3,3.75,2780,5002,2.0,0.0,0.0,3,10,2780,0,1999,0,98007,47.5939,-122.15,3110,5717,10,15,2014,UNK,-330,-715
1568100380,10/16/2014,345000.0,2,1.0,1160,8504,1.0,0.0,0.0,4,7,1160,0,1949,0,98155,47.7364,-122.295,1320,8504,10,16,2014,UNK,-160,0
8078570460,9/24/2014,305500.0,4,2.5,1850,7199,2.0,0.0,0.0,4,7,1850,0,1989,0,98031,47.4031,-122.17200000000001,1940,7432,9,24,2014,UNK,-90,-233
6382000080,7/8/2014,340000.0,3,2.25,2120,13090,1.0,0.0,0.0,3,8,2120,0,1997,0,98002,47.29600000000001,-122.219,1400,12039,7,8,2014,UNK,720,1051
7905380080,2/26/2015,330000.0,5,2.5,2620,12763,1.0,0.0,0.0,3,7,1400,1220,1979,0,98034,47.72,-122.213,2390,9156,2,26,2015,UNK,230,3607
6600490250,4/21/2015,269000.0,4,2.5,2060,3608,2.0,0.0,0.0,3,7,2060,0,2004,0,98198,47.361999999999995,-122.309,2060,3608,4,21,2015,N,0,0
7200001756,6/12/2014,349950.0,3,1.0,1060,9525,1.0,0.0,0.0,3,7,1060,0,1966,0,98052,47.6855,-122.111,1630,9525,6,12,2014,UNK,-570,0
4427100130,3/4/2015,431000.0,3,1.0,1500,6240,1.0,0.0,0.0,4,7,1500,0,1953,0,98125,47.7281,-122.311,1230,6240,3,4,2015,UNK,270,0
5606000255,10/17/2014,735000.0,4,1.75,2380,5700,2.0,0.0,1.0,4,7,1820,560,1946,0,98105,47.6656,-122.271,2190,5700,10,17,2014,UNK,190,0
1402700170,7/17/2014,414000.0,5,3.0,3045,5030,2.0,0.0,0.0,3,8,3045,0,1999,0,98058,47.4386,-122.12700000000001,3045,5322,7,17,2014,UNK,0,-292
5366200460,5/20/2014,619500.0,3,2.5,1700,4105,2.0,0.0,0.0,3,8,1700,0,1992,0,98122,47.6078,-122.292,1880,3665,5,20,2014,UNK,-180,440
1245500725,10/30/2014,675000.0,3,1.75,1240,13869,1.0,0.0,0.0,4,7,1240,0,1957,0,98033,47.6919,-122.21,1970,7790,10,30,2014,UNK,-730,6079
9477201060,4/23/2015,380500.0,3,1.0,1410,7854,1.0,0.0,0.0,4,7,1410,0,1971,0,98034,47.7303,-122.19200000000001,1460,7500,4,23,2015,UNK,-50,354
4060000290,6/17/2014,253000.0,3,1.5,880,6600,1.0,0.0,0.0,5,6,880,0,1945,0,98178,47.5002,-122.24700000000001,1020,6600,6,17,2014,UNK,-140,0
522059327,5/28/2014,157500.0,2,1.0,740,9003,1.0,0.0,0.0,3,5,740,0,1949,0,98031,47.4217,-122.197,1230,8050,5,28,2014,UNK,-490,953
686530020,6/9/2014,627000.0,4,2.0,2030,9300,1.0,0.0,0.0,4,8,2030,0,1976,0,98052,47.6658,-122.149,1800,9018,6,9,2014,UNK,230,282
5145100460,9/24/2014,469500.0,4,2.5,2090,7241,1.0,0.0,0.0,4,7,1140,950,2001,0,98034,47.726000000000006,-122.221,1510,7402,9,24,2014,UNK,580,-161
6329000380,6/19/2014,319950.0,2,1.0,920,8341,1.0,0.0,0.0,3,7,920,0,1939,0,98146,47.5015,-122.38,2330,9792,6,19,2014,UNK,-1410,-1451
8960200280,2/18/2015,249500.0,3,1.0,1180,7200,1.0,0.0,0.0,4,7,1180,0,1968,0,98058,47.4249,-122.178,1180,7200,2,18,2015,UNK,0,0
2867100007,2/23/2015,485000.0,3,1.0,1260,3230,1.5,0.0,0.0,3,7,1260,0,1907,0,98119,47.644,-122.369,1700,3500,2,23,2015,UNK,-440,-270
9542100005,10/24/2014,1130000.0,5,3.0,3690,10260,1.0,0.0,4.0,4,9,2070,1620,1967,0,98005,47.5919,-122.176,3160,14000,10,24,2014,UNK,530,-3740
1545807280,6/28/2014,314500.0,3,1.75,1700,17355,1.0,0.0,0.0,3,7,1200,500,1978,0,98038,47.3637,-122.057,1900,9528,6,28,2014,UNK,-200,7827
3996900460,4/3/2015,220000.0,2,1.0,770,8149,1.0,0.0,0.0,3,6,770,0,1948,0,98155,47.7467,-122.3,880,8149,4,3,2015,UNK,-110,0
217500005,11/24/2014,444950.0,3,2.5,2020,7800,1.0,0.0,0.0,4,7,1330,690,1958,0,98133,47.7368,-122.337,1870,7800,11,24,2014,UNK,150,0
1513800080,8/25/2014,598000.0,4,2.5,2030,9825,1.0,0.0,0.0,3,8,1330,700,1985,0,98115,47.6892,-122.3,2180,7500,8,25,2014,UNK,-150,2325
8691390460,6/16/2014,699850.0,4,3.5,2690,6164,2.0,0.0,0.0,3,9,2690,0,2002,0,98075,47.599,-121.973,2910,5000,6,16,2014,UNK,-220,1164
6633900170,5/8/2014,595000.0,3,2.5,1750,3354,2.0,0.0,0.0,4,7,1750,0,1991,0,98033,47.6953,-122.199,1750,4286,5,8,2014,UNK,0,-932
205000050,12/18/2014,735000.0,4,2.5,3270,45537,2.0,0.0,0.0,3,9,3270,0,1993,0,98053,47.6303,-121.984,2670,38827,12,18,2014,UNK,600,6710
8838900167,5/9/2014,542500.0,4,2.5,2330,14289,2.0,0.0,0.0,4,8,2330,0,1978,0,98007,47.5916,-122.148,2210,12823,5,9,2014,UNK,120,1466
7199330170,5/12/2015,450000.0,3,1.75,1720,6960,1.0,0.0,0.0,3,7,1140,580,1978,0,98052,47.6972,-122.12899999999999,1720,7280,5,12,2015,UNK,0,-320
236500050,7/28/2014,298500.0,3,2.0,2420,8800,1.0,0.0,0.0,4,7,1420,1000,1959,0,98188,47.4322,-122.291,1546,8666,7,28,2014,UNK,874,134
2025049028,6/9/2014,403950.0,2,1.0,710,1136,2.0,0.0,0.0,4,7,710,0,1943,0,98102,47.6414,-122.329,1370,1173,6,9,2014,UNK,-660,-37
3298700305,12/29/2014,271000.0,2,1.0,710,4240,1.0,0.0,0.0,4,6,710,0,1942,0,98106,47.5226,-122.351,850,5200,12,29,2014,UNK,-140,-960
6145600780,9/11/2014,335000.0,2,1.0,1510,3844,1.0,0.0,0.0,4,7,1510,0,1923,1970,98133,47.7038,-122.348,1170,3844,9,11,2014,Y,340,0
1332700010,12/16/2014,305000.0,2,2.25,1610,1968,2.0,0.0,0.0,5,7,1610,0,1979,0,98056,47.5184,-122.196,1950,1968,12,16,2014,UNK,-340,0
2768300655,3/17/2015,630000.0,3,3.0,1880,2200,2.0,0.0,0.0,3,8,1520,360,2007,0,98107,47.6666,-122.367,1500,1426,3,17,2015,N,380,774
7224500010,6/3/2014,253000.0,2,1.75,1220,5000,1.0,0.0,0.0,5,7,860,360,1921,0,98055,47.4906,-122.204,1120,5000,6,3,2014,UNK,100,0
4037000185,9/19/2014,395000.0,4,1.75,2060,7900,1.0,0.0,0.0,4,7,1070,990,1957,0,98008,47.6028,-122.12,1830,8000,9,19,2014,UNK,230,-100
7614100020,10/17/2014,265000.0,3,2.5,1340,10290,1.0,0.0,0.0,4,7,1140,200,1981,0,98042,47.3553,-122.149,1760,7903,10,17,2014,UNK,-420,2387
1423400225,7/21/2014,225000.0,2,1.0,1030,9192,1.0,0.0,0.0,4,6,1030,0,1959,0,98058,47.4565,-122.181,1030,9190,7,21,2014,UNK,0,2
5419000050,9/17/2014,338500.0,4,2.5,2717,4513,2.0,0.0,0.0,3,8,2717,0,2005,0,98001,47.3373,-122.266,2550,4841,9,17,2014,N,167,-328
5151200290,5/12/2014,300000.0,2,1.75,1360,8100,1.0,0.0,0.0,3,7,860,500,1975,0,98177,47.7295,-122.359,1830,6766,5,12,2014,UNK,-470,1334
4060000170,8/20/2014,255000.0,2,1.0,1260,7810,2.0,0.0,0.0,3,6,1260,0,1945,0,98178,47.5003,-122.24799999999999,1260,7755,8,20,2014,UNK,0,55
1568100290,6/20/2014,337000.0,4,3.0,2240,8504,2.0,0.0,0.0,3,7,2240,0,1992,0,98155,47.7348,-122.295,1570,8460,6,20,2014,UNK,670,44
4137010010,4/16/2015,324900.0,3,2.25,2080,9740,2.0,0.0,0.0,3,8,2080,0,1988,0,98092,47.261,-122.219,2080,8705,4,16,2015,UNK,0,1035
2581900284,7/7/2014,821000.0,3,2.75,2760,8476,1.0,0.0,0.0,4,8,1690,1070,1967,0,98040,47.5402,-122.215,2610,9835,7,7,2014,UNK,150,-1359
1222069136,12/12/2014,500000.0,4,2.75,3000,213008,1.0,0.0,0.0,4,8,3000,0,1975,0,98038,47.4032,-121.98200000000001,2300,74191,12,12,2014,UNK,700,138817
7625701795,3/2/2015,885000.0,4,3.5,3310,6000,2.0,0.0,2.0,3,8,2200,1110,2010,0,98136,47.5511,-122.391,1420,6000,3,2,2015,N,1890,0
1771100440,6/10/2014,360000.0,4,2.0,1630,10375,1.0,0.0,0.0,5,7,1630,0,1968,0,98077,47.7566,-122.073,1360,10026,6,10,2014,UNK,270,349
3211200290,5/27/2014,304000.0,3,1.0,900,7500,1.0,0.0,0.0,4,7,900,0,1972,0,98034,47.7314,-122.23700000000001,1960,7500,5,27,2014,UNK,-1060,0
4154302045,3/16/2015,376000.0,2,1.0,880,2400,1.0,0.0,0.0,3,6,760,120,1918,0,98118,47.5643,-122.275,1180,6300,3,16,2015,UNK,-300,-3900
4036801315,11/4/2014,425000.0,4,1.5,1620,7875,1.0,0.0,0.0,3,7,1620,0,1956,0,98008,47.6041,-122.126,1890,8400,11,4,2014,UNK,-270,-525
9185700414,5/22/2014,1180000.0,3,1.75,1610,7200,1.0,0.0,0.0,3,8,1090,520,1973,0,98112,47.6279,-122.287,3790,7200,5,22,2014,UNK,-2180,0
1221000562,7/22/2014,187000.0,3,2.5,1730,1803,2.0,0.0,0.0,3,7,1730,0,2005,0,98166,47.4648,-122.335,1190,7980,7,22,2014,N,540,-6177
1890000250,6/27/2014,710000.0,2,1.5,1640,4080,1.5,0.0,0.0,5,7,1540,100,1916,0,98105,47.6624,-122.325,1880,4080,6,27,2014,UNK,-240,0
7436400020,3/25/2015,585000.0,3,1.75,1840,7350,1.0,0.0,0.0,3,8,1370,470,1974,0,98033,47.6729,-122.166,1920,8518,3,25,2015,UNK,-80,-1168
3303850290,4/9/2015,1400000.0,5,4.0,4700,22326,2.0,0.0,0.0,3,11,4700,0,2002,0,98006,47.5417,-122.111,4730,27110,4,9,2015,UNK,-30,-4784
2025059026,2/25/2015,1980000.0,4,3.5,4500,44384,1.0,0.0,0.0,3,12,3340,1160,1990,0,98004,47.6323,-122.19200000000001,2540,26287,2,25,2015,UNK,1960,18097
3751600430,12/26/2014,250000.0,3,1.75,1780,35233,1.0,0.0,0.0,4,8,1420,360,1979,0,98001,47.2949,-122.26899999999999,1950,17334,12,26,2014,UNK,-170,17899
7856640460,12/18/2014,950000.0,4,2.75,3800,12200,2.0,0.0,3.0,4,10,3800,0,1986,0,98006,47.5689,-122.156,3710,14796,12,18,2014,UNK,90,-2596
9510920050,9/2/2014,725000.0,3,2.5,2980,16996,2.0,0.0,0.0,3,10,2980,0,1992,0,98075,47.595,-122.016,2980,15438,9,2,2014,UNK,0,1558
8651720020,5/12/2014,505000.0,4,2.5,2780,6369,1.0,0.0,0.0,3,8,1590,1190,1978,0,98034,47.7284,-122.21600000000001,2170,7490,5,12,2014,UNK,610,-1121
2114700500,4/18/2015,90000.0,1,1.0,560,4120,1.0,0.0,0.0,3,4,560,0,1947,0,98106,47.5335,-122.348,980,4120,4,18,2015,UNK,-420,0
7950303530,4/9/2015,400000.0,4,2.0,2060,3060,2.0,0.0,0.0,3,7,2060,0,1968,0,98118,47.5631,-122.285,1630,3766,4,9,2015,UNK,430,-706
8910500471,2/17/2015,407000.0,3,1.0,1140,7785,1.0,0.0,0.0,3,8,1140,0,1954,0,98177,47.708999999999996,-122.363,2080,10620,2,17,2015,UNK,-940,-2835
9550204450,12/19/2014,651000.0,3,1.5,1890,4400,1.5,0.0,0.0,5,7,1890,0,1919,0,98105,47.6662,-122.32600000000001,1620,4080,12,19,2014,UNK,270,320
4024101990,2/5/2015,485000.0,3,2.25,2090,7450,1.0,0.0,0.0,3,7,1350,740,1978,0,98155,47.7598,-122.303,1740,7644,2,5,2015,UNK,350,-194
5595900345,1/13/2015,460000.0,4,2.75,3460,13168,2.0,0.0,0.0,4,8,3460,0,1932,1986,98022,47.2046,-121.99600000000001,1500,7670,1,13,2015,Y,1960,5498
1782500095,3/9/2015,369000.0,2,1.0,1320,6135,1.0,0.0,0.0,4,7,880,440,1942,0,98126,47.5265,-122.37899999999999,1050,4693,3,9,2015,UNK,270,1442
8887001192,6/20/2014,355000.0,2,1.0,1240,27042,1.0,0.0,1.0,3,6,1000,240,1943,0,98070,47.5026,-122.465,2140,20059,6,20,2014,UNK,-900,6983
4006000307,9/16/2014,155000.0,2,1.0,810,4755,1.0,0.0,0.0,3,7,810,0,1980,0,98118,47.5313,-122.28,1180,4755,9,16,2014,UNK,-370,0
5605000440,12/15/2014,1000000.0,3,1.0,1880,5450,1.5,0.0,0.0,4,8,1880,0,1924,0,98112,47.6453,-122.302,2580,5450,12,15,2014,UNK,-700,0
2591840050,2/11/2015,419625.0,4,2.5,2680,11590,2.0,0.0,0.0,4,9,2680,0,1988,0,98058,47.4395,-122.163,2580,8225,2,11,2015,UNK,100,3365
1442300005,2/18/2015,435000.0,3,2.0,2040,6880,2.0,0.0,0.0,4,7,2040,0,1954,0,98133,47.7601,-122.351,1710,7597,2,18,2015,UNK,330,-717
3343901440,5/11/2015,379000.0,4,1.75,2180,7876,1.0,0.0,0.0,4,7,1290,890,1977,0,98056,47.5157,-122.191,1960,7225,5,11,2015,UNK,220,651
9406590250,2/24/2015,293000.0,4,2.25,1870,5371,2.0,0.0,0.0,3,7,1870,0,2009,0,98038,47.3844,-122.036,2380,4502,2,24,2015,N,-510,869
2212250080,8/6/2014,592100.0,4,2.75,2310,7851,1.0,0.0,0.0,4,8,1790,520,1989,0,98006,47.5473,-122.18700000000001,2230,7359,8,6,2014,UNK,80,492
3578700073,11/10/2014,362000.0,3,1.75,1120,9730,1.0,0.0,0.0,3,7,1120,0,1944,1989,98011,47.7372,-122.221,2530,8717,11,10,2014,Y,-1410,1013
1123049126,12/3/2014,227000.0,3,1.0,1340,10035,1.0,0.0,0.0,3,7,1340,0,1959,0,98178,47.4916,-122.25399999999999,2090,10035,12,3,2014,UNK,-750,0
526059259,8/19/2014,335500.0,3,1.75,1260,8487,1.0,0.0,0.0,3,7,1260,0,1970,0,98011,47.7664,-122.20100000000001,1890,13051,8,19,2014,UNK,-630,-4564
3222079136,8/18/2014,213000.0,3,1.75,1200,55321,1.5,0.0,0.0,5,7,1200,0,1977,0,98010,47.3492,-121.935,1910,54450,8,18,2014,UNK,-710,871
7237300290,3/26/2015,338000.0,5,2.5,2400,4496,2.0,0.0,0.0,3,7,2400,0,2004,0,98042,47.3692,-122.126,1880,4319,3,26,2015,N,520,177
7468900235,10/22/2014,163500.0,3,1.0,940,7200,1.0,0.0,0.0,4,7,940,0,1954,0,98002,47.2979,-122.223,1090,7800,10,22,2014,UNK,-150,-600
3352401476,11/24/2014,199988.0,2,1.0,860,5000,1.0,0.0,0.0,3,7,860,0,1949,0,98178,47.5005,-122.26700000000001,1130,6000,11,24,2014,UNK,-270,-1000
4217402162,7/25/2014,1190000.0,3,2.25,2390,7875,1.0,0.0,1.0,3,10,1980,410,1948,0,98105,47.6515,-122.27799999999999,3720,9075,7,25,2014,UNK,-1330,-1200
6147650430,4/7/2015,320000.0,4,2.5,3130,5200,2.0,0.0,0.0,3,7,3130,0,2005,0,98042,47.3828,-122.098,3020,5200,4,7,2015,N,110,0
1133000235,6/16/2014,450000.0,6,2.25,3550,11780,1.0,0.0,0.0,4,8,2960,590,1948,0,98125,47.7218,-122.31200000000001,2360,8850,6,16,2014,UNK,1190,2930
2781270080,10/30/2014,249900.0,2,2.0,1470,2541,2.0,0.0,0.0,3,6,1470,0,2005,0,98038,47.3502,-122.02,1310,2721,10,30,2014,N,160,-180
1423200170,6/12/2014,223000.0,2,1.0,910,9869,1.0,0.0,0.0,3,6,910,0,1957,0,98058,47.4572,-122.184,1480,9750,6,12,2014,UNK,-570,119
3023059071,2/10/2015,631000.0,4,4.0,2630,59586,1.0,0.0,0.0,3,7,1470,1160,1963,0,98055,47.4496,-122.209,2230,5715,2,10,2015,UNK,400,53871
511700170,5/5/2015,350000.0,4,2.25,1780,10416,1.0,0.0,0.0,5,7,1060,720,1963,0,98055,47.4414,-122.189,1780,9975,5,5,2015,UNK,0,441
2124089028,7/14/2014,279000.0,3,1.75,1430,39160,1.0,0.0,0.0,3,7,900,530,1925,1987,98065,47.5513,-121.801,1430,40860,7,14,2014,Y,0,-1700
1431700280,4/9/2015,310000.0,5,2.0,2730,7344,1.0,0.0,0.0,5,7,1510,1220,1962,0,98058,47.4602,-122.171,1730,7700,4,9,2015,UNK,1000,-356
7686202635,8/12/2014,185000.0,2,1.0,900,8000,1.0,0.0,0.0,4,6,900,0,1954,0,98198,47.4217,-122.31700000000001,1240,8000,8,12,2014,UNK,-340,0
3874400380,3/16/2015,445000.0,3,2.5,1740,22089,1.0,0.0,0.0,4,8,1130,610,1977,0,98070,47.3948,-122.435,2000,24925,3,16,2015,UNK,-260,-2836
642500080,12/12/2014,365000.0,4,2.5,2905,4874,2.0,0.0,0.0,3,9,2905,0,2003,0,98031,47.4084,-122.169,2900,5271,12,12,2014,UNK,5,-397
1591600527,4/23/2015,333500.0,3,1.5,2230,9120,1.0,0.0,0.0,3,7,1390,840,1959,0,98146,47.5008,-122.35799999999999,1420,8450,4,23,2015,UNK,810,670
5587000010,11/20/2014,385000.0,3,2.25,1680,8450,1.0,0.0,0.0,3,8,1340,340,1960,0,98177,47.7575,-122.361,1850,8300,11,20,2014,UNK,-170,150
2201500440,5/20/2014,345000.0,3,1.5,1240,11200,1.0,0.0,0.0,4,7,1240,0,1954,0,98006,47.5716,-122.13799999999999,1240,11008,5,20,2014,UNK,0,192
7603100095,11/10/2014,1260000.0,3,3.0,3230,8625,2.0,0.0,3.0,3,10,2220,1010,1998,0,98116,47.562,-122.404,2330,6022,11,10,2014,UNK,900,2603
9412200080,5/23/2014,440000.0,4,2.5,2560,10400,1.0,0.0,0.0,4,7,1280,1280,1965,0,98027,47.5225,-122.04,1740,11050,5,23,2014,UNK,820,-650
7852130080,9/25/2014,444500.0,3,2.5,2600,4724,2.0,0.0,0.0,3,7,2600,0,2002,0,98065,47.5359,-121.87799999999999,2400,4724,9,25,2014,UNK,200,0
2923039243,11/13/2014,340000.0,4,1.0,1200,11834,1.0,1.0,3.0,3,6,1200,0,1972,0,98070,47.4557,-122.443,1670,47462,11,13,2014,UNK,-470,-35628
6908200250,3/12/2015,680000.0,4,1.0,1660,6075,1.5,0.0,0.0,5,7,1660,0,1915,0,98117,47.6755,-122.40299999999999,1810,5400,3,12,2015,UNK,-150,675
3039000010,9/9/2014,420000.0,3,1.75,1140,8558,1.0,0.0,0.0,4,7,1140,0,1982,0,98033,47.7027,-122.198,1490,10530,9,9,2014,UNK,-350,-1972
1657300280,12/29/2014,438500.0,3,2.25,3050,10689,2.0,0.0,0.0,4,9,3050,0,1988,0,98092,47.3326,-122.20100000000001,2697,10925,12,29,2014,UNK,353,-236
9200000050,9/18/2014,109500.0,2,1.0,800,10625,1.0,0.0,0.0,3,6,800,0,1942,0,98168,47.496,-122.31700000000001,1130,10625,9,18,2014,UNK,-330,0
7508200080,4/10/2015,461000.0,4,2.75,1700,7495,1.0,0.0,0.0,4,7,1200,500,1964,0,98133,47.7589,-122.354,1650,7495,4,10,2015,UNK,50,0
5454200080,8/11/2014,968000.0,4,1.75,2630,9645,1.0,0.0,0.0,4,9,2630,0,1963,0,98040,47.5459,-122.228,2690,10439,8,11,2014,UNK,-60,-794
7972601100,9/23/2014,355000.0,3,1.75,1960,7705,1.0,0.0,0.0,4,7,980,980,1950,0,98106,47.53,-122.34700000000001,1380,4349,9,23,2014,UNK,580,3356
5112800190,3/27/2015,249000.0,3,1.5,1180,11579,1.0,0.0,0.0,4,7,1180,0,1962,0,98058,47.4502,-122.089,1780,22486,3,27,2015,UNK,-600,-10907
984210170,3/26/2015,256500.0,5,2.5,1960,7350,1.0,0.0,0.0,4,7,1360,600,1969,0,98058,47.4368,-122.165,1900,7350,3,26,2015,UNK,60,0
8081500050,3/2/2015,1810000.0,5,2.5,4250,20441,1.0,0.0,1.0,4,11,2490,1760,1984,0,98004,47.6377,-122.211,3620,16304,3,2,2015,UNK,630,4137
8731801190,12/23/2014,269000.0,3,2.25,1950,8661,1.0,0.0,0.0,4,8,1950,0,1966,0,98023,47.3127,-122.36200000000001,1950,8800,12,23,2014,UNK,0,-139
9103000715,11/12/2014,1350000.0,4,3.5,3600,5217,2.0,0.0,0.0,3,9,2720,880,1947,2014,98112,47.6189,-122.286,2270,5217,11,12,2014,Y,1330,0
8732300430,6/20/2014,885000.0,3,2.25,2060,9552,1.0,0.0,0.0,4,9,1610,450,1975,0,98040,47.5402,-122.23100000000001,2930,11212,6,20,2014,UNK,-870,-1660
3754700170,4/23/2015,455000.0,3,2.0,1640,9825,1.0,0.0,0.0,4,7,1090,550,1971,0,98034,47.7244,-122.2,1500,9750,4,23,2015,UNK,140,75
2652500795,6/9/2014,980000.0,4,2.5,2730,4800,1.5,0.0,0.0,5,8,2230,500,1909,0,98119,47.641999999999996,-122.35799999999999,2190,4200,6,9,2014,UNK,540,600
7454000470,8/1/2014,412500.0,3,1.75,1530,6300,1.0,0.0,0.0,3,6,1530,0,1942,2004,98126,47.51600000000001,-122.375,920,6300,8,1,2014,Y,610,0
3630121060,12/17/2014,740000.0,4,3.5,3060,4777,2.0,0.0,0.0,3,9,3060,0,2007,0,98029,47.555,-122.0,3060,4935,12,17,2014,N,0,-158
1370800825,8/23/2014,1300000.0,4,2.25,2860,5658,2.0,0.0,3.0,3,10,2130,730,1933,0,98199,47.6395,-122.40899999999999,2700,5221,8,23,2014,UNK,160,437
4310702759,3/12/2015,326000.0,2,1.5,1030,798,3.0,0.0,0.0,3,8,1030,0,2008,0,98103,47.6975,-122.34,1020,1026,3,12,2015,N,10,-228
8635750950,6/7/2014,568500.0,4,2.5,2460,4200,2.0,0.0,0.0,3,8,2460,0,1998,0,98074,47.6041,-122.02,2460,4200,6,7,2014,UNK,0,0
3448900420,9/22/2014,620000.0,4,2.5,2500,8282,2.0,0.0,0.0,3,9,2500,0,2013,0,98056,47.5127,-122.169,2500,8046,9,22,2014,N,0,236
2113700005,4/17/2015,283000.0,3,1.75,1830,7600,2.0,0.0,0.0,3,7,1490,340,1947,0,98106,47.5317,-122.351,1300,4000,4,17,2015,UNK,530,3600
8615800500,8/14/2014,875000.0,6,3.25,2820,4536,2.0,0.0,0.0,4,8,1930,890,1917,0,98105,47.6688,-122.309,2820,4536,8,14,2014,UNK,0,0
9106000005,5/27/2015,1310000.0,4,2.25,3750,5000,2.0,0.0,0.0,5,8,2440,1310,1924,0,98115,47.6747,-122.303,2170,4590,5,27,2015,UNK,1580,410
806800420,10/23/2014,289950.0,3,2.5,2070,6145,2.0,0.0,0.0,3,7,2070,0,2003,0,98092,47.3357,-122.17200000000001,2070,5297,10,23,2014,UNK,0,848
2787311190,11/14/2014,252500.0,3,2.5,1780,7192,1.0,0.0,0.0,4,7,1250,530,1974,0,98031,47.4093,-122.17299999999999,1870,8500,11,14,2014,UNK,-90,-1308
3342102385,10/29/2014,376000.0,4,2.25,2200,6750,1.0,0.0,0.0,5,8,1480,720,1959,0,98056,47.5215,-122.20200000000001,2710,6750,10,29,2014,UNK,-510,0
7504000290,5/22/2014,635700.0,4,2.5,3240,13978,1.0,0.0,0.0,3,9,1860,1380,1977,0,98074,47.6298,-122.057,3150,12767,5,22,2014,UNK,90,1211
8691300500,10/28/2014,710000.0,4,2.5,2880,12349,2.0,0.0,0.0,3,10,2880,0,1996,0,98075,47.5879,-121.973,3490,11539,10,28,2014,UNK,-610,810
930000425,3/1/2015,440000.0,3,1.75,1570,5120,1.0,0.0,2.0,3,7,980,590,1947,0,98177,47.7166,-122.365,2420,7200,3,1,2015,UNK,-850,-2080
3291800670,6/30/2014,439000.0,3,2.5,3180,7904,1.0,0.0,0.0,3,8,1810,1370,2006,0,98056,47.489,-122.181,1950,7800,6,30,2014,N,1230,104
1425059145,6/16/2014,455000.0,2,1.5,1310,12196,1.5,0.0,0.0,3,6,1310,0,1970,0,98052,47.6487,-122.12200000000001,2970,12196,6,16,2014,UNK,-1660,0
4406000050,5/19/2014,225000.0,2,1.0,910,9612,1.0,0.0,0.0,4,7,910,0,1981,0,98058,47.4297,-122.152,1410,9611,5,19,2014,UNK,-500,1
1432700420,7/28/2014,250000.0,3,1.0,1460,10914,1.0,0.0,0.0,4,7,1460,0,1959,0,98058,47.4511,-122.17299999999999,1490,8314,7,28,2014,UNK,-30,2600
5561400470,4/7/2015,585000.0,4,3.25,3410,34939,2.0,0.0,0.0,4,9,2470,940,1992,0,98027,47.458999999999996,-122.00299999999999,2450,39045,4,7,2015,UNK,960,-4106
8827901350,4/7/2015,685000.0,3,1.75,2720,4720,1.5,0.0,0.0,4,7,1580,1140,1925,0,98105,47.6691,-122.29,1660,4640,4,7,2015,UNK,1060,80
6190700284,6/20/2014,420000.0,5,2.75,2280,10319,1.0,0.0,0.0,3,8,1300,980,1959,0,98177,47.7566,-122.363,2370,8056,6,20,2014,UNK,-90,2263
3644100073,11/22/2014,245000.0,2,1.0,670,1675,1.0,0.0,0.0,5,6,670,0,1960,0,98144,47.5918,-122.295,1220,1740,11,22,2014,UNK,-550,-65
3223059173,11/4/2014,275000.0,4,2.0,1480,15000,1.0,0.0,0.0,4,7,1480,0,1957,0,98055,47.4312,-122.196,1450,8768,11,4,2014,UNK,30,6232
109210460,10/29/2014,270000.0,3,2.0,2330,8000,1.0,0.0,0.0,3,7,1390,940,1986,0,98023,47.2958,-122.368,1570,7227,10,29,2014,UNK,760,773
9106000050,10/21/2014,767250.0,4,3.0,2170,2500,2.0,0.0,0.0,3,8,1710,460,1997,0,98115,47.6742,-122.303,2170,4080,10,21,2014,UNK,0,-1580
4337600280,9/4/2014,229000.0,3,2.0,1760,9900,1.0,0.0,0.0,4,7,1760,0,1943,0,98166,47.4783,-122.338,1190,9900,9,4,2014,UNK,570,0
3438501100,4/27/2015,400000.0,3,1.0,1240,4000,1.5,0.0,0.0,3,8,1240,0,1928,0,98106,47.5467,-122.359,1200,17707,4,27,2015,UNK,40,-13707
7935000280,8/12/2014,2200000.0,5,3.25,5210,35765,2.5,0.0,4.0,5,10,4940,270,1911,0,98136,47.5463,-122.397,2590,10250,8,12,2014,UNK,2620,25515
7419700010,7/7/2014,665000.0,5,2.0,2800,17788,1.0,0.0,0.0,4,8,1400,1400,1963,0,98033,47.6719,-122.163,1760,18282,7,7,2014,UNK,1040,-494
1626069102,3/23/2015,500000.0,4,2.25,2060,44431,2.0,0.0,0.0,3,7,2060,0,1988,0,98077,47.744,-122.046,2160,45657,3,23,2015,UNK,-100,-1226
7574000080,4/1/2015,355500.0,5,2.0,2360,19899,1.0,0.0,0.0,4,7,2360,0,1968,0,98010,47.3299,-122.046,1860,19998,4,1,2015,UNK,500,-99
3830700010,12/5/2014,369000.0,4,2.5,2370,6557,2.0,0.0,0.0,3,9,2370,0,1998,0,98042,47.423,-122.155,2370,7378,12,5,2014,UNK,0,-821
1454100010,2/2/2015,338500.0,2,1.0,720,6050,1.0,0.0,0.0,2,5,720,0,1951,0,98125,47.7259,-122.29,1480,7280,2,2,2015,UNK,-760,-1230
603001045,4/29/2015,256000.0,3,1.0,950,4000,1.0,0.0,0.0,3,7,780,170,1949,0,98118,47.5232,-122.28399999999999,1230,4000,4,29,2015,UNK,-280,0
2607720440,3/4/2015,470000.0,3,2.5,1980,9725,2.0,0.0,0.0,3,8,1980,0,1994,0,98045,47.4856,-121.802,2070,9834,3,4,2015,UNK,-90,-109
930000470,5/27/2014,675000.0,3,2.5,2540,7680,2.0,0.0,1.0,4,9,2540,0,1940,2001,98177,47.7175,-122.36399999999999,2490,7680,5,27,2014,Y,50,0
2621750280,11/10/2014,369950.0,4,2.75,2760,7533,1.0,0.0,0.0,3,8,1400,1360,1997,0,98042,47.371,-122.10799999999999,2340,7943,11,10,2014,UNK,420,-410
7853220470,9/15/2014,615000.0,5,3.5,2950,7980,2.0,0.0,3.0,3,9,2350,600,2005,0,98065,47.5339,-121.85799999999999,2950,7980,9,15,2014,N,0,0
4139660430,5/5/2015,1200000.0,5,3.0,3640,28531,2.0,0.0,0.0,3,10,3640,0,1996,0,98006,47.5502,-122.13,3330,17186,5,5,2015,UNK,310,11345
1338800430,7/28/2014,950000.0,3,1.75,2150,3503,2.0,0.0,0.0,3,8,1870,280,1921,0,98112,47.6285,-122.303,3920,6402,7,28,2014,UNK,-1770,-2899
1338800491,10/21/2014,799500.0,4,2.5,2760,5750,2.0,0.0,0.0,3,8,2760,0,1993,0,98112,47.626999999999995,-122.303,2760,5390,10,21,2014,UNK,0,360
792000006,7/9/2014,187000.0,2,1.0,840,11600,1.0,0.0,0.0,3,6,840,0,1952,0,98168,47.492,-122.302,1610,9120,7,9,2014,UNK,-770,2480
7504020670,5/20/2014,598000.0,5,2.25,2890,12478,2.0,0.0,0.0,3,9,2890,0,1977,0,98074,47.6295,-122.052,2570,11880,5,20,2014,UNK,320,598
4017600010,4/17/2015,429950.0,3,2.25,2060,10160,1.0,0.0,0.0,4,8,1340,720,1967,0,98155,47.7712,-122.285,2320,11186,4,17,2015,UNK,-260,-1026
1471701410,3/31/2015,347950.0,5,2.25,1700,13500,1.5,0.0,0.0,4,7,1700,0,1962,0,98059,47.4611,-122.06700000000001,1810,14550,3,31,2015,UNK,-110,-1050
3528000470,5/9/2014,851000.0,3,2.5,3560,107290,2.0,0.0,0.0,3,10,3560,0,1987,0,98053,47.6652,-122.04899999999999,3660,89298,5,9,2014,UNK,-100,17992
3192000080,10/29/2014,205000.0,3,1.0,1210,10185,1.0,0.0,0.0,3,6,1210,0,1957,0,98146,47.4873,-122.345,1320,10245,10,29,2014,UNK,-110,-60
1565100010,3/27/2015,225000.0,3,2.25,1590,9200,1.0,0.0,0.0,4,7,1110,480,1979,0,98092,47.2917,-122.184,1880,9200,3,27,2015,UNK,-290,0
9201000460,10/6/2014,705000.0,4,2.25,2620,10536,1.0,0.0,0.0,3,8,1520,1100,1979,0,98075,47.5847,-122.075,2760,12431,10,6,2014,UNK,-140,-1895
323059316,5/5/2015,535000.0,5,2.5,3190,6178,2.0,0.0,0.0,3,8,3190,0,2003,0,98059,47.5104,-122.154,2480,7548,5,5,2015,UNK,710,-1370
6802200190,1/21/2015,222500.0,3,2.0,1450,9044,2.0,0.0,0.0,3,7,1450,0,1990,0,98022,47.1955,-121.98700000000001,1450,9044,1,21,2015,UNK,0,0
1773100430,4/24/2015,313500.0,2,1.5,1270,1282,2.0,0.0,0.0,3,8,1000,270,2006,0,98106,47.5581,-122.363,1270,1325,4,24,2015,N,0,-43
6137610190,3/17/2015,632000.0,3,2.25,2730,7521,2.0,0.0,2.0,3,9,2730,0,1992,0,98011,47.7704,-122.196,2700,8204,3,17,2015,UNK,30,-683
1568100387,3/22/2015,467000.0,3,2.0,1840,3432,2.0,0.0,0.0,3,7,1840,0,2012,0,98155,47.7368,-122.295,1280,7573,3,22,2015,N,560,-4141
3826500290,4/24/2015,339000.0,3,2.25,1970,7210,1.0,0.0,0.0,4,8,1380,590,1978,0,98030,47.3821,-122.171,1970,7350,4,24,2015,UNK,0,-140
629410190,6/19/2014,712000.0,3,2.75,3200,6699,2.0,0.0,0.0,3,9,3200,0,2004,0,98075,47.5884,-121.991,3020,6699,6,19,2014,N,180,0
4189800050,5/20/2014,335000.0,3,1.0,1060,10050,1.0,0.0,0.0,4,7,1060,0,1967,0,98028,47.7355,-122.23100000000001,1570,9938,5,20,2014,UNK,-510,112
6126600950,7/17/2014,470000.0,3,3.25,1740,1693,2.0,0.0,0.0,3,8,1360,380,2007,0,98116,47.558,-122.382,1130,1626,7,17,2014,N,610,67
5411800250,7/24/2014,367000.0,3,1.0,810,7000,1.0,0.0,0.0,3,7,810,0,1968,0,98052,47.6591,-122.134,1820,7589,7,24,2014,UNK,-1010,-589
7853302140,5/24/2014,440500.0,3,2.5,2460,4399,2.0,0.0,0.0,3,7,2460,0,2007,0,98065,47.5415,-121.884,2060,4399,5,24,2014,N,400,0
1423910670,5/27/2014,305000.0,4,1.0,2100,9288,1.0,0.0,0.0,4,7,1050,1050,1968,0,98058,47.4558,-122.171,1600,8550,5,27,2014,UNK,500,738
2301400470,9/8/2014,635000.0,3,1.75,1530,5000,1.0,0.0,2.0,3,7,1020,510,1948,0,98117,47.6806,-122.36,1530,5000,9,8,2014,UNK,0,0
1860600290,6/27/2014,1020000.0,3,2.25,1670,4800,1.5,0.0,3.0,3,8,1670,0,1903,0,98119,47.6356,-122.367,2300,4800,6,27,2014,UNK,-630,0
9267200345,6/2/2014,342000.0,2,2.5,1175,1366,2.0,0.0,0.0,3,8,740,435,2005,0,98103,47.6962,-122.34200000000001,1710,1255,6,2,2014,N,-535,111
3826500170,11/11/2014,283000.0,3,2.25,2130,8800,1.0,0.0,0.0,3,8,1270,860,1978,0,98030,47.383,-122.16799999999999,1960,8075,11,11,2014,UNK,170,725
9804500420,4/24/2015,430000.0,4,2.75,2470,50123,1.0,0.0,0.0,3,8,1280,1190,1978,0,98022,47.2504,-122.0,2200,54520,4,24,2015,UNK,270,-4397
2895550190,8/8/2014,245000.0,4,2.5,1700,4268,2.0,0.0,0.0,3,7,1700,0,2000,0,98001,47.3303,-122.26799999999999,1700,4488,8,8,2014,UNK,0,-220
6699930440,6/5/2014,355500.0,3,2.5,2600,5540,2.0,0.0,0.0,3,8,2600,0,2004,0,98038,47.3446,-122.041,2600,5540,6,5,2014,N,0,0
3543900380,4/9/2015,395000.0,3,1.0,1460,5000,1.0,0.0,0.0,4,7,1460,0,1934,1960,98115,47.6837,-122.32,1790,4000,4,9,2015,Y,-330,1000
59500050,12/16/2014,324900.0,4,2.25,2010,7280,2.0,0.0,0.0,4,8,2010,0,1988,0,98032,47.3585,-122.286,1660,7579,12,16,2014,UNK,350,-299
9274202885,5/8/2014,660000.0,3,1.75,1320,5750,1.5,0.0,0.0,5,7,1320,0,1918,0,98116,47.5848,-122.391,1440,5750,5,8,2014,UNK,-120,0
7701930050,8/11/2014,570000.0,3,2.5,3150,20189,2.0,0.0,0.0,3,10,3150,0,1990,0,98058,47.446999999999996,-122.088,2920,20612,8,11,2014,UNK,230,-423
200800480,11/6/2014,552321.0,3,2.5,1960,8469,2.0,0.0,0.0,4,8,1960,0,1984,0,98052,47.7236,-122.105,2040,8189,11,6,2014,UNK,-80,280
3835500005,5/28/2014,1100000.0,2,1.75,2050,11900,1.0,0.0,0.0,4,8,2050,0,1950,0,98004,47.6209,-122.219,2980,11900,5,28,2014,UNK,-930,0
9543000896,8/25/2014,237000.0,3,1.5,1800,9216,1.0,0.0,0.0,4,7,1800,0,1950,0,98001,47.2739,-122.249,1400,10022,8,25,2014,UNK,400,-806
1090000005,5/4/2015,402000.0,2,1.0,1210,5600,1.5,0.0,0.0,3,7,1210,0,1922,0,98136,47.5322,-122.39200000000001,1400,5028,5,4,2015,UNK,-190,572
5561000430,10/16/2014,470000.0,3,2.25,1830,39165,1.0,0.0,0.0,5,8,1830,0,1963,0,98027,47.4612,-121.992,2020,36184,10,16,2014,UNK,-190,2981
1568100670,3/20/2015,395900.0,3,1.75,1880,8706,1.0,0.0,0.0,3,7,940,940,1927,0,98155,47.7362,-122.292,1880,7200,3,20,2015,UNK,0,1506
6813600440,10/22/2014,442000.0,2,1.75,860,5535,1.0,0.0,0.0,3,7,860,0,1948,0,98103,47.6901,-122.331,1420,4960,10,22,2014,UNK,-560,575
7701990380,10/15/2014,795000.0,4,2.75,2890,16397,2.0,0.0,0.0,3,10,2890,0,1997,0,98077,47.7102,-122.072,3170,16397,10,15,2014,UNK,-280,0
7153400010,8/12/2014,190500.0,3,2.0,1390,10155,1.0,0.0,0.0,3,7,1130,260,1980,0,98003,47.2575,-122.305,1790,10155,8,12,2014,UNK,-400,0
5608010420,11/20/2014,808000.0,4,2.75,3340,7230,2.0,0.0,0.0,3,9,3340,0,1996,0,98027,47.549,-122.096,3230,7529,11,20,2014,UNK,110,-299
9141100073,8/26/2014,500000.0,4,2.5,2040,6685,2.0,0.0,0.0,3,8,2040,0,1998,0,98133,47.7413,-122.354,1890,8253,8,26,2014,UNK,150,-1568
629400480,6/19/2014,775000.0,4,2.75,3010,15992,2.0,0.0,0.0,3,11,3010,0,1996,0,98075,47.5895,-121.994,3330,12333,6,19,2014,UNK,-320,3659
9250900104,11/10/2014,300000.0,5,1.75,2110,8500,1.0,0.0,0.0,3,7,1100,1010,1962,0,98133,47.7737,-122.35,2020,8500,11,10,2014,UNK,90,0
9250900104,4/10/2015,496000.0,5,1.75,2110,8500,1.0,0.0,0.0,3,7,1100,1010,1962,0,98133,47.7737,-122.35,2020,8500,4,10,2015,UNK,90,0
5104531700,6/20/2014,448000.0,4,2.5,2510,6853,2.0,0.0,2.0,3,9,2510,0,2006,0,98038,47.3547,-122.00299999999999,3400,6965,6,20,2014,N,-890,-112
623039026,11/25/2014,645000.0,2,2.25,2770,11884,1.0,0.0,3.0,4,8,1570,1200,1969,0,98070,47.5098,-122.47399999999999,2310,17097,11,25,2014,UNK,460,-5213
7626200235,5/23/2014,464600.0,3,1.75,1120,5500,1.5,0.0,0.0,4,7,1120,0,1925,0,98136,47.5445,-122.391,1490,5500,5,23,2014,UNK,-370,0
7228500425,7/28/2014,590000.0,3,1.0,1530,2370,2.0,0.0,0.0,3,8,1530,0,1901,0,98122,47.6108,-122.303,1310,2370,7,28,2014,UNK,220,0
3332500095,10/7/2014,399000.0,3,2.5,1800,3300,2.0,0.0,0.0,3,7,1690,110,2004,0,98118,47.5491,-122.27600000000001,1570,3902,10,7,2014,N,230,-602
7950300440,10/15/2014,305000.0,2,1.0,1030,6000,1.0,0.0,0.0,3,7,1030,0,1925,0,98118,47.5669,-122.28299999999999,1510,5000,10,15,2014,UNK,-480,1000
8143000280,11/21/2014,478000.0,3,1.75,1210,6175,1.0,0.0,0.0,3,7,1210,0,1976,0,98034,47.7291,-122.20200000000001,1520,7475,11,21,2014,UNK,-310,-1300
4045500715,12/17/2014,598800.0,1,1.0,1090,32010,1.0,0.0,0.0,4,6,1090,0,1958,0,98014,47.6928,-121.87,1870,25346,12,17,2014,UNK,-780,6664
1155620190,6/3/2014,430000.0,4,2.25,1790,7203,1.0,0.0,0.0,4,7,1110,680,1973,0,98155,47.7709,-122.294,2270,9000,6,3,2014,UNK,-480,-1797
3332000715,7/1/2014,433000.0,4,1.5,1550,5053,1.0,0.0,0.0,4,7,1180,370,1963,0,98118,47.5499,-122.274,1450,5639,7,1,2014,UNK,100,-586
5113000420,3/20/2015,420000.0,4,2.75,2400,20000,1.0,0.0,0.0,3,8,1170,1230,1961,2015,98058,47.4556,-122.087,1690,20000,3,20,2015,Y,710,0
3223039181,6/9/2014,585000.0,4,1.75,2470,131790,2.0,0.0,2.0,3,8,2470,0,1937,0,98070,47.4421,-122.444,1470,92747,6,9,2014,UNK,1000,39043
7399300420,8/18/2014,255000.0,3,1.0,1170,7395,1.0,0.0,0.0,4,7,1170,0,1969,0,98055,47.4627,-122.19,1430,7920,8,18,2014,UNK,-260,-525
1088400190,4/22/2015,305000.0,3,1.0,1120,10125,1.0,0.0,0.0,3,6,1120,0,1961,0,98059,47.4794,-122.07799999999999,1120,8820,4,22,2015,UNK,0,1305
1588600177,2/25/2015,396000.0,4,1.0,1040,4420,1.5,0.0,0.0,3,6,1040,0,1944,0,98117,47.6945,-122.368,1310,4920,2,25,2015,UNK,-270,-500
9264950420,5/8/2014,347500.0,4,2.5,2460,7350,2.0,0.0,0.0,3,9,2460,0,1989,0,98023,47.3061,-122.34899999999999,2390,8568,5,8,2014,UNK,70,-1218
5418650080,8/14/2014,900000.0,4,2.5,3690,11468,2.0,0.0,0.0,3,11,3690,0,1987,0,98027,47.5699,-122.09200000000001,3370,10751,8,14,2014,UNK,320,717
9492800020,9/30/2014,425000.0,3,1.75,1960,43332,1.0,0.0,0.0,4,7,1400,560,1982,0,98077,47.739,-122.04799999999999,2010,44431,9,30,2014,UNK,-50,-1099
323089173,5/19/2014,429000.0,3,2.5,1920,15124,2.0,0.0,0.0,3,8,1920,0,1995,0,98045,47.5015,-121.773,1920,16477,5,19,2014,UNK,0,-1353
6821102358,2/24/2015,540000.0,3,2.25,1670,3135,2.0,0.0,0.0,3,8,1220,450,2002,0,98199,47.6478,-122.396,1630,1596,2,24,2015,UNK,40,1539
943100689,1/27/2015,324950.0,3,2.0,1340,9750,1.0,0.0,0.0,4,7,890,450,1974,0,98024,47.5644,-121.898,1460,12900,1,27,2015,UNK,-120,-3150
8722100825,4/29/2015,1050000.0,3,2.25,2610,3357,2.0,0.0,0.0,4,7,1980,630,1926,0,98112,47.63800000000001,-122.306,1940,3357,4,29,2015,UNK,670,0
4223000280,10/29/2014,221000.0,4,1.75,1540,7200,1.0,0.0,0.0,3,7,1260,280,1966,0,98003,47.3424,-122.30799999999999,1540,8416,10,29,2014,UNK,0,-1216
1454100122,6/11/2014,405000.0,3,2.0,1640,7201,1.0,0.0,0.0,3,8,1640,0,1948,0,98125,47.7216,-122.289,1750,7201,6,11,2014,UNK,-110,0
3323500010,1/7/2015,1150000.0,3,2.5,2100,15120,1.0,0.0,0.0,4,8,2100,0,1953,0,98004,47.6201,-122.22200000000001,3070,16078,1,7,2015,UNK,-970,-958
9557300080,8/22/2014,588000.0,4,1.75,1930,7245,1.0,0.0,0.0,4,8,1510,420,1972,0,98008,47.6396,-122.11200000000001,1880,7245,8,22,2014,UNK,50,0
6306100080,9/9/2014,234950.0,3,2.0,1430,10850,1.0,0.0,0.0,3,7,1430,0,1994,0,98001,47.2671,-122.23299999999999,1610,8015,9,9,2014,UNK,-180,2835
5700001100,10/7/2014,580000.0,4,1.5,2430,4995,1.5,0.0,0.0,4,7,1730,700,1928,0,98144,47.5782,-122.292,2240,5000,10,7,2014,UNK,190,-5
6187500080,7/16/2014,637000.0,5,3.0,2460,7240,1.0,0.0,0.0,3,9,1840,620,1991,0,98006,47.5486,-122.189,2530,7885,7,16,2014,UNK,-70,-645
7369600080,10/30/2014,704000.0,4,2.25,2490,6973,1.0,0.0,0.0,4,8,1490,0,1953,0,98199,47.6516,-122.40899999999999,1780,5612,10,30,2014,UNK,710,1361
1623049145,9/25/2014,210000.0,2,1.0,880,9750,1.0,0.0,0.0,5,6,880,0,1938,0,98168,47.4885,-122.29799999999999,1220,9406,9,25,2014,UNK,-340,344
2877102330,5/16/2014,772000.0,4,2.5,2110,3750,2.0,0.0,0.0,3,8,2110,0,2000,0,98117,47.6789,-122.363,1700,5000,5,16,2014,UNK,410,-1250
546001060,4/27/2015,763000.0,4,1.75,1850,4388,2.0,0.0,0.0,5,8,1850,0,1941,0,98117,47.6885,-122.381,1410,4107,4,27,2015,UNK,440,281
2822059091,2/18/2015,213500.0,2,1.5,2060,7713,1.5,0.0,0.0,4,7,2060,0,1930,0,98030,47.3722,-122.185,1780,7713,2,18,2015,UNK,280,0
3971701300,12/20/2014,255000.0,2,1.0,1360,9367,1.0,0.0,0.0,4,6,680,680,1924,0,98155,47.7689,-122.315,1360,7543,12,20,2014,UNK,0,1824
1732600050,10/17/2014,423500.0,3,2.0,2000,10490,1.0,0.0,0.0,3,8,1430,570,1978,0,98033,47.6976,-122.166,1530,7659,10,17,2014,UNK,470,2831
3585900430,12/22/2014,520000.0,3,1.5,1810,18483,1.0,0.0,0.0,3,8,1810,0,1954,0,98177,47.7617,-122.37799999999999,2920,20279,12,22,2014,UNK,-1110,-1796
6791000050,9/8/2014,550000.0,3,2.75,2230,14400,1.0,0.0,0.0,4,8,1460,770,1977,0,98075,47.5791,-122.04799999999999,2200,13280,9,8,2014,UNK,30,1120
1818800289,1/21/2015,795000.0,3,2.75,1820,7517,1.0,0.0,0.0,3,9,1820,0,1997,0,98116,47.5705,-122.406,2540,8035,1,21,2015,UNK,-720,-518
2738600080,8/15/2014,495000.0,4,3.0,2740,2811,2.0,0.0,0.0,3,8,2240,500,2003,0,98072,47.7738,-122.15799999999999,2740,3596,8,15,2014,UNK,0,-785
1310440950,3/2/2015,455000.0,4,2.5,2710,6558,2.0,0.0,0.0,3,9,2710,0,1997,0,98058,47.434,-122.109,2710,7635,3,2,2015,UNK,0,-1077
1322049150,3/5/2015,85000.0,2,1.0,910,9753,1.0,0.0,0.0,3,5,910,0,1947,0,98032,47.3897,-122.236,1160,7405,3,5,2015,UNK,-250,2348
7200080,11/4/2014,239000.0,4,2.0,1980,10585,1.5,0.0,0.0,2,6,1980,0,1924,0,98055,47.4836,-122.214,1360,7810,11,4,2014,UNK,620,2775
1788800080,7/30/2014,184900.0,3,1.0,1040,10080,1.0,0.0,0.0,3,6,1040,0,1959,0,98023,47.32899999999999,-122.34299999999999,1000,8736,7,30,2014,UNK,40,1344
1328320920,4/21/2015,386000.0,4,2.25,2810,8560,1.0,0.0,0.0,3,8,1610,1200,1979,0,98058,47.4437,-122.124,2400,7600,4,21,2015,UNK,410,960
7283900185,6/4/2014,415000.0,4,2.5,2000,5962,2.0,0.0,0.0,3,8,2000,0,1999,0,98133,47.7695,-122.35,1790,10500,6,4,2014,UNK,210,-4538
8685500020,5/12/2015,387000.0,3,1.0,1530,6372,1.0,0.0,0.0,3,7,1210,320,1962,0,98118,47.535,-122.289,1960,6426,5,12,2015,UNK,-430,-54
1338800425,3/4/2015,2140000.0,6,4.0,5110,7128,2.5,0.0,0.0,4,11,5110,0,1906,0,98112,47.6285,-122.304,4110,6480,3,4,2015,UNK,1000,648
282500010,1/7/2015,685000.0,4,2.25,3133,16197,2.0,0.0,0.0,3,9,2533,600,1965,2010,98166,47.4255,-122.338,3090,15588,1,7,2015,Y,43,609
798000630,10/31/2014,340000.0,4,2.5,2020,32710,1.0,0.0,0.0,3,7,1070,950,1941,0,98168,47.4969,-122.33,1340,17700,10,31,2014,UNK,680,15010
5583200345,5/11/2015,422000.0,2,1.0,750,4000,1.0,0.0,0.0,4,6,750,0,1926,0,98118,47.5547,-122.272,1120,5038,5,11,2015,UNK,-370,-1038
1036100130,8/8/2014,442000.0,3,2.5,1980,39932,2.0,0.0,0.0,3,8,1980,0,1994,0,98011,47.7433,-122.196,2610,12769,8,8,2014,UNK,-630,27163
795002375,5/27/2014,280000.0,3,1.0,1200,6250,1.0,0.0,0.0,3,6,920,280,1943,0,98168,47.5095,-122.331,1280,9375,5,27,2014,UNK,-80,-3125
1245000461,7/3/2014,1150000.0,5,2.5,3580,8921,2.0,0.0,0.0,3,9,3580,0,2000,0,98033,47.69300000000001,-122.20200000000001,2710,9308,7,3,2014,UNK,870,-387
6802200280,11/10/2014,279000.0,3,2.5,2010,11618,2.0,0.0,0.0,3,7,2010,0,1990,0,98022,47.1956,-121.985,1550,9354,11,10,2014,UNK,460,2264
9521100795,6/23/2014,569000.0,4,2.0,1730,3884,1.0,0.0,0.0,5,7,1060,670,1924,0,98103,47.6624,-122.34899999999999,1360,3563,6,23,2014,UNK,370,321
4039800080,5/29/2014,1360000.0,5,3.5,5960,13703,2.0,0.0,2.0,3,10,4770,1190,1984,0,98008,47.6151,-122.10700000000001,2810,17320,5,29,2014,UNK,3150,-3617
6146600595,4/10/2015,209950.0,2,1.0,860,5080,1.0,0.0,0.0,3,7,860,0,1960,0,98032,47.39,-122.236,1250,6477,4,10,2015,UNK,-390,-1397
6380500151,3/17/2015,468000.0,3,1.5,1370,7697,1.0,0.0,0.0,3,7,1370,0,1939,0,98177,47.7153,-122.361,1370,7697,3,17,2015,UNK,0,0
8643000185,4/30/2015,237100.0,3,1.75,1360,9603,1.0,0.0,0.0,3,7,1360,0,1963,0,98198,47.3959,-122.309,2240,10605,4,30,2015,UNK,-880,-1002
7212650950,7/8/2014,336000.0,4,2.5,2530,8169,2.0,0.0,0.0,3,8,2530,0,1993,0,98003,47.2634,-122.31200000000001,2220,8013,7,8,2014,UNK,310,156
357000005,12/22/2014,500000.0,4,2.0,1680,3813,2.0,0.0,0.0,4,7,1680,0,1900,0,98144,47.593,-122.29299999999999,2540,3996,12,22,2014,UNK,-860,-183
5648600010,4/26/2015,290000.0,3,2.5,1580,6860,2.0,0.0,0.0,3,7,1580,0,1995,0,98055,47.4447,-122.18799999999999,1580,7050,4,26,2015,UNK,0,-190
2818600010,3/14/2015,1190000.0,7,3.5,3890,8342,2.0,0.0,4.0,3,9,2840,1050,1968,0,98117,47.7011,-122.39200000000001,2870,8342,3,14,2015,UNK,1020,0
9842300095,7/25/2014,365000.0,5,2.0,1600,4168,1.5,0.0,0.0,3,7,1600,0,1927,0,98126,47.5297,-122.381,1190,4168,7,25,2014,UNK,410,0
3977630130,3/25/2015,146300.0,3,1.0,1200,9668,1.0,0.0,0.0,5,6,1200,0,1975,0,98092,47.3156,-122.12799999999999,1200,9800,3,25,2015,UNK,0,-132
5160300020,6/9/2014,554000.0,3,1.75,1760,10780,1.0,0.0,0.0,3,8,1760,0,1977,0,98005,47.5938,-122.154,2090,10780,6,9,2014,UNK,-330,0
3754700050,6/18/2014,424000.0,3,2.0,1670,7700,1.0,0.0,0.0,3,7,1170,500,1972,0,98034,47.725,-122.2,1500,7875,6,18,2014,UNK,170,-175
629860010,4/29/2015,1350000.0,4,3.5,4640,9827,2.0,0.0,2.0,3,10,3210,1430,2007,0,98027,47.5524,-122.07799999999999,3810,8207,4,29,2015,N,830,1620
446000010,11/19/2014,508500.0,4,1.5,1800,6750,1.5,0.0,0.0,4,7,1800,0,1950,0,98115,47.6868,-122.285,1420,5900,11,19,2014,UNK,380,850
8562000010,5/1/2015,244500.0,3,1.75,1210,8864,1.0,0.0,0.0,3,7,1210,0,1985,0,98042,47.3639,-122.08,1510,8062,5,1,2015,UNK,-300,802
646910480,11/20/2014,206000.0,2,2.5,1280,1566,2.0,0.0,0.0,3,7,1280,0,2005,0,98055,47.4336,-122.195,1460,1845,11,20,2014,N,-180,-279
868000415,9/5/2014,643500.0,3,2.0,1650,7104,2.0,0.0,0.0,3,8,1650,0,1945,0,98177,47.7053,-122.374,1730,7104,9,5,2014,UNK,-80,0
1826049430,5/20/2014,372500.0,4,1.75,1590,10523,2.0,0.0,0.0,4,7,1590,0,1922,0,98133,47.7358,-122.34200000000001,1610,8568,5,20,2014,UNK,-20,1955
2769600190,7/15/2014,630000.0,5,2.0,1900,5000,1.0,0.0,2.0,3,8,1720,180,1957,0,98107,47.6735,-122.36200000000001,1770,5000,7,15,2014,UNK,130,0
3630070280,7/10/2014,418000.0,2,2.5,1500,3608,2.0,0.0,0.0,3,8,1500,0,2005,0,98029,47.5472,-121.994,2080,2686,7,10,2014,N,-580,922
8944460190,2/25/2015,425000.0,4,2.5,2689,6688,2.0,0.0,0.0,3,9,2689,0,2006,0,98030,47.3803,-122.184,2665,5700,2,25,2015,N,24,988
3630180470,2/5/2015,800000.0,4,2.75,3250,5500,2.0,0.0,0.0,3,9,3250,0,2007,0,98027,47.5398,-121.99700000000001,3920,6000,2,5,2015,N,-670,-500
6099400293,12/8/2014,208000.0,2,1.0,960,13438,1.0,0.0,0.0,3,7,960,0,1951,0,98168,47.4745,-122.295,1630,11656,12,8,2014,UNK,-670,1782
6791000280,7/14/2014,476000.0,3,1.75,1650,9600,1.0,0.0,0.0,4,7,1650,0,1977,0,98075,47.5779,-122.044,2040,12220,7,14,2014,UNK,-390,-2620
7796450190,2/2/2015,277500.0,3,2.5,1690,5171,2.0,0.0,0.0,3,8,1690,0,2003,0,98023,47.2779,-122.34700000000001,2550,5025,2,2,2015,UNK,-860,146
2294900010,8/13/2014,478000.0,3,1.75,2790,36585,1.0,0.0,0.0,4,8,1410,1380,1970,0,98027,47.4734,-121.999,1900,45302,8,13,2014,UNK,890,-8717
1186000095,7/8/2014,890000.0,4,2.75,2310,4020,3.0,0.0,0.0,5,8,2310,0,1979,0,98122,47.6154,-122.291,2270,3750,7,8,2014,UNK,40,270
2770601763,3/23/2015,450000.0,3,3.5,1790,1288,3.0,0.0,0.0,3,8,1390,400,2000,0,98199,47.651,-122.384,1560,1426,3,23,2015,UNK,230,-138
3392100050,6/25/2014,205000.0,3,1.0,1230,8750,1.0,0.0,0.0,3,6,1230,0,1965,0,98003,47.3266,-122.334,1230,8750,6,25,2014,UNK,0,0
2878600655,7/18/2014,665000.0,3,2.0,1620,2640,1.5,0.0,0.0,5,8,1620,0,1929,0,98115,47.6884,-122.322,1470,4080,7,18,2014,UNK,150,-1440
3299200080,10/3/2014,518000.0,4,2.75,2440,12051,1.0,0.0,0.0,5,8,1440,1000,1966,0,98133,47.7456,-122.351,2030,8006,10,3,2014,UNK,410,4045
2564900020,9/24/2014,465000.0,4,2.25,2100,7350,2.0,0.0,0.0,3,8,2100,0,1979,0,98033,47.7019,-122.171,1780,7350,9,24,2014,UNK,320,0
2111010080,6/17/2014,330000.0,3,2.5,3040,7232,2.0,0.0,0.0,3,7,3040,0,2003,0,98092,47.3355,-122.16799999999999,2760,6926,6,17,2014,UNK,280,306
6669080020,12/26/2014,449400.0,4,3.0,2490,5064,2.0,0.0,0.0,3,7,2490,0,2007,0,98056,47.5139,-122.189,2470,5064,12,26,2014,N,20,0
8682300010,2/6/2015,829000.0,3,2.75,2690,10443,1.0,0.0,0.0,3,9,2690,0,2007,0,98053,47.7185,-122.024,1440,4185,2,6,2015,N,1250,6258
1974200020,2/20/2015,450000.0,4,1.75,2190,9752,1.0,0.0,0.0,3,8,2190,0,1964,0,98034,47.7108,-122.23899999999999,2040,9964,2,20,2015,UNK,150,-212
3211000190,10/1/2014,310000.0,3,1.75,1490,9120,1.0,0.0,0.0,5,7,1490,0,1959,0,98059,47.4806,-122.163,1340,8040,10,1,2014,UNK,150,1080
6354000050,9/8/2014,615000.0,3,2.25,2530,45234,2.0,0.0,0.0,4,9,2530,0,1985,0,98072,47.7221,-122.12,3110,35617,9,8,2014,UNK,-580,9617
625049153,6/3/2014,605000.0,3,2.0,2060,4040,1.0,0.0,0.0,4,8,1120,940,1947,0,98103,47.6798,-122.352,1500,4000,6,3,2014,UNK,560,40
5561000190,5/2/2014,437500.0,3,2.25,1970,35100,2.0,0.0,0.0,4,9,1970,0,1977,0,98027,47.4635,-121.991,2340,35100,5,2,2014,UNK,-370,0
4449800595,9/22/2014,545000.0,3,1.75,1400,4000,1.5,0.0,0.0,4,7,1400,0,1925,0,98117,47.6902,-122.38799999999999,1050,4330,9,22,2014,UNK,350,-330
1115750190,7/17/2014,770000.0,3,2.5,3680,35617,1.0,0.0,0.0,3,10,2390,1290,1985,0,98052,47.7213,-122.12,3570,35633,7,17,2014,UNK,110,-16
8644300170,7/3/2014,600000.0,5,2.25,3000,13899,2.0,0.0,0.0,4,8,3000,0,1975,0,98052,47.6373,-122.105,2270,10763,7,3,2014,UNK,730,3136
9523102660,5/13/2014,560000.0,3,1.0,1440,5000,2.0,0.0,0.0,3,7,1440,0,1910,0,98103,47.6741,-122.354,1850,4500,5,13,2014,UNK,-410,500
1630700380,1/30/2015,1920000.0,5,5.75,7730,230868,2.0,0.0,0.0,3,12,6660,1070,2004,0,98077,47.7615,-122.084,2660,39292,1,30,2015,N,5070,191576
7588700007,11/24/2014,457000.0,3,1.0,1170,3348,1.5,0.0,0.0,4,7,1170,0,1924,0,98117,47.687,-122.37799999999999,1590,4219,11,24,2014,UNK,-420,-871
3501600235,5/5/2014,585000.0,2,1.0,1770,8640,1.5,0.0,0.0,3,6,1520,250,1949,0,98117,47.6926,-122.363,1060,4804,5,5,2014,UNK,710,3836
9545230280,5/7/2014,560000.0,3,2.0,1860,13374,1.0,0.0,0.0,3,8,1860,0,1985,0,98027,47.5397,-122.054,1960,9797,5,7,2014,UNK,-100,3577
7905200130,4/5/2015,345000.0,2,1.0,770,3008,1.0,0.0,0.0,4,5,770,0,1917,0,98116,47.5686,-122.389,1550,4563,4,5,2015,UNK,-780,-1555
2742100250,7/20/2014,550000.0,4,3.5,3820,17745,2.0,0.0,2.0,3,8,2440,1380,1955,0,98108,47.556999999999995,-122.295,2520,9640,7,20,2014,UNK,1300,8105
5104540500,6/24/2014,589950.0,4,2.5,3190,8195,2.0,0.0,0.0,3,10,3190,0,2006,0,98038,47.3555,-122.00299999999999,3400,7607,6,24,2014,N,-210,588
638100073,6/2/2014,327000.0,3,1.5,1320,13200,1.0,0.0,0.0,3,7,1320,0,1970,0,98059,47.5009,-122.14299999999999,1730,13200,6,2,2014,UNK,-410,0
3022039071,5/30/2014,800000.0,2,2.25,1730,31491,2.0,1.0,2.0,4,7,1730,0,1947,1988,98070,47.37300000000001,-122.464,1400,12410,5,30,2014,Y,330,19081
3426079024,5/21/2014,150000.0,3,1.0,1010,25000,1.0,0.0,0.0,3,6,1010,0,1966,0,98014,47.6927,-121.90100000000001,2020,101494,5,21,2014,UNK,-1010,-76494
2767604254,6/3/2014,425000.0,2,2.5,1140,1182,3.0,0.0,0.0,3,8,1140,0,2007,0,98107,47.6713,-122.383,1290,1189,6,3,2014,N,-150,-7
1138010170,8/1/2014,350000.0,3,1.0,860,7030,1.0,0.0,0.0,3,7,860,0,1973,0,98034,47.7151,-122.211,1360,7500,8,1,2014,UNK,-500,-470
9407100500,3/11/2015,273000.0,3,1.75,1540,10545,2.0,0.0,0.0,4,6,1540,0,1978,0,98045,47.4451,-121.76299999999999,1540,10000,3,11,2015,UNK,0,545
191100250,3/20/2015,750000.0,4,2.25,2160,9525,1.0,0.0,0.0,3,8,1080,1080,1961,0,98040,47.5651,-122.221,2780,9525,3,20,2015,UNK,-620,0
1557000190,10/9/2014,240000.0,3,1.5,1450,9477,1.0,0.0,0.0,4,7,1450,0,1963,0,98031,47.4215,-122.20299999999999,1460,9477,10,9,2014,UNK,-10,0
8732020670,3/20/2015,400000.0,3,1.75,1830,9620,1.0,0.0,0.0,4,8,1830,0,1978,0,98023,47.3123,-122.389,1990,8280,3,20,2015,UNK,-160,1340
5029450290,10/3/2014,230000.0,3,1.5,1630,6625,1.0,0.0,0.0,5,7,980,650,1980,0,98023,47.29,-122.368,1440,7145,10,3,2014,UNK,190,-520
8035600290,4/13/2015,372000.0,4,2.5,2500,8215,2.0,0.0,0.0,3,8,2500,0,1990,0,98031,47.4124,-122.204,2360,7801,4,13,2015,UNK,140,414
6450301835,7/5/2014,459500.0,3,1.75,1470,4950,1.0,0.0,0.0,3,7,1030,440,1984,0,98133,47.7325,-122.337,1100,5250,7,5,2014,UNK,370,-300
6388930420,8/5/2014,582000.0,3,2.5,2380,19860,2.0,0.0,0.0,4,8,2380,0,1995,0,98056,47.5255,-122.17299999999999,2450,10220,8,5,2014,UNK,-70,9640
2296700470,11/6/2014,465000.0,4,2.5,2170,7700,1.0,0.0,0.0,3,7,1420,750,1969,0,98034,47.7216,-122.219,1710,7770,11,6,2014,UNK,460,-70
1473120190,5/30/2014,386000.0,3,2.0,2120,7560,1.0,0.0,0.0,3,9,2120,0,1991,0,98058,47.435,-122.16,2660,7700,5,30,2014,UNK,-540,-140
11200290,6/9/2014,546000.0,3,2.5,1530,3464,2.0,0.0,0.0,3,8,1530,0,1998,0,98007,47.6179,-122.141,1530,3446,6,9,2014,UNK,0,18
5530000050,10/27/2014,278000.0,3,1.75,2710,9088,1.0,0.0,0.0,4,7,2060,650,1965,0,98001,47.3073,-122.272,1690,10454,10,27,2014,UNK,1020,-1366
7853220670,9/18/2014,540000.0,3,2.5,2860,8935,2.0,0.0,0.0,3,8,2860,0,2004,0,98065,47.5336,-121.855,2650,6167,9,18,2014,N,210,2768
3124089049,12/8/2014,529000.0,4,1.75,2800,90169,2.0,0.0,0.0,3,7,2800,0,1934,0,98065,47.5204,-121.829,1600,27194,12,8,2014,UNK,1200,62975
868000305,6/17/2014,554000.0,4,1.0,1120,7104,1.5,0.0,0.0,3,7,1120,0,1946,0,98177,47.7055,-122.37200000000001,1370,7104,6,17,2014,UNK,-250,0
1311200380,8/27/2014,210000.0,3,1.0,1730,7210,1.0,0.0,0.0,3,7,1430,300,1963,0,98001,47.3404,-122.28,1820,7210,8,27,2014,UNK,-90,0
9197100101,5/4/2015,225000.0,2,1.0,1010,5408,1.0,0.0,0.0,4,6,1010,0,1926,0,98032,47.3759,-122.238,980,7800,5,4,2015,UNK,30,-2392
6646200280,7/15/2014,561600.0,4,2.5,2350,6624,2.0,0.0,0.0,3,9,2350,0,1990,0,98074,47.6262,-122.045,2590,11240,7,15,2014,UNK,-240,-4616
7116500920,5/20/2014,300000.0,6,5.25,2860,5682,2.0,0.0,0.0,3,7,2860,0,1978,0,98002,47.303000000000004,-122.221,1390,5956,5,20,2014,UNK,1470,-274
1068000255,8/27/2014,1650000.0,4,3.5,4285,9567,2.0,0.0,1.0,5,10,3485,800,1946,0,98199,47.6434,-122.40899999999999,2960,6902,8,27,2014,UNK,1325,2665
1240700170,6/9/2014,1020000.0,4,3.75,4060,19290,2.0,0.0,0.0,3,10,4060,0,2002,0,98074,47.6051,-122.053,4020,13250,6,9,2014,UNK,40,6040
4031000250,6/26/2014,150000.0,3,1.0,1310,9612,1.0,0.0,0.0,3,7,960,350,1962,0,98001,47.2958,-122.285,1310,9812,6,26,2014,UNK,0,-200
7625703260,9/24/2014,400950.0,2,1.75,2320,6250,1.0,0.0,0.0,3,7,1400,920,1948,0,98136,47.5468,-122.38600000000001,1420,6250,9,24,2014,UNK,900,0
8651580660,1/21/2015,620000.0,4,2.25,2210,8101,2.0,0.0,0.0,3,9,2210,0,1985,0,98074,47.6475,-122.07,2330,8842,1,21,2015,UNK,-120,-741
6117500980,8/18/2014,449000.0,4,2.75,2090,14141,1.5,0.0,0.0,4,8,1680,410,1941,0,98166,47.4333,-122.34700000000001,1990,12920,8,18,2014,UNK,100,1221
9547205380,7/28/2014,630000.0,4,2.5,2240,4025,1.0,0.0,2.0,3,7,1250,990,1926,0,98115,47.6818,-122.311,1380,3500,7,28,2014,UNK,860,525
414100280,4/14/2015,336000.0,2,1.0,1180,7200,1.0,0.0,0.0,4,6,1180,0,1949,0,98133,47.7475,-122.34200000000001,1180,7200,4,14,2015,UNK,0,0
321059091,6/5/2014,299950.0,4,1.75,1560,31299,1.0,0.0,0.0,4,7,1560,0,1965,0,98092,47.3384,-122.164,2460,44907,6,5,2014,UNK,-900,-13608
7772000010,3/9/2015,352500.0,4,2.0,1970,7451,1.0,0.0,0.0,3,8,1350,620,1962,0,98133,47.765,-122.335,1980,7510,3,9,2015,UNK,-10,-59
7200179,10/16/2014,150000.0,2,1.0,840,12750,1.0,0.0,0.0,3,6,840,0,1925,0,98055,47.483999999999995,-122.211,1480,6969,10,16,2014,UNK,-640,5781
7200179,4/24/2015,175000.0,2,1.0,840,12750,1.0,0.0,0.0,3,6,840,0,1925,0,98055,47.483999999999995,-122.211,1480,6969,4,24,2015,UNK,-640,5781
8029500380,7/31/2014,305000.0,3,2.0,1830,10873,1.0,0.0,0.0,3,8,1830,0,1989,0,98023,47.3066,-122.39399999999999,2490,8976,7,31,2014,UNK,-660,1897
825059178,9/23/2014,2570000.0,4,3.75,4475,20424,2.0,0.0,4.0,3,12,2659,1816,1999,0,98033,47.6646,-122.208,4340,5250,9,23,2014,UNK,135,15174
6021502750,7/15/2014,607500.0,3,1.5,1800,4700,1.0,0.0,0.0,3,7,1200,600,1941,0,98117,47.6858,-122.385,1580,4700,7,15,2014,UNK,220,0
9268200380,11/18/2014,505000.0,2,1.0,1250,5040,1.0,0.0,0.0,3,7,950,300,1920,0,98117,47.6959,-122.365,1290,5040,11,18,2014,UNK,-40,0
2008000420,10/27/2014,280500.0,3,1.75,2440,10179,1.0,0.0,0.0,4,7,1220,1220,1962,0,98198,47.4118,-122.314,1650,9711,10,27,2014,UNK,790,468
8914100170,7/31/2014,610000.0,3,2.5,2910,12283,2.0,0.0,2.0,3,10,2910,0,1993,0,98058,47.4602,-122.152,2680,22499,7,31,2014,UNK,230,-10216
6654700250,8/12/2014,381000.0,5,2.75,3060,6895,2.0,0.0,0.0,3,8,3060,0,2003,0,98042,47.3809,-122.098,2590,6895,8,12,2014,UNK,470,0
6139800430,5/22/2014,482000.0,5,2.25,2230,9600,1.0,0.0,0.0,3,8,1320,910,1978,0,98077,47.7466,-122.07600000000001,2080,9760,5,22,2014,UNK,150,-160
9477201470,10/22/2014,379950.0,3,1.0,1270,6900,1.0,0.0,0.0,3,7,1270,0,1977,0,98034,47.7279,-122.19200000000001,1480,7280,10,22,2014,UNK,-210,-380
3025300095,10/9/2014,2500000.0,4,4.5,4300,19844,2.0,0.0,0.0,3,11,4300,0,1985,1999,98039,47.6218,-122.23700000000001,3070,19845,10,9,2014,Y,1230,-1
3211290050,6/23/2014,425000.0,3,2.25,1580,39189,1.0,0.0,0.0,3,7,1180,400,1992,0,98053,47.6365,-121.97200000000001,1580,29649,6,23,2014,UNK,0,9540
7511200190,9/10/2014,580000.0,4,2.25,2570,36465,2.0,0.0,0.0,4,8,2570,0,1980,0,98053,47.6555,-122.042,2390,41454,9,10,2014,UNK,180,-4989
5739601300,3/30/2015,605000.0,2,1.0,860,6510,1.0,0.0,0.0,3,7,860,0,1952,0,98004,47.6021,-122.20200000000001,1740,10800,3,30,2015,UNK,-880,-4290
3278602660,5/20/2014,194000.0,1,1.0,820,1060,1.0,0.0,0.0,3,8,760,60,2007,0,98126,47.5472,-122.37200000000001,1770,1853,5,20,2014,N,-950,-793
8078410250,4/1/2015,546200.0,4,2.25,2090,8579,2.0,0.0,0.0,3,8,2090,0,1987,0,98074,47.6364,-122.03,1850,8843,4,1,2015,UNK,240,-264
2798000020,8/15/2014,1400000.0,4,3.5,3560,16782,2.0,0.0,0.0,3,10,2560,1000,2014,0,98040,47.5569,-122.225,3100,18047,8,15,2014,N,460,-1265
2739200050,4/3/2015,315000.0,3,1.75,1860,9629,1.0,0.0,0.0,4,7,1240,620,1961,0,98059,47.4913,-122.14299999999999,1940,9629,4,3,2015,UNK,-80,0
9278200095,12/17/2014,465000.0,3,1.5,900,8690,1.5,0.0,0.0,5,6,900,0,1941,0,98116,47.5751,-122.39299999999999,1000,6150,12,17,2014,UNK,-100,2540
3222079120,10/1/2014,330000.0,2,1.0,1160,32251,1.0,0.0,0.0,3,6,580,580,1963,0,98010,47.3537,-121.939,1160,33656,10,1,2014,UNK,0,-1405
4401200010,8/8/2014,795000.0,4,2.75,3100,7501,2.0,0.0,0.0,3,10,3100,0,1998,0,98052,47.6859,-122.109,3140,8672,8,8,2014,UNK,-40,-1171
2473250280,8/26/2014,265000.0,4,2.25,2300,9100,1.0,0.0,0.0,3,7,1280,1020,1977,0,98058,47.4576,-122.16,1640,9100,8,26,2014,UNK,660,0
4441300170,1/12/2015,1300000.0,4,2.5,3110,11857,2.0,0.0,4.0,3,11,2040,1070,1990,0,98117,47.6952,-122.402,3110,11570,1,12,2015,UNK,0,287
723049530,5/5/2015,126500.0,3,1.0,1130,12212,1.0,0.0,0.0,3,6,1130,0,1942,0,98146,47.4952,-122.34,1190,9240,5,5,2015,UNK,-60,2972
6752510010,8/5/2014,760000.0,4,2.5,2920,7901,2.0,0.0,0.0,3,9,2920,0,2004,0,98052,47.7036,-122.125,3020,7900,8,5,2014,N,-100,1
955000430,9/3/2014,540000.0,2,1.25,1230,1569,2.0,0.0,0.0,3,9,1050,180,2009,0,98112,47.6193,-122.304,1100,1230,9,3,2014,N,130,339
8663100050,5/19/2014,446000.0,5,2.75,2190,12687,1.0,0.0,0.0,5,7,1370,820,1978,0,98028,47.7762,-122.257,2280,10784,5,19,2014,UNK,-90,1903
226109056,3/26/2015,170000.0,1,0.75,850,5600,1.0,0.0,2.0,3,6,850,0,1903,0,98019,47.7654,-121.48,900,12250,3,26,2015,UNK,-50,-6650
2558600130,10/23/2014,379000.0,3,2.5,1500,7420,1.0,0.0,0.0,3,7,1000,500,1972,0,98034,47.7236,-122.17399999999999,1840,7272,10,23,2014,UNK,-340,148
8823900290,3/17/2015,1400000.0,9,4.0,4620,5508,2.5,0.0,0.0,3,11,3870,750,1915,0,98105,47.6684,-122.309,2710,4320,3,17,2015,UNK,1910,1188
8691400080,6/20/2014,800000.0,4,2.75,3150,7035,2.0,0.0,0.0,3,9,3150,0,2004,0,98075,47.5979,-121.97399999999999,3200,7035,6,20,2014,N,-50,0
621069102,3/16/2015,260000.0,3,1.0,1300,10139,1.0,0.0,0.0,3,7,1300,0,1962,2007,98042,47.3427,-122.087,1260,10139,3,16,2015,Y,40,0
5456000280,3/10/2015,820000.0,5,2.5,3160,8000,1.0,0.0,0.0,4,7,1580,1580,1960,0,98040,47.5735,-122.208,2440,8079,3,10,2015,UNK,720,-79
2891400380,4/14/2015,449950.0,3,1.75,2070,96703,1.0,0.0,3.0,4,7,2070,0,1999,0,98092,47.2853,-122.008,1820,117612,4,14,2015,UNK,250,-20909
2297400020,9/2/2014,392000.0,3,2.25,1790,7125,1.0,0.0,0.0,3,7,1220,570,1974,0,98034,47.7184,-122.226,2040,7950,9,2,2014,UNK,-250,-825
7215721350,4/22/2015,465000.0,3,2.5,1650,4636,2.0,0.0,0.0,3,8,1650,0,1999,0,98075,47.5997,-122.016,1650,4504,4,22,2015,UNK,0,132
5490210670,8/22/2014,449950.0,4,2.5,2070,7312,1.0,0.0,0.0,4,7,1230,840,1977,0,98052,47.6958,-122.12,1770,7668,8,22,2014,UNK,300,-356
6431500122,4/28/2015,520000.0,3,1.5,1580,8841,1.5,0.0,0.0,5,7,1180,400,1923,0,98103,47.6931,-122.352,1580,7512,4,28,2015,UNK,0,1329
3376600170,8/28/2014,546800.0,4,2.25,2170,10000,1.0,0.0,0.0,3,8,1420,750,1975,0,98008,47.6219,-122.109,2390,11000,8,28,2014,UNK,-220,-1000
8861000235,3/24/2015,825000.0,4,2.75,2220,11925,1.0,0.0,0.0,3,7,1560,660,1953,1985,98004,47.6381,-122.205,2500,11377,3,24,2015,Y,-280,548
2881700231,4/22/2015,337000.0,3,1.75,1440,11364,1.0,0.0,0.0,3,7,1440,0,1985,0,98155,47.743,-122.32799999999999,1950,9390,4,22,2015,UNK,-510,1974
534000080,6/11/2014,333000.0,2,1.0,720,6686,1.0,0.0,0.0,3,6,720,0,1942,0,98117,47.7003,-122.36200000000001,1200,6686,6,11,2014,UNK,-480,0
6371000020,11/11/2014,380000.0,2,2.0,1120,780,2.0,0.0,0.0,3,8,760,360,2004,0,98116,47.5788,-122.41,1120,1322,11,11,2014,N,0,-542
7212651440,4/28/2015,280000.0,3,2.5,1970,8426,2.0,0.0,0.0,3,8,1970,0,1992,0,98003,47.2674,-122.306,1970,9197,4,28,2015,UNK,0,-771
7575500080,11/20/2014,202000.0,3,1.5,1420,9081,1.0,0.0,0.0,4,6,1420,0,1990,0,98022,47.1948,-121.999,1090,8410,11,20,2014,UNK,330,671
7197800020,4/27/2015,585000.0,4,2.5,2250,4119,2.0,0.0,0.0,3,8,2250,0,2001,0,98075,47.5973,-122.03399999999999,2290,3115,4,27,2015,UNK,-40,1004
5592900285,11/4/2014,435000.0,4,2.0,2630,9663,1.0,0.0,1.0,4,8,1330,1300,1956,0,98056,47.4841,-122.19,1900,8894,11,4,2014,UNK,730,769
525069127,5/23/2014,1200000.0,4,3.5,4740,172497,2.0,0.0,0.0,3,11,4740,0,2003,0,98053,47.6779,-122.075,2120,49658,5,23,2014,UNK,2620,122839
2460900010,9/24/2014,364000.0,2,2.25,1280,2574,2.0,0.0,0.0,3,7,1280,0,1992,0,98144,47.5939,-122.302,1250,3960,9,24,2014,UNK,30,-1386
1566100595,5/14/2014,300000.0,3,1.0,1260,8280,1.0,0.0,0.0,3,6,1260,0,1946,0,98115,47.7,-122.29899999999999,2100,8280,5,14,2014,UNK,-840,0
8682291680,3/17/2015,558000.0,2,1.75,1930,4601,1.0,0.0,0.0,3,8,1930,0,2006,0,98053,47.7196,-122.022,1670,4500,3,17,2015,N,260,101
7841300285,8/11/2014,199950.0,1,1.5,1048,4800,1.0,0.0,0.0,3,7,1048,0,1942,0,98055,47.4759,-122.212,950,4800,8,11,2014,UNK,98,0
6071700020,8/27/2014,515000.0,3,2.25,1640,8400,1.0,0.0,0.0,4,8,1640,0,1962,0,98006,47.5484,-122.17200000000001,2110,8400,8,27,2014,UNK,-470,0
4315700275,11/7/2014,590000.0,4,2.5,2380,4950,2.0,0.0,0.0,3,8,2380,0,2004,0,98136,47.5382,-122.391,1370,5120,11,7,2014,N,1010,-170
2330000130,7/23/2014,813500.0,4,2.0,2530,15520,1.0,0.0,0.0,5,8,2220,310,1964,0,98005,47.613,-122.167,2500,13300,7,23,2014,UNK,30,2220
1246700103,4/23/2015,725000.0,4,2.5,2700,25870,2.0,0.0,0.0,4,8,2700,0,1992,0,98033,47.6934,-122.161,1540,20720,4,23,2015,UNK,1160,5150
7504200250,4/28/2015,490000.0,3,2.25,2330,3600,1.5,0.0,0.0,3,8,2330,0,1971,0,98074,47.631,-122.061,2050,4275,4,28,2015,UNK,280,-675
3797310010,8/27/2014,277000.0,3,2.25,2160,9612,2.0,0.0,0.0,3,7,2160,0,1994,0,98022,47.1927,-122.01100000000001,1970,9247,8,27,2014,UNK,190,365
4058000010,5/9/2014,325000.0,4,1.5,1470,70800,1.0,0.0,0.0,3,7,1470,0,1976,0,98010,47.3458,-121.948,1810,72337,5,9,2014,UNK,-340,-1537
3888100022,9/25/2014,649800.0,4,2.5,2280,9827,2.0,0.0,0.0,3,8,2280,0,1995,0,98033,47.6883,-122.16799999999999,1660,9827,9,25,2014,UNK,620,0
1934800022,7/23/2014,425000.0,3,1.0,1280,3200,1.5,0.0,0.0,3,7,1280,0,1903,0,98122,47.6029,-122.307,1320,1676,7,23,2014,UNK,-40,1524
3501100280,3/29/2015,460000.0,2,1.0,850,4650,1.0,0.0,0.0,3,7,850,0,1975,0,98117,47.6926,-122.365,980,4700,3,29,2015,UNK,-130,-50
2725069108,8/5/2014,750000.0,3,3.25,4610,81935,2.0,0.0,0.0,4,9,4610,0,1984,0,98074,47.6217,-122.021,2900,43500,8,5,2014,UNK,1710,38435
126039413,7/10/2014,469000.0,5,2.5,2690,11745,1.0,0.0,0.0,3,8,1790,900,1960,0,98177,47.7708,-122.36200000000001,2670,7905,7,10,2014,UNK,20,3840
461001435,6/10/2014,566000.0,4,1.75,2440,5000,1.0,0.0,0.0,3,8,1340,1100,1954,0,98117,47.6823,-122.37100000000001,2170,5000,6,10,2014,UNK,270,0
6403500290,5/2/2014,407500.0,3,2.5,1930,10460,2.0,0.0,0.0,3,8,1930,0,1996,0,98059,47.4938,-122.161,2290,8228,5,2,2014,UNK,-360,2232
2826049108,10/28/2014,353500.0,2,1.0,800,8775,1.0,0.0,0.0,3,6,800,0,1942,0,98125,47.7171,-122.307,1470,8976,10,28,2014,UNK,-670,-201
1823069102,5/8/2014,524000.0,3,2.25,2430,73151,1.0,0.0,0.0,3,8,2430,0,1974,0,98059,47.4749,-122.09200000000001,2800,39250,5,8,2014,UNK,-370,33901
4233400280,8/22/2014,264950.0,4,2.5,1990,9656,2.0,0.0,0.0,3,7,1990,0,1994,0,98010,47.3125,-121.99799999999999,1500,9656,8,22,2014,UNK,490,0
1088800470,10/28/2014,547500.0,3,2.5,2550,10355,2.0,0.0,0.0,3,9,2550,0,1990,0,98011,47.739,-122.20299999999999,2550,10084,10,28,2014,UNK,0,271
2025701060,11/17/2014,264500.0,3,2.25,1370,7087,2.0,0.0,0.0,3,7,1370,0,1993,0,98038,47.3504,-122.035,1400,6600,11,17,2014,UNK,-30,487
7922900250,5/20/2014,507500.0,3,2.0,2020,8118,1.0,0.0,0.0,3,7,1020,1000,1963,0,98008,47.5866,-122.118,1670,8118,5,20,2014,UNK,350,0
6372000280,10/8/2014,560000.0,3,3.5,1560,2198,2.0,0.0,0.0,3,8,1180,380,2006,0,98116,47.5812,-122.40299999999999,1550,1467,10,8,2014,N,10,731
1424130050,12/16/2014,995000.0,5,4.0,5610,22529,2.0,0.0,0.0,3,11,4090,1520,1996,0,98072,47.7239,-122.09200000000001,3860,24751,12,16,2014,UNK,1750,-2222
7942601435,3/24/2015,835000.0,6,2.0,3560,5120,2.5,0.0,2.0,3,9,3560,0,1900,0,98122,47.6056,-122.311,2130,5120,3,24,2015,UNK,1430,0
3959401284,6/26/2014,440000.0,3,1.5,2120,6290,1.0,0.0,0.0,4,8,1220,900,1949,0,98108,47.5658,-122.318,1620,5400,6,26,2014,UNK,500,890
1370802335,7/28/2014,1020000.0,3,2.5,2920,5629,1.0,0.0,2.0,5,8,1460,1460,1955,0,98199,47.641999999999996,-122.405,2380,5000,7,28,2014,UNK,540,629
4058801680,5/23/2014,300000.0,2,1.0,1340,7788,1.0,0.0,2.0,3,7,1340,0,1947,0,98178,47.5094,-122.244,2550,7788,5,23,2014,UNK,-1210,0
3501100050,12/10/2014,125000.0,3,1.0,1230,4800,1.5,0.0,0.0,1,6,1230,0,1916,0,98117,47.6941,-122.365,1230,4800,12,10,2014,UNK,0,0
1231000895,11/5/2014,986000.0,4,3.5,2840,5900,2.0,0.0,0.0,3,10,1920,920,1910,2008,98118,47.5543,-122.26799999999999,1300,4900,11,5,2014,Y,1540,1000
7129300500,8/12/2014,315000.0,4,2.5,2080,5650,1.0,0.0,0.0,3,7,1680,400,1950,0,98178,47.5107,-122.257,1270,5650,8,12,2014,UNK,810,0
6752600050,8/12/2014,320000.0,4,2.5,2070,7007,2.0,0.0,0.0,3,7,2070,0,1996,0,98031,47.3968,-122.171,2130,8100,8,12,2014,UNK,-60,-1093
3303990380,12/4/2014,972000.0,4,3.25,4010,13797,2.0,0.0,0.0,3,11,4010,0,2003,0,98059,47.5229,-122.152,3980,12120,12,4,2014,UNK,30,1677
2579500006,9/9/2014,760000.0,3,2.5,2190,10000,1.0,0.0,0.0,4,7,1540,650,1957,0,98040,47.5419,-122.214,2880,11782,9,9,2014,UNK,-690,-1782
3365900462,9/3/2014,265000.0,4,3.0,1730,7264,2.0,0.0,0.0,3,6,1730,0,1920,0,98168,47.4738,-122.264,1500,12104,9,3,2014,UNK,230,-4840
2695600130,11/18/2014,355000.0,2,1.0,1250,4558,1.0,0.0,0.0,3,7,1250,0,1948,0,98126,47.5318,-122.37899999999999,1180,4494,11,18,2014,UNK,70,64
3438501700,8/27/2014,300000.0,3,1.0,1300,20812,1.0,0.0,0.0,3,6,1300,0,1927,0,98106,47.5435,-122.359,1210,17340,8,27,2014,UNK,90,3472
3876311350,8/26/2014,474950.0,5,2.5,2080,8347,1.0,0.0,0.0,4,7,1460,620,1975,0,98034,47.7334,-122.16799999999999,1840,7713,8,26,2014,UNK,240,634
4046710050,8/27/2014,470000.0,4,2.0,2180,17180,2.0,0.0,0.0,4,7,2180,0,1977,0,98014,47.698,-121.92,1880,14043,8,27,2014,UNK,300,3137
1725059259,11/25/2014,437500.0,3,1.0,1630,16393,1.0,0.0,0.0,3,7,1630,0,1969,0,98033,47.6576,-122.186,1880,23497,11,25,2014,UNK,-250,-7104
7518503220,10/28/2014,520000.0,2,1.5,1840,3825,1.0,0.0,0.0,3,8,1040,800,1928,0,98117,47.6808,-122.38,1290,5100,10,28,2014,UNK,550,-1275
3445000005,11/17/2014,237600.0,2,1.0,1370,11584,1.0,0.0,0.0,4,6,1370,0,1950,0,98198,47.4224,-122.29299999999999,1330,8012,11,17,2014,UNK,40,3572
3530420020,7/11/2014,162950.0,2,1.0,950,2784,1.0,0.0,0.0,4,8,950,0,1972,0,98198,47.3793,-122.321,1080,3899,7,11,2014,UNK,-130,-1115
6893300290,11/11/2014,457000.0,3,1.75,1690,6375,1.0,0.0,0.0,3,8,1690,0,1903,2002,98024,47.5247,-121.926,1270,7774,11,11,2014,Y,420,-1399
7856560480,8/8/2014,635000.0,3,2.5,1780,11000,1.0,0.0,0.0,4,8,1210,570,1980,0,98006,47.5574,-122.149,2310,9700,8,8,2014,UNK,-530,1300
8121100415,5/30/2014,735000.0,4,3.0,2840,4120,1.5,0.0,0.0,4,8,2060,780,1931,0,98118,47.5683,-122.28299999999999,1840,5871,5,30,2014,UNK,1000,-1751
3754501060,9/18/2014,910000.0,2,2.5,2000,5150,2.0,0.0,4.0,3,9,2000,0,1992,0,98034,47.7056,-122.223,2510,6800,9,18,2014,UNK,-510,-1650
3278602040,10/21/2014,346500.0,3,3.25,1570,2048,2.0,0.0,0.0,3,8,1290,280,2006,0,98126,47.548,-122.375,1570,2006,10,21,2014,N,0,42
1592000050,9/5/2014,655000.0,4,2.5,2370,9517,1.0,0.0,0.0,3,9,1630,740,1984,0,98074,47.6222,-122.03399999999999,2440,9035,9,5,2014,UNK,-70,482
1324079007,11/10/2014,425000.0,3,1.75,1610,144619,1.0,0.0,0.0,3,7,1610,0,1977,0,98024,47.5659,-121.863,2220,144619,11,10,2014,UNK,-610,0
7140600225,2/17/2015,137000.0,3,1.0,1300,10125,1.0,0.0,0.0,4,6,1300,0,1959,0,98002,47.2921,-122.215,1300,10125,2,17,2015,UNK,0,0
200500680,7/15/2014,557500.0,3,2.5,2620,11056,2.0,0.0,0.0,3,9,2620,0,1988,0,98011,47.7378,-122.21799999999999,2560,8688,7,15,2014,UNK,60,2368
421079142,5/9/2014,415000.0,4,2.25,3060,48787,2.0,0.0,0.0,3,8,3060,0,1992,0,98010,47.3397,-121.91799999999999,2090,48787,5,9,2014,UNK,970,0
9346700280,6/20/2014,830000.0,5,2.25,2780,10192,2.0,0.0,0.0,4,9,2780,0,1978,0,98007,47.6134,-122.152,2740,9900,6,20,2014,UNK,40,292
293800680,4/15/2015,949000.0,4,3.0,4270,85643,2.0,0.0,0.0,3,11,4270,0,1991,0,98077,47.7711,-122.04799999999999,3760,51170,4,15,2015,UNK,510,34473
339600190,10/14/2014,420000.0,3,1.0,1310,3963,1.0,0.0,0.0,5,7,1310,0,1986,0,98052,47.6826,-122.096,1010,3363,10,14,2014,UNK,300,600
1787600190,4/3/2015,353000.0,2,1.0,1100,7500,1.0,0.0,0.0,3,7,1100,0,1951,0,98125,47.7235,-122.32600000000001,1920,7149,4,3,2015,UNK,-820,351
2026079016,9/4/2014,560000.0,3,1.75,1480,383328,1.5,0.0,0.0,3,8,1480,0,1980,0,98019,47.7192,-121.932,1480,67082,9,4,2014,UNK,0,316246
8673400086,5/2/2014,445700.0,3,2.5,1270,1180,3.0,0.0,0.0,3,8,1270,0,2001,0,98107,47.6697,-122.39200000000001,1320,1180,5,2,2014,UNK,-50,0
2760200050,7/17/2014,226000.0,4,1.0,1270,6459,1.5,0.0,0.0,3,7,1270,0,1918,0,98118,47.5441,-122.273,1300,4100,7,17,2014,UNK,-30,2359
3205000050,12/5/2014,358000.0,3,1.0,890,9870,1.0,0.0,0.0,4,7,890,0,1960,0,98056,47.5398,-122.178,1270,9861,12,5,2014,UNK,-380,9
2201500680,3/5/2015,501000.0,3,1.75,1480,8667,1.0,0.0,0.0,5,7,740,740,1954,0,98006,47.5718,-122.13600000000001,1600,10644,3,5,2015,UNK,-120,-1977
4022902555,3/21/2015,609000.0,4,2.5,3240,23870,1.0,0.0,0.0,3,9,1840,1400,1972,0,98155,47.7731,-122.28200000000001,2290,13340,3,21,2015,UNK,950,10530
3410600080,7/9/2014,734950.0,4,3.25,4280,47179,2.0,0.0,0.0,3,10,3050,1230,2002,0,98092,47.3017,-122.12700000000001,2820,43401,7,9,2014,UNK,1460,3778
7385300020,6/13/2014,725000.0,5,2.5,3210,12000,1.0,0.0,0.0,4,8,1830,1380,1968,0,98007,47.6205,-122.148,2450,12000,6,13,2014,UNK,760,0
3876312570,8/11/2014,350500.0,3,2.25,1870,7200,1.0,0.0,0.0,3,7,1390,480,1975,0,98072,47.733999999999995,-122.17399999999999,1830,7876,8,11,2014,UNK,40,-676
5016002275,6/2/2014,610000.0,5,2.5,3990,3839,1.0,0.0,0.0,4,8,1990,2000,1962,0,98112,47.6236,-122.29899999999999,2090,5000,6,2,2014,UNK,1900,-1161
3213200250,11/6/2014,605125.0,2,1.0,1160,5029,1.0,0.0,0.0,3,7,910,250,1940,0,98115,47.6723,-122.266,1220,5029,11,6,2014,UNK,-60,0
6448000010,4/28/2015,1390000.0,4,2.25,2940,20384,2.0,0.0,0.0,4,9,2940,0,1970,0,98004,47.6214,-122.227,3410,19910,4,28,2015,UNK,-470,474
1330900050,4/21/2015,550000.0,3,2.25,1850,37264,2.0,0.0,0.0,3,8,1850,0,1981,0,98053,47.6486,-122.035,2390,36036,4,21,2015,UNK,-540,1228
2810600022,10/7/2014,335000.0,2,1.75,1060,1202,2.0,0.0,0.0,3,7,760,300,2003,0,98136,47.5426,-122.38799999999999,1060,1493,10,7,2014,UNK,0,-291
1761600050,12/31/2014,397000.0,3,2.0,1100,9165,1.0,0.0,0.0,4,7,1100,0,1969,0,98034,47.7304,-122.23100000000001,1510,8500,12,31,2014,UNK,-410,665
4233400480,11/24/2014,240000.0,3,2.0,1190,10299,1.0,0.0,0.0,3,7,1190,0,1994,0,98010,47.31399999999999,-122.0,1700,9849,11,24,2014,UNK,-510,450
4222310680,9/26/2014,240000.0,3,2.0,1030,11118,1.0,0.0,0.0,5,7,1030,0,1970,0,98003,47.3463,-122.30799999999999,1300,7920,9,26,2014,UNK,-270,3198
5630500005,11/20/2014,262500.0,2,1.5,1140,14373,1.0,0.0,0.0,3,7,1140,0,1949,1996,98011,47.7354,-122.219,2140,9860,11,20,2014,Y,-1000,4513
9523102040,9/22/2014,440000.0,3,1.5,2260,5300,1.0,0.0,0.0,3,7,1200,1060,1940,0,98103,47.6756,-122.348,1950,5000,9,22,2014,UNK,310,300
2626119028,3/23/2015,160000.0,3,1.0,1140,3240,1.5,0.0,0.0,4,6,1140,0,1910,0,98014,47.7093,-121.36399999999999,1140,4700,3,23,2015,UNK,0,-1460
5015001680,6/11/2014,427000.0,4,1.0,1860,4736,1.5,0.0,0.0,1,7,1860,0,1901,0,98112,47.6251,-122.3,1800,4000,6,11,2014,UNK,60,736
7202360430,7/1/2014,920000.0,4,3.5,4080,10666,2.0,0.0,0.0,3,9,4080,0,2005,0,98053,47.6818,-122.023,3920,8154,7,1,2014,N,160,2512
3880900170,8/5/2014,2300000.0,4,2.5,3280,7100,2.0,0.0,4.0,3,10,2180,1100,1911,1987,98119,47.6285,-122.36200000000001,3240,6674,8,5,2014,Y,40,426
926069142,11/24/2014,480000.0,4,2.5,2870,35757,2.0,0.0,0.0,4,9,2870,0,1977,0,98077,47.7568,-122.05,2700,41221,11,24,2014,UNK,170,-5464
2790410250,5/5/2014,615000.0,4,1.75,2300,11700,1.0,0.0,0.0,4,9,1960,340,1977,0,98052,47.6331,-122.094,2840,12000,5,5,2014,UNK,-540,-300
6681500080,8/22/2014,736500.0,3,2.0,2230,4800,1.5,0.0,0.0,4,7,1290,940,1915,0,98199,47.645,-122.38600000000001,1650,5040,8,22,2014,UNK,580,-240
9274201809,11/19/2014,542500.0,3,2.5,1920,1649,2.5,0.0,0.0,3,8,1600,320,2004,0,98116,47.5901,-122.38799999999999,1650,3053,11,19,2014,N,270,-1404
418000415,3/19/2015,191000.0,2,1.0,700,5000,1.0,0.0,0.0,5,6,700,0,1952,0,98056,47.4927,-122.17200000000001,1040,5200,3,19,2015,UNK,-340,-200
8078460050,7/18/2014,730000.0,4,2.5,2740,11975,2.0,0.0,0.0,4,8,2740,0,1991,0,98074,47.6315,-122.02799999999999,2310,9068,7,18,2014,UNK,430,2907
7151700585,11/25/2014,1230000.0,5,2.25,3440,5000,2.0,0.0,2.0,5,9,3440,0,1901,0,98122,47.6127,-122.286,2822,5000,11,25,2014,UNK,618,0
2722059292,6/4/2014,129000.0,1,1.0,650,15364,1.0,0.0,0.0,4,5,650,0,1967,0,98042,47.3721,-122.15899999999999,1630,7952,6,4,2014,UNK,-980,7412
2223059099,7/9/2014,284000.0,3,1.5,1500,10018,1.0,0.0,0.0,4,7,1500,0,1957,0,98058,47.468,-122.163,1500,10937,7,9,2014,UNK,0,-919
1703050500,3/21/2015,645000.0,3,2.5,2490,5978,2.0,0.0,0.0,3,9,2490,0,2003,0,98074,47.6298,-122.022,2710,6629,3,21,2015,UNK,-220,-651
6386600130,6/24/2014,218000.0,3,1.5,1330,7600,1.0,0.0,0.0,4,7,1330,0,1968,0,98023,47.3103,-122.366,1500,7776,6,24,2014,UNK,-170,-176
9194102188,10/9/2014,675000.0,4,3.5,3190,6875,2.0,0.0,2.0,3,8,2120,1070,1999,0,98034,47.7082,-122.221,2550,6875,10,9,2014,UNK,640,0
2464400285,12/29/2014,575000.0,3,2.5,1590,2910,2.0,0.0,0.0,3,7,1110,480,1984,0,98115,47.6855,-122.321,1590,3880,12,29,2014,UNK,0,-970
6450301310,10/30/2014,225000.0,2,1.0,830,5720,1.0,0.0,0.0,4,6,830,0,1950,0,98133,47.7339,-122.339,1150,5250,10,30,2014,UNK,-320,470
7427800080,4/8/2015,626000.0,3,2.25,1810,5107,2.0,0.0,0.0,3,8,1810,0,1989,0,98033,47.6882,-122.171,1760,5454,4,8,2015,UNK,50,-347
40000669,3/19/2015,499950.0,4,2.5,2910,20067,2.0,0.0,0.0,3,9,2910,0,2001,0,98168,47.4714,-122.273,1730,21420,3,19,2015,UNK,1180,-1353
5538300225,5/13/2014,405000.0,4,1.75,2180,13529,1.0,0.0,0.0,3,7,1090,1090,1956,0,98155,47.7516,-122.294,2000,13529,5,13,2014,UNK,180,0
4239400840,10/29/2014,152500.0,3,1.0,1090,3523,1.0,0.0,0.0,4,6,1090,0,1969,0,98092,47.3161,-122.182,1030,3200,10,29,2014,UNK,60,323
8035650500,7/16/2014,325000.0,4,2.5,2160,6825,2.0,0.0,0.0,3,8,2160,0,1994,0,98031,47.4111,-122.2,2020,7035,7,16,2014,UNK,140,-210
3888100029,5/29/2014,475300.0,3,1.0,2110,10005,1.0,0.0,0.0,5,7,1110,1000,1924,0,98033,47.688,-122.16799999999999,1360,9827,5,29,2014,UNK,750,178
4364700585,4/8/2015,485000.0,3,1.75,2180,7318,1.0,0.0,0.0,4,7,1210,970,1967,0,98126,47.5251,-122.37,2140,7560,4,8,2015,UNK,40,-242
9839300285,4/12/2015,720000.0,3,2.5,2100,2200,2.0,0.0,0.0,4,7,1500,600,1919,0,98122,47.614,-122.294,1750,4400,4,12,2015,UNK,350,-2200
6141100380,5/15/2014,465000.0,3,1.75,1410,6886,1.0,0.0,0.0,3,7,1410,0,1924,2013,98133,47.7183,-122.353,1410,6561,5,15,2014,Y,0,325
5652601330,6/4/2014,489000.0,3,1.5,1020,9072,1.0,0.0,0.0,3,7,920,100,1930,0,98115,47.695,-122.301,1620,7930,6,4,2014,UNK,-600,1142
3025059093,7/29/2014,3100000.0,5,5.25,5090,23669,2.0,0.0,0.0,3,12,5090,0,2006,0,98004,47.6297,-122.21600000000001,3830,22605,7,29,2014,N,1260,1064
5466700290,1/8/2015,288000.0,3,2.25,2090,7500,1.0,0.0,0.0,4,7,1280,810,1977,0,98031,47.3951,-122.17200000000001,1800,7350,1,8,2015,UNK,290,150
5437800020,8/8/2014,225000.0,3,1.75,1350,9793,1.0,0.0,0.0,4,7,1350,0,1968,0,98022,47.1981,-122.00299999999999,1690,8080,8,8,2014,UNK,-340,1713
7784400185,4/21/2015,499000.0,3,1.75,2650,11774,1.0,0.0,1.0,3,8,2240,410,1952,0,98146,47.4909,-122.363,2650,10120,4,21,2015,UNK,0,1654
5561301150,11/11/2014,632000.0,5,3.0,3520,36558,2.0,0.0,0.0,4,8,2100,1420,1985,0,98027,47.4658,-122.007,3000,36558,11,11,2014,UNK,520,0
1523550480,6/13/2014,580000.0,3,2.5,2040,4627,2.0,0.0,0.0,3,8,2040,0,1992,0,98052,47.6365,-122.10799999999999,2230,4500,6,13,2014,UNK,-190,127
8083400066,4/23/2015,730000.0,4,1.5,2340,5000,2.0,0.0,0.0,3,8,2100,240,1912,0,98122,47.6065,-122.291,2320,5500,4,23,2015,UNK,20,-500
3797710020,3/27/2015,325000.0,4,2.25,1770,7799,2.0,0.0,0.0,3,7,1770,0,1998,0,98031,47.4192,-122.20200000000001,1770,7778,3,27,2015,UNK,0,21
3205200480,4/15/2015,421000.0,3,1.75,1100,8662,1.0,0.0,0.0,5,7,1100,0,1964,0,98056,47.5368,-122.17299999999999,1100,9240,4,15,2015,UNK,0,-578
869700050,1/20/2015,316000.0,3,2.5,1490,4078,2.0,0.0,0.0,3,8,1490,0,1998,0,98059,47.4915,-122.155,1310,2767,1,20,2015,UNK,180,1311
2877101310,8/4/2014,415000.0,2,1.0,1460,4200,1.0,0.0,0.0,4,6,880,580,1914,0,98117,47.6774,-122.361,1540,4200,8,4,2014,UNK,-80,0
7202330280,9/22/2014,401000.0,3,2.25,1350,2839,2.0,0.0,0.0,3,7,1350,0,2003,0,98053,47.6824,-122.036,1650,3093,9,22,2014,UNK,-300,-254
6146600420,2/24/2015,229950.0,3,0.75,1030,12700,1.0,0.0,0.0,4,5,1030,0,1944,0,98032,47.3877,-122.236,1140,6955,2,24,2015,UNK,-110,5745
8563030500,3/30/2015,539950.0,3,1.75,1820,9875,1.0,0.0,0.0,4,8,1820,0,1966,0,98008,47.6243,-122.094,2670,10000,3,30,2015,UNK,-850,-125
3624039150,6/5/2014,335000.0,3,2.0,1170,5360,1.0,0.0,0.0,3,6,1170,0,1919,0,98106,47.5181,-122.36399999999999,1180,7200,6,5,2014,UNK,-10,-1840
7853210050,7/7/2014,339000.0,3,2.5,1450,3748,2.0,0.0,0.0,3,7,1450,0,2004,0,98065,47.532,-121.85,1970,3748,7,7,2014,N,-520,0
3293700480,10/20/2014,414950.0,4,1.75,2200,8545,1.0,0.0,0.0,4,7,1100,1100,1918,1982,98133,47.7481,-122.353,1940,9315,10,20,2014,Y,260,-770
3210700170,12/2/2014,650000.0,4,2.0,1610,8976,1.0,0.0,0.0,4,8,1610,0,1966,0,98004,47.6011,-122.19200000000001,1930,8976,12,2,2014,UNK,-320,0
8161020050,12/3/2014,445000.0,3,2.5,2690,21883,2.0,0.0,0.0,3,8,2690,0,1994,0,98014,47.6462,-121.904,2370,21781,12,3,2014,UNK,320,102
8731983340,3/20/2015,295000.0,3,2.25,1850,7800,2.0,0.0,0.0,3,9,1850,0,1974,0,98023,47.3146,-122.37899999999999,2360,8000,3,20,2015,UNK,-510,-200
7871500280,4/13/2015,975000.0,4,2.25,2250,3600,2.0,0.0,0.0,4,9,2010,240,1912,0,98119,47.643,-122.37,1910,3990,4,13,2015,UNK,340,-390
3276200280,12/19/2014,296500.0,3,1.5,1580,10100,1.0,0.0,0.0,4,7,1580,0,1961,0,98055,47.4423,-122.193,1650,10032,12,19,2014,UNK,-70,68
826069180,10/21/2014,440000.0,4,2.75,2030,56192,1.0,0.0,0.0,3,8,1550,480,1979,0,98077,47.751999999999995,-122.073,2510,44866,10,21,2014,UNK,-480,11326
3955800080,12/29/2014,420000.0,5,1.5,1890,10880,1.0,0.0,0.0,3,7,1890,0,1962,0,98034,47.7196,-122.197,1670,9750,12,29,2014,UNK,220,1130
1657310170,7/23/2014,302000.0,3,2.5,2140,9492,2.0,0.0,0.0,3,8,2140,0,1994,0,98092,47.3289,-122.204,2180,9184,7,23,2014,UNK,-40,308
2597690050,4/9/2015,350000.0,4,1.75,1770,7336,1.0,0.0,0.0,4,8,1770,0,1986,0,98058,47.4265,-122.163,2030,8183,4,9,2015,UNK,-260,-847
720079001,6/26/2014,667000.0,3,1.75,3320,478288,1.5,0.0,3.0,4,8,2260,1060,1933,1982,98022,47.2407,-121.95299999999999,2960,217800,6,26,2014,Y,360,260488
3975400185,5/13/2015,645000.0,3,2.0,1640,4218,1.0,0.0,0.0,4,7,910,730,1941,0,98103,47.6546,-122.344,1670,4000,5,13,2015,UNK,-30,218
3342101795,11/11/2014,430000.0,4,2.75,1820,5400,1.0,0.0,0.0,4,7,1220,600,1988,0,98056,47.5204,-122.205,1630,5400,11,11,2014,UNK,190,0
9297301190,5/13/2014,413000.0,4,1.0,1410,6000,1.0,0.0,0.0,3,7,810,600,1925,0,98126,47.566,-122.37299999999999,1500,4800,5,13,2014,UNK,-90,1200
7424100050,12/1/2014,420000.0,3,1.0,1240,7300,1.0,0.0,0.0,3,7,1240,0,1968,0,98033,47.6775,-122.16799999999999,1240,8260,12,1,2014,UNK,0,-960
7199340480,10/29/2014,495000.0,3,2.25,1780,8050,1.0,0.0,0.0,4,7,1230,550,1979,0,98052,47.6977,-122.126,1780,7200,10,29,2014,UNK,0,850
2525049259,8/12/2014,2190000.0,4,4.5,4240,13162,2.0,0.0,0.0,3,10,4240,0,2004,0,98039,47.6193,-122.229,3010,12163,8,12,2014,N,1230,999
8835700250,4/26/2015,965000.0,4,2.5,3570,17411,2.0,0.0,0.0,3,10,3570,0,1990,0,98075,47.5617,-122.03,3510,16153,4,26,2015,UNK,60,1258
6150700005,12/1/2014,500000.0,4,2.5,1900,5001,1.0,0.0,0.0,3,8,1200,700,2008,0,98133,47.7289,-122.335,1950,4680,12,1,2014,N,-50,321
6819100080,10/1/2014,636100.0,3,1.0,1010,6000,1.5,0.0,0.0,3,7,1010,0,1919,1977,98119,47.6438,-122.35700000000001,1960,4000,10,1,2014,Y,-950,2000
3904902630,6/3/2014,720000.0,4,2.5,2870,12648,2.0,0.0,0.0,4,9,2870,0,1986,0,98029,47.5632,-122.01700000000001,2560,12648,6,3,2014,UNK,310,0
5152200020,5/4/2015,298000.0,3,1.75,1620,12825,1.0,0.0,0.0,3,8,1340,280,1962,0,98003,47.3321,-122.323,2076,11200,5,4,2015,UNK,-456,1625
3300701440,7/29/2014,409000.0,2,1.75,1480,4000,1.0,0.0,0.0,4,6,740,0,1925,0,98117,47.6916,-122.38,1060,4000,7,29,2014,UNK,420,0
1152700020,12/26/2014,370000.0,4,2.5,2650,5706,2.0,0.0,0.0,3,9,2650,0,2005,0,98042,47.3515,-122.164,2760,5749,12,26,2014,N,-110,-43
8944300010,7/25/2014,230000.0,5,1.0,1410,9000,1.0,0.0,0.0,5,7,1410,0,1967,0,98023,47.3054,-122.369,1200,8346,7,25,2014,UNK,210,654
8680300010,3/24/2015,290000.0,3,2.0,1360,6685,1.0,0.0,0.0,3,7,1360,0,1952,0,98155,47.7365,-122.324,1300,8138,3,24,2015,UNK,60,-1453
8731950080,2/19/2015,420000.0,4,2.25,2930,9840,1.0,0.0,0.0,4,8,1560,1370,1977,0,98023,47.3103,-122.382,2800,8374,2,19,2015,UNK,130,1466
5608000080,7/22/2014,917000.0,4,2.5,3500,10891,2.0,0.0,2.0,3,10,3500,0,1995,0,98027,47.5533,-122.09299999999999,3820,13521,7,22,2014,UNK,-320,-2630
2225039130,6/25/2014,957000.0,5,3.25,3160,5000,2.0,0.0,2.0,3,10,2180,980,2005,0,98199,47.6464,-122.405,3160,5746,6,25,2014,N,0,-746
7504180130,7/1/2014,482000.0,3,2.25,1710,21485,2.0,0.0,0.0,3,7,1710,0,1989,0,98074,47.6198,-122.053,1680,21485,7,1,2014,UNK,30,0
3956100190,11/21/2014,488000.0,3,1.75,2180,14734,2.0,0.0,0.0,3,9,2180,0,1990,0,98045,47.4831,-121.76700000000001,2300,21618,11,21,2014,UNK,-120,-6884
2346200050,10/17/2014,760369.0,5,2.5,2870,4712,2.0,0.0,0.0,3,9,2870,0,2014,0,98006,47.5463,-122.182,2870,6768,10,17,2014,N,0,-2056
40000471,6/4/2014,170000.0,2,1.0,1500,18540,1.0,0.0,0.0,3,8,1500,0,1950,0,98168,47.4727,-122.281,1700,9355,6,4,2014,UNK,-200,9185
9346950050,4/29/2015,625000.0,3,2.5,2120,10021,1.0,0.0,0.0,4,8,1230,890,1976,0,98006,47.5621,-122.135,2690,10183,4,29,2015,UNK,-570,-162
9477201150,12/2/2014,357000.0,3,1.5,1590,6750,1.0,0.0,0.0,3,7,1080,510,1976,0,98034,47.73,-122.191,1590,7400,12,2,2014,UNK,0,-650
8078430130,4/7/2015,583000.0,3,2.25,1830,8276,1.0,0.0,0.0,3,8,1350,480,1989,0,98074,47.6336,-122.025,1920,8276,4,7,2015,UNK,-90,0
6404600006,8/20/2014,173250.0,3,2.0,1210,9097,1.0,0.0,0.0,4,7,1210,0,1954,0,98168,47.4849,-122.303,1360,10125,8,20,2014,UNK,-150,-1028
6415100122,7/16/2014,414050.0,4,2.0,1590,10331,1.5,0.0,0.0,4,7,1590,0,1956,0,98133,47.7273,-122.33200000000001,1400,9434,7,16,2014,UNK,190,897
5505700020,6/18/2014,400000.0,3,1.75,1050,6150,1.5,0.0,0.0,4,6,950,100,1928,0,98116,47.5715,-122.39399999999999,1360,6150,6,18,2014,UNK,-310,0
1117300050,3/27/2015,537000.0,3,2.0,1550,27003,1.5,0.0,0.0,3,8,1550,0,1982,0,98074,47.606,-122.056,2400,27003,3,27,2015,UNK,-850,0
8651710430,6/6/2014,465000.0,4,2.25,2070,7500,2.0,0.0,0.0,4,7,2070,0,1977,0,98034,47.727,-122.21700000000001,2080,7700,6,6,2014,UNK,-10,-200
9292000380,8/18/2014,425000.0,3,2.25,1740,9682,1.0,0.0,0.0,5,8,1740,0,1969,0,98056,47.5138,-122.17299999999999,2100,9536,8,18,2014,UNK,-360,146
2525059127,11/18/2014,445000.0,4,2.0,1700,21780,1.0,0.0,0.0,4,6,1080,620,1940,0,98052,47.6289,-122.10799999999999,2070,12054,11,18,2014,UNK,-370,9726
1788300010,12/11/2014,179950.0,2,1.0,1200,9000,1.0,0.0,0.0,3,6,1200,0,1958,0,98023,47.3277,-122.34899999999999,1040,9600,12,11,2014,UNK,160,-600
1150700130,4/21/2015,275000.0,3,2.5,1710,7230,2.0,0.0,0.0,3,7,1710,0,1996,0,98003,47.2778,-122.29799999999999,1720,6537,4,21,2015,UNK,-10,693
3354400545,7/15/2014,190000.0,4,2.5,1840,13493,2.0,0.0,0.0,3,7,1840,0,1994,0,98001,47.2649,-122.242,1430,11463,7,15,2014,UNK,410,2030
2742100009,5/6/2014,385000.0,3,1.75,1900,5520,1.0,0.0,0.0,3,7,1280,620,1982,0,98118,47.5549,-122.292,1330,5196,5,6,2014,UNK,570,324
2475900170,4/29/2015,303000.0,4,1.0,2300,9583,1.0,0.0,0.0,3,6,1220,1080,1928,0,98024,47.5671,-121.89,1200,11325,4,29,2015,UNK,1100,-1742
9189700255,1/5/2015,165000.0,3,1.0,970,7503,1.0,0.0,0.0,4,6,970,0,1967,0,98058,47.4688,-122.163,1230,9504,1,5,2015,UNK,-260,-2001
2769600480,4/30/2015,600000.0,2,2.0,1270,5000,1.0,0.0,0.0,3,6,1270,0,1944,0,98107,47.6729,-122.363,2190,5000,4,30,2015,UNK,-920,0
2260800170,7/18/2014,710000.0,3,2.25,3130,65775,2.0,0.0,0.0,4,8,3130,0,1978,0,98027,47.5462,-122.085,3130,72309,7,18,2014,UNK,0,-6534
1118500010,3/27/2015,875000.0,5,3.25,4230,21455,2.0,0.0,0.0,3,10,2720,1510,1990,0,98074,47.6375,-122.015,3280,22393,3,27,2015,UNK,950,-938
5636010280,9/2/2014,269950.0,3,2.5,1480,9743,2.0,0.0,0.0,4,7,1480,0,1996,0,98010,47.3293,-122.001,1810,9601,9,2,2014,UNK,-330,142
2326059099,5/2/2014,838000.0,4,2.5,3310,42998,2.0,0.0,0.0,3,9,3310,0,2001,0,98052,47.7232,-122.131,3350,42847,5,2,2014,UNK,-40,151
4423100095,5/23/2014,670500.0,4,2.0,1590,6750,1.0,0.0,0.0,3,7,1590,0,1951,0,98102,47.6406,-122.31700000000001,2370,4500,5,23,2014,UNK,-780,2250
8142000080,2/12/2015,420000.0,4,1.5,1690,9391,1.0,0.0,0.0,3,7,1290,400,1960,0,98155,47.7438,-122.329,1780,9390,2,12,2015,UNK,-90,1
3222059007,9/13/2014,370000.0,3,1.5,1690,161913,1.0,0.0,0.0,2,7,1430,260,1952,0,98030,47.356,-122.189,1930,12548,9,13,2014,UNK,-240,149365
6648000050,6/24/2014,360000.0,3,1.75,1500,7200,1.0,0.0,0.0,3,7,1500,0,1957,0,98133,47.7748,-122.337,1650,7392,6,24,2014,UNK,-150,-192
3574900170,10/3/2014,562500.0,4,2.5,2320,8721,2.0,0.0,0.0,3,8,2320,0,1991,0,98034,47.7326,-122.226,2260,8268,10,3,2014,UNK,60,453
2008000130,8/18/2014,360500.0,3,2.5,3300,11525,1.0,0.0,0.0,5,8,1650,1650,1961,0,98198,47.4113,-122.315,1950,9680,8,18,2014,UNK,1350,1845
291300010,5/21/2014,389999.0,3,2.25,1445,1471,2.0,0.0,0.0,3,7,1300,145,2003,0,98027,47.5342,-122.072,1410,1399,5,21,2014,UNK,35,72
9412200280,8/27/2014,450000.0,4,3.0,1890,13140,1.0,0.0,0.0,4,7,1270,620,1967,0,98027,47.5221,-122.044,1900,11160,8,27,2014,UNK,-10,1980
9315000010,3/3/2015,247500.0,4,2.0,1760,8400,1.0,0.0,0.0,3,7,1060,700,1962,0,98003,47.3258,-122.323,1280,8415,3,3,2015,UNK,480,-15
7889600080,2/19/2015,208000.0,3,1.0,1050,6240,1.0,0.0,0.0,5,5,1050,0,1948,0,98146,47.4933,-122.338,1410,6240,2,19,2015,UNK,-360,0
8663310010,12/26/2014,455000.0,3,2.5,1980,7309,2.0,0.0,0.0,3,7,1980,0,1993,0,98034,47.7257,-122.17200000000001,2060,9681,12,26,2014,UNK,-80,-2372
930000305,11/10/2014,379400.0,4,1.75,2120,7680,1.0,0.0,0.0,4,7,1060,1060,1950,0,98177,47.7172,-122.361,1530,7680,11,10,2014,UNK,590,0
7606200275,12/30/2014,190000.0,3,1.5,760,40039,1.0,0.0,0.0,3,6,760,0,1906,0,98065,47.5295,-121.829,980,6000,12,30,2014,UNK,-220,34039
203900380,8/21/2014,326188.0,3,1.0,1300,8800,1.0,0.0,0.0,3,7,1300,0,1977,0,98053,47.64,-121.96600000000001,1600,12210,8,21,2014,UNK,-300,-3410
880000005,5/22/2014,168000.0,2,2.5,1160,2174,2.0,0.0,0.0,3,7,1160,0,1998,0,98106,47.5264,-122.366,1380,1919,5,22,2014,UNK,-220,255
9406570290,5/16/2014,314000.0,4,2.5,2340,8990,2.0,0.0,0.0,3,8,2340,0,2003,0,98038,47.3781,-122.03,2980,6718,5,16,2014,UNK,-640,2272
5561000920,5/2/2014,630000.0,4,2.75,2710,37277,2.0,0.0,0.0,3,9,2710,0,2000,0,98027,47.4634,-121.98700000000001,2390,39299,5,2,2014,UNK,320,-2022
4037000470,3/16/2015,550000.0,3,1.75,1440,8957,1.0,0.0,0.0,4,7,1440,0,1957,0,98008,47.6008,-122.118,1340,8780,3,16,2015,UNK,100,177
8651511060,6/30/2014,530000.0,4,2.25,1980,15086,2.0,0.0,0.0,3,8,1980,0,1981,0,98074,47.647,-122.064,2100,10927,6,30,2014,UNK,-120,4159
9413600010,2/6/2015,637500.0,3,1.75,1680,10685,1.0,0.0,0.0,4,7,1680,0,1966,0,98033,47.6556,-122.193,3340,10390,2,6,2015,UNK,-1660,295
9358001732,4/28/2015,400000.0,3,2.5,1390,2815,2.0,0.0,0.0,3,8,1390,0,1999,0,98126,47.566,-122.366,1390,3700,4,28,2015,UNK,0,-885
8820900029,6/10/2014,700000.0,5,2.75,3100,9825,2.0,0.0,2.0,4,8,3100,0,1950,1982,98125,47.7188,-122.281,2120,8400,6,10,2014,Y,980,1425
6802200670,11/14/2014,272000.0,3,2.5,1680,8512,2.0,0.0,0.0,3,7,1680,0,1991,0,98022,47.1952,-121.986,1580,8512,11,14,2014,UNK,100,0
7852190630,4/17/2015,600000.0,4,2.5,2710,6474,2.0,0.0,0.0,3,8,2710,0,2004,0,98065,47.5383,-121.87799999999999,2870,6968,4,17,2015,N,-160,-494
2815600235,4/2/2015,450600.0,2,1.0,840,7020,1.5,0.0,0.0,4,7,840,0,1943,0,98136,47.5513,-122.39399999999999,1310,7072,4,2,2015,UNK,-470,-52
3013300660,10/28/2014,550000.0,3,2.25,2090,8095,2.0,0.0,2.0,3,10,2090,0,1988,0,98136,47.5287,-122.385,1940,5635,10,28,2014,UNK,150,2460
8091600080,1/23/2015,225000.0,3,1.0,1120,8407,1.0,0.0,0.0,5,6,1120,0,1987,0,98022,47.2051,-122.006,1250,8658,1,23,2015,UNK,-130,-251
8651402750,2/18/2015,132825.0,3,1.5,1210,5200,1.0,0.0,0.0,5,6,1210,0,1969,0,98042,47.3615,-122.087,1120,5200,2,18,2015,UNK,90,0
8651402750,4/30/2015,219950.0,3,1.5,1210,5200,1.0,0.0,0.0,5,6,1210,0,1969,0,98042,47.3615,-122.087,1120,5200,4,30,2015,UNK,90,0
2215500080,5/28/2014,580000.0,5,2.0,1940,6000,1.0,0.0,0.0,5,7,970,970,1945,0,98115,47.6875,-122.287,1700,6000,5,28,2014,UNK,240,0
225069016,7/22/2014,568000.0,3,1.75,1930,213008,1.0,0.0,2.0,3,7,1300,630,1980,0,98053,47.6751,-121.993,2860,208652,7,22,2014,UNK,-930,4356
766900250,4/2/2015,406000.0,3,1.75,1270,6017,1.0,0.0,0.0,4,7,1030,240,1990,0,98028,47.736999999999995,-122.225,1630,7381,4,2,2015,UNK,-360,-1364
2922703260,7/16/2014,469000.0,3,1.75,1680,2400,1.5,0.0,0.0,3,7,1170,510,1929,0,98117,47.6849,-122.367,1080,4560,7,16,2014,UNK,600,-2160
8011100095,6/10/2014,415000.0,3,2.5,2090,6045,2.0,0.0,0.0,3,8,2090,0,2000,0,98056,47.4947,-122.17399999999999,2040,6392,6,10,2014,UNK,50,-347
2206700280,12/8/2014,390000.0,3,1.5,1000,13991,1.0,0.0,0.0,4,7,1000,0,1956,0,98006,47.5643,-122.13799999999999,1520,11465,12,8,2014,UNK,-520,2526
7985000010,4/15/2015,251000.0,3,1.75,1350,10125,1.0,0.0,0.0,3,8,1350,0,1967,0,98003,47.3334,-122.29799999999999,1520,9720,4,15,2015,UNK,-170,405
1504800050,3/12/2015,750000.0,3,2.5,3280,6750,2.0,0.0,1.0,3,9,2440,840,2001,0,98126,47.5219,-122.38,1770,6387,3,12,2015,UNK,1510,363
5351200280,4/7/2015,845000.0,4,2.5,2390,5071,2.0,0.0,0.0,3,9,1760,630,1988,0,98122,47.6144,-122.28299999999999,1940,5071,4,7,2015,UNK,450,0
7229900005,10/10/2014,350000.0,3,1.5,1860,17640,1.0,0.0,0.0,4,7,1860,0,1966,0,98059,47.483999999999995,-122.111,1860,17820,10,10,2014,UNK,0,-180
3126049217,2/25/2015,322000.0,3,1.0,1380,5864,1.0,0.0,0.0,3,7,790,590,1944,0,98133,47.7049,-122.339,1509,5864,2,25,2015,UNK,-129,0
7446500010,5/7/2015,664500.0,4,2.25,3070,9210,2.0,0.0,0.0,3,8,2740,330,2010,0,98011,47.7638,-122.196,2580,9660,5,7,2015,N,490,-450
2721600010,1/7/2015,988000.0,3,1.75,2190,3800,1.5,0.0,2.0,4,8,2190,0,1923,0,98109,47.643,-122.355,2190,3880,1,7,2015,UNK,0,-80
3392900080,7/6/2014,625000.0,2,1.75,1990,4000,1.0,0.0,0.0,5,7,1090,900,1952,0,98103,47.6889,-122.34200000000001,1270,5700,7,6,2014,UNK,720,-1700
1524059027,5/6/2014,675000.0,2,1.0,930,36478,1.0,0.0,2.0,3,6,930,0,1951,0,98006,47.5699,-122.164,2800,11141,5,6,2014,UNK,-1870,25337
9414500480,4/7/2015,503000.0,3,1.75,2070,9827,1.0,0.0,0.0,4,7,1420,650,1967,0,98027,47.522,-122.05,2150,9827,4,7,2015,UNK,-80,0
8576400050,5/9/2014,431000.0,4,2.25,2170,10500,1.0,0.0,2.0,4,8,1270,900,1960,0,98166,47.4394,-122.338,2080,11019,5,9,2014,UNK,90,-519
5252000170,11/26/2014,250000.0,3,1.75,1910,10230,1.0,0.0,0.0,4,7,1290,620,1964,0,98031,47.4185,-122.20700000000001,1590,10800,11,26,2014,UNK,320,-570
2676500080,6/5/2014,268500.0,4,2.5,2100,4237,2.0,0.0,0.0,3,8,2100,0,2006,0,98031,47.3901,-122.17399999999999,2100,4575,6,5,2014,N,0,-338
3585900080,3/26/2015,1070000.0,6,3.25,3560,21400,2.0,0.0,4.0,4,9,3560,0,1952,0,98177,47.7602,-122.37200000000001,3560,24338,3,26,2015,UNK,0,-2938
5126900321,5/29/2014,295000.0,4,2.5,2290,4539,2.0,0.0,0.0,3,7,2290,0,2001,0,98058,47.4753,-122.17200000000001,1710,7200,5,29,2014,UNK,580,-2661
8563500020,7/25/2014,780000.0,3,2.25,2130,11782,1.0,0.0,0.0,4,8,1590,540,1977,0,98040,47.5423,-122.215,2700,11782,7,25,2014,UNK,-570,0
6624030050,4/28/2015,354000.0,3,2.5,2160,15817,2.0,0.0,0.0,3,8,2160,0,1999,0,98031,47.4166,-122.18299999999999,1990,15817,4,28,2015,UNK,170,0
4343800080,8/18/2014,305000.0,2,1.0,860,7250,1.0,0.0,0.0,3,6,860,0,1949,0,98133,47.7206,-122.35,1270,7250,8,18,2014,UNK,-410,0
1873100050,4/1/2015,733000.0,5,2.75,2880,4425,2.0,0.0,0.0,3,8,2880,0,2005,0,98052,47.7048,-122.109,2940,6581,4,1,2015,N,-60,-2156
3210700380,9/16/2014,640000.0,4,2.75,2100,11894,1.0,0.0,0.0,4,8,1720,380,1968,0,98004,47.6006,-122.194,2390,9450,9,16,2014,UNK,-290,2444
4099500605,4/17/2015,840000.0,4,2.5,2360,9600,1.0,0.0,2.0,3,8,1630,730,1973,0,98040,47.5889,-122.249,2140,6300,4,17,2015,UNK,220,3300
4217401365,12/10/2014,1480000.0,5,3.25,3680,10300,1.5,0.0,0.0,4,10,3680,0,1927,0,98105,47.6548,-122.28,2690,7200,12,10,2014,UNK,990,3100
923000095,3/26/2015,525000.0,3,1.0,1560,8100,1.0,0.0,0.0,4,8,1140,420,1952,0,98177,47.7261,-122.36399999999999,2130,8100,3,26,2015,UNK,-570,0
1828000050,5/14/2014,625000.0,4,2.75,1680,11180,1.0,0.0,0.0,4,7,1680,0,1966,0,98052,47.6557,-122.12700000000001,2400,9627,5,14,2014,UNK,-720,1553
9126100346,6/17/2014,350000.0,3,2.0,1380,3600,3.0,0.0,0.0,3,8,1380,0,2015,0,98122,47.6074,-122.305,1480,3600,6,17,2014,N,-100,0
2919201365,6/16/2014,650000.0,4,2.75,2610,4160,3.0,0.0,0.0,5,8,1910,700,1910,0,98103,47.6901,-122.35700000000001,1470,4140,6,16,2014,UNK,1140,20
9297300500,10/23/2014,435000.0,2,1.0,870,4000,1.0,0.0,2.0,3,7,870,0,1950,0,98126,47.5682,-122.374,1690,4000,10,23,2014,UNK,-820,0
6073200010,6/26/2014,660000.0,3,1.0,1210,9622,1.0,0.0,1.0,3,8,1210,0,1955,2009,98006,47.5728,-122.179,1580,9714,6,26,2014,Y,-370,-92
8807810660,3/2/2015,350000.0,3,1.0,1150,12877,1.0,0.0,0.0,4,6,1150,0,1970,0,98053,47.6614,-122.056,1490,12150,3,2,2015,UNK,-340,727
2112700185,3/25/2015,435000.0,3,2.5,3110,6000,1.0,0.0,2.0,3,8,1560,1550,1967,0,98106,47.5331,-122.353,2060,6000,3,25,2015,UNK,1050,0
1789800020,6/3/2014,375900.0,6,1.5,2550,33740,1.0,0.0,0.0,4,8,1750,800,1958,0,98023,47.3222,-122.36200000000001,2010,28200,6,3,2014,UNK,540,5540
3275300050,11/24/2014,272000.0,3,3.0,2430,10500,1.0,0.0,0.0,4,8,2150,280,1983,0,98003,47.2579,-122.31200000000001,1670,9800,11,24,2014,UNK,760,700
3279000420,1/15/2015,233000.0,3,1.75,1460,7800,1.0,0.0,0.0,2,7,1040,420,1979,0,98023,47.3035,-122.382,1310,7865,1,15,2015,UNK,150,-65
952001660,9/16/2014,500000.0,4,1.5,1330,5750,1.5,0.0,2.0,3,7,1330,0,1915,0,98116,47.5681,-122.384,1360,5750,9,16,2014,UNK,-30,0
4023500362,4/2/2015,540000.0,4,1.75,2040,9322,1.0,0.0,0.0,3,8,1440,600,1977,0,98155,47.7611,-122.29799999999999,1910,10026,4,2,2015,UNK,130,-704
9510910050,7/1/2014,712000.0,3,2.5,2375,4094,2.0,0.0,0.0,3,9,2375,0,2002,0,98052,47.6627,-122.086,2095,4442,7,1,2014,UNK,280,-348
1137400050,9/25/2014,425000.0,4,2.5,2480,4504,2.0,0.0,0.0,3,7,2480,0,2005,0,98059,47.4998,-122.15,2950,4504,9,25,2014,N,-470,0
8864000425,8/5/2014,242000.0,3,1.75,1580,6099,1.0,0.0,0.0,5,7,790,0,1944,0,98168,47.4807,-122.29,1330,6099,8,5,2014,UNK,250,0
5518800010,7/3/2014,515000.0,5,3.25,2740,9629,1.0,0.0,0.0,5,7,1390,1350,1977,0,98011,47.7645,-122.197,2150,10500,7,3,2014,UNK,590,-871
3204800430,7/8/2014,415000.0,4,1.75,1920,7700,2.0,0.0,0.0,4,7,1920,0,1970,0,98056,47.5381,-122.177,1310,7700,7,8,2014,UNK,610,0
5152960080,12/10/2014,375000.0,3,2.75,2200,9600,1.0,0.0,3.0,4,8,1570,630,1977,0,98003,47.3438,-122.323,2680,9896,12,10,2014,UNK,-480,-296
7696500280,10/27/2014,182500.0,3,1.0,910,7194,1.0,0.0,0.0,4,7,910,0,1971,0,98001,47.3337,-122.275,1530,7200,10,27,2014,UNK,-620,-6
8643000190,3/23/2015,310000.0,3,1.5,1860,10379,1.0,0.0,0.0,3,7,1240,620,1963,0,98198,47.3962,-122.309,2240,11328,3,23,2015,UNK,-380,-949
7625701045,10/27/2014,360000.0,3,1.75,1510,6000,1.0,0.0,0.0,3,7,1060,450,1947,0,98136,47.5535,-122.39,1610,6000,10,27,2014,UNK,-100,0
7202360670,4/8/2015,889000.0,4,3.5,3920,9555,2.0,0.0,0.0,3,9,3920,0,2004,0,98053,47.6797,-122.025,3920,8598,4,8,2015,N,0,957
4305700086,4/10/2015,450500.0,2,1.0,1330,3698,1.0,0.0,0.0,3,7,1330,0,1952,0,98117,47.6866,-122.37200000000001,1900,5000,4,10,2015,UNK,-570,-1302
731500170,4/22/2015,342000.0,4,2.25,1964,3541,2.0,0.0,0.0,3,9,1964,0,2013,0,98030,47.3594,-122.20100000000001,1757,3547,4,22,2015,N,207,-6
5096300130,7/14/2014,413000.0,3,2.0,1520,3451,1.0,0.0,0.0,3,8,1520,0,1996,0,98177,47.7753,-122.375,1800,3451,7,14,2014,UNK,-280,0
1441600020,5/27/2014,960000.0,5,4.0,3720,15200,2.0,0.0,0.0,3,10,3720,0,2005,0,98075,47.5956,-122.02600000000001,4100,19036,5,27,2014,N,-380,-3836
6163900073,9/5/2014,180000.0,2,1.0,770,9370,1.0,0.0,0.0,3,7,770,0,1947,0,98155,47.762,-122.321,1060,9352,9,5,2014,UNK,-290,18
5581400080,6/18/2014,770000.0,4,2.5,3210,14910,2.0,0.0,0.0,3,10,3210,0,1995,0,98074,47.6073,-122.06200000000001,3280,14910,6,18,2014,UNK,-70,0
8100000080,8/13/2014,224400.0,3,1.75,1070,7200,1.0,0.0,0.0,3,7,1070,0,1994,0,98010,47.3129,-122.023,1280,7200,8,13,2014,UNK,-210,0
5379806590,4/30/2015,280000.0,3,1.5,1430,8861,1.0,0.0,0.0,3,7,1430,0,1956,0,98188,47.4454,-122.289,1080,9425,4,30,2015,UNK,350,-564
9286100250,3/19/2015,500000.0,3,2.5,1670,2575,2.0,0.0,0.0,3,8,1670,0,2000,0,98027,47.53100000000001,-122.04700000000001,1670,2897,3,19,2015,UNK,0,-322
4337600005,2/3/2015,153000.0,2,1.0,710,9000,1.0,0.0,0.0,5,6,710,0,1943,0,98166,47.4811,-122.339,1230,9000,2,3,2015,UNK,-520,0
3645100280,6/13/2014,385000.0,3,2.25,1920,4833,1.0,0.0,0.0,4,7,1060,860,1921,0,98133,47.7067,-122.352,1580,5134,6,13,2014,UNK,340,-301
6170900190,8/19/2014,325000.0,2,1.0,750,5534,1.0,0.0,0.0,3,7,750,0,1947,0,98177,47.7017,-122.36,1050,5534,8,19,2014,UNK,-300,0
8581400345,4/9/2015,315000.0,4,3.0,2210,4191,2.0,0.0,0.0,3,7,2210,0,2004,0,98002,47.2959,-122.225,890,4288,4,9,2015,N,1320,-97
4345300050,6/17/2014,294999.0,4,2.5,1660,9760,2.0,0.0,0.0,3,7,1660,0,1994,0,98030,47.3635,-122.18799999999999,1580,9614,6,17,2014,UNK,80,146
6143000020,10/27/2014,175000.0,3,1.75,1910,17003,1.5,0.0,0.0,4,8,1910,0,1963,0,98001,47.3095,-122.28299999999999,1820,14806,10,27,2014,UNK,90,2197
6143000020,4/6/2015,299000.0,3,1.75,1910,17003,1.5,0.0,0.0,4,8,1910,0,1963,0,98001,47.3095,-122.28299999999999,1820,14806,4,6,2015,UNK,90,2197
111000190,2/9/2015,146000.0,2,1.0,780,9750,1.0,0.0,0.0,3,6,780,0,1937,0,98168,47.4816,-122.322,1670,9750,2,9,2015,UNK,-890,0
5306100255,11/5/2014,290000.0,3,2.25,1650,10336,1.0,0.0,0.0,3,7,1500,150,1962,0,98133,47.7757,-122.35,1420,10260,11,5,2014,UNK,230,76
1370803180,8/8/2014,1780000.0,3,3.25,3230,7800,2.0,0.0,3.0,3,10,3230,0,2005,0,98199,47.6348,-122.40299999999999,3030,6600,8,8,2014,N,200,1200
5249803745,5/29/2014,367500.0,2,1.0,810,4800,1.0,0.0,0.0,3,6,810,0,1919,0,98118,47.5614,-122.27,1040,4800,5,29,2014,UNK,-230,0
2787250080,3/27/2015,535000.0,4,2.5,2750,15099,2.0,0.0,0.0,3,8,2750,0,1994,0,98019,47.7298,-121.97200000000001,2500,14564,3,27,2015,UNK,250,535
8656300345,8/5/2014,334999.0,3,2.5,1650,13816,2.0,0.0,0.0,3,7,1650,0,1998,0,98014,47.6553,-121.913,1630,18750,8,5,2014,UNK,20,-4934
582000185,8/21/2014,655000.0,3,1.75,1960,5520,1.0,0.0,0.0,4,7,1080,880,1952,0,98199,47.6535,-122.397,1720,5760,8,21,2014,UNK,240,-240
191100235,6/3/2014,1300000.0,4,3.5,2790,10125,1.5,0.0,0.0,5,8,2790,0,1985,0,98040,47.5651,-122.22,2570,10125,6,3,2014,UNK,220,0
6662410250,3/21/2015,480000.0,4,2.25,2230,11200,1.0,0.0,0.0,4,7,1300,930,1977,0,98011,47.7691,-122.167,2090,10563,3,21,2015,UNK,140,637
1053000010,4/21/2015,465000.0,3,1.5,1280,4720,1.0,0.0,0.0,4,7,850,430,1941,0,98126,47.5509,-122.37700000000001,1280,4720,4,21,2015,UNK,0,0
2473100635,5/8/2014,297950.0,3,2.0,1240,10800,1.0,0.0,0.0,3,7,1240,0,1967,2010,98058,47.449,-122.155,1480,8840,5,8,2014,Y,-240,1960
7960100050,4/15/2015,590000.0,3,2.0,1860,3600,1.5,0.0,0.0,3,7,1110,750,1915,0,98122,47.6102,-122.296,1680,3695,4,15,2015,UNK,180,-95
1177000130,5/22/2014,805000.0,4,2.75,2410,6000,1.0,0.0,0.0,5,8,1410,1000,1950,0,98107,47.6707,-122.399,1760,6000,5,22,2014,UNK,650,0
8732160250,1/20/2015,204250.0,3,2.25,1960,7708,1.0,0.0,0.0,4,7,1490,470,1984,0,98023,47.2981,-122.374,1580,8063,1,20,2015,UNK,380,-355
3905100630,7/16/2014,500000.0,3,2.25,1710,4561,2.0,0.0,0.0,4,8,1710,0,1994,0,98029,47.5691,-122.00399999999999,1810,4770,7,16,2014,UNK,-100,-209
5469501410,9/17/2014,490000.0,4,2.5,3480,12696,1.0,0.0,0.0,4,9,1980,1500,1977,0,98042,47.3816,-122.15299999999999,3480,14175,9,17,2014,UNK,0,-1479
4107100190,3/24/2015,2500000.0,4,3.75,3480,14850,1.0,0.0,4.0,3,9,1870,1610,1951,2013,98004,47.6227,-122.21600000000001,4780,18480,3,24,2015,Y,-1300,-3630
5215200050,7/29/2014,750000.0,3,2.5,2960,69351,2.0,1.0,3.0,4,9,2960,0,1990,0,98070,47.4,-122.42,2350,41433,7,29,2014,UNK,610,27918
4027700006,4/9/2015,405000.0,4,2.5,2670,20894,2.0,0.0,0.0,3,9,2330,340,2002,0,98155,47.7735,-122.281,2440,15815,4,9,2015,UNK,230,5079
421000500,7/21/2014,209995.0,2,1.0,700,7303,1.0,0.0,0.0,5,5,700,0,1953,0,98056,47.4934,-122.166,960,6060,7,21,2014,UNK,-260,1243
305010190,10/16/2014,680000.0,4,2.5,2830,8399,2.0,0.0,0.0,3,9,2830,0,1998,0,98075,47.5851,-122.03399999999999,2520,6890,10,16,2014,UNK,310,1509
751000190,10/2/2014,355000.0,3,1.75,1120,7740,1.0,0.0,0.0,4,6,860,260,1948,0,98125,47.7107,-122.291,1240,7740,10,2,2014,UNK,-120,0
1446400715,4/22/2015,280000.0,2,1.0,1310,6600,1.0,0.0,0.0,3,6,1310,0,1942,0,98168,47.4834,-122.33200000000001,1240,6600,4,22,2015,UNK,70,0
4027701284,6/5/2014,385000.0,3,2.25,1710,11500,1.0,0.0,0.0,3,7,1210,500,1978,0,98028,47.7675,-122.26700000000001,1800,11500,6,5,2014,UNK,-90,0
6072000380,7/1/2014,505000.0,4,2.75,2200,9778,1.0,0.0,0.0,4,8,1100,1100,1962,0,98006,47.5472,-122.176,2140,11321,7,1,2014,UNK,60,-1543
7212651100,8/22/2014,429900.0,4,3.25,3310,8897,2.0,0.0,0.0,3,9,2380,930,1991,0,98003,47.2655,-122.31,2490,8638,8,22,2014,UNK,820,259
6977000080,7/21/2014,560000.0,4,2.5,2280,9874,2.0,0.0,0.0,3,9,2280,0,1989,0,98034,47.7099,-122.229,2670,9782,7,21,2014,UNK,-390,92
8651440780,9/29/2014,231000.0,3,2.0,1640,4875,1.0,0.0,0.0,4,7,1040,600,1977,0,98042,47.3661,-122.094,1640,5200,9,29,2014,UNK,0,-325
3298701025,4/27/2015,135000.0,2,1.0,750,5217,1.0,0.0,0.0,4,6,750,0,1943,0,98106,47.5188,-122.353,760,4440,4,27,2015,UNK,-10,777
475000605,6/23/2014,800000.0,4,3.0,3520,4895,1.0,0.0,0.0,3,8,1980,1540,1954,0,98107,47.6678,-122.361,1570,2153,6,23,2014,UNK,1950,2742
1023059430,12/20/2014,420000.0,3,2.5,2720,8622,2.0,0.0,0.0,3,8,2720,0,2002,0,98059,47.4954,-122.163,1950,8603,12,20,2014,UNK,770,19
3760000020,10/22/2014,360000.0,3,1.0,1660,9600,1.0,0.0,0.0,3,7,1660,0,1963,0,98034,47.708,-122.21600000000001,2020,9600,10,22,2014,UNK,-360,0
3905090080,5/30/2014,642000.0,4,2.5,2560,8780,2.0,0.0,0.0,3,9,2560,0,1992,0,98029,47.5717,-121.991,2780,8357,5,30,2014,UNK,-220,423
339600290,4/6/2015,379950.0,3,2.0,1080,5077,1.0,0.0,0.0,3,7,1080,0,1985,0,98052,47.6836,-122.095,1070,3471,4,6,2015,UNK,10,1606
9542400010,7/11/2014,745000.0,3,1.75,2050,11041,1.5,0.0,0.0,5,9,2050,0,1959,0,98005,47.5968,-122.17399999999999,2530,11041,7,11,2014,UNK,-480,0
1498303895,7/29/2014,630000.0,4,2.0,2670,3240,1.5,0.0,0.0,4,9,1780,890,1930,0,98144,47.5841,-122.294,1820,4000,7,29,2014,UNK,850,-760
739820050,5/5/2015,250000.0,3,2.5,1730,7200,2.0,0.0,0.0,4,7,1730,0,1985,0,98031,47.4029,-122.196,1770,7396,5,5,2015,UNK,-40,-196
9238450430,6/24/2014,275000.0,3,1.0,990,9798,1.0,0.0,0.0,3,7,990,0,1968,0,98072,47.766999999999996,-122.164,1210,9870,6,24,2014,UNK,-220,-72
3336000050,5/1/2015,435000.0,6,3.0,3560,4290,1.0,0.0,0.0,4,7,1780,1780,1957,0,98118,47.5282,-122.26899999999999,3040,6000,5,1,2015,UNK,520,-1710
5269200050,3/5/2015,175000.0,2,1.0,700,8174,1.0,0.0,0.0,3,5,700,0,1941,0,98146,47.5136,-122.34899999999999,1250,8046,3,5,2015,UNK,-550,128
1982200430,6/12/2014,560000.0,4,1.75,1880,3880,1.5,0.0,0.0,4,7,1090,790,1944,0,98107,47.6635,-122.36200000000001,1390,3880,6,12,2014,UNK,490,0
3763300005,5/20/2014,325000.0,4,2.25,1870,9680,1.0,0.0,0.0,4,7,1170,700,1959,0,98034,47.7157,-122.234,2000,9790,5,20,2014,UNK,-130,-110
1336800185,6/17/2014,1190000.0,3,2.75,2500,5568,2.0,0.0,0.0,5,9,2500,0,1905,0,98112,47.6258,-122.31200000000001,2810,5568,6,17,2014,UNK,-310,0
1561910190,6/27/2014,399950.0,3,2.5,2570,10431,2.0,0.0,0.0,3,9,2570,0,1989,0,98031,47.4188,-122.213,2590,10078,6,27,2014,UNK,-20,353
5415350480,6/17/2014,752000.0,4,2.5,2940,10382,2.0,0.0,0.0,4,9,2940,0,1991,0,98059,47.5333,-122.15100000000001,2980,10547,6,17,2014,UNK,-40,-165
1126059108,4/23/2015,1200000.0,4,3.5,3930,43560,2.0,0.0,0.0,3,10,3930,0,2003,0,98072,47.7497,-122.12100000000001,2860,36460,4,23,2015,UNK,1070,7100
3818700185,9/25/2014,400000.0,4,1.5,2150,11026,1.0,0.0,0.0,4,7,2150,0,1952,0,98028,47.7635,-122.26299999999999,1760,10283,9,25,2014,UNK,390,743
7883601155,5/30/2014,240000.0,3,2.0,1330,6000,1.0,0.0,0.0,4,7,630,700,1900,0,98108,47.5255,-122.32700000000001,1140,6000,5,30,2014,UNK,190,0
7559600430,11/11/2014,640000.0,5,2.5,3220,4759,2.0,0.0,0.0,3,8,3220,0,2003,0,98075,47.5957,-122.03200000000001,2550,4759,11,11,2014,UNK,670,0
3449820380,4/2/2015,564450.0,3,2.5,2710,6174,2.0,0.0,0.0,3,9,2710,0,1998,0,98056,47.512,-122.17399999999999,2730,7266,4,2,2015,UNK,-20,-1092
1523069022,5/6/2015,300000.0,3,1.5,1630,82764,1.0,0.0,0.0,4,6,1630,0,1948,0,98027,47.4743,-122.02600000000001,1680,199069,5,6,2015,UNK,-50,-116305
7569450480,3/17/2015,286000.0,3,2.5,1680,4226,2.0,0.0,0.0,3,8,1680,0,2003,0,98042,47.3684,-122.12299999999999,1800,5559,3,17,2015,UNK,-120,-1333
7202340190,2/19/2015,531800.0,3,2.5,1930,5344,2.0,0.0,0.0,3,7,1930,0,2004,0,98053,47.6783,-122.03200000000001,2410,5080,2,19,2015,N,-480,264
8651710190,10/24/2014,502000.0,4,2.25,2140,10943,1.0,0.0,0.0,3,7,1550,590,1977,0,98034,47.7271,-122.215,2350,9000,10,24,2014,UNK,-210,1943
5450900010,8/21/2014,993500.0,4,2.25,4070,23321,2.0,0.0,0.0,4,10,4070,0,1968,0,98040,47.5563,-122.219,2820,10871,8,21,2014,UNK,1250,12450
2201500980,10/20/2014,450000.0,3,1.0,1350,10000,1.0,0.0,0.0,4,7,1350,0,1954,0,98006,47.5741,-122.133,1450,10000,10,20,2014,UNK,-100,0
2624079028,10/27/2014,997950.0,4,3.5,4270,117176,2.0,0.0,0.0,3,9,4270,0,2008,0,98024,47.5352,-121.883,2610,5251,10,27,2014,N,1660,111925
3095000185,10/13/2014,526000.0,3,1.0,1320,5250,1.5,0.0,0.0,5,7,1320,0,1913,0,98126,47.5566,-122.37799999999999,1490,5250,10,13,2014,UNK,-170,0
4476400275,1/14/2015,335000.0,3,1.75,2100,8298,1.0,0.0,0.0,4,7,1230,870,1952,0,98166,47.4601,-122.36,1700,10830,1,14,2015,UNK,400,-2532
8018600980,12/3/2014,187250.0,2,1.0,710,14700,1.0,0.0,0.0,5,6,710,0,1926,0,98168,47.4939,-122.318,1320,14700,12,3,2014,UNK,-610,0
7173700591,8/11/2014,735000.0,3,2.25,2350,6000,1.0,0.0,0.0,5,7,1020,1330,1948,0,98115,47.6809,-122.305,1570,5000,8,11,2014,UNK,780,1000
2568800290,2/18/2015,425000.0,3,1.0,1180,8400,1.0,0.0,0.0,3,7,1180,0,1951,0,98125,47.7028,-122.295,1740,7020,2,18,2015,UNK,-560,1380
5111400086,5/12/2014,110000.0,3,1.0,1250,53143,1.0,0.0,0.0,5,6,1250,0,1945,0,98038,47.4235,-122.051,1820,217800,5,12,2014,UNK,-570,-164657
1079350020,8/21/2014,305000.0,3,2.0,1490,7697,1.0,0.0,0.0,3,7,1490,0,1994,0,98059,47.4852,-122.164,1540,7529,8,21,2014,UNK,-50,168
88000591,4/14/2015,212000.0,3,1.0,1000,9450,1.0,0.0,0.0,3,6,1000,0,1962,0,98055,47.4562,-122.193,1300,13500,4,14,2015,UNK,-300,-4050
2524049108,5/12/2015,1380000.0,5,4.25,4050,18827,1.0,0.0,2.0,4,10,2150,1900,1979,0,98040,47.5323,-122.23700000000001,3600,25120,5,12,2015,UNK,450,-6293
1552800280,9/18/2014,298950.0,5,2.25,2300,11505,1.0,0.0,0.0,3,8,1300,1000,1963,0,98030,47.3812,-122.223,2350,11505,9,18,2014,UNK,-50,0
2423020010,3/16/2015,525000.0,3,1.75,1330,8136,1.0,0.0,0.0,4,7,1330,0,1977,0,98033,47.7001,-122.17299999999999,1330,8136,3,16,2015,UNK,0,0
629410130,5/14/2014,707000.0,4,3.25,3200,7081,2.0,0.0,0.0,3,9,3200,0,2004,0,98075,47.5886,-121.98899999999999,3120,6094,5,14,2014,N,80,987
4139440480,6/26/2014,695000.0,3,2.75,2590,12063,2.0,0.0,0.0,3,10,2590,0,1993,0,98006,47.5527,-122.12,2850,8469,6,26,2014,UNK,-260,3594
4139440480,12/1/2014,796500.0,3,2.75,2590,12063,2.0,0.0,0.0,3,10,2590,0,1993,0,98006,47.5527,-122.12,2850,8469,12,1,2014,UNK,-260,3594
7016300050,7/23/2014,420000.0,4,2.5,2030,8100,1.0,0.0,0.0,3,7,1150,880,1973,0,98034,47.7404,-122.186,1770,8071,7,23,2014,UNK,260,29
3425059099,6/25/2014,625000.0,5,2.5,2700,21208,1.0,0.0,0.0,4,8,1950,750,1955,0,98005,47.6078,-122.154,2550,20409,6,25,2014,UNK,150,799
9541600280,8/23/2014,620000.0,3,1.75,1670,9900,1.0,0.0,0.0,4,8,1670,0,1957,0,98005,47.595,-122.17200000000001,2410,8800,8,23,2014,UNK,-740,1100
3025300225,10/31/2014,1450000.0,5,2.75,3090,19865,1.0,0.0,0.0,4,9,3090,0,1953,0,98039,47.6232,-122.235,2970,19862,10,31,2014,UNK,120,3
7214770020,4/9/2015,549950.0,5,2.5,2650,54380,2.0,0.0,0.0,3,9,2650,0,1984,0,98077,47.7726,-122.081,2560,49044,4,9,2015,UNK,90,5336
7227801630,2/27/2015,275000.0,4,2.0,1440,10920,1.0,0.0,0.0,3,5,1440,0,1943,0,98056,47.5049,-122.18,1500,11902,2,27,2015,UNK,-60,-982
7284900098,9/24/2014,705000.0,3,2.5,2820,7200,1.0,0.0,3.0,3,9,1780,1040,1979,0,98177,47.7691,-122.38799999999999,2300,7200,9,24,2014,UNK,520,0
7696630080,5/6/2014,197000.0,3,1.75,1690,7735,1.0,0.0,0.0,4,7,1060,630,1976,0,98001,47.3324,-122.28,1580,7503,5,6,2014,UNK,110,232
3235390010,5/5/2015,265000.0,3,1.75,1420,8126,1.0,0.0,0.0,3,8,1420,0,1991,0,98031,47.3871,-122.189,1730,7954,5,5,2015,UNK,-310,172
2966800010,11/20/2014,297000.0,4,1.75,1790,5341,1.0,0.0,0.0,4,7,1050,740,1951,0,98166,47.4663,-122.363,1540,6916,11,20,2014,UNK,250,-1575
6600410290,8/19/2014,207500.0,3,1.75,1320,12528,1.0,0.0,0.0,4,7,1320,0,1970,0,98042,47.3234,-122.14200000000001,1340,11039,8,19,2014,UNK,-20,1489
6300500479,8/19/2014,410000.0,3,2.5,1509,1418,3.0,0.0,0.0,3,8,1509,0,2014,0,98133,47.7047,-122.34,1509,1991,8,19,2014,N,0,-573
1450900020,10/3/2014,268000.0,3,2.0,1610,8416,1.0,0.0,0.0,3,7,1610,0,1994,0,98031,47.397,-122.18700000000001,1600,8308,10,3,2014,UNK,10,108
1284000010,8/5/2014,330000.0,4,1.75,1550,50094,1.0,0.0,3.0,4,6,1550,0,1967,0,98022,47.2194,-122.059,1720,50094,8,5,2014,UNK,-170,0
3626039028,8/18/2014,417500.0,3,1.0,1160,7491,1.0,0.0,0.0,4,6,1160,0,1917,0,98177,47.7024,-122.359,1800,2267,8,18,2014,UNK,-640,5224
7856560380,8/4/2014,760000.0,4,2.25,2500,8500,2.0,0.0,0.0,4,8,2500,0,1979,0,98006,47.5569,-122.15100000000001,2470,9100,8,4,2014,UNK,30,-600
2770604346,7/5/2014,499000.0,3,2.5,1540,1326,3.0,0.0,0.0,3,8,1390,150,1995,0,98119,47.6457,-122.374,1680,1592,7,5,2014,UNK,-140,-266
9202650130,6/18/2014,620000.0,4,2.5,1910,7683,2.0,0.0,0.0,3,8,1910,0,1987,0,98027,47.5644,-122.09200000000001,1980,8485,6,18,2014,UNK,-70,-802
8700100010,7/10/2014,315000.0,3,2.5,2340,6837,2.0,0.0,0.0,3,7,2340,0,1992,0,98030,47.3608,-122.194,1850,6209,7,10,2014,UNK,490,628
4045750010,4/9/2015,624950.0,3,2.5,2060,4730,2.0,0.0,0.0,4,8,2060,0,1994,0,98033,47.6874,-122.178,1980,5010,4,9,2015,UNK,80,-280
5706201470,4/28/2015,525000.0,3,2.25,1960,12350,1.0,0.0,0.0,4,7,1960,0,1961,0,98027,47.5247,-122.052,1920,13608,4,28,2015,UNK,40,-1258
8835210130,8/8/2014,300000.0,2,1.5,1150,3927,2.0,0.0,0.0,3,7,1150,0,1982,0,98034,47.7248,-122.162,1400,3425,8,8,2014,UNK,-250,502
8731990440,3/10/2015,299900.0,4,2.75,2330,7200,1.0,0.0,0.0,4,8,1560,770,1977,0,98023,47.3203,-122.385,2350,7600,3,10,2015,UNK,-20,-400
5540000050,6/12/2014,299000.0,3,2.5,2210,10119,1.0,0.0,0.0,4,7,1450,760,1966,0,98030,47.3783,-122.22,2110,10119,6,12,2014,UNK,100,0
2470200020,5/14/2014,1880000.0,4,2.75,3260,19542,1.0,0.0,0.0,4,10,2170,1090,1968,0,98039,47.6245,-122.236,3480,19863,5,14,2014,UNK,-220,-321
9500900430,6/13/2014,265000.0,4,1.75,1900,10588,1.0,0.0,0.0,5,6,1900,0,1958,0,98002,47.288999999999994,-122.212,1530,10587,6,13,2014,UNK,370,1
3024089049,6/9/2014,280000.0,2,1.75,1610,158558,1.5,0.0,0.0,2,6,1610,0,1948,0,98065,47.5319,-121.84,1800,3572,6,9,2014,UNK,-190,154986
6600410170,5/28/2014,124740.0,3,1.0,1340,15600,1.0,0.0,0.0,4,6,1340,0,1978,0,98042,47.3224,-122.14299999999999,1320,9800,5,28,2014,UNK,20,5800
7796000095,1/6/2015,1090000.0,3,2.75,3170,34850,1.0,0.0,0.0,5,9,3170,0,1957,0,98033,47.6611,-122.169,3920,36740,1,6,2015,UNK,-750,-1890
1338600225,5/28/2014,1970000.0,8,3.5,4440,6480,2.0,0.0,3.0,5,10,3140,1300,1959,0,98112,47.631,-122.303,4440,8640,5,28,2014,UNK,0,-2160
316000190,2/15/2015,219000.0,4,1.0,1370,5339,1.5,0.0,0.0,4,6,1370,0,1948,0,98168,47.5046,-122.3,1280,7048,2,15,2015,UNK,90,-1709
9276200190,4/16/2015,569950.0,5,1.0,1420,6250,1.5,0.0,0.0,4,8,1420,0,1926,0,98116,47.5807,-122.389,1420,6250,4,16,2015,UNK,0,0
1447600285,6/9/2014,212500.0,2,2.0,1030,21712,1.0,0.0,0.0,4,6,1030,0,1938,0,98168,47.4905,-122.331,1790,9199,6,9,2014,UNK,-760,12513
5307100280,8/11/2014,680000.0,3,2.25,1820,8316,1.0,0.0,0.0,5,7,1320,500,1960,0,98005,47.5849,-122.169,1780,8400,8,11,2014,UNK,40,-84
1338800280,9/29/2014,1460000.0,4,1.5,2650,6900,2.0,0.0,0.0,4,9,2400,250,1909,0,98112,47.6275,-122.305,2420,6900,9,29,2014,UNK,230,0
3211200420,6/18/2014,300000.0,3,1.0,910,7700,1.0,0.0,0.0,4,7,910,0,1971,0,98034,47.7303,-122.238,1250,7700,6,18,2014,UNK,-340,0
2770604082,3/10/2015,629950.0,3,2.5,1680,1683,2.0,0.0,0.0,3,9,1120,560,2014,0,98119,47.6424,-122.374,1610,1249,3,10,2015,N,70,434
7334600280,12/2/2014,349900.0,2,1.75,1550,9230,1.0,0.0,0.0,3,6,970,580,1969,0,98045,47.4701,-121.744,1550,10856,12,2,2014,UNK,0,-1626
5406500440,8/12/2014,690000.0,4,2.5,2780,6235,2.0,0.0,0.0,3,8,2780,0,2001,0,98075,47.5976,-122.039,2670,4410,8,12,2014,UNK,110,1825
1235100328,2/25/2015,1450000.0,5,4.0,4070,11334,2.0,0.0,0.0,3,10,4070,0,2014,0,98033,47.6771,-122.18700000000001,2640,9401,2,25,2015,N,1430,1933
4141010050,1/21/2015,1290000.0,3,2.5,3240,12625,2.0,0.0,0.0,3,11,3240,0,1987,0,98040,47.5327,-122.23200000000001,3470,12331,1,21,2015,UNK,-230,294
9510310280,7/9/2014,696000.0,4,3.5,3650,38546,2.0,0.0,0.0,3,9,2550,1100,1996,0,98045,47.4776,-121.73,2860,34284,7,9,2014,UNK,790,4262
725069102,3/30/2015,650000.0,3,2.25,2180,60112,2.0,0.0,0.0,3,8,2180,0,1976,0,98053,47.6723,-122.08200000000001,2060,120225,3,30,2015,UNK,120,-60113
8562901350,8/12/2014,640000.0,3,3.5,2480,10800,2.0,0.0,0.0,3,8,2480,0,1998,0,98074,47.6083,-122.06,2380,11310,8,12,2014,UNK,100,-510
1442700430,8/8/2014,499950.0,5,2.5,3180,23809,1.0,0.0,0.0,3,9,3180,0,1978,0,98038,47.3727,-122.054,2500,15778,8,8,2014,UNK,680,8031
6806300980,12/23/2014,490000.0,4,2.5,3630,8387,2.0,0.0,0.0,3,10,3630,0,1997,0,98042,47.3623,-122.12700000000001,3370,8869,12,23,2014,UNK,260,-482
8562740290,10/10/2014,685000.0,5,2.5,3160,5635,2.0,0.0,0.0,3,9,3160,0,2003,0,98027,47.5362,-122.06700000000001,3670,6087,10,10,2014,UNK,-510,-452
7454001405,4/3/2015,387500.0,4,1.0,1370,7140,2.0,0.0,0.0,3,6,1370,0,1942,0,98146,47.512,-122.376,1090,6300,4,3,2015,UNK,280,840
952007141,4/21/2015,401750.0,2,1.5,1070,1236,2.0,0.0,0.0,3,8,1000,70,2005,0,98116,47.5619,-122.382,1170,1888,4,21,2015,N,-100,-652
1545806720,8/26/2014,254950.0,4,2.0,2180,8800,1.0,0.0,0.0,5,7,1170,0,1977,0,98038,47.3676,-122.046,1630,8800,8,26,2014,UNK,550,0
5561300980,3/20/2015,500000.0,4,2.25,2420,36680,2.0,0.0,0.0,4,8,2420,0,1977,0,98027,47.4663,-122.006,2410,36680,3,20,2015,UNK,10,0
9348700480,7/15/2014,856500.0,4,2.5,3290,8147,2.0,0.0,0.0,3,10,3290,0,2003,0,98052,47.7048,-122.10700000000001,3290,7467,7,15,2014,UNK,0,680
1868900285,5/23/2014,552000.0,3,1.0,1430,5000,1.0,0.0,0.0,4,6,1080,350,1919,0,98115,47.6724,-122.296,1630,4600,5,23,2014,UNK,-200,400
8651720470,9/10/2014,506500.0,4,2.5,1890,7200,1.0,0.0,0.0,4,7,1500,390,1978,0,98034,47.7278,-122.21799999999999,2070,7200,9,10,2014,UNK,-180,0
3904950190,5/27/2014,500000.0,3,2.25,1760,4539,2.0,0.0,0.0,3,8,1760,0,1988,0,98029,47.5754,-122.01299999999999,1960,4808,5,27,2014,UNK,-200,-269
5300200050,7/29/2014,280000.0,4,2.75,2230,10160,1.0,0.0,0.0,3,7,1400,830,1968,0,98168,47.5123,-122.32,1740,10080,7,29,2014,UNK,490,80
7334501300,3/6/2015,308000.0,3,1.75,1630,11475,1.0,0.0,0.0,4,7,1330,300,1979,0,98045,47.4635,-121.74600000000001,1630,11475,3,6,2015,UNK,0,0
8078350280,2/5/2015,613500.0,3,2.5,2350,7035,2.0,0.0,0.0,3,8,2350,0,1989,0,98029,47.5713,-122.02,2270,7192,2,5,2015,UNK,80,-157
4068300280,7/8/2014,255000.0,3,1.75,1550,9720,1.0,0.0,0.0,3,7,1050,500,1976,0,98010,47.3433,-122.037,1550,9750,7,8,2014,UNK,0,-30
2625079030,10/28/2014,545000.0,3,2.5,3550,136343,2.0,0.0,0.0,3,10,3550,0,1977,0,98014,47.6223,-121.869,3080,215186,10,28,2014,UNK,470,-78843
1024069063,9/23/2014,620000.0,4,2.5,2720,34498,1.0,0.0,0.0,5,7,1360,1360,1966,0,98075,47.5832,-122.02,1920,22474,9,23,2014,UNK,800,12024
3624039102,10/25/2014,450000.0,3,1.75,1740,6800,1.5,0.0,0.0,4,7,1740,0,1949,0,98126,47.5314,-122.37299999999999,990,6800,10,25,2014,UNK,750,0
8025700460,5/8/2015,279000.0,4,1.75,1840,7275,1.0,0.0,0.0,3,7,1090,750,1976,0,98031,47.4002,-122.189,1840,7275,5,8,2015,UNK,0,0
8956000460,1/23/2015,625000.0,3,2.5,2010,3200,2.0,0.0,0.0,3,9,2010,0,2009,0,98027,47.5463,-122.015,2250,3200,1,23,2015,N,-240,0
2329800630,5/27/2014,274950.0,3,1.75,1670,7415,1.0,0.0,0.0,3,7,1320,350,1987,0,98042,47.3776,-122.116,1650,8585,5,27,2014,UNK,20,-1170
2491200050,10/23/2014,423000.0,3,1.75,1820,6038,1.0,0.0,0.0,4,7,1040,780,1952,0,98126,47.5233,-122.37799999999999,1700,6040,10,23,2014,UNK,120,-2
6181700250,2/26/2015,350000.0,2,1.0,720,5820,1.0,0.0,1.0,5,6,720,0,1950,0,98028,47.7598,-122.255,952,5820,2,26,2015,UNK,-232,0
2460500020,3/30/2015,305000.0,4,1.75,2370,10140,1.0,0.0,0.0,3,7,1460,910,1968,0,98001,47.3352,-122.27799999999999,1450,7800,3,30,2015,UNK,920,2340
7893801760,11/17/2014,368000.0,3,1.75,2120,11340,1.0,0.0,3.0,4,7,1060,1060,1966,0,98198,47.4109,-122.329,1830,8650,11,17,2014,UNK,290,2690
5259800440,9/26/2014,232000.0,3,1.75,1290,6604,1.0,0.0,0.0,3,7,1290,0,1984,0,98023,47.323,-122.34899999999999,1440,6682,9,26,2014,UNK,-150,-78
7338402850,11/26/2014,250000.0,4,3.0,1800,2500,2.0,0.0,0.0,3,7,1800,0,2000,0,98108,47.5333,-122.294,1830,6900,11,26,2014,UNK,-30,-4400
1423910130,2/11/2015,220000.0,3,1.75,1230,8917,1.0,0.0,0.0,4,7,1230,0,1966,0,98058,47.4528,-122.17200000000001,1420,7938,2,11,2015,UNK,-190,979
2769602135,8/13/2014,435000.0,3,2.0,1380,2500,1.0,0.0,0.0,3,7,750,630,1986,0,98107,47.6753,-122.363,1630,3800,8,13,2014,UNK,-250,-1300
4365200425,6/24/2014,350000.0,2,1.0,740,7680,1.0,0.0,0.0,4,6,740,0,1922,0,98126,47.5245,-122.37100000000001,1080,7680,6,24,2014,UNK,-340,0
2473380920,8/13/2014,206325.0,5,2.5,1720,10202,1.5,0.0,0.0,3,7,1720,0,1970,0,98058,47.4572,-122.167,1720,8478,8,13,2014,UNK,0,1724
2473380920,2/27/2015,339000.0,5,2.5,1720,10202,1.5,0.0,0.0,3,7,1720,0,1970,0,98058,47.4572,-122.167,1720,8478,2,27,2015,UNK,0,1724
2787700630,3/18/2015,399000.0,4,2.5,2100,7355,1.0,0.0,0.0,5,7,2100,0,1969,0,98059,47.5078,-122.161,1750,7200,3,18,2015,UNK,350,155
6917700305,2/19/2015,529000.0,2,1.0,1210,7667,1.0,0.0,0.0,3,6,900,310,1950,0,98199,47.6571,-122.396,1330,6462,2,19,2015,UNK,-120,1205
7215720420,3/4/2015,640000.0,4,2.5,2210,7722,2.0,0.0,0.0,3,9,2210,0,1999,0,98075,47.5992,-122.01899999999999,2970,8683,3,4,2015,UNK,-760,-961
2856100250,11/6/2014,735000.0,4,2.5,2470,2550,3.0,0.0,0.0,3,8,2470,0,2004,0,98117,47.6765,-122.389,1270,3060,11,6,2014,N,1200,-510
9421500130,6/16/2014,378000.0,5,2.5,2760,8015,1.0,0.0,0.0,4,8,1600,1160,1960,0,98125,47.7255,-122.29700000000001,460,18000,6,16,2014,UNK,2300,-9985
1250201640,5/7/2014,775000.0,3,2.0,2540,7200,1.5,0.0,3.0,4,8,1600,940,1905,0,98144,47.5972,-122.292,2040,5900,5,7,2014,UNK,500,1300
5316100920,7/25/2014,2250000.0,3,4.25,5150,7800,2.5,0.0,2.0,3,11,4170,980,1954,0,98112,47.6288,-122.28200000000001,4270,7800,7,25,2014,UNK,880,0
6813600605,1/28/2015,1350000.0,4,4.5,3420,7440,3.0,0.0,0.0,3,9,3420,0,2014,0,98103,47.6875,-122.33,1360,5580,1,28,2015,N,2060,1860
1974300020,8/27/2014,380000.0,4,2.5,2270,11500,1.0,0.0,0.0,3,8,1540,730,1967,0,98034,47.7089,-122.241,2020,10918,8,27,2014,UNK,250,582
1974300020,2/18/2015,624900.0,4,2.5,2270,11500,1.0,0.0,0.0,3,8,1540,730,1967,0,98034,47.7089,-122.241,2020,10918,2,18,2015,UNK,250,582
3630020380,11/7/2014,379770.0,3,2.5,1470,1779,2.0,0.0,0.0,3,8,1160,310,2005,0,98029,47.5472,-121.99799999999999,1470,1576,11,7,2014,N,0,203
1771000290,12/3/2014,340000.0,3,1.75,1280,16200,1.0,0.0,0.0,3,8,1030,250,1976,0,98077,47.7427,-122.071,1160,10565,12,3,2014,UNK,120,5635
5126310470,1/15/2015,515500.0,4,2.75,2830,8126,2.0,0.0,0.0,3,8,2830,0,2005,0,98059,47.4863,-122.14,2830,7916,1,15,2015,N,0,210
1870400605,11/17/2014,600000.0,4,2.25,1970,7125,1.5,0.0,0.0,3,7,1500,470,1908,0,98115,47.6725,-122.29299999999999,1980,4750,11,17,2014,UNK,-10,2375
4047200825,10/11/2014,400000.0,1,1.0,1390,60984,1.0,0.0,0.0,3,6,1390,0,1960,0,98019,47.7652,-121.90299999999999,1620,24225,10,11,2014,UNK,-230,36759
7304300430,12/1/2014,364000.0,4,1.0,1020,11383,1.5,0.0,0.0,5,6,1020,0,1947,0,98155,47.7429,-122.321,1290,11213,12,1,2014,UNK,-270,170
8079010190,6/26/2014,440000.0,4,2.5,2250,7526,2.0,0.0,0.0,3,8,2250,0,1989,0,98059,47.5123,-122.15,1980,7526,6,26,2014,UNK,270,0
1453600182,5/28/2014,285000.0,2,1.0,800,6240,1.0,0.0,0.0,3,6,800,0,1954,0,98125,47.7257,-122.296,1530,8000,5,28,2014,UNK,-730,-1760
9828700235,4/1/2015,669000.0,3,1.0,1560,4500,1.5,0.0,0.0,5,7,1560,0,1915,0,98112,47.6204,-122.292,1530,4500,4,1,2015,UNK,30,0
3448002285,7/2/2014,475000.0,4,2.0,2100,13468,1.0,0.0,0.0,5,7,1050,1050,1962,0,98125,47.7139,-122.292,1470,8675,7,2,2014,UNK,630,4793
2513500010,5/4/2015,747000.0,2,1.0,990,4000,1.0,0.0,0.0,4,7,990,0,1911,0,98103,47.6589,-122.34100000000001,1560,4000,5,4,2015,UNK,-570,0
9284801100,1/5/2015,317000.0,3,1.5,1060,5750,1.0,0.0,0.0,2,7,1060,0,1981,0,98126,47.5532,-122.37200000000001,1060,5750,1,5,2015,UNK,0,0
8901000491,8/28/2014,390000.0,2,1.0,1270,8164,1.0,0.0,0.0,4,6,1270,0,1941,0,98125,47.7116,-122.311,1580,9095,8,28,2014,UNK,-310,-931
452002135,4/22/2015,1070000.0,4,2.5,2740,5000,2.0,0.0,0.0,3,9,2740,0,2012,0,98107,47.674,-122.37100000000001,1660,5000,4,22,2015,N,1080,0
6610000591,10/21/2014,1210000.0,4,2.75,2470,5500,1.0,0.0,3.0,3,9,1570,900,1960,2005,98107,47.6586,-122.35799999999999,1620,5500,10,21,2014,Y,850,0
7518501025,3/27/2015,580000.0,3,1.75,1970,5100,1.0,0.0,0.0,3,7,1130,840,1908,1965,98117,47.6831,-122.37899999999999,1250,4080,3,27,2015,Y,720,1020
6072400470,11/13/2014,518000.0,4,2.5,2070,10244,1.0,0.0,0.0,3,8,1370,700,1969,0,98006,47.5592,-122.178,2070,9683,11,13,2014,UNK,0,561
1865800250,12/4/2014,147500.0,3,1.75,1010,6552,1.0,0.0,0.0,3,7,1010,0,1969,0,98042,47.375,-122.117,1010,6552,12,4,2014,UNK,0,0
6072650250,4/24/2015,555000.0,4,2.25,2220,8125,1.0,0.0,0.0,4,8,1450,770,1965,0,98006,47.5429,-122.177,1980,8700,4,24,2015,UNK,240,-575
8807900233,6/30/2014,427500.0,2,2.0,1090,934,3.0,0.0,0.0,3,8,1090,0,2008,0,98109,47.6341,-122.34200000000001,1090,1376,6,30,2014,N,0,-442
3585901025,6/13/2014,1740000.0,3,2.5,4310,32093,1.5,0.0,4.0,5,10,2510,1800,1982,0,98177,47.7624,-122.38,3810,26400,6,13,2014,UNK,500,5693
9238440020,7/17/2014,265950.0,3,2.5,1490,3840,2.0,0.0,0.0,3,7,1490,0,2002,0,98042,47.373999999999995,-122.133,2060,4384,7,17,2014,UNK,-570,-544
9325800005,12/1/2014,247500.0,2,1.0,700,6046,1.0,0.0,0.0,3,6,700,0,1950,0,98133,47.7172,-122.34,990,6790,12,1,2014,UNK,-290,-744
7520000020,5/23/2014,244000.0,4,1.0,1450,8960,1.0,0.0,0.0,3,6,1450,0,1943,0,98146,47.4972,-122.348,1160,7680,5,23,2014,UNK,290,1280
3904920380,3/23/2015,578550.0,3,2.5,2120,6602,2.0,0.0,0.0,4,8,2120,0,1989,0,98029,47.5669,-122.012,2330,7795,3,23,2015,UNK,-210,-1193
3630080430,6/17/2014,451000.0,4,2.5,1670,3315,2.0,0.0,0.0,3,7,1670,0,2005,0,98029,47.5532,-121.99799999999999,1650,2051,6,17,2014,N,20,1264
8682262230,8/26/2014,489000.0,2,1.75,1810,4220,2.0,0.0,0.0,3,8,1810,0,2004,0,98053,47.7177,-122.03399999999999,1350,4479,8,26,2014,N,460,-259
3326079016,5/4/2015,190000.0,2,1.0,710,1164794,1.0,0.0,0.0,2,5,710,0,1915,0,98014,47.6888,-121.90899999999999,1680,16730,5,4,2015,UNK,-970,1148064
7214800430,3/5/2015,475000.0,3,3.0,2540,18900,1.0,0.0,0.0,3,7,1580,960,1978,0,98072,47.754,-122.14399999999999,2270,16000,3,5,2015,UNK,270,2900
6430000275,5/6/2014,485000.0,3,2.0,1420,4080,1.5,0.0,0.0,3,7,1420,0,1905,2013,98103,47.6872,-122.34899999999999,1420,4590,5,6,2014,Y,0,-510
1924079090,10/16/2014,530000.0,3,2.75,2440,45738,2.0,0.0,0.0,3,8,1840,600,1987,0,98027,47.5453,-121.95700000000001,2440,189100,10,16,2014,UNK,0,-143362
1509500380,1/28/2015,379000.0,4,2.5,2570,10155,2.0,0.0,0.0,3,9,2570,0,1994,0,98030,47.3842,-122.17,2770,10155,1,28,2015,UNK,-200,0
9809000010,1/6/2015,1630000.0,5,2.5,3090,16583,2.0,0.0,0.0,4,9,3090,0,1964,0,98004,47.6458,-122.21799999999999,3740,17853,1,6,2015,UNK,-650,-1270
8722101100,3/19/2015,739000.0,3,1.75,2050,5160,1.5,0.0,0.0,4,8,1300,750,1926,0,98112,47.6374,-122.304,2220,5960,3,19,2015,UNK,-170,-800
8651410670,11/25/2014,189950.0,3,1.0,920,6460,1.0,0.0,0.0,5,6,920,0,1969,0,98042,47.3665,-122.08200000000001,920,4770,11,25,2014,UNK,0,1690
3629830250,12/22/2014,637500.0,4,3.0,2320,4468,2.0,0.0,0.0,3,8,2160,160,1999,0,98029,47.54600000000001,-122.009,2330,3541,12,22,2014,UNK,-10,927
868001435,1/27/2015,2230000.0,3,3.0,3450,16740,1.0,0.0,4.0,4,9,1960,1490,1949,0,98177,47.7067,-122.38,3220,12528,1,27,2015,UNK,230,4212
4168100020,12/4/2014,209950.0,3,1.0,1660,8800,1.0,0.0,0.0,4,7,960,700,1963,0,98023,47.3212,-122.352,1370,10112,12,4,2014,UNK,290,-1312
814000020,2/20/2015,460000.0,3,1.0,1130,7000,1.0,0.0,0.0,3,6,830,300,1944,0,98125,47.7132,-122.28299999999999,1050,7000,2,20,2015,UNK,80,0
7852010950,10/20/2014,543500.0,4,2.5,2550,5835,2.0,0.0,0.0,3,8,2550,0,1998,0,98065,47.5373,-121.87,2420,5817,10,20,2014,UNK,130,18
2395710010,6/5/2014,376000.0,4,2.75,2420,5773,2.0,0.0,0.0,3,8,2420,0,2005,0,98038,47.3772,-122.029,2420,6200,6,5,2014,N,0,-427
3630000130,10/28/2014,430000.0,3,2.25,1470,1703,2.0,0.0,0.0,3,8,1470,0,2005,0,98029,47.5478,-121.999,1380,1107,10,28,2014,N,90,596
2105200010,9/4/2014,515000.0,4,2.5,2030,39049,1.0,0.0,0.0,4,7,1530,500,1953,0,98166,47.4413,-122.345,2400,14605,9,4,2014,UNK,-370,24444
2856100381,7/11/2014,580000.0,7,2.75,2310,2400,1.5,0.0,0.0,3,6,2310,0,1915,0,98117,47.6775,-122.39,1340,3825,7,11,2014,UNK,970,-1425
5608030020,2/3/2015,600000.0,5,3.5,3370,16846,2.0,0.0,1.0,3,9,2650,720,1998,0,98027,47.5584,-122.089,3330,13000,2,3,2015,UNK,40,3846
3404700080,11/12/2014,476800.0,3,1.75,1900,43700,1.5,0.0,0.0,4,6,1900,0,1919,0,98052,47.7265,-122.13600000000001,2070,43995,11,12,2014,UNK,-170,-295
1890000275,4/29/2015,815000.0,3,1.5,1940,3570,2.0,0.0,0.0,4,8,1740,200,1916,0,98105,47.6618,-122.325,1580,3570,4,29,2015,UNK,360,0
7852000010,5/27/2014,455600.0,3,2.5,2420,8252,2.0,0.0,0.0,3,7,2420,0,1998,0,98065,47.5382,-121.87100000000001,2420,5818,5,27,2014,UNK,0,2434
5230300280,5/15/2014,270000.0,3,1.0,1010,9514,1.0,0.0,0.0,3,7,1010,0,1969,0,98059,47.4936,-122.105,1010,9514,5,15,2014,UNK,0,0
4232902335,8/14/2014,1200000.0,5,4.0,2710,2800,3.0,0.0,0.0,3,10,2380,330,1974,2008,98119,47.6346,-122.36399999999999,1530,3600,8,14,2014,Y,1180,-800
4232900250,7/10/2014,525000.0,2,1.5,1340,3600,1.5,0.0,0.0,3,7,1340,0,1903,0,98119,47.6358,-122.36399999999999,1340,3600,7,10,2014,UNK,0,0
1312930250,5/28/2014,242000.0,3,1.75,1310,9645,1.0,0.0,0.0,3,7,1310,0,1979,0,98198,47.4051,-122.29,1440,9893,5,28,2014,UNK,-130,-248
6446200305,6/23/2014,715000.0,4,2.5,2650,30500,1.0,0.0,0.0,4,8,1680,970,1960,0,98029,47.5535,-122.02799999999999,2650,30500,6,23,2014,UNK,0,0
7852020670,4/2/2015,475000.0,3,2.75,1890,3938,2.0,0.0,0.0,3,8,1890,0,1999,0,98065,47.5336,-121.867,1890,4142,4,2,2015,UNK,0,-204
4475000170,11/11/2014,370000.0,4,3.0,2580,5511,2.0,0.0,0.0,3,8,2580,0,1999,0,98058,47.4286,-122.185,2010,5600,11,11,2014,UNK,570,-89
7202360170,5/23/2014,788600.0,4,2.75,3500,7200,2.0,0.0,0.0,3,9,3500,0,2005,0,98053,47.6818,-122.025,3920,7666,5,23,2014,N,-420,-466
6146600185,5/7/2014,160000.0,2,1.0,1040,13100,1.0,0.0,0.0,5,6,1040,0,1912,0,98032,47.3877,-122.234,910,5080,5,7,2014,UNK,130,8020
2825079001,8/14/2014,800000.0,5,1.75,1930,501376,2.0,0.0,0.0,3,7,1930,0,1930,0,98014,47.6294,-121.911,1710,87120,8,14,2014,UNK,220,414256
3905040780,9/24/2014,520000.0,4,3.0,2190,5085,2.0,0.0,0.0,4,8,2190,0,1992,0,98029,47.5693,-122.00200000000001,2130,5142,9,24,2014,UNK,60,-57
2488200168,7/18/2014,725000.0,3,1.75,1530,4000,2.0,0.0,0.0,3,8,1530,0,1985,0,98136,47.5239,-122.38799999999999,2140,5000,7,18,2014,UNK,-610,-1000
3336000170,10/3/2014,335000.0,4,1.0,1480,6500,1.5,0.0,0.0,4,7,1480,0,1914,0,98118,47.5282,-122.26700000000001,2380,6000,10,3,2014,UNK,-900,500
8835700010,1/16/2015,919000.0,4,2.5,3620,17133,1.0,0.0,4.0,3,10,2220,1400,1993,0,98075,47.5604,-122.027,3530,17026,1,16,2015,UNK,90,107
303800020,5/13/2015,425000.0,3,2.75,3370,13929,2.0,0.0,0.0,3,9,2650,720,1986,0,98092,47.3411,-122.197,2150,14048,5,13,2015,UNK,1220,-119
3971700670,3/14/2015,420000.0,5,2.5,2100,14395,1.0,0.0,0.0,3,7,1140,960,1983,0,98155,47.7723,-122.31700000000001,1830,8700,3,14,2015,UNK,270,5695
2481610050,11/24/2014,905000.0,4,3.0,3370,47959,2.0,0.0,0.0,4,10,3370,0,1981,0,98072,47.733000000000004,-122.12899999999999,3370,38896,11,24,2014,UNK,0,9063
4154304505,9/19/2014,435000.0,2,1.0,2240,7200,1.0,0.0,0.0,4,7,1120,1120,1940,0,98118,47.5631,-122.271,1390,6000,9,19,2014,UNK,850,1200
7202330170,7/17/2014,438000.0,3,2.5,1650,3031,2.0,0.0,0.0,3,7,1650,0,2003,0,98053,47.681999999999995,-122.03399999999999,1560,3070,7,17,2014,UNK,90,-39
9430100020,6/17/2014,725000.0,4,2.75,2630,7505,2.0,0.0,0.0,3,8,2630,0,1994,0,98052,47.6846,-122.163,2670,7506,6,17,2014,UNK,-40,-1
2436700280,5/28/2014,840000.0,4,1.75,2330,4000,2.0,0.0,0.0,5,8,1300,1030,1924,0,98105,47.666000000000004,-122.289,2040,4000,5,28,2014,UNK,290,0
7525211410,7/15/2014,425500.0,3,2.5,1970,2752,2.0,0.0,0.0,3,8,1970,0,1978,0,98052,47.6345,-122.10799999999999,1850,2778,7,15,2014,UNK,120,-26
3760500514,9/12/2014,853505.0,3,2.5,2820,14890,1.0,0.0,4.0,3,9,1770,1050,1985,0,98034,47.7019,-122.228,3740,14890,9,12,2014,UNK,-920,0
4067600255,5/22/2014,398000.0,2,1.0,590,10945,1.5,0.0,0.0,3,5,590,0,1983,0,98010,47.3364,-122.03299999999999,2020,15180,5,22,2014,UNK,-1430,-4235
7853302130,6/4/2014,418500.0,3,2.5,2060,4399,2.0,0.0,0.0,3,7,2060,0,2007,0,98065,47.5415,-121.884,2060,4399,6,4,2014,N,0,0
811000050,12/31/2014,826000.0,3,1.5,1890,5000,1.5,0.0,0.0,3,9,1890,0,1929,0,98109,47.6312,-122.353,2560,5000,12,31,2014,UNK,-670,0
8691330130,6/11/2014,742000.0,4,2.5,2810,10986,2.0,0.0,0.0,3,10,2810,0,1997,0,98075,47.5943,-121.98100000000001,3540,10986,6,11,2014,UNK,-730,0
6623400050,9/9/2014,180000.0,4,1.0,1470,18581,1.5,0.0,0.0,3,6,1470,0,1924,0,98055,47.4336,-122.197,1770,18581,9,9,2014,UNK,-300,0
9542801410,1/14/2015,286000.0,4,1.75,2190,8400,2.0,0.0,0.0,2,8,2190,0,1978,0,98023,47.3003,-122.37299999999999,2410,7700,1,14,2015,UNK,-220,700
7202330190,10/1/2014,421200.0,3,2.5,1440,3060,2.0,0.0,0.0,3,7,1440,0,2003,0,98053,47.6821,-122.035,1650,3060,10,1,2014,UNK,-210,0
3303950660,7/31/2014,390000.0,3,3.0,2480,14141,1.0,0.0,0.0,3,8,1500,980,1994,0,98038,47.3778,-122.03299999999999,2480,10667,7,31,2014,UNK,0,3474
4140930010,9/19/2014,739000.0,4,2.5,2780,6737,2.0,0.0,0.0,3,9,2780,0,2002,0,98006,47.5656,-122.12200000000001,2750,7950,9,19,2014,UNK,30,-1213
2724069169,7/24/2014,499900.0,4,3.0,2180,12196,2.0,0.0,0.0,4,7,2180,0,1968,0,98027,47.5338,-122.03299999999999,1500,6534,7,24,2014,UNK,680,5662
7979900430,12/3/2014,670000.0,3,2.25,3340,13805,1.0,0.0,0.0,3,8,3340,0,1950,0,98155,47.744,-122.292,2060,12304,12,3,2014,UNK,1280,1501
1338300010,10/13/2014,842500.0,3,2.25,2560,3996,1.5,0.0,0.0,3,8,2150,410,1910,0,98112,47.6321,-122.306,2970,4320,10,13,2014,UNK,-410,-324
5238800020,12/8/2014,492500.0,2,2.25,1600,80400,2.0,0.0,0.0,4,7,1600,0,1978,0,98070,47.4422,-122.505,1600,198414,12,8,2014,UNK,0,-118014
4154305575,9/3/2014,836500.0,3,2.5,2230,7200,3.0,0.0,3.0,3,9,2230,0,1996,0,98118,47.558,-122.265,2230,7200,9,3,2014,UNK,0,0
6821102385,3/26/2015,334000.0,2,1.0,900,1818,2.0,0.0,0.0,4,7,900,0,1945,0,98199,47.6485,-122.397,1570,1830,3,26,2015,UNK,-670,-12
6600410480,8/28/2014,179900.0,3,1.0,1010,9920,1.0,0.0,0.0,3,6,1010,0,1977,0,98042,47.3238,-122.14,1270,9680,8,28,2014,UNK,-260,240
4146800050,11/26/2014,563000.0,3,2.0,1580,5289,1.0,0.0,0.0,3,7,870,710,1940,0,98103,47.6881,-122.34200000000001,1310,5535,11,26,2014,UNK,270,-246
3793500050,3/3/2015,310000.0,3,2.5,1890,6300,2.0,0.0,0.0,3,7,1890,0,2003,0,98038,47.3673,-122.031,2100,6525,3,3,2015,UNK,-210,-225
641900050,8/19/2014,335000.0,4,2.25,2160,8817,1.0,0.0,0.0,3,7,1460,700,1965,0,98133,47.7595,-122.35600000000001,1880,8817,8,19,2014,UNK,280,0
641900050,2/6/2015,499950.0,4,2.25,2160,8817,1.0,0.0,0.0,3,7,1460,700,1965,0,98133,47.7595,-122.35600000000001,1880,8817,2,6,2015,UNK,280,0
2402100715,7/26/2014,658500.0,2,1.0,1410,5101,1.5,0.0,0.0,3,8,1410,0,1927,0,98103,47.6872,-122.333,1410,4224,7,26,2014,UNK,0,877
1453602313,10/29/2014,297000.0,2,1.5,1430,1650,3.0,0.0,0.0,3,7,1430,0,1999,0,98125,47.7222,-122.29,1430,1650,10,29,2014,UNK,0,0
1890000225,6/20/2014,725000.0,6,1.75,2380,4080,2.0,0.0,0.0,3,8,2380,0,1917,0,98105,47.6629,-122.325,2030,4080,6,20,2014,UNK,350,0
7525900050,12/5/2014,780000.0,3,2.25,2206,82031,1.0,0.0,2.0,3,6,866,1340,1983,0,98074,47.6302,-122.069,2590,53024,12,5,2014,UNK,-384,29007
6413600290,5/9/2014,252500.0,3,1.0,1030,6127,1.0,0.0,0.0,3,7,880,150,1947,0,98125,47.7192,-122.32,1610,6127,5,9,2014,UNK,-580,0
952006728,6/13/2014,330000.0,3,2.5,1070,1155,2.0,0.0,0.0,3,7,720,350,2005,0,98102,47.5617,-122.385,1120,2594,6,13,2014,N,-50,-1439
1088801350,2/10/2015,525000.0,3,2.5,2320,9610,1.0,0.0,0.0,3,9,1730,590,1990,0,98011,47.7394,-122.204,2450,9608,2,10,2015,UNK,-130,2
3575302759,8/6/2014,365000.0,2,1.75,1270,7500,1.0,0.0,0.0,4,7,1270,0,1982,0,98074,47.6186,-122.06299999999999,1280,7500,8,6,2014,UNK,-10,0
3508100161,3/27/2015,500000.0,4,3.0,2570,9104,2.0,0.0,2.0,3,7,2570,0,1930,0,98116,47.5821,-122.40100000000001,1630,4950,3,27,2015,UNK,940,4154
8651410190,11/12/2014,179950.0,3,1.0,920,4875,1.0,0.0,0.0,5,6,920,0,1969,0,98042,47.3648,-122.081,960,5200,11,12,2014,UNK,-40,-325
1823099028,7/22/2014,440000.0,3,2.0,1790,32379,1.0,0.0,0.0,3,7,1790,0,2007,0,98045,47.4826,-121.698,2290,43560,7,22,2014,N,-500,-11181
745000005,8/25/2014,145000.0,1,0.75,480,9750,1.0,0.0,0.0,2,4,480,0,1948,0,98146,47.4982,-122.36200000000001,1550,9924,8,25,2014,UNK,-1070,-174
9414700020,4/22/2015,331000.0,4,3.0,2483,5701,2.0,0.0,0.0,3,8,2483,0,2005,0,98030,47.3623,-122.199,2075,5720,4,22,2015,N,408,-19
2331300415,6/20/2014,780000.0,3,2.25,2140,3000,2.0,0.0,0.0,3,9,2140,0,1905,0,98103,47.6767,-122.351,1430,4712,6,20,2014,UNK,710,-1712
6815100380,5/14/2015,855000.0,3,1.75,1900,4000,1.0,0.0,0.0,3,7,1300,600,1965,0,98103,47.6854,-122.331,1880,4000,5,14,2015,UNK,20,0
7575610250,10/14/2014,225000.0,3,2.25,1650,7739,1.0,0.0,0.0,3,8,1290,360,1986,0,98003,47.3532,-122.304,1650,6033,10,14,2014,UNK,0,1706
5153900080,7/14/2014,199000.0,3,1.0,1510,9100,1.0,0.0,0.0,3,7,1510,0,1966,0,98003,47.3331,-122.319,1180,7220,7,14,2014,UNK,330,1880
7525410190,5/2/2014,550000.0,3,1.75,2910,35200,1.5,0.0,0.0,3,8,2910,0,1979,0,98075,47.5747,-122.035,2590,37500,5,2,2014,UNK,320,-2300
6819100020,5/29/2014,1430000.0,4,4.25,4960,6000,2.5,0.0,0.0,3,11,3680,1280,1909,2003,98109,47.6437,-122.35600000000001,2160,4080,5,29,2014,Y,2800,1920
1868902745,5/2/2014,805000.0,3,2.0,2710,4500,1.5,0.0,0.0,4,8,1880,830,1929,0,98115,47.6747,-122.295,2060,4500,5,2,2014,UNK,650,0
3783100080,6/4/2014,261000.0,3,1.5,1810,29308,1.0,0.0,0.0,3,7,950,860,1983,0,98042,47.3585,-122.06700000000001,1790,37531,6,4,2014,UNK,20,-8223
3327750020,9/9/2014,347000.0,3,1.0,940,9198,1.0,0.0,0.0,3,7,940,0,1968,0,98052,47.6889,-122.117,1430,8370,9,9,2014,UNK,-490,828
1112700010,6/19/2014,390000.0,3,2.25,1600,10240,1.0,0.0,0.0,3,7,1090,510,1979,0,98034,47.7281,-122.23200000000001,1520,9394,6,19,2014,UNK,80,846
9269260420,11/10/2014,436000.0,4,2.5,2640,3899,2.0,0.0,0.0,3,7,2640,0,2000,0,98011,47.754,-122.21700000000001,2460,4057,11,10,2014,UNK,180,-158
9286730020,3/31/2015,1800000.0,5,3.25,3890,20005,1.0,0.0,0.0,3,10,2260,1630,1977,0,98004,47.6312,-122.22399999999999,3450,20176,3,31,2015,UNK,440,-171
8673400190,7/23/2014,557000.0,3,2.5,1630,1587,3.0,0.0,0.0,3,8,1630,0,2004,0,98107,47.6693,-122.39299999999999,1500,1527,7,23,2014,N,130,60
1951600250,4/6/2015,135000.0,3,1.0,830,9600,1.0,0.0,0.0,3,7,830,0,1959,0,98032,47.3698,-122.29700000000001,1240,9198,4,6,2015,UNK,-410,402
3296900280,3/25/2015,425000.0,3,2.5,1800,14036,2.0,0.0,0.0,3,8,1800,0,1993,0,98019,47.7334,-121.97,2450,14025,3,25,2015,UNK,-650,11
5459000305,4/8/2015,648752.0,3,2.25,2060,9953,1.0,0.0,0.0,5,8,1070,990,1964,0,98040,47.5767,-122.23299999999999,2340,9600,4,8,2015,UNK,-280,353
4122900020,6/26/2014,1390000.0,4,3.0,4040,20001,1.0,0.0,0.0,3,9,2020,2020,1972,2001,98004,47.6408,-122.212,2990,20098,6,26,2014,Y,1050,-97
5212000020,3/24/2015,630100.0,4,2.75,1910,11356,1.0,0.0,0.0,5,7,1160,750,1977,0,98033,47.6999,-122.2,1770,11357,3,24,2015,UNK,140,-1
1825079005,6/9/2014,739000.0,4,2.5,2800,246114,2.0,0.0,0.0,3,9,2800,0,1999,0,98014,47.6586,-121.962,2750,60351,6,9,2014,UNK,50,185763
6450303235,8/18/2014,269000.0,3,1.5,1320,2625,2.0,0.0,0.0,3,7,1320,0,1986,0,98133,47.7316,-122.338,1230,5250,8,18,2014,UNK,90,-2625
7227501190,4/27/2015,250000.0,3,1.0,1220,5038,1.0,0.0,0.0,5,6,1220,0,1942,0,98056,47.496,-122.189,1140,5038,4,27,2015,UNK,80,0
7853300020,3/20/2015,475000.0,5,2.75,3100,5298,2.0,0.0,0.0,3,7,3100,0,2007,0,98065,47.5369,-121.887,2440,5250,3,20,2015,N,660,48
2922703235,11/19/2014,290000.0,1,1.0,550,5700,1.0,0.0,0.0,2,6,550,0,1916,0,98117,47.6846,-122.366,1100,4560,11,19,2014,UNK,-550,1140
6138000095,11/18/2014,219000.0,3,1.0,1080,10639,1.5,0.0,0.0,3,7,1080,0,1953,0,98002,47.3171,-122.219,1470,10600,11,18,2014,UNK,-390,39
2356800020,9/29/2014,416000.0,2,1.0,880,6650,1.0,0.0,0.0,5,6,880,0,1918,0,98117,47.6914,-122.37200000000001,1250,6650,9,29,2014,UNK,-370,0
5379805495,4/13/2015,179000.0,2,1.0,720,8914,1.0,0.0,0.0,3,6,720,0,1949,0,98188,47.4488,-122.274,1100,8916,4,13,2015,UNK,-380,-2
3861440010,7/15/2014,302000.0,4,2.75,2030,9120,1.0,0.0,0.0,4,7,2030,0,1988,0,98003,47.282,-122.303,1790,7627,7,15,2014,UNK,240,1493
2505500009,4/27/2015,565000.0,4,2.0,2040,8281,2.0,0.0,1.0,3,7,2040,0,1961,0,98033,47.6689,-122.195,2560,8281,4,27,2015,UNK,-520,0
3388000080,4/22/2015,281700.0,3,1.0,1570,8316,1.0,0.0,0.0,3,7,1070,500,1962,0,98031,47.3943,-122.198,2030,8295,4,22,2015,UNK,-460,21
480000170,6/27/2014,480000.0,2,1.0,1500,3420,1.0,0.0,0.0,3,7,1500,0,1902,0,98103,47.661,-122.338,2050,3420,6,27,2014,UNK,-550,0
2597650660,10/13/2014,775000.0,4,2.5,3180,15358,2.0,0.0,0.0,3,9,3180,0,1988,0,98027,47.5172,-122.053,3020,15522,10,13,2014,UNK,160,-164
7304300470,9/4/2014,375000.0,3,1.75,1260,11224,1.0,0.0,0.0,5,7,1260,0,1947,0,98155,47.7444,-122.321,1570,11052,9,4,2014,UNK,-310,172
7334600170,10/13/2014,345000.0,3,1.5,1390,13860,2.0,0.0,0.0,3,7,1390,0,1979,0,98045,47.4704,-121.74700000000001,1390,11860,10,13,2014,UNK,0,2000
7222000244,2/23/2015,300000.0,3,3.0,2850,9375,1.0,0.0,0.0,3,8,2240,610,1977,0,98055,47.4655,-122.209,1800,9375,2,23,2015,UNK,1050,0
9558020840,4/22/2015,364950.0,4,2.5,2070,2992,2.0,0.0,0.0,3,8,2070,0,2002,0,98058,47.4496,-122.12,1900,2957,4,22,2015,UNK,170,35
5592900020,12/2/2014,410000.0,3,3.25,2650,7819,1.0,0.0,2.0,4,8,1760,890,1956,0,98056,47.4821,-122.19200000000001,2400,7727,12,2,2014,UNK,250,92
8732190380,4/14/2015,231000.0,3,1.75,1220,8817,1.0,0.0,0.0,3,7,1220,0,1978,0,98023,47.3111,-122.396,2000,8028,4,14,2015,UNK,-780,789
2249800080,5/23/2014,445000.0,3,2.0,1630,8702,1.0,0.0,0.0,3,9,1630,0,1987,0,98056,47.5168,-122.193,2250,9890,5,23,2014,UNK,-620,-1188
2062600020,7/8/2014,530000.0,2,2.5,1785,779,2.0,0.0,0.0,3,7,1595,190,1975,0,98004,47.5959,-122.198,1780,794,7,8,2014,UNK,5,-15
7660100309,12/26/2014,353500.0,3,2.5,1260,972,2.0,0.0,0.0,3,8,840,420,2008,0,98144,47.5872,-122.316,1270,925,12,26,2014,N,-10,47
6093900280,5/7/2014,209950.0,3,1.5,1380,11130,1.0,0.0,0.0,3,7,1380,0,1960,0,98003,47.3146,-122.323,1380,9200,5,7,2014,UNK,0,1930
4154303125,4/23/2015,650000.0,3,1.75,2330,7200,1.0,0.0,0.0,4,8,1320,1010,1950,0,98118,47.565,-122.274,1820,7200,4,23,2015,UNK,510,0
2695600005,6/20/2014,325000.0,2,1.0,840,4239,1.0,0.0,0.0,3,7,840,0,1948,0,98126,47.5319,-122.382,1120,4494,6,20,2014,UNK,-280,-255
3826500020,8/28/2014,257000.0,3,2.25,1730,9516,1.0,0.0,0.0,3,8,1180,550,1978,0,98030,47.3823,-122.166,1870,8165,8,28,2014,UNK,-140,1351
9238440130,6/30/2014,337000.0,4,2.5,2230,5970,2.0,0.0,0.0,4,7,2230,0,2002,0,98042,47.3745,-122.131,1970,4919,6,30,2014,UNK,260,1051
3630030010,9/26/2014,541000.0,3,2.5,1790,4038,2.0,0.0,0.0,3,8,1790,0,2005,0,98029,47.5499,-121.99799999999999,1700,3365,9,26,2014,N,90,673
1592000130,11/14/2014,577500.0,3,2.5,2280,10879,2.0,0.0,0.0,3,9,2280,0,1984,0,98074,47.6217,-122.03399999999999,2400,9536,11,14,2014,UNK,-120,1343
2487200279,11/24/2014,560000.0,3,2.5,2430,5128,1.0,0.0,1.0,3,8,1270,1160,1978,0,98136,47.5198,-122.389,2510,5330,11,24,2014,UNK,-80,-202
1959703070,10/29/2014,979700.0,5,3.0,3730,5500,1.5,0.0,0.0,3,7,2160,1570,1927,0,98102,47.6507,-122.32,1890,5500,10,29,2014,UNK,1840,0
4038700680,7/25/2014,750000.0,5,3.0,2230,8560,1.0,0.0,0.0,3,8,1150,1080,1960,2014,98008,47.6154,-122.115,2040,8560,7,25,2014,Y,190,0
9390700095,8/8/2014,407500.0,2,1.0,770,2971,1.0,0.0,2.0,3,7,770,0,1923,0,98102,47.6358,-122.322,1440,4000,8,8,2014,UNK,-670,-1029
6392003810,5/23/2014,530000.0,4,1.75,1814,5000,1.0,0.0,0.0,4,7,944,870,1951,0,98115,47.684,-122.281,1290,5000,5,23,2014,UNK,524,0
7806210250,4/6/2015,235000.0,4,1.75,1920,9350,1.0,0.0,0.0,4,7,1000,920,1977,0,98002,47.292,-122.195,1910,8400,4,6,2015,UNK,10,950
2919200440,4/7/2015,715000.0,4,2.5,1860,3840,1.5,0.0,0.0,3,7,1170,690,1928,2014,98117,47.6886,-122.359,1400,3840,4,7,2015,Y,460,0
6751500185,4/21/2015,795000.0,5,3.0,2750,10000,1.0,0.0,0.0,4,7,1730,1020,1957,0,98008,47.5878,-122.13,2520,10000,4,21,2015,UNK,230,0
5137300130,5/9/2014,465000.0,4,2.5,1930,9653,1.0,0.0,0.0,4,9,1930,0,1968,0,98023,47.3367,-122.335,2100,10454,5,9,2014,UNK,-170,-801
2744000010,5/13/2014,287600.0,3,2.5,1950,8251,2.0,0.0,0.0,3,7,1950,0,1990,0,98001,47.343,-122.28,1540,8588,5,13,2014,UNK,410,-337
4279600010,12/30/2014,630000.0,6,3.0,2470,9328,2.0,0.0,0.0,3,8,2470,0,1982,0,98007,47.6025,-122.15299999999999,2470,9454,12,30,2014,UNK,0,-126
2540830020,4/1/2015,445000.0,3,2.25,1630,6449,1.0,0.0,0.0,3,7,1310,320,1986,0,98011,47.7275,-122.23200000000001,1620,7429,4,1,2015,UNK,10,-980
7214800190,1/5/2015,490000.0,4,2.25,2110,16200,1.0,0.0,0.0,3,8,1630,480,1978,0,98072,47.751999999999995,-122.14399999999999,2370,16000,1,5,2015,UNK,-260,200
9169100185,2/25/2015,565000.0,3,1.75,1490,5000,1.0,0.0,1.0,3,8,1250,240,1954,0,98136,47.5257,-122.39200000000001,1980,5000,2,25,2015,UNK,-490,0
859000022,8/19/2014,330000.0,3,2.5,1740,1844,2.0,0.0,0.0,3,8,1320,420,2008,0,98106,47.5248,-122.365,1740,1789,8,19,2014,N,0,55
1180005050,12/18/2014,463000.0,4,2.75,1900,6000,1.0,0.0,2.0,3,7,1300,600,1961,0,98178,47.495,-122.229,2230,6000,12,18,2014,UNK,-330,0
3625700010,5/6/2014,1870000.0,5,4.0,4510,15175,2.0,0.0,0.0,3,10,4510,0,1969,2002,98040,47.5309,-122.228,3510,13500,5,6,2014,Y,1000,1675
7335400020,6/26/2014,219500.0,3,1.0,1090,6710,1.5,0.0,0.0,5,5,1090,0,1912,0,98002,47.3066,-122.21700000000001,1170,6708,6,26,2014,UNK,-80,2
8902000050,10/27/2014,622200.0,3,1.75,1720,7200,1.0,0.0,0.0,3,7,1420,300,1959,0,98125,47.7062,-122.304,1380,8000,10,27,2014,UNK,340,-800
1972200698,5/28/2014,474800.0,2,3.25,1400,1243,3.0,0.0,0.0,3,8,1400,0,2000,0,98103,47.6534,-122.353,1400,1335,5,28,2014,UNK,0,-92
415100010,6/11/2014,465000.0,4,2.5,2090,9702,1.0,0.0,0.0,5,7,1320,770,1965,0,98133,47.7467,-122.339,1850,7200,6,11,2014,UNK,240,2502
5500200010,10/14/2014,389950.0,3,1.75,1580,9049,1.0,0.0,0.0,3,8,1580,0,1966,0,98177,47.7776,-122.375,2100,8446,10,14,2014,UNK,-520,603
1842390130,10/24/2014,650000.0,4,2.5,2620,19864,2.0,0.0,0.0,4,8,2620,0,1984,0,98052,47.7014,-122.12200000000001,2500,13285,10,24,2014,UNK,120,6579
6362900007,9/5/2014,395000.0,3,2.0,1500,2506,1.0,0.0,0.0,3,7,870,630,2003,0,98144,47.5962,-122.301,1500,4662,9,5,2014,UNK,0,-2156
5466380050,12/19/2014,304500.0,4,2.5,2030,5202,2.0,0.0,0.0,3,8,2030,0,2001,0,98031,47.38800000000001,-122.176,2260,5232,12,19,2014,UNK,-230,-30
7417700185,3/14/2015,307000.0,3,1.0,1020,8484,1.0,0.0,0.0,3,6,1020,0,1949,0,98155,47.7719,-122.31,1180,9660,3,14,2015,UNK,-160,-1176
4127000050,1/7/2015,485000.0,3,2.5,1540,7120,1.0,0.0,0.0,3,7,770,770,1938,2013,98038,47.3729,-122.037,1000,6638,1,7,2015,Y,540,482
8084900170,10/23/2014,1560000.0,5,3.0,3910,16200,1.0,0.0,0.0,4,9,2890,1020,1960,0,98004,47.6326,-122.21700000000001,3620,16200,10,23,2014,UNK,290,0
2205700470,1/22/2015,650500.0,5,4.25,3920,11412,2.0,0.0,0.0,3,7,3920,0,1955,2005,98006,47.5766,-122.15100000000001,1400,9750,1,22,2015,Y,2520,1662
3629200020,2/2/2015,960000.0,4,2.5,3180,10105,2.0,0.0,0.0,4,9,3180,0,1986,0,98040,47.5328,-122.226,2670,10355,2,2,2015,UNK,510,-250
6070800050,2/13/2015,710000.0,3,2.5,2330,9160,2.0,0.0,0.0,3,9,2330,0,1997,0,98006,47.5467,-122.181,2460,9160,2,13,2015,UNK,-130,0
6329000185,3/29/2015,540000.0,3,2.5,2600,23361,1.5,1.0,4.0,3,8,2150,450,1912,0,98146,47.4997,-122.37899999999999,1700,14700,3,29,2015,UNK,900,8661
8815400020,7/24/2014,601000.0,4,1.75,1950,4200,1.0,0.0,0.0,5,7,1040,910,1951,0,98115,47.6755,-122.285,1450,5000,7,24,2014,UNK,500,-800
1742800430,5/4/2015,463828.0,5,1.75,3250,13702,1.0,0.0,2.0,3,8,1650,1600,1965,0,98055,47.4883,-122.225,2620,11328,5,4,2015,UNK,630,2374
5006000170,2/11/2015,293000.0,4,1.0,1130,8308,1.5,0.0,0.0,4,6,1130,0,1944,0,98166,47.4669,-122.355,1130,8652,2,11,2015,UNK,0,-344
7202310010,10/20/2014,597500.0,3,2.5,2620,4800,2.0,0.0,0.0,3,7,2620,0,2002,0,98053,47.6849,-122.037,2400,4756,10,20,2014,UNK,220,44
323089005,3/26/2015,240000.0,2,1.0,1120,45302,1.0,0.0,2.0,4,5,1120,0,1932,0,98045,47.5105,-121.77,2150,101930,3,26,2015,UNK,-1030,-56628
1525079056,5/2/2014,284000.0,3,1.75,1800,23103,1.0,0.0,0.0,3,7,1800,0,1968,0,98014,47.6517,-121.906,1410,18163,5,2,2014,UNK,390,4940
4140900050,1/26/2015,440000.0,4,1.75,2180,10200,1.0,0.0,2.0,3,8,2000,180,1966,0,98028,47.7638,-122.27,2590,10445,1,26,2015,UNK,-410,-245
7387500235,5/15/2014,340000.0,3,1.75,1960,8136,1.0,0.0,0.0,3,7,980,980,1948,0,98106,47.5208,-122.36399999999999,1070,7480,5,15,2014,UNK,890,656
7387500235,3/17/2015,363000.0,3,1.75,1960,8136,1.0,0.0,0.0,3,7,980,980,1948,0,98106,47.5208,-122.36399999999999,1070,7480,3,17,2015,UNK,890,656
3726800010,7/14/2014,270000.0,2,1.0,1150,3600,1.0,0.0,0.0,3,6,1150,0,1910,0,98144,47.5729,-122.31,1160,4000,7,14,2014,UNK,-10,-400
2621760290,8/27/2014,365000.0,4,2.5,2800,6820,2.0,0.0,0.0,4,7,2800,0,1997,0,98042,47.3695,-122.10799999999999,2060,6820,8,27,2014,UNK,740,0
6046401300,6/9/2014,428000.0,3,2.0,1310,2550,1.0,0.0,0.0,3,7,780,530,1986,0,98103,47.6911,-122.35,1460,5100,6,9,2014,UNK,-150,-2550
3326069026,4/1/2015,600000.0,3,1.75,2340,57499,1.0,0.0,0.0,3,8,2340,0,1988,0,98053,47.6989,-122.044,3260,137649,4,1,2015,UNK,-920,-80150
6608500290,10/24/2014,405000.0,3,2.5,1430,10200,1.0,0.0,0.0,3,7,1430,0,1960,0,98033,47.7012,-122.166,1470,10350,10,24,2014,UNK,-40,-150
1862700290,7/11/2014,339900.0,4,2.5,2340,9748,1.0,0.0,1.0,3,8,1610,730,1981,0,98003,47.3363,-122.331,2070,8241,7,11,2014,UNK,270,1507
4331000190,12/23/2014,275000.0,3,1.0,1290,11250,1.0,0.0,0.0,3,7,1290,0,1956,0,98166,47.4743,-122.34100000000001,1410,11196,12,23,2014,UNK,-120,54
5101400994,7/17/2014,361600.0,2,1.0,760,6380,1.0,0.0,0.0,3,6,760,0,1941,0,98115,47.6914,-122.31,1590,6380,7,17,2014,UNK,-830,0
1615900020,3/20/2015,325000.0,6,2.0,2780,13950,2.5,0.0,0.0,4,7,2780,0,1955,1964,98030,47.3738,-122.226,2120,13950,3,20,2015,Y,660,0
2804600005,12/19/2014,1050000.0,3,2.0,2090,4077,1.5,0.0,0.0,4,8,1530,560,1931,0,98112,47.6433,-122.3,2010,4132,12,19,2014,UNK,80,-55
7431500280,11/10/2014,959750.0,4,3.0,3060,50002,1.0,0.0,2.0,4,8,2460,600,1957,0,98008,47.6205,-122.096,2740,16181,11,10,2014,UNK,320,33821
6303401365,6/3/2014,210000.0,3,1.0,1110,7962,1.0,0.0,0.0,3,7,1110,0,1962,0,98146,47.5035,-122.36,1200,8094,6,3,2014,UNK,-90,-132
2817850290,12/1/2014,258000.0,3,2.0,1790,7879,1.5,0.0,0.0,3,7,1790,0,1998,0,98001,47.2634,-122.289,1790,7879,12,1,2014,UNK,0,0
3205100080,7/8/2014,468000.0,3,1.5,1830,9848,1.0,0.0,0.0,5,7,1830,0,1962,0,98056,47.538999999999994,-122.18,1830,8168,7,8,2014,UNK,0,1680
2464400280,5/4/2015,710000.0,4,3.5,2850,2910,2.0,0.0,2.0,3,8,1970,880,1905,0,98115,47.6855,-122.321,1460,3880,5,4,2015,UNK,1390,-970
7889601300,4/21/2015,268000.0,3,1.0,1420,6000,1.0,0.0,0.0,3,6,1420,0,1941,0,98146,47.4913,-122.336,1480,6000,4,21,2015,UNK,-60,0
8151600101,1/16/2015,115000.0,2,1.0,790,7252,1.0,0.0,0.0,3,5,790,0,1930,0,98146,47.5048,-122.365,1260,11470,1,16,2015,UNK,-470,-4218
3764650010,5/13/2015,500000.0,3,2.5,2300,4307,2.0,0.0,0.0,3,8,2300,0,1998,0,98034,47.7326,-122.197,2010,4307,5,13,2015,UNK,290,0
3521069150,10/17/2014,431000.0,3,2.5,2440,71002,1.0,0.0,0.0,4,9,2440,0,1996,0,98022,47.2689,-122.01,3170,84000,10,17,2014,UNK,-730,-12998
4345000440,2/23/2015,241500.0,3,2.0,1310,7349,1.0,0.0,0.0,3,7,870,440,1995,0,98030,47.3639,-122.186,1690,6580,2,23,2015,UNK,-380,769
1822059073,4/14/2015,300000.0,3,1.0,1380,12000,1.0,0.0,0.0,3,7,1380,0,1963,0,98031,47.3997,-122.215,1890,22001,4,14,2015,UNK,-510,-10001
2600130190,11/7/2014,982000.0,4,2.5,2790,10289,2.0,0.0,0.0,3,9,2790,0,1987,0,98006,47.5483,-122.15799999999999,2650,10126,11,7,2014,UNK,140,163
7985100190,1/6/2015,248500.0,3,2.5,1360,7293,2.0,0.0,0.0,3,8,1360,0,1988,0,98003,47.3304,-122.302,1540,7353,1,6,2015,UNK,-180,-60
305010050,12/31/2014,665000.0,4,2.5,2510,5936,2.0,0.0,0.0,3,9,2510,0,1998,0,98075,47.5847,-122.03200000000001,2760,6060,12,31,2014,UNK,-250,-124
3761100257,7/14/2014,1220000.0,3,3.0,4560,16339,2.0,0.0,2.0,3,10,4040,520,2001,0,98034,47.7024,-122.243,2620,11561,7,14,2014,UNK,1940,4778
952003340,7/9/2014,380000.0,2,1.0,780,3910,1.0,0.0,0.0,3,6,780,0,1918,0,98126,47.566,-122.38,1500,5060,7,9,2014,UNK,-720,-1150
3347401315,6/16/2014,220000.0,3,2.0,1410,7998,1.0,0.0,0.0,4,7,1410,0,1940,0,98178,47.4968,-122.277,1780,8278,6,16,2014,UNK,-370,-280
513000585,7/7/2014,631500.0,4,2.0,2530,5650,1.5,0.0,0.0,4,8,1910,620,1910,0,98116,47.5778,-122.382,1310,5750,7,7,2014,UNK,1220,-100
1049010050,12/19/2014,386100.0,3,2.0,1270,6760,1.0,0.0,0.0,5,7,1270,0,1972,0,98034,47.7381,-122.179,1550,5734,12,19,2014,UNK,-280,1026
1370802455,8/13/2014,1050000.0,4,4.5,3180,4606,2.0,0.0,3.0,4,9,1990,1190,1929,0,98199,47.6402,-122.405,2110,5323,8,13,2014,UNK,1070,-717
4206901435,1/22/2015,650000.0,2,1.75,1450,4000,1.5,0.0,0.0,4,7,1350,100,1903,0,98105,47.6571,-122.32600000000001,1310,4000,1,22,2015,UNK,140,0
1467400095,2/24/2015,545000.0,4,1.75,2040,53578,1.0,0.0,0.0,5,7,1160,880,1959,0,98038,47.3844,-122.0,2040,53578,2,24,2015,UNK,0,0
2592210290,10/10/2014,870000.0,4,2.5,2650,12001,2.0,0.0,0.0,4,9,2650,0,1984,0,98006,47.5496,-122.14,2880,14054,10,10,2014,UNK,-230,-2053
3034200275,8/17/2014,380000.0,3,1.75,1240,8611,1.0,0.0,0.0,4,7,1240,0,1973,0,98133,47.7175,-122.331,1700,8037,8,17,2014,UNK,-460,574
7221400285,2/9/2015,265000.0,2,1.0,820,8423,1.0,0.0,2.0,3,6,820,0,1957,0,98055,47.4741,-122.2,1960,9140,2,9,2015,UNK,-1140,-717
7518502210,5/30/2014,645500.0,2,1.0,1890,5202,1.5,0.0,0.0,4,7,1890,0,1909,0,98117,47.6786,-122.37899999999999,1670,5100,5,30,2014,UNK,220,102
1646501845,9/13/2014,570000.0,3,2.0,1270,3090,2.0,0.0,0.0,5,7,1270,0,1911,0,98117,47.685,-122.359,1440,3090,9,13,2014,UNK,-170,0
8081020380,2/17/2015,1200000.0,4,2.5,3350,11688,1.0,0.0,2.0,3,10,1760,1590,1995,0,98006,47.5507,-122.133,4240,10804,2,17,2015,UNK,-890,884
2158900095,10/27/2014,605000.0,2,1.0,1550,3200,1.5,0.0,0.0,3,8,1550,0,1927,0,98112,47.6368,-122.306,1800,3937,10,27,2014,UNK,-250,-737
4031000460,6/10/2014,199500.0,3,1.0,920,9812,1.0,0.0,0.0,4,7,920,0,1962,0,98001,47.2958,-122.28399999999999,1188,9812,6,10,2014,UNK,-268,0
3881900605,3/15/2015,445000.0,2,1.0,950,4800,1.0,0.0,0.0,3,6,950,0,1941,0,98144,47.5864,-122.301,1420,5400,3,15,2015,UNK,-470,-600
5700002285,10/16/2014,495000.0,4,1.75,2040,3570,1.0,0.0,0.0,4,7,1020,1020,1917,0,98144,47.5754,-122.288,1790,4206,10,16,2014,UNK,250,-636
6392002635,6/12/2014,594000.0,4,1.75,1870,5200,2.0,0.0,0.0,4,7,1200,670,1937,0,98115,47.6843,-122.28299999999999,1790,5000,6,12,2014,UNK,80,200
6822100305,8/19/2014,465000.0,3,1.75,1720,5280,1.0,0.0,0.0,4,8,900,820,1943,0,98199,47.6493,-122.40100000000001,1600,6000,8,19,2014,UNK,120,-720
1871400585,4/22/2015,160000.0,2,1.0,1020,13647,1.0,0.0,0.0,5,6,1020,0,1915,1974,98022,47.2848,-121.927,980,8250,4,22,2015,Y,40,5397
7300410010,12/4/2014,340000.0,4,2.5,2690,6099,2.0,0.0,0.0,3,9,2690,0,1998,0,98092,47.3314,-122.171,2520,6168,12,4,2014,UNK,170,-69
925069134,9/10/2014,870000.0,4,2.0,3090,41147,1.0,0.0,0.0,3,7,3090,0,1990,0,98052,47.6748,-122.04899999999999,3300,34280,9,10,2014,UNK,-210,6867
2114700460,8/18/2014,249000.0,3,1.5,1070,5150,1.0,0.0,0.0,4,6,1070,0,1940,0,98106,47.5335,-122.34899999999999,1020,4800,8,18,2014,UNK,50,350
3326059238,5/6/2015,500000.0,4,2.25,2050,7201,2.0,0.0,0.0,3,8,2050,0,1994,0,98033,47.7003,-122.165,1970,7350,5,6,2015,UNK,80,-149
3750606890,6/26/2014,220000.0,3,1.5,1660,15600,2.0,0.0,0.0,3,7,1660,0,1981,0,98001,47.2589,-122.279,1660,14400,6,26,2014,UNK,0,1200
9117100130,8/12/2014,368500.0,5,1.75,2810,9360,1.0,0.0,0.0,4,7,1520,1290,1965,0,98055,47.4361,-122.193,1770,9360,8,12,2014,UNK,1040,0
5469502660,9/29/2014,439950.0,4,2.25,2460,14600,1.0,0.0,0.0,4,8,1720,740,1977,0,98042,47.3762,-122.16,2460,14600,9,29,2014,UNK,0,0
3356402232,9/24/2014,179900.0,3,1.75,1230,12000,1.0,0.0,0.0,3,6,1230,0,1970,0,98001,47.2878,-122.251,1550,12000,9,24,2014,UNK,-320,0
8030500010,5/28/2014,490000.0,4,2.5,2360,4367,2.0,0.0,0.0,3,8,2360,0,2003,0,98011,47.7731,-122.167,2360,4868,5,28,2014,UNK,0,-501
2425700022,9/29/2014,425000.0,4,1.75,1730,11890,1.0,0.0,0.0,2,7,980,750,1955,0,98004,47.5979,-122.194,2100,12325,9,29,2014,UNK,-370,-435
3956100050,8/29/2014,533300.0,4,2.5,2770,21806,2.0,0.0,0.0,3,9,2770,0,1991,0,98045,47.4815,-121.76799999999999,2500,21656,8,29,2014,UNK,270,150
5292200010,1/16/2015,447500.0,4,2.0,1770,3332,2.0,0.0,0.0,3,7,1630,140,1924,1975,98118,47.5563,-122.281,1640,4000,1,16,2015,Y,130,-668
4178310080,7/23/2014,768000.0,5,2.75,3030,13640,2.0,0.0,0.0,4,8,3030,0,1980,0,98007,47.6186,-122.146,2500,13225,7,23,2014,UNK,530,415
1180002745,5/21/2014,285000.0,3,1.75,2380,6000,1.5,0.0,0.0,3,7,1320,0,1935,0,98178,47.49800000000001,-122.22200000000001,1290,6000,5,21,2014,UNK,1090,0
4047200655,5/9/2014,336900.0,3,1.75,1780,120661,1.0,0.0,0.0,4,6,1780,0,1979,0,98019,47.7731,-121.897,1440,25000,5,9,2014,UNK,340,95661
9477000080,7/14/2014,415000.0,4,1.5,1540,7886,2.0,0.0,0.0,3,7,1540,0,1967,0,98034,47.733999999999995,-122.193,1550,7396,7,14,2014,UNK,-10,490
3905100840,7/23/2014,500000.0,3,2.25,1580,4379,2.0,0.0,0.0,4,8,1580,0,1994,0,98029,47.5694,-122.005,1770,4187,7,23,2014,UNK,-190,192
7885800290,11/3/2014,337000.0,4,2.5,3200,5772,2.0,0.0,0.0,3,8,3200,0,2003,0,98042,47.3486,-122.15299999999999,3010,5772,11,3,2014,UNK,190,0
9475710170,9/19/2014,419950.0,4,2.5,2220,6800,2.0,0.0,0.0,3,7,2220,0,2002,0,98059,47.49,-122.15,2220,5303,9,19,2014,UNK,0,1497
6885900415,1/7/2015,290000.0,4,2.75,2240,8162,2.0,0.0,0.0,5,7,1380,860,1946,0,98133,47.7427,-122.34,1550,8163,1,7,2015,UNK,690,-1
5285200020,7/18/2014,349950.0,2,1.75,1640,4176,1.0,0.0,0.0,4,7,1040,600,1948,0,98118,47.5162,-122.26,1460,5200,7,18,2014,UNK,180,-1024
4039400430,5/16/2014,330000.0,3,1.5,1170,4950,1.0,0.0,0.0,4,7,1170,0,1960,0,98007,47.6057,-122.135,1570,7700,5,16,2014,UNK,-400,-2750
2481610170,6/9/2014,965000.0,4,2.25,3160,34560,1.0,0.0,0.0,4,10,3160,0,1981,0,98072,47.7337,-122.132,3530,38045,6,9,2014,UNK,-370,-3485
1795910420,10/31/2014,515000.0,3,2.5,2100,7851,2.0,0.0,0.0,3,8,2100,0,1986,0,98052,47.7242,-122.105,2100,8187,10,31,2014,UNK,0,-336
7135521680,5/22/2014,665000.0,4,2.5,2600,17388,2.0,0.0,0.0,3,9,2600,0,1996,0,98059,47.5283,-122.146,2950,11553,5,22,2014,UNK,-350,5835
2011000020,8/26/2014,265000.0,3,1.75,1630,5999,1.5,0.0,0.0,4,7,1630,0,1985,0,98198,47.3816,-122.31299999999999,1540,7500,8,26,2014,UNK,90,-1501
1196002395,9/17/2014,545400.0,3,2.0,2850,19200,1.0,0.0,3.0,3,8,2340,510,2004,0,98023,47.3378,-122.348,2860,18240,9,17,2014,N,-10,960
3876590420,6/24/2014,350000.0,4,3.0,2560,5606,2.0,0.0,0.0,3,9,2560,0,2004,0,98092,47.3274,-122.178,2667,7334,6,24,2014,N,-107,-1728
4358700164,11/13/2014,260000.0,2,1.5,980,1296,2.0,0.0,0.0,3,7,840,140,2001,0,98133,47.7075,-122.336,1100,1228,11,13,2014,UNK,-120,68
7631800015,4/7/2015,2510000.0,3,3.25,5480,57990,2.0,1.0,4.0,3,11,5480,0,1991,0,98166,47.4558,-122.37100000000001,2500,22954,4,7,2015,UNK,2980,35036
3260810150,9/26/2014,355000.0,3,2.0,2160,8091,1.5,0.0,0.0,3,8,2160,0,2000,0,98003,47.3474,-122.303,2190,8297,9,26,2014,UNK,-30,-206
7015201015,10/28/2014,879000.0,3,3.0,3030,5156,1.5,0.0,0.0,4,9,2080,950,1929,0,98119,47.647,-122.369,1910,5720,10,28,2014,UNK,1120,-564
9348700450,8/18/2014,833000.0,4,3.5,3560,7178,2.0,0.0,3.0,3,10,2590,0,2006,0,98052,47.7054,-122.10700000000001,3290,6978,8,18,2014,N,270,200
3151600035,1/7/2015,261590.0,2,1.0,760,6407,1.0,0.0,0.0,3,6,760,0,1943,0,98178,47.4977,-122.259,1050,8580,1,7,2015,UNK,-290,-2173
2254502070,11/5/2014,512500.0,3,3.0,2260,2400,2.0,0.0,0.0,3,7,2260,0,1909,1972,98122,47.6094,-122.31,1320,2790,11,5,2014,Y,940,-390
8127700210,4/27/2015,600000.0,2,1.75,1560,3200,1.0,0.0,0.0,5,7,880,680,1946,0,98199,47.6419,-122.39399999999999,2060,4940,4,27,2015,UNK,-500,-1740
2926049237,10/6/2014,417500.0,5,3.0,2270,6664,1.0,0.0,0.0,3,7,1340,930,1995,0,98125,47.7191,-122.315,1870,6187,10,6,2014,UNK,400,477
7785000230,5/27/2014,970000.0,5,3.0,3480,15185,2.0,0.0,0.0,4,8,3480,0,1964,0,98040,47.5757,-122.21600000000001,3030,14257,5,27,2014,UNK,450,928
2025701390,8/12/2014,316000.0,3,2.25,1900,7479,2.0,0.0,0.0,4,7,1900,0,1992,0,98038,47.3495,-122.037,1520,6559,8,12,2014,UNK,380,920
1561900330,3/6/2015,397500.0,4,3.0,2350,9952,1.0,0.0,0.0,3,9,1650,700,1989,0,98031,47.4194,-122.211,2440,9100,3,6,2015,UNK,-90,852
1370800940,7/21/2014,1350000.0,3,2.5,2390,5500,1.0,0.0,3.0,3,9,1700,690,1952,0,98199,47.6389,-122.40899999999999,2700,5500,7,21,2014,UNK,-310,0
8691300900,8/21/2014,840000.0,4,2.5,3730,9847,2.0,0.0,0.0,3,10,3730,0,1997,0,98075,47.586999999999996,-121.976,3490,10219,8,21,2014,UNK,240,-372
3751606514,6/26/2014,270000.0,2,1.0,1780,81021,1.0,0.0,3.0,4,9,1780,0,1954,0,98001,47.2712,-122.265,1780,26723,6,26,2014,UNK,0,54298
5104510490,5/27/2014,312900.0,4,2.5,1630,4473,2.0,0.0,0.0,3,7,1630,0,2003,0,98038,47.3546,-122.015,1830,5082,5,27,2014,UNK,-200,-609
3432500210,3/26/2015,325000.0,2,1.0,1130,6908,1.5,0.0,0.0,3,6,1130,0,1945,0,98155,47.745,-122.31299999999999,1150,6908,3,26,2015,UNK,-20,0
2771604791,7/19/2014,680000.0,3,1.75,2140,3584,1.0,0.0,0.0,3,7,1070,1070,1952,0,98199,47.636,-122.391,1620,4000,7,19,2014,UNK,520,-416
2537500040,3/4/2015,763000.0,4,2.5,3220,7873,2.0,0.0,0.0,3,10,3220,0,1994,0,98075,47.5849,-122.03,2610,8023,3,4,2015,UNK,610,-150
1222069089,9/4/2014,375000.0,1,1.0,800,533610,1.5,0.0,0.0,5,5,800,0,1950,0,98038,47.4134,-121.986,1790,216057,9,4,2014,UNK,-990,317553
3332500100,4/8/2015,475000.0,3,2.5,1800,3300,2.0,0.0,0.0,3,7,1690,110,2004,0,98118,47.5491,-122.27600000000001,1570,4097,4,8,2015,N,230,-797
7625702616,11/21/2014,219000.0,2,2.5,809,940,2.0,0.0,0.0,3,7,809,0,2003,0,98136,47.5499,-122.384,1260,4240,11,21,2014,UNK,-451,-3300
2561330040,3/23/2015,415000.0,3,2.25,1820,9694,1.0,0.0,0.0,3,7,1240,580,1977,0,98074,47.6157,-122.05,1820,9694,3,23,2015,UNK,0,0
1423049019,5/23/2014,90000.0,2,1.0,580,7500,1.0,0.0,0.0,3,5,580,0,1943,0,98178,47.4852,-122.251,1700,11250,5,23,2014,UNK,-1120,-3750
1423049019,3/31/2015,220000.0,2,1.0,580,7500,1.0,0.0,0.0,3,5,580,0,1943,0,98178,47.4852,-122.251,1700,11250,3,31,2015,UNK,-1120,-3750
9277200065,2/26/2015,616000.0,3,2.0,2900,5650,1.0,0.0,2.0,3,8,1520,1380,1959,0,98116,47.5789,-122.396,1810,6250,2,26,2015,UNK,1090,-600
1920079039,8/15/2014,269500.0,2,1.0,1140,74052,1.0,0.0,0.0,4,6,1140,0,1968,0,98022,47.2093,-121.962,1730,43560,8,15,2014,UNK,-590,30492
7515000035,4/24/2015,395350.0,2,1.0,1060,5754,1.0,0.0,0.0,4,6,1060,0,1917,0,98117,47.6931,-122.37200000000001,1460,7200,4,24,2015,UNK,-400,-1446
5315101728,3/19/2015,770000.0,4,3.0,2320,7200,1.0,0.0,0.0,3,7,1260,1060,1943,2000,98040,47.5893,-122.23200000000001,1760,7200,3,19,2015,Y,560,0
326069164,4/29/2015,840000.0,4,2.5,3450,43216,2.0,0.0,0.0,3,9,3450,0,2000,0,98072,47.7625,-122.025,3030,50481,4,29,2015,UNK,420,-7265
2695600410,11/6/2014,428950.0,2,1.0,1760,4441,1.0,0.0,0.0,3,8,1310,450,1950,0,98126,47.5311,-122.381,1350,5748,11,6,2014,UNK,410,-1307
9348700610,12/17/2014,800000.0,4,3.75,3370,6766,2.0,0.0,0.0,3,9,3370,0,2005,0,98052,47.7063,-122.10600000000001,3530,6766,12,17,2014,N,-160,0
7308900100,6/19/2014,401000.0,4,1.0,1940,5753,1.5,0.0,0.0,3,7,1940,0,1947,0,98177,47.7188,-122.35799999999999,2170,6075,6,19,2014,UNK,-230,-322
1453601502,2/26/2015,303697.0,4,2.0,2520,7334,1.0,0.0,0.0,3,7,1600,920,1955,0,98125,47.7263,-122.291,2040,7937,2,26,2015,UNK,480,-603
4077800593,9/15/2014,355000.0,3,1.0,1360,8968,1.0,0.0,0.0,3,7,1360,0,1956,0,98125,47.7105,-122.289,1490,7355,9,15,2014,UNK,-130,1613
9268200641,8/20/2014,350000.0,2,1.0,800,5040,1.0,0.0,0.0,3,6,800,0,1960,0,98117,47.6953,-122.36200000000001,1020,5040,8,20,2014,UNK,-220,0
6705850300,4/14/2015,754999.0,4,2.5,3010,9323,2.0,0.0,0.0,3,10,3010,0,1992,0,98075,47.578,-122.053,2840,8413,4,14,2015,UNK,170,910
3720800115,3/31/2015,982218.0,3,1.75,2340,5500,2.0,0.0,2.0,3,9,2340,0,1988,0,98102,47.6451,-122.319,2830,5500,3,31,2015,UNK,-490,0
8079040330,9/27/2014,406500.0,3,2.0,1780,8621,1.0,0.0,0.0,3,8,1780,0,1992,0,98059,47.5062,-122.149,2470,8542,9,27,2014,UNK,-690,79
1824079052,4/1/2015,1650000.0,4,3.25,4200,210394,2.0,0.0,0.0,4,10,4200,0,1993,0,98024,47.5607,-121.961,2370,184694,4,1,2015,UNK,1830,25700
1923300315,2/17/2015,565000.0,2,1.75,1720,3000,1.0,0.0,0.0,5,7,860,860,1925,0,98103,47.68600000000001,-122.351,1360,4500,2,17,2015,UNK,360,-1500
3336001316,11/6/2014,160000.0,2,1.0,830,4500,1.0,0.0,0.0,3,6,830,0,1920,0,98118,47.5248,-122.265,1092,5350,11,6,2014,UNK,-262,-850
9382200025,1/15/2015,220000.0,3,1.0,1090,6320,1.0,0.0,0.0,3,6,890,200,1954,0,98146,47.4976,-122.35,1460,7080,1,15,2015,UNK,-370,-760
7237500650,2/13/2015,1280000.0,5,4.25,5040,9466,2.0,0.0,0.0,3,11,5040,0,2004,0,98059,47.5282,-122.133,4300,9417,2,13,2015,N,740,49
3100500065,7/8/2014,970000.0,5,2.75,3500,5040,2.0,0.0,2.0,3,9,2950,550,1927,2007,98126,47.5527,-122.37899999999999,1450,5040,7,8,2014,Y,2050,0
795000620,9/24/2014,115000.0,3,1.0,1080,6250,1.0,0.0,0.0,2,5,1080,0,1950,0,98168,47.5045,-122.33,1070,6250,9,24,2014,UNK,10,0
795000620,12/15/2014,124000.0,3,1.0,1080,6250,1.0,0.0,0.0,2,5,1080,0,1950,0,98168,47.5045,-122.33,1070,6250,12,15,2014,UNK,10,0
795000620,3/11/2015,157000.0,3,1.0,1080,6250,1.0,0.0,0.0,2,5,1080,0,1950,0,98168,47.5045,-122.33,1070,6250,3,11,2015,UNK,10,0
8651430220,7/25/2014,183000.0,3,1.0,870,5200,1.0,0.0,0.0,5,6,870,0,1969,0,98042,47.3702,-122.07799999999999,870,5200,7,25,2014,UNK,0,0
7954300740,9/9/2014,527000.0,4,2.5,2830,6163,2.0,0.0,0.0,3,9,2830,0,2000,0,98056,47.5227,-122.19,2730,6202,9,9,2014,UNK,100,-39
4046601460,6/6/2014,407193.0,4,2.0,1880,14653,2.0,0.0,0.0,3,8,1880,0,1978,0,98014,47.6959,-121.921,1750,14858,6,6,2014,UNK,130,-205
6933600456,3/13/2015,970000.0,4,2.75,3600,5040,2.0,0.0,0.0,3,9,2610,990,2004,0,98199,47.6487,-122.38799999999999,1590,5040,3,13,2015,N,2010,0
9357000650,5/27/2014,535000.0,4,2.5,2340,5600,2.0,0.0,0.0,3,7,2340,0,1921,2013,98146,47.5117,-122.37899999999999,1310,5600,5,27,2014,Y,1030,0
7347600490,8/14/2014,245000.0,3,2.0,2040,13125,1.0,0.0,0.0,3,6,810,1230,1910,0,98168,47.478,-122.27799999999999,1460,10582,8,14,2014,UNK,580,2543
5095400760,6/23/2014,337000.0,3,1.75,1310,12750,1.0,0.0,0.0,3,7,1310,0,1993,0,98059,47.4695,-122.07,1790,13500,6,23,2014,UNK,-480,-750
1245003660,3/21/2015,630000.0,3,2.0,1470,6000,1.0,0.0,0.0,3,8,1090,380,1950,1996,98033,47.6829,-122.20200000000001,1880,7799,3,21,2015,Y,-410,-1799
3275300040,6/6/2014,320000.0,3,1.75,1370,9900,1.0,0.0,0.0,4,7,1370,0,1983,0,98003,47.2575,-122.31200000000001,1490,9600,6,6,2014,UNK,-120,300
2407000405,2/26/2015,228500.0,3,1.0,1080,7486,1.5,0.0,0.0,3,6,990,90,1942,0,98146,47.4838,-122.335,1170,7800,2,26,2015,UNK,-90,-314
6664900330,2/23/2015,293000.0,3,2.5,1990,7577,2.0,0.0,0.0,3,7,1990,0,1990,0,98023,47.2908,-122.351,1900,7152,2,23,2015,UNK,90,425
4036800900,9/24/2014,447000.0,3,1.0,1310,7000,1.0,0.0,0.0,4,7,1310,0,1958,0,98008,47.6019,-122.12299999999999,1280,7300,9,24,2014,UNK,30,-300
8648220150,5/7/2014,226500.0,3,1.75,1640,10762,1.0,0.0,0.0,3,7,1130,510,1988,0,98042,47.3586,-122.074,1680,10259,5,7,2014,UNK,-40,503
3876313170,12/9/2014,436000.0,3,2.25,1770,8000,1.0,0.0,0.0,4,7,1350,420,1976,0,98072,47.7358,-122.17,1850,7875,12,9,2014,UNK,-80,125
2738600220,8/4/2014,451000.0,3,2.5,2050,4876,2.0,0.0,0.0,3,8,2050,0,2005,0,98072,47.7746,-122.15799999999999,2320,4065,8,4,2014,N,-270,811
1593000690,4/8/2015,315000.0,3,1.0,1170,62290,2.0,0.0,0.0,3,5,1170,0,1986,0,98045,47.5104,-121.787,1810,42173,4,8,2015,UNK,-640,20117
5101406536,10/28/2014,450000.0,2,1.0,1340,7250,1.0,0.0,0.0,4,7,1340,0,1951,0,98125,47.7015,-122.32,1450,7026,10,28,2014,UNK,-110,224
2267000485,12/1/2014,635000.0,3,1.5,2240,5300,1.0,0.0,0.0,5,7,1120,1120,1955,0,98117,47.6927,-122.395,1740,7110,12,1,2014,UNK,500,-1810
822059059,3/25/2015,292500.0,2,1.0,880,17743,1.0,0.0,0.0,4,5,880,0,1951,0,98031,47.4115,-122.197,1217,13000,3,25,2015,UNK,-337,4743
2310110230,5/20/2014,329900.0,3,2.5,2170,4905,2.0,0.0,0.0,3,8,2170,0,2004,0,98038,47.3503,-122.039,2300,4935,5,20,2014,N,-130,-30
7974200777,11/18/2014,531000.0,2,1.5,1260,6660,1.5,0.0,0.0,4,7,1260,0,1926,0,98115,47.6792,-122.287,2140,4770,11,18,2014,UNK,-880,1890
2025059201,7/31/2014,725000.0,3,1.75,1880,13300,1.0,0.0,0.0,3,7,1380,500,1967,0,98004,47.63399999999999,-122.204,3550,10883,7,31,2014,UNK,-1670,2417
1074100110,5/25/2014,355300.0,3,2.5,1620,7410,1.0,0.0,0.0,5,7,1620,0,1955,0,98133,47.7708,-122.335,1450,8121,5,25,2014,UNK,170,-711
8000200090,4/27/2015,280000.0,3,2.5,1610,10022,2.0,0.0,0.0,3,7,1610,0,1996,0,98003,47.2583,-122.3,1820,10017,4,27,2015,UNK,-210,5
1247100035,6/30/2014,1100000.0,4,2.75,3330,9143,2.0,0.0,0.0,4,10,3330,0,1995,0,98033,47.6821,-122.19,2390,9143,6,30,2014,UNK,940,0
7010700210,6/5/2014,605004.0,4,2.0,1370,4000,2.0,0.0,0.0,3,9,1370,0,1951,1994,98199,47.6593,-122.39399999999999,2010,5720,6,5,2014,Y,-640,-1720
7950304065,3/9/2015,260000.0,2,1.0,690,6000,1.0,0.0,0.0,3,6,690,0,1949,0,98118,47.5621,-122.28299999999999,840,3030,3,9,2015,UNK,-150,2970
9523100026,7/23/2014,748000.0,4,2.5,3170,4979,2.0,0.0,0.0,4,7,2570,600,1925,0,98103,47.6655,-122.34,2060,5000,7,23,2014,UNK,1110,-21
1093000090,4/16/2015,776000.0,2,2.0,1990,6180,1.0,0.0,0.0,4,7,1010,980,1941,0,98115,47.6792,-122.303,1470,5150,4,16,2015,UNK,520,1030
1532300155,9/16/2014,425000.0,4,1.0,1080,6095,1.5,0.0,0.0,4,6,1080,0,1924,0,98103,47.6962,-122.346,1200,5060,9,16,2014,UNK,-120,1035
4006000423,1/8/2015,230000.0,4,1.0,1870,14703,1.5,0.0,0.0,3,6,1090,780,1928,0,98118,47.5274,-122.281,1650,6045,1,8,2015,UNK,220,8658
8665900331,1/30/2015,418000.0,3,1.75,1670,12075,1.0,0.0,0.0,3,7,1370,300,1958,0,98155,47.7681,-122.307,1800,12123,1,30,2015,UNK,-130,-48
3370000150,8/4/2014,440000.0,4,2.5,2800,28254,2.0,0.0,0.0,3,9,2800,0,2001,0,98038,47.3552,-122.06299999999999,2530,4694,8,4,2014,UNK,270,23560
1853080540,11/24/2014,858450.0,5,2.75,3460,7977,2.0,0.0,0.0,3,9,3460,0,2011,0,98074,47.5908,-122.06200000000001,3390,6630,11,24,2014,N,70,1347
1023089197,10/7/2014,390000.0,3,2.0,1930,12443,1.0,0.0,0.0,3,7,1930,0,1969,0,98045,47.4906,-121.775,1400,12183,10,7,2014,UNK,530,260
1175001075,9/16/2014,957000.0,4,3.0,2370,3836,2.0,0.0,0.0,3,9,1750,620,1969,2008,98107,47.6718,-122.39399999999999,1690,4698,9,16,2014,Y,680,-862
6392001810,9/4/2014,507000.0,3,1.0,1180,6000,1.0,0.0,0.0,3,7,1180,0,1950,0,98115,47.6853,-122.286,1680,6000,9,4,2014,UNK,-500,0
2767603160,2/25/2015,575000.0,2,1.0,1320,4750,1.5,0.0,0.0,4,7,1320,0,1928,0,98107,47.6729,-122.38,1360,2873,2,25,2015,UNK,-40,1877
8129700985,4/27/2015,700000.0,3,1.75,1350,4000,1.5,0.0,0.0,4,7,1350,0,1925,0,98103,47.6581,-122.354,1880,4000,4,27,2015,UNK,-530,0
9406500600,2/5/2015,239950.0,2,1.5,1068,1452,2.0,0.0,0.0,3,7,1068,0,1990,0,98028,47.753,-122.244,1078,1357,2,5,2015,UNK,-10,95
3830620300,11/3/2014,253000.0,3,1.0,1580,8240,1.0,0.0,0.0,4,7,1040,540,1978,0,98030,47.3542,-122.181,1480,9200,11,3,2014,UNK,100,-960
4237901250,3/27/2015,540000.0,4,1.0,1690,3417,1.5,0.0,0.0,3,7,1690,0,1907,0,98199,47.663000000000004,-122.402,1970,4800,3,27,2015,UNK,-280,-1383
3754501240,2/6/2015,1550000.0,3,4.0,5120,4600,3.0,0.0,2.0,3,11,4490,630,2008,0,98034,47.7052,-122.223,2510,5918,2,6,2015,N,2610,-1318
2226069018,11/12/2014,805000.0,4,2.5,3960,38615,2.0,0.0,0.0,3,10,3960,0,2000,0,98077,47.7249,-122.024,3290,43560,11,12,2014,UNK,670,-4945
4206901215,6/12/2014,920000.0,4,3.25,2420,4000,1.5,0.0,0.0,5,9,1870,550,1911,0,98105,47.6567,-122.325,1810,4000,6,12,2014,UNK,610,0
3904930730,11/5/2014,496600.0,3,2.5,1910,5562,2.0,0.0,0.0,3,8,1910,0,1988,0,98029,47.5738,-122.01700000000001,1940,4647,11,5,2014,UNK,-30,915
2115510300,10/16/2014,246000.0,3,2.25,1440,10500,1.0,0.0,0.0,3,8,1130,310,1983,0,98023,47.31800000000001,-122.391,1510,8125,10,16,2014,UNK,-70,2375
1773100620,5/5/2015,350000.0,5,3.0,2320,8400,1.0,0.0,0.0,3,7,1510,810,1963,0,98106,47.556999999999995,-122.365,1200,4800,5,5,2015,UNK,1120,3600
5075400150,5/23/2014,585000.0,3,2.0,1670,4572,1.5,0.0,0.0,3,8,1670,0,1931,0,98117,47.6854,-122.37299999999999,1480,4890,5,23,2014,UNK,190,-318
3893100319,3/23/2015,450000.0,3,1.75,1390,11700,1.0,0.0,0.0,4,7,1390,0,1966,0,98033,47.7002,-122.19200000000001,1060,8686,3,23,2015,UNK,330,3014
4139440610,5/12/2014,746000.0,3,2.5,2620,8950,2.0,0.0,0.0,3,9,2620,0,1992,0,98006,47.5523,-122.119,2850,8809,5,12,2014,UNK,-230,141
2481590090,10/27/2014,598555.0,3,2.5,3040,7880,2.0,0.0,0.0,3,9,3040,0,2004,0,98056,47.5277,-122.184,3040,7880,10,27,2014,N,0,0
3222049151,10/30/2014,820000.0,3,2.5,2990,10711,1.0,1.0,4.0,3,9,1560,1430,1976,1991,98198,47.3573,-122.324,2870,11476,10,30,2014,Y,120,-765
1545805030,10/21/2014,266500.0,3,2.25,1740,5460,1.0,0.0,0.0,3,7,1210,530,1998,0,98038,47.3648,-122.046,1740,7500,10,21,2014,UNK,0,-2040
620079042,3/23/2015,370000.0,2,1.0,2360,105850,1.0,0.0,2.0,2,6,1180,1180,1947,0,98022,47.2495,-121.97,2640,386812,3,23,2015,UNK,-280,-280962
6848200325,9/4/2014,625000.0,3,2.75,2240,3600,2.5,0.0,0.0,3,7,1650,590,1901,0,98102,47.6244,-122.32600000000001,1716,3120,9,4,2014,UNK,524,480
6929603207,12/10/2014,243500.0,4,2.0,1610,6200,1.0,0.0,0.0,4,7,1610,0,1979,0,98198,47.3833,-122.306,1610,7500,12,10,2014,UNK,0,-1300
3626039229,3/17/2015,340000.0,2,1.0,700,5829,1.0,0.0,0.0,3,6,700,0,1945,0,98103,47.6958,-122.35700000000001,1160,6700,3,17,2015,UNK,-460,-871
5589900610,9/18/2014,559950.0,5,3.0,2730,9519,1.0,0.0,0.0,3,8,1670,1060,2014,0,98155,47.7504,-122.307,1150,9519,9,18,2014,N,1580,0
7153400100,2/19/2015,315000.0,3,2.75,1780,15114,1.0,0.0,0.0,3,7,1080,700,1980,0,98003,47.258,-122.305,1792,10155,2,19,2015,UNK,-12,4959
1125069086,4/28/2015,753000.0,3,2.5,3070,223463,2.0,0.0,0.0,3,9,3070,0,2003,0,98053,47.663999999999994,-121.993,3640,223463,4,28,2015,UNK,-570,0
2902200076,1/28/2015,800000.0,3,3.0,2060,3200,2.0,0.0,0.0,3,8,2060,0,1907,0,98102,47.637,-122.324,1760,2669,1,28,2015,UNK,300,531
8024201210,9/11/2014,550000.0,3,2.25,1360,5111,1.5,0.0,0.0,5,7,1360,0,1934,0,98115,47.6988,-122.31299999999999,1900,5111,9,11,2014,UNK,-540,0
3755500065,11/6/2014,465000.0,3,2.0,1430,14250,1.0,0.0,0.0,3,7,1430,0,1953,0,98033,47.701,-122.199,1530,11475,11,6,2014,UNK,-100,2775
3890600150,5/28/2014,465000.0,3,2.25,1840,5752,2.0,0.0,0.0,3,7,1840,0,2003,0,98034,47.7042,-122.18700000000001,1670,2462,5,28,2014,UNK,170,3290
2141320230,4/10/2015,710000.0,4,2.25,2000,8068,2.0,0.0,0.0,5,8,2000,0,1976,0,98006,47.5584,-122.137,2080,7837,4,10,2015,UNK,-80,231
8078430360,12/16/2014,505000.0,3,2.5,1820,11012,2.0,0.0,0.0,3,8,1820,0,1988,0,98074,47.6358,-122.02600000000001,1860,7767,12,16,2014,UNK,-40,3245
333100209,3/18/2015,690000.0,3,1.75,2330,16300,2.0,0.0,0.0,3,9,2330,0,1964,0,98034,47.7037,-122.24,2330,16300,3,18,2015,UNK,0,0
5419800090,11/21/2014,217500.0,2,2.0,1070,8400,1.0,0.0,0.0,4,7,1070,0,1980,0,98031,47.4014,-122.186,1430,8190,11,21,2014,UNK,-360,210
1868900395,9/2/2014,500000.0,2,1.0,930,3750,1.0,0.0,0.0,4,7,930,0,1909,0,98115,47.6733,-122.296,1740,4300,9,2,2014,UNK,-810,-550
1568100730,2/18/2015,325000.0,2,2.0,1040,5796,1.0,0.0,2.0,4,6,1040,0,1921,0,98155,47.7362,-122.29,2300,5796,2,18,2015,UNK,-1260,0
1785400770,8/25/2014,500000.0,4,2.25,1960,12436,2.0,0.0,0.0,3,8,1960,0,1984,0,98074,47.6276,-122.037,1960,12436,8,25,2014,UNK,0,0
2724079014,3/31/2015,721500.0,3,3.25,2970,234788,2.0,0.0,3.0,3,9,2040,930,1991,0,98024,47.5353,-121.897,2970,220413,3,31,2015,UNK,0,14375
1370801800,5/19/2014,924000.0,3,1.5,2200,5000,1.5,0.0,0.0,3,9,2200,0,1932,0,98199,47.6404,-122.40799999999999,2860,5000,5,19,2014,UNK,-660,0
3585901085,6/4/2014,2010000.0,6,4.5,3810,28176,1.0,0.0,4.0,5,10,3810,0,1969,0,98177,47.7612,-122.381,3810,26400,6,4,2014,UNK,0,1776
424049283,4/15/2015,345000.0,2,1.5,830,1034,2.0,0.0,0.0,3,8,830,0,2009,0,98144,47.5926,-122.3,1130,2534,4,15,2015,N,-300,-1500
7851990230,3/16/2015,825000.0,4,3.5,3920,11086,2.0,0.0,0.0,3,10,3920,0,1999,0,98065,47.5416,-121.869,3740,10880,3,16,2015,UNK,180,206
1423069076,9/26/2014,560000.0,3,2.0,2870,95396,1.0,0.0,0.0,4,9,1350,1520,1980,0,98027,47.4834,-122.001,2870,102366,9,26,2014,UNK,0,-6970
1786830090,7/8/2014,599000.0,3,2.0,2560,14680,1.0,0.0,0.0,3,8,1330,1230,1987,0,98052,47.648,-122.118,2390,13848,7,8,2014,UNK,170,832
2968801240,5/12/2014,211000.0,3,1.5,1350,7620,1.0,0.0,0.0,5,6,1350,0,1941,0,98166,47.4565,-122.35,1350,7620,5,12,2014,UNK,0,0
3344500210,4/24/2015,425000.0,4,2.25,1240,21190,1.0,0.0,0.0,3,8,910,330,1974,0,98056,47.5123,-122.197,1760,8200,4,24,2015,UNK,-520,12990
226039317,1/7/2015,750000.0,4,2.75,3210,8520,1.0,0.0,2.0,4,7,1810,1400,1976,0,98177,47.7743,-122.38799999999999,2450,7360,1,7,2015,UNK,760,1160
7202330530,1/16/2015,479000.0,3,2.5,1690,3322,2.0,0.0,0.0,3,7,1690,0,2003,0,98053,47.6824,-122.036,1650,3446,1,16,2015,UNK,40,-124
3905090230,2/27/2015,612500.0,4,2.5,2550,10623,2.0,0.0,0.0,3,9,2550,0,1992,0,98029,47.5695,-121.992,2750,8100,2,27,2015,UNK,-200,2523
6446200365,5/5/2015,605000.0,5,1.75,3240,34510,2.0,0.0,0.0,4,7,2690,550,1963,0,98029,47.5529,-122.027,2650,28250,5,5,2015,UNK,590,6260
856001130,2/23/2015,1360000.0,4,2.5,3560,8960,2.0,0.0,0.0,3,10,3560,0,2001,0,98033,47.6903,-122.213,1660,7680,2,23,2015,UNK,1900,1280
7861500150,12/2/2014,389900.0,3,2.5,2160,59241,1.0,0.0,0.0,3,7,2160,0,2007,0,98042,47.3304,-122.13,2290,125017,12,2,2014,N,-130,-65776
5014600210,12/15/2014,710000.0,4,2.5,3060,5000,2.0,0.0,0.0,3,9,3060,0,2006,0,98059,47.5395,-122.18799999999999,2870,5548,12,15,2014,N,190,-548
2215900900,5/5/2015,295000.0,3,2.5,1690,8564,2.0,0.0,0.0,4,7,1690,0,1992,0,98038,47.3518,-122.057,1690,7532,5,5,2015,UNK,0,1032
2025700740,7/2/2014,275250.0,3,2.25,1520,7199,2.0,0.0,0.0,4,7,1520,0,1992,0,98038,47.3492,-122.03399999999999,1410,6751,7,2,2014,UNK,110,448
2591730230,9/12/2014,250000.0,4,2.5,2040,5770,2.0,0.0,0.0,3,7,2040,0,1994,0,98038,47.3522,-122.059,1570,6753,9,12,2014,UNK,470,-983
7611200195,2/20/2015,709000.0,3,2.0,2360,18000,1.0,0.0,0.0,4,8,2180,180,1951,0,98177,47.7133,-122.367,2600,17300,2,20,2015,UNK,-240,700
9297800090,7/8/2014,399500.0,4,1.75,1360,4840,1.5,0.0,0.0,4,7,1360,0,1928,0,98126,47.556000000000004,-122.376,1320,4840,7,8,2014,UNK,40,0
2215900930,5/9/2014,225000.0,3,2.5,2000,9202,2.0,0.0,0.0,4,7,2000,0,1992,0,98038,47.3516,-122.057,1750,7827,5,9,2014,UNK,250,1375
7215730930,1/12/2015,500000.0,3,2.5,1650,4648,2.0,0.0,0.0,3,8,1650,0,2001,0,98075,47.5968,-122.015,1800,5637,1,12,2015,UNK,-150,-989
5201810110,6/9/2014,364900.0,3,3.0,2500,8304,2.0,0.0,0.0,3,8,2500,0,1997,0,98031,47.4022,-122.166,2290,7855,6,9,2014,UNK,210,449
3575302562,11/13/2014,356000.0,3,1.5,1140,7500,1.0,0.0,0.0,3,7,1140,0,1976,0,98074,47.619,-122.064,1380,7500,11,13,2014,UNK,-240,0
3438502290,2/2/2015,616750.0,3,1.5,2140,47743,1.5,0.0,0.0,3,9,2140,0,1978,0,98106,47.5402,-122.365,1060,6016,2,2,2015,UNK,1080,41727
8881900230,12/2/2014,755000.0,3,2.75,2870,6600,2.0,0.0,2.0,3,8,2870,0,1984,0,98008,47.5745,-122.113,2570,7925,12,2,2014,UNK,300,-1325
3500100015,8/12/2014,327500.0,2,1.0,830,8183,1.0,0.0,0.0,5,6,830,0,1950,0,98155,47.7366,-122.302,1180,8184,8,12,2014,UNK,-350,-1
8651511250,4/15/2015,605000.0,3,2.25,1960,10139,2.0,0.0,0.0,3,8,1960,0,1984,0,98074,47.6481,-122.061,2080,9753,4,15,2015,UNK,-120,386
8651401960,4/13/2015,179950.0,4,1.5,1130,5200,1.0,0.0,0.0,3,6,1130,0,1968,0,98042,47.3616,-122.089,1140,5200,4,13,2015,UNK,-10,0
7937900040,12/19/2014,633000.0,5,2.75,3630,30570,2.0,0.0,0.0,3,11,3630,0,2000,0,98058,47.4243,-122.09700000000001,3620,41965,12,19,2014,UNK,10,-11395
6199000141,3/12/2015,349950.0,4,2.0,1764,15600,1.0,0.0,0.0,5,7,1764,0,1942,0,98058,47.4318,-122.181,1490,22387,3,12,2015,UNK,274,-6787
3271300365,4/7/2015,1080000.0,3,2.75,2770,5800,1.0,0.0,0.0,4,8,1650,1120,1959,0,98199,47.6496,-122.413,2340,5800,4,7,2015,UNK,430,0
9264030040,4/30/2015,425000.0,3,2.5,2650,12247,2.0,0.0,0.0,3,9,2650,0,2002,0,98001,47.3185,-122.259,2920,8965,4,30,2015,UNK,-270,3282
9829200580,9/17/2014,990000.0,3,2.75,2500,6350,2.0,0.0,0.0,5,9,2370,130,1979,0,98122,47.6035,-122.285,2090,5454,9,17,2014,UNK,410,896
2929600035,6/27/2014,410000.0,3,1.0,2710,19000,2.0,0.0,3.0,4,7,2710,0,1950,0,98166,47.4462,-122.359,2150,19000,6,27,2014,UNK,560,0
3459410230,11/11/2014,590000.0,3,2.25,2490,8800,2.0,0.0,0.0,4,8,2490,0,1975,0,98006,47.5666,-122.132,2690,10000,11,11,2014,UNK,-200,-1200
7303200450,4/8/2015,242000.0,3,1.75,1500,7560,1.0,0.0,0.0,3,7,1500,0,1979,0,98003,47.3467,-122.296,1500,7560,4,8,2015,UNK,0,0
924069042,11/25/2014,775000.0,3,2.0,1160,13747,1.0,0.0,0.0,5,5,580,580,1931,0,98075,47.585,-122.051,2961,16320,11,25,2014,UNK,-1801,-2573
287000110,6/25/2014,680000.0,4,1.5,1880,6200,1.0,0.0,2.0,5,8,1440,440,1954,0,98146,47.5035,-122.384,2070,6500,6,25,2014,UNK,-190,-300
1018000276,3/27/2015,217000.0,3,2.5,1340,4200,2.0,0.0,0.0,3,7,1340,0,2002,0,98002,47.2942,-122.226,990,4520,3,27,2015,UNK,350,-320
1560870040,4/21/2015,395000.0,3,2.5,1960,3953,2.0,0.0,0.0,3,8,1960,0,1999,0,98059,47.4904,-122.15799999999999,1690,3593,4,21,2015,UNK,270,360
7135500120,5/19/2014,572500.0,3,2.25,2030,9791,1.0,0.0,0.0,4,8,1500,530,1984,0,98059,47.534,-122.161,2030,11031,5,19,2014,UNK,0,-1240
5101408835,9/9/2014,559900.0,5,3.0,2200,6380,1.0,0.0,0.0,3,7,1440,760,1987,0,98125,47.7033,-122.322,1960,5800,9,9,2014,UNK,240,580
472000590,6/24/2014,845000.0,3,2.0,2540,4750,1.5,0.0,0.0,5,9,1840,700,1930,0,98117,47.6838,-122.4,2190,4750,6,24,2014,UNK,350,0
104550750,7/28/2014,241000.0,3,2.0,1520,7131,1.0,0.0,0.0,3,8,1520,0,1993,0,98023,47.3061,-122.361,1890,7379,7,28,2014,UNK,-370,-248
7576700150,10/1/2014,1330000.0,3,2.25,2360,5504,2.0,0.0,0.0,4,8,2080,280,1913,0,98122,47.617,-122.288,2840,5470,10,1,2014,UNK,-480,34
7137300245,4/29/2015,475000.0,3,1.75,1340,2805,1.5,0.0,0.0,3,7,1340,0,1919,0,98144,47.5922,-122.29700000000001,1650,2805,4,29,2015,UNK,-310,0
5511600315,2/18/2015,575000.0,2,1.5,1400,5810,2.0,0.0,0.0,3,7,1400,0,1940,0,98103,47.6843,-122.34100000000001,1470,3920,2,18,2015,UNK,-70,1890
1422059039,8/28/2014,455000.0,4,2.75,3030,117378,1.0,0.0,0.0,4,8,1680,1350,1959,0,98042,47.401,-122.135,2060,110957,8,28,2014,UNK,970,6421
1026069095,6/24/2014,839000.0,3,2.5,3200,203425,1.0,0.0,0.0,3,10,3200,0,2000,0,98077,47.7614,-122.015,3200,203425,6,24,2014,UNK,0,0
2207100165,4/30/2015,475000.0,4,1.5,1580,10260,1.0,0.0,0.0,4,7,1030,550,1955,0,98007,47.5984,-122.147,1520,7000,4,30,2015,UNK,60,3260
1705400361,12/8/2014,600000.0,2,1.0,2120,6897,1.0,0.0,0.0,4,7,1060,1060,1923,0,98118,47.5566,-122.27799999999999,1900,4462,12,8,2014,UNK,220,2435
1370804115,11/6/2014,515000.0,2,1.0,1640,5200,1.0,0.0,0.0,4,7,1040,600,1937,0,98199,47.6426,-122.40299999999999,1780,5040,11,6,2014,UNK,-140,160
9527000090,3/18/2015,425000.0,3,2.25,1890,8400,1.0,0.0,0.0,3,8,1520,0,1977,0,98034,47.7103,-122.23200000000001,1830,7980,3,18,2015,UNK,60,420
1556200145,10/7/2014,565000.0,4,2.0,1710,3875,1.5,0.0,0.0,4,7,1710,0,1907,0,98122,47.6086,-122.294,1710,3812,10,7,2014,UNK,0,63
1245500286,5/23/2014,498000.0,2,2.0,1140,8282,1.0,0.0,0.0,3,6,1140,0,1924,2009,98033,47.6949,-122.21,1650,9000,5,23,2014,Y,-510,-718
8824900120,6/6/2014,739000.0,4,3.0,2720,3800,2.0,0.0,0.0,5,8,1800,920,1919,0,98115,47.6756,-122.306,1940,4001,6,6,2014,UNK,780,-201
3959401645,6/4/2014,355000.0,2,1.75,1650,4000,1.0,0.0,0.0,4,7,950,700,1947,0,98108,47.5622,-122.319,1060,4110,6,4,2014,UNK,590,-110
9264900880,7/15/2014,263000.0,3,1.75,1790,7485,1.0,0.0,0.0,4,8,1330,460,1979,0,98023,47.3118,-122.34,1970,8097,7,15,2014,UNK,-180,-612
2826049160,9/5/2014,375000.0,4,1.75,1680,6834,1.5,0.0,0.0,3,7,1680,0,1948,0,98125,47.716,-122.307,950,7425,9,5,2014,UNK,730,-591
3449500035,9/30/2014,322000.0,3,1.75,2200,12231,1.0,0.0,0.0,4,7,1250,950,1964,0,98056,47.5076,-122.17299999999999,2200,9825,9,30,2014,UNK,0,2406
9266700845,4/29/2015,325000.0,2,1.0,830,5100,1.0,0.0,0.0,3,6,830,0,1941,0,98103,47.6932,-122.346,1050,5100,4,29,2015,UNK,-220,0
2493200455,10/21/2014,290000.0,2,1.0,770,4800,1.0,0.0,0.0,3,7,770,0,1943,0,98136,47.527,-122.383,1390,4800,10,21,2014,UNK,-620,0
6352600210,6/11/2014,809950.0,4,2.5,3280,6181,2.0,0.0,0.0,3,10,3280,0,2001,0,98074,47.6484,-122.081,3110,7570,6,11,2014,UNK,170,-1389
4278900110,10/9/2014,969500.0,3,3.25,2080,3025,2.0,0.0,2.0,4,8,1220,860,1984,0,98122,47.6051,-122.289,2680,6518,10,9,2014,UNK,-600,-3493
7214790110,6/13/2014,665000.0,4,2.5,2790,43091,2.0,0.0,0.0,4,9,2790,0,1989,0,98077,47.7759,-122.08,2750,35290,6,13,2014,UNK,40,7801
9358400150,2/6/2015,635000.0,5,3.5,4150,13232,2.0,0.0,0.0,3,11,4150,0,2006,0,98003,47.3417,-122.182,3840,15121,2,6,2015,N,310,-1889
1545802100,10/29/2014,272450.0,3,2.25,1780,7332,2.0,0.0,0.0,3,7,1780,0,1987,0,98038,47.3593,-122.051,1510,7625,10,29,2014,UNK,270,-293
8563000110,4/24/2015,427000.0,4,1.75,1460,9750,1.0,0.0,0.0,4,7,1460,0,1967,0,98008,47.6205,-122.102,1820,9840,4,24,2015,UNK,-360,-90
8074400150,4/1/2015,261500.0,3,1.0,1410,8174,1.0,0.0,0.0,3,8,1410,0,1958,0,98056,47.4969,-122.178,1500,8058,4,1,2015,UNK,-90,116
1951800040,6/20/2014,488800.0,4,2.25,2170,9665,1.0,0.0,0.0,4,8,1300,870,1976,0,98006,47.5444,-122.165,2170,12054,6,20,2014,UNK,0,-2389
7934000090,2/25/2015,340000.0,2,1.0,690,5200,1.0,0.0,0.0,3,6,690,0,1918,0,98136,47.556000000000004,-122.395,1380,5700,2,25,2015,UNK,-690,-500
50300090,8/11/2014,398950.0,4,3.0,3000,10297,2.0,0.0,0.0,3,8,3000,0,2003,0,98042,47.3684,-122.073,2520,8366,8,11,2014,UNK,480,1931
8651430210,3/21/2015,217000.0,3,1.0,870,5200,1.0,0.0,0.0,5,6,870,0,1969,0,98042,47.3701,-122.07799999999999,1020,5200,3,21,2015,UNK,-150,0
126059019,3/16/2015,799000.0,4,2.5,3170,94855,1.0,0.0,0.0,4,9,1910,1260,1978,0,98072,47.7648,-122.11200000000001,2590,65340,3,16,2015,UNK,580,29515
2599700040,12/30/2014,160000.0,4,1.0,1540,7350,1.0,0.0,0.0,4,6,770,770,1969,0,98023,47.3318,-122.34,910,8000,12,30,2014,UNK,630,-650
9512501400,9/2/2014,447000.0,3,1.0,1270,8800,1.0,0.0,0.0,3,7,1270,0,1968,0,98052,47.6703,-122.15,1560,8250,9,2,2014,UNK,-290,550
9169600043,4/24/2015,765000.0,3,1.75,2190,6450,1.0,0.0,0.0,3,8,1480,710,1957,0,98136,47.5284,-122.391,2190,6450,4,24,2015,UNK,0,0
4139900210,6/20/2014,1320000.0,4,3.5,4410,36200,2.0,0.0,0.0,3,11,4410,0,1989,0,98006,47.5487,-122.126,4760,35860,6,20,2014,UNK,-350,340
9558010090,8/22/2014,445000.0,4,2.5,2790,8111,2.0,0.0,0.0,3,9,2480,310,2004,0,98058,47.4492,-122.116,2550,7634,8,22,2014,N,240,477
8101900100,3/28/2015,310000.0,3,1.0,1510,6000,1.0,0.0,0.0,3,8,1170,340,1953,0,98118,47.5168,-122.285,1125,6000,3,28,2015,UNK,385,0
5592900205,4/9/2015,380000.0,2,1.75,1800,7191,1.0,0.0,3.0,4,7,990,810,1952,0,98056,47.4828,-122.191,1940,7400,4,9,2015,UNK,-140,-209
1624049228,11/24/2014,325000.0,4,1.0,2410,6975,1.0,0.0,0.0,3,7,1510,900,1957,0,98108,47.5692,-122.295,1880,6255,11,24,2014,UNK,530,720
2473410360,6/17/2014,345000.0,4,2.75,2250,7412,1.0,0.0,0.0,4,8,1480,770,1975,0,98058,47.4449,-122.12899999999999,2070,7632,6,17,2014,UNK,180,-220
7750500120,11/18/2014,300000.0,3,1.0,950,4760,1.5,0.0,0.0,3,6,950,0,1929,0,98106,47.5236,-122.348,1080,4760,11,18,2014,UNK,-130,0
1630700361,6/27/2014,530000.0,4,1.75,2860,48351,1.0,0.0,0.0,3,8,1710,1150,1978,0,98077,47.7605,-122.085,2460,43560,6,27,2014,UNK,400,4791
1630700361,4/9/2015,583500.0,4,1.75,2860,48351,1.0,0.0,0.0,3,8,1710,1150,1978,0,98077,47.7605,-122.085,2460,43560,4,9,2015,UNK,400,4791
4025300210,2/17/2015,410000.0,2,1.0,1560,10125,1.0,0.0,0.0,4,7,1130,430,1954,0,98155,47.7488,-122.304,1680,10125,2,17,2015,UNK,-120,0
2922701175,9/19/2014,535000.0,2,1.5,1940,5700,1.0,0.0,0.0,3,7,970,970,1937,0,98117,47.6881,-122.367,1250,5700,9,19,2014,UNK,690,0
7352200450,1/15/2015,2050000.0,4,3.25,3580,19989,1.5,1.0,4.0,4,7,3480,100,1915,1965,98125,47.7087,-122.27600000000001,2410,6389,1,15,2015,Y,1170,13600
9320990120,7/3/2014,345000.0,4,2.5,2040,5523,2.0,0.0,0.0,3,7,2040,0,1999,0,98148,47.431999999999995,-122.32799999999999,1720,6646,7,3,2014,UNK,320,-1123
1238500281,4/10/2015,539000.0,5,1.0,1700,11727,1.5,0.0,0.0,4,7,1700,0,1954,0,98033,47.68600000000001,-122.17200000000001,1740,8212,4,10,2015,UNK,-40,3515
1951800580,10/24/2014,590000.0,4,2.5,3700,12500,1.0,0.0,0.0,5,8,1920,1780,1973,0,98006,47.5403,-122.16799999999999,2020,8350,10,24,2014,UNK,1680,4150
3530430100,8/15/2014,187000.0,2,1.75,1050,2926,1.0,0.0,0.0,4,8,1050,0,1974,0,98198,47.3811,-122.31700000000001,1150,3802,8,15,2014,UNK,-100,-876
1623059092,5/9/2014,270000.0,3,2.0,1690,9583,1.0,0.0,0.0,4,7,1690,0,1969,0,98059,47.4825,-122.164,1690,9583,5,9,2014,UNK,0,0
7177300735,3/29/2015,546000.0,2,1.0,1120,6180,1.0,0.0,0.0,4,7,1120,0,1939,0,98115,47.6824,-122.301,1420,5356,3,29,2015,UNK,-300,824
1525039057,7/2/2014,520000.0,3,1.75,1490,1036,2.0,0.0,0.0,3,10,1090,400,2008,0,98199,47.6588,-122.40299999999999,1460,1206,7,2,2014,N,30,-170
5393601635,12/29/2014,515000.0,5,2.0,2220,6000,1.5,0.0,0.0,4,7,1390,830,1925,0,98144,47.5822,-122.295,1600,6000,12,29,2014,UNK,620,0
4217401240,7/17/2014,990000.0,3,2.5,2160,6000,1.5,0.0,0.0,4,8,1880,280,1939,0,98105,47.6582,-122.28,2300,6000,7,17,2014,UNK,-140,0
3438501450,5/7/2015,382000.0,2,1.0,870,10492,1.0,0.0,0.0,3,7,870,0,1937,0,98106,47.5467,-122.365,1300,7987,5,7,2015,UNK,-430,2505
1872900065,4/10/2015,1210000.0,3,1.75,1900,13600,1.0,0.0,0.0,4,8,1900,0,1956,0,98004,47.6163,-122.219,2510,16600,4,10,2015,UNK,-610,-3000
9285800180,6/26/2014,900000.0,4,3.5,3370,5000,2.0,0.0,2.0,3,8,2470,900,2008,0,98126,47.5714,-122.38,1820,5000,6,26,2014,N,1550,0
4322200220,4/21/2015,675000.0,3,2.75,3370,5350,1.5,0.0,1.0,4,7,2310,1060,1910,0,98136,47.5373,-122.39,1720,5618,4,21,2015,UNK,1650,-268
1819800042,11/14/2014,460000.0,2,1.0,880,3300,1.0,0.0,0.0,4,7,880,0,1909,0,98107,47.6566,-122.36,1960,5500,11,14,2014,UNK,-1080,-2200
2946001675,6/3/2014,234000.0,2,1.0,940,5375,1.0,0.0,0.0,4,5,940,0,1952,0,98198,47.4206,-122.324,1200,7500,6,3,2014,UNK,-260,-2125
1138010530,4/29/2015,399000.0,3,1.0,1340,7191,1.0,0.0,0.0,3,7,1340,0,1974,0,98034,47.7148,-122.212,1340,7215,4,29,2015,UNK,0,-24
7763400035,4/2/2015,253500.0,3,1.5,1440,12040,1.0,0.0,0.0,4,7,1440,0,1959,0,98042,47.3715,-122.16,1720,12040,4,2,2015,UNK,-280,0
925059107,8/20/2014,475000.0,3,1.5,1750,12632,1.0,0.0,0.0,4,7,1750,0,1952,0,98033,47.6736,-122.176,1740,12196,8,20,2014,UNK,10,436
1112000100,3/30/2015,740000.0,5,3.5,3990,5000,2.0,0.0,0.0,3,8,2910,1080,2004,0,98118,47.54,-122.27,1310,5000,3,30,2015,N,2680,0
7010700936,6/13/2014,799000.0,3,2.5,2860,4442,2.0,0.0,0.0,3,8,2860,0,2000,0,98199,47.661,-122.396,1440,4400,6,13,2014,UNK,1420,42
9558010300,4/23/2015,390000.0,4,2.5,1940,3864,2.0,0.0,0.0,3,8,1940,0,2003,0,98058,47.4507,-122.12,1900,3864,4,23,2015,UNK,40,0
7304301010,9/15/2014,421000.0,2,1.5,1400,11245,1.0,0.0,0.0,5,7,1400,0,1947,0,98155,47.7469,-122.321,1220,11241,9,15,2014,UNK,180,4
2329800110,1/28/2015,296500.0,3,2.5,1770,6033,2.0,0.0,0.0,4,7,1770,0,1987,0,98042,47.3764,-122.119,1590,6510,1,28,2015,UNK,180,-477
8712100530,8/13/2014,895000.0,4,2.0,1710,4178,1.5,0.0,0.0,4,8,1710,0,1926,0,98112,47.6373,-122.3,1760,4178,8,13,2014,UNK,-50,0
3814800300,8/11/2014,386000.0,4,2.5,2810,11897,2.0,0.0,0.0,3,8,2810,0,2003,0,98092,47.3251,-122.186,1770,4240,8,11,2014,UNK,1040,7657
4022300035,10/9/2014,424000.0,3,1.0,1580,13912,1.0,0.0,0.0,4,8,1580,0,1955,0,98155,47.7552,-122.27600000000001,2130,16420,10,9,2014,UNK,-550,-2508
6021503840,6/10/2014,749000.0,3,1.0,1580,5000,1.5,0.0,0.0,3,7,1580,0,1926,0,98117,47.684,-122.38600000000001,1280,4000,6,10,2014,UNK,300,1000
5210200081,11/10/2014,523000.0,3,1.0,1440,8681,1.5,0.0,0.0,3,7,1440,0,1937,0,98115,47.6976,-122.28299999999999,1700,7770,11,10,2014,UNK,-260,911
821049123,10/28/2014,389000.0,4,2.5,2420,9147,2.0,0.0,0.0,3,10,2420,0,1998,0,98003,47.3221,-122.322,1400,7200,10,28,2014,UNK,1020,1947
6929600945,8/25/2014,270000.0,4,1.5,1930,15000,1.0,0.0,0.0,5,7,1930,0,1946,0,98198,47.3864,-122.31200000000001,1620,7500,8,25,2014,UNK,310,7500
5229300027,9/10/2014,275000.0,3,1.0,1190,27215,1.0,0.0,0.0,5,7,1190,0,1943,1989,98059,47.4978,-122.115,1450,56628,9,10,2014,Y,-260,-29413
2214800730,9/5/2014,287500.0,4,2.5,2240,6944,1.0,0.0,2.0,3,7,1310,930,1979,0,98001,47.338,-122.258,1780,7477,9,5,2014,UNK,460,-533
3521059124,9/24/2014,345000.0,2,2.5,2550,216344,2.5,0.0,0.0,3,7,2550,0,1993,0,98092,47.2584,-122.124,1750,289978,9,24,2014,UNK,800,-73634
1931300850,5/27/2014,427000.0,2,1.0,920,3780,1.0,0.0,0.0,3,6,920,0,1910,0,98103,47.6576,-122.348,1570,2640,5,27,2014,UNK,-650,1140
2206500110,9/5/2014,508450.0,4,1.75,1520,9600,1.0,0.0,0.0,4,7,1000,520,1955,0,98006,47.5763,-122.154,1510,9000,9,5,2014,UNK,10,600
3856903515,12/22/2014,705000.0,3,2.0,1460,6250,1.5,0.0,0.0,4,7,1460,0,1912,0,98103,47.6693,-122.333,1690,4750,12,22,2014,UNK,-230,1500
5561401530,10/29/2014,550000.0,1,1.5,1900,40600,1.5,0.0,0.0,5,9,1450,450,1977,0,98027,47.4718,-122.009,2920,40427,10,29,2014,UNK,-1020,173
2206900065,5/1/2015,380000.0,3,1.5,1430,11173,1.0,0.0,0.0,1,7,1430,0,1955,0,98006,47.5734,-122.15299999999999,1520,11659,5,1,2015,UNK,-90,-486
7852090820,7/29/2014,539900.0,3,2.5,2500,4203,2.0,0.0,0.0,3,8,2500,0,2001,0,98065,47.5346,-121.875,2460,4798,7,29,2014,UNK,40,-595
2354300915,9/3/2014,330000.0,2,1.0,720,7250,1.0,0.0,0.0,3,5,720,0,1943,0,98027,47.5267,-122.03200000000001,1760,7250,9,3,2014,UNK,-1040,0
9214400120,6/2/2014,455000.0,2,1.0,1140,5720,1.0,0.0,0.0,3,7,850,290,1947,0,98115,47.6827,-122.29799999999999,1410,5832,6,2,2014,UNK,-270,-112
7298050090,10/7/2014,510000.0,4,4.0,3530,10935,2.0,0.0,0.0,3,10,3530,0,1992,0,98023,47.3016,-122.34200000000001,3360,11250,10,7,2014,UNK,170,-315
1323059098,4/2/2015,315000.0,3,2.0,1220,14645,1.0,0.0,0.0,3,6,1220,0,1970,0,98059,47.4842,-122.117,1980,24960,4,2,2015,UNK,-760,-10315
7345000120,6/17/2014,206000.0,3,1.0,1320,7000,1.0,0.0,0.0,4,7,1320,0,1967,0,98002,47.2787,-122.205,1260,7455,6,17,2014,UNK,60,-455
8563050110,5/22/2014,592500.0,4,3.0,2170,8240,1.0,0.0,0.0,4,8,1370,800,1968,0,98052,47.6291,-122.09299999999999,2020,7944,5,22,2014,UNK,150,296
3754010040,10/23/2014,744000.0,3,2.5,2020,7512,2.0,0.0,0.0,4,8,2020,0,1981,0,98033,47.6927,-122.206,2410,8500,10,23,2014,UNK,-390,-988
8944320100,10/27/2014,334500.0,3,2.5,1990,3694,2.0,0.0,0.0,3,8,1990,0,1989,0,98042,47.3872,-122.154,2110,3842,10,27,2014,UNK,-120,-148
6788201781,6/5/2014,886000.0,4,2.0,2660,3900,1.5,0.0,0.0,4,7,1480,1180,1923,0,98112,47.6398,-122.306,2350,3900,6,5,2014,UNK,310,0
1036400100,10/21/2014,600000.0,4,2.5,2360,13500,1.0,0.0,0.0,4,8,1780,580,1973,0,98052,47.6315,-122.103,2780,12400,10,21,2014,UNK,-420,1100
323089085,4/22/2015,850000.0,3,2.0,2740,101930,1.0,0.0,2.0,3,9,2740,0,1999,0,98045,47.5056,-121.77,2140,83635,4,22,2015,UNK,600,18295
7905200365,4/8/2015,550000.0,3,1.75,1360,5850,1.0,0.0,0.0,4,7,1000,360,1938,0,98116,47.5711,-122.391,1540,5850,4,8,2015,UNK,-180,0
2420069268,8/21/2014,184900.0,2,1.0,1230,5000,1.0,0.0,0.0,5,6,1230,0,1911,0,98022,47.2064,-121.988,1230,5413,8,21,2014,UNK,0,-413
7957600025,5/8/2014,245000.0,3,1.5,1260,7964,1.0,0.0,0.0,4,7,1260,0,1955,0,98148,47.4307,-122.334,1510,8776,5,8,2014,UNK,-250,-812
1338600090,9/23/2014,370000.0,2,1.0,1040,4172,1.0,0.0,0.0,3,7,1040,0,1946,0,98112,47.6308,-122.302,3120,4800,9,23,2014,UNK,-2080,-628
5255690100,4/21/2015,480000.0,4,2.5,2700,9700,1.0,0.0,0.0,3,8,1670,1030,1978,0,98011,47.7752,-122.198,2470,9228,4,21,2015,UNK,230,472
1646500365,11/21/2014,579000.0,3,1.75,1800,4429,2.0,0.0,0.0,4,7,1800,0,1906,0,98103,47.6842,-122.35700000000001,1310,4429,11,21,2014,UNK,490,0
2645500021,10/9/2014,339275.0,3,1.5,1590,7260,1.0,0.0,0.0,3,7,1080,510,1964,0,98133,47.7753,-122.353,1590,7594,10,9,2014,UNK,0,-334
2220069003,2/23/2015,425000.0,3,2.75,1360,542322,1.0,0.0,2.0,4,7,1140,220,1955,0,98022,47.2069,-122.024,1700,60548,2,23,2015,UNK,-340,481774
2123049498,1/20/2015,170000.0,3,1.75,1370,10780,1.0,0.0,0.0,3,7,1370,0,1959,0,98168,47.4727,-122.29799999999999,1370,10317,1,20,2015,UNK,0,463
4139450360,5/14/2014,950000.0,4,2.5,3320,7644,2.0,0.0,0.0,3,10,3320,0,1995,0,98006,47.5541,-122.10600000000001,3320,9472,5,14,2014,UNK,0,-1828
2600100300,9/16/2014,623000.0,4,2.5,2980,9235,1.0,0.0,0.0,4,8,1690,1290,1977,0,98006,47.5513,-122.162,2690,10046,9,16,2014,UNK,290,-811
2767600150,5/19/2014,477000.0,3,2.5,1350,2053,3.0,0.0,0.0,3,8,1350,0,2005,0,98117,47.6758,-122.38600000000001,1350,4150,5,19,2014,N,0,-2097
1771000970,10/10/2014,330000.0,3,1.0,1160,9600,1.0,0.0,0.0,4,7,1160,0,1967,0,98077,47.7419,-122.073,1160,9730,10,10,2014,UNK,0,-130
7960100120,6/12/2014,600000.0,3,2.25,1480,5400,2.0,0.0,0.0,4,8,1480,0,1914,0,98122,47.6095,-122.296,1280,3600,6,12,2014,UNK,200,1800
424049039,7/7/2014,570000.0,3,2.0,1640,2808,1.0,0.0,3.0,4,7,820,820,1924,0,98144,47.5945,-122.291,2270,5328,7,7,2014,UNK,-630,-2520
7853220970,5/28/2014,515000.0,4,2.5,2680,7178,2.0,0.0,0.0,3,8,2680,0,2004,0,98065,47.5325,-121.85600000000001,2540,7133,5,28,2014,N,140,45
439000230,4/29/2015,805000.0,4,2.25,2440,9889,1.0,0.0,0.0,3,7,1540,900,1952,0,98115,47.6932,-122.3,1710,6284,4,29,2015,UNK,730,3605
9406510040,2/6/2015,555000.0,4,2.5,2920,24074,2.0,0.0,0.0,3,9,2920,0,1997,0,98038,47.381,-122.056,2760,26023,2,6,2015,UNK,160,-1949
7697850360,2/4/2015,245000.0,3,2.25,1780,9598,2.0,0.0,0.0,4,7,1780,0,1985,0,98030,47.3718,-122.182,1820,7533,2,4,2015,UNK,-40,2065
2923500750,7/18/2014,638150.0,4,2.5,2170,7275,1.0,0.0,0.0,3,8,1820,350,1978,0,98027,47.5672,-122.09,2390,7275,7,18,2014,UNK,-220,0
3024059057,5/1/2015,1650000.0,4,4.5,5550,16065,2.0,0.0,0.0,3,9,3880,1670,2003,0,98040,47.5455,-122.214,3470,16488,5,1,2015,UNK,2080,-423
322059095,8/11/2014,269950.0,4,2.5,2060,13500,1.0,0.0,0.0,3,7,1260,800,1968,0,98042,47.4229,-122.15299999999999,1610,10714,8,11,2014,UNK,450,2786
8651400580,9/20/2014,195000.0,3,1.5,1050,5525,1.0,0.0,0.0,5,6,1050,0,1969,0,98042,47.3608,-122.083,1100,5200,9,20,2014,UNK,-50,325
7812800855,3/11/2015,159100.0,2,1.0,790,7095,1.0,0.0,0.0,3,6,790,0,1944,0,98178,47.4928,-122.23899999999999,1150,7200,3,11,2015,UNK,-360,-105
4151800265,3/6/2015,550000.0,3,1.0,1010,6120,1.0,0.0,0.0,3,6,1010,0,1942,0,98033,47.6648,-122.204,1260,5977,3,6,2015,UNK,-250,143
1005000062,8/1/2014,299000.0,2,1.0,1040,4600,1.0,0.0,0.0,4,6,1040,0,1950,0,98118,47.5387,-122.277,1390,5897,8,1,2014,UNK,-350,-1297
9528105305,1/21/2015,1380000.0,4,3.5,3130,4500,2.0,0.0,0.0,3,9,2060,1070,2014,0,98103,47.677,-122.33,1500,4500,1,21,2015,N,1630,0
7225000215,4/7/2015,249500.0,2,1.0,900,4500,1.0,0.0,0.0,3,6,900,0,1951,0,98055,47.4881,-122.204,860,4500,4,7,2015,UNK,40,0
5605000215,2/25/2015,700000.0,4,1.0,1470,5450,1.5,0.0,0.0,3,7,1470,0,1918,0,98112,47.6458,-122.306,2160,5450,2,25,2015,UNK,-690,0
1922059401,7/25/2014,275000.0,4,1.0,1080,26114,1.5,0.0,0.0,5,5,1080,0,1900,0,98030,47.3834,-122.215,1720,20360,7,25,2014,UNK,-640,5754
3824100286,3/19/2015,565000.0,3,2.25,2440,8378,1.0,0.0,0.0,3,7,1480,960,1962,0,98028,47.7705,-122.26,2510,9602,3,19,2015,UNK,-70,-1224
1226039058,5/3/2015,425000.0,4,1.75,2520,11017,1.0,0.0,0.0,4,7,1320,1200,1956,0,98133,47.7604,-122.35600000000001,1660,8775,5,3,2015,UNK,860,2242
2770605175,2/27/2015,620047.0,4,1.75,1760,6000,1.0,0.0,0.0,3,7,880,880,1946,0,98119,47.6508,-122.37299999999999,2040,6000,2,27,2015,UNK,-280,0
6791200120,9/23/2014,480000.0,3,2.25,1820,13362,1.0,0.0,0.0,3,8,1220,600,1977,0,98075,47.5898,-122.052,2050,15000,9,23,2014,UNK,-230,-1638
6791200120,4/7/2015,515000.0,3,2.25,1820,13362,1.0,0.0,0.0,3,8,1220,600,1977,0,98075,47.5898,-122.052,2050,15000,4,7,2015,UNK,-230,-1638
4137010590,5/14/2014,420000.0,4,2.5,3040,24123,2.0,0.0,0.0,3,8,3040,0,1999,0,98092,47.2667,-122.21600000000001,2420,10026,5,14,2014,UNK,620,14097
5495200040,1/26/2015,610000.0,5,3.25,3490,23400,1.0,0.0,0.0,4,8,1890,1600,1957,0,98006,47.5701,-122.124,2660,12400,1,26,2015,UNK,830,11000
868000175,10/1/2014,849000.0,4,1.5,2440,8040,1.0,0.0,0.0,4,8,1440,1000,1950,0,98177,47.7081,-122.374,2140,7920,10,1,2014,UNK,300,120
8820902549,11/19/2014,718000.0,3,1.75,2280,3446,2.0,0.0,0.0,3,8,2280,0,1949,1991,98125,47.715,-122.28200000000001,1610,6670,11,19,2014,Y,670,-3224
8731980040,5/6/2014,295000.0,3,2.25,1980,8000,1.0,0.0,0.0,4,9,1560,420,1974,0,98023,47.3149,-122.37799999999999,2360,8000,5,6,2014,UNK,-380,0
3096000040,4/30/2015,871000.0,5,1.75,2360,6150,1.0,0.0,0.0,5,7,1180,1180,1940,0,98107,47.6732,-122.4,2100,5500,4,30,2015,UNK,260,650
4058800215,5/28/2014,430000.0,3,3.75,3890,7140,1.0,0.0,2.0,3,8,2390,1500,1943,2007,98178,47.5073,-122.23899999999999,1820,7320,5,28,2014,Y,2070,-180
3579800405,8/25/2014,440000.0,4,2.5,2300,10880,1.0,0.0,0.0,4,7,1190,1110,1961,0,98028,47.7341,-122.242,1960,10400,8,25,2014,UNK,340,480
3188100065,5/27/2014,405000.0,2,1.0,910,6490,1.0,0.0,0.0,3,7,910,0,1942,0,98115,47.6892,-122.306,1040,6490,5,27,2014,UNK,-130,0
8570900038,8/11/2014,340000.0,3,2.0,1140,11620,1.0,0.0,0.0,3,7,1140,0,1994,0,98045,47.4991,-121.78299999999999,1140,8400,8,11,2014,UNK,0,3220
4379400490,7/10/2014,675000.0,4,2.5,2390,5249,2.0,0.0,0.0,3,9,2390,0,2006,0,98074,47.6194,-122.02600000000001,2600,5342,7,10,2014,N,-210,-93
952003575,5/27/2014,480000.0,3,1.0,1150,4945,1.0,0.0,2.0,3,7,1150,0,1943,0,98126,47.5663,-122.37899999999999,1390,4945,5,27,2014,UNK,-240,0
162500015,10/20/2014,362500.0,5,2.0,2330,8586,1.0,0.0,0.0,4,7,1270,1060,1961,0,98133,47.7671,-122.334,1550,8287,10,20,2014,UNK,780,299
7732410360,8/22/2014,752888.0,3,2.5,2420,9000,2.0,0.0,0.0,4,9,2420,0,1987,0,98007,47.6599,-122.146,2630,9000,8,22,2014,UNK,-210,0
3031200120,11/18/2014,255000.0,4,1.75,960,8863,1.0,0.0,0.0,5,6,580,380,1949,0,98118,47.5372,-122.289,1720,8249,11,18,2014,UNK,-760,614
2131700900,8/13/2014,283700.0,1,1.75,1010,10900,1.0,0.0,0.0,4,6,1010,0,1968,0,98019,47.7391,-121.98200000000001,1410,8359,8,13,2014,UNK,-400,2541
2122059198,8/25/2014,335000.0,4,2.5,2370,6000,2.0,0.0,0.0,3,8,2370,0,2001,0,98030,47.3732,-122.179,2190,6070,8,25,2014,UNK,180,-70
7340600735,6/3/2014,285000.0,3,1.75,2880,18296,1.0,0.0,0.0,3,8,1580,1300,1958,0,98168,47.4881,-122.281,1380,9592,6,3,2014,UNK,1500,8704
2923049393,8/13/2014,278000.0,4,2.25,2400,7738,1.5,0.0,0.0,3,8,2400,0,1964,0,98148,47.4562,-122.33,2170,8452,8,13,2014,UNK,230,-714
7922710450,3/27/2015,731000.0,5,2.5,3670,8960,1.5,0.0,0.0,3,8,3670,0,1973,0,98052,47.6654,-122.14200000000001,2340,9425,3,27,2015,UNK,1330,-465
192450180,3/10/2015,335000.0,3,1.5,1140,15890,1.0,0.0,0.0,3,7,840,300,1985,0,98045,47.4752,-121.757,1200,15247,3,10,2015,UNK,-60,643
782700120,3/23/2015,334200.0,3,1.75,1410,45302,1.0,0.0,0.0,3,7,1410,0,1980,0,98019,47.7077,-121.914,2240,49222,3,23,2015,UNK,-830,-3920
2887703155,2/25/2015,642000.0,6,1.0,1530,4305,1.5,0.0,0.0,4,7,1530,0,1921,0,98115,47.6862,-122.31,1530,3800,2,25,2015,UNK,0,505
5700000245,6/2/2014,540000.0,4,1.75,1720,4240,1.5,0.0,0.0,4,7,1460,260,1925,0,98144,47.57899999999999,-122.294,1930,4280,6,2,2014,UNK,-210,-40
2420069003,3/31/2015,299000.0,3,2.5,1620,79993,1.0,0.0,2.0,4,6,1620,0,1960,0,98022,47.2138,-121.98200000000001,1620,15680,3,31,2015,UNK,0,64313
9274202165,1/20/2015,560000.0,3,1.75,1570,4375,1.0,0.0,0.0,3,7,970,600,1940,0,98116,47.5889,-122.389,1790,5750,1,20,2015,UNK,-220,-1375
9287802410,8/22/2014,852000.0,5,2.75,1990,3750,1.5,0.0,0.0,4,7,1990,0,1913,0,98107,47.6733,-122.35799999999999,1820,5000,8,22,2014,UNK,170,-1250
2324039077,4/27/2015,306000.0,2,1.0,930,5650,1.0,0.0,2.0,3,7,930,0,1941,0,98126,47.5478,-122.37700000000001,1340,6400,4,27,2015,UNK,-410,-750
9329300040,9/10/2014,440000.0,3,1.75,1550,7820,1.0,0.0,0.0,4,7,1210,340,1981,0,98034,47.717,-122.163,1550,6900,9,10,2014,UNK,0,920
259700180,4/28/2015,517000.0,4,1.0,1650,8250,1.0,0.0,0.0,3,7,1650,0,1966,0,98008,47.6366,-122.118,2240,9776,4,28,2015,UNK,-590,-1526
5100400315,5/23/2014,379000.0,2,1.0,800,6380,1.0,0.0,2.0,3,7,800,0,1940,0,98115,47.691,-122.309,920,5940,5,23,2014,UNK,-120,440
3424069076,10/13/2014,360000.0,2,1.0,930,6098,1.0,0.0,0.0,4,6,930,0,1919,0,98027,47.5289,-122.03,1730,9000,10,13,2014,UNK,-800,-2902
9138100261,10/29/2014,645000.0,4,1.5,2550,4000,1.5,0.0,0.0,4,7,1760,790,1926,0,98115,47.6811,-122.318,1840,4000,10,29,2014,UNK,710,0
7227500740,11/7/2014,217000.0,2,1.0,720,4760,1.0,0.0,0.0,5,5,720,0,1942,0,98056,47.496,-122.186,840,4760,11,7,2014,UNK,-120,0
8150100265,11/18/2014,255000.0,2,1.0,620,4760,1.0,0.0,0.0,3,6,620,0,1941,0,98126,47.5292,-122.376,620,4760,11,18,2014,UNK,0,0
1150000040,7/21/2014,625000.0,3,2.5,2360,12164,2.0,0.0,0.0,3,10,2360,0,1987,0,98029,47.5596,-122.022,2400,11260,7,21,2014,UNK,-40,904
9238900616,6/10/2014,680000.0,3,1.75,1760,8400,1.0,0.0,0.0,4,8,1460,300,1960,0,98136,47.5355,-122.39,1980,8400,6,10,2014,UNK,-220,0
9289900065,9/11/2014,440000.0,3,1.75,2100,29735,1.0,0.0,0.0,4,7,1080,1020,1957,0,98155,47.7622,-122.302,2100,11250,9,11,2014,UNK,0,18485
7504020610,6/18/2014,615000.0,5,2.25,2480,12070,2.0,0.0,0.0,3,9,2480,0,1978,0,98074,47.631,-122.052,2570,12000,6,18,2014,UNK,-90,70
7454001210,6/3/2014,239000.0,3,1.0,1040,6860,2.0,0.0,0.0,3,6,1040,0,1942,0,98146,47.5121,-122.375,1030,6512,6,3,2014,UNK,10,348
2122039137,4/13/2015,462500.0,3,2.5,1656,108900,1.0,0.0,0.0,4,7,1656,0,1985,0,98070,47.3758,-122.425,2030,29859,4,13,2015,UNK,-374,79041
6884800180,6/11/2014,619400.0,4,2.0,2090,3610,1.5,0.0,0.0,5,7,1790,300,1927,0,98115,47.6881,-122.31299999999999,1660,3767,6,11,2014,UNK,430,-157
7110000068,7/3/2014,975000.0,6,2.75,2520,54160,2.0,1.0,4.0,3,7,2520,0,1954,0,98146,47.4969,-122.376,2790,26809,7,3,2014,UNK,-270,27351
7625701935,10/13/2014,330000.0,2,1.0,700,4000,1.0,0.0,0.0,3,6,700,0,1943,0,98136,47.5487,-122.391,1060,6000,10,13,2014,UNK,-360,-2000
4054500180,7/24/2014,985000.0,4,3.25,4030,36762,2.0,0.0,0.0,3,11,4030,0,1988,0,98077,47.7235,-122.039,4090,40371,7,24,2014,UNK,-60,-3609
2917200475,3/23/2015,430000.0,2,1.0,760,7114,1.0,0.0,0.0,3,6,760,0,1946,0,98103,47.7005,-122.352,780,7102,3,23,2015,UNK,-20,12
3262300555,7/8/2014,2460000.0,4,5.25,6500,14986,2.0,0.0,0.0,3,11,5180,1320,2001,0,98039,47.6304,-122.236,2270,8119,7,8,2014,UNK,4230,6867
1245003740,7/23/2014,778000.0,3,2.0,1840,6000,2.0,0.0,0.0,5,7,1720,120,1946,0,98033,47.6828,-122.20700000000001,1390,6000,7,23,2014,UNK,450,0
1796381120,7/28/2014,219000.0,3,2.0,1090,7350,1.0,0.0,0.0,4,7,1090,0,1990,0,98042,47.3687,-122.085,1490,7741,7,28,2014,UNK,-400,-391
3761100180,9/17/2014,1600000.0,4,2.5,2980,13341,1.5,1.0,4.0,5,8,1800,1180,1928,0,98034,47.70399999999999,-122.245,2340,19810,9,17,2014,UNK,640,-6469
6666800180,1/30/2015,715000.0,4,2.25,1900,8272,1.0,0.0,0.0,4,9,1460,440,1966,0,98040,47.5803,-122.227,2040,8479,1,30,2015,UNK,-140,-207
8651200040,8/14/2014,950000.0,4,2.5,2790,15653,2.0,0.0,0.0,4,10,2790,0,1964,0,98040,47.5477,-122.215,3520,15653,8,14,2014,UNK,-730,0
5100402310,12/12/2014,425000.0,2,1.0,1280,5026,1.0,0.0,2.0,4,8,1020,260,1951,0,98115,47.6938,-122.31200000000001,1540,6380,12,12,2014,UNK,-260,-1354
421049170,7/17/2014,239000.0,3,1.0,1510,15022,1.0,0.0,0.0,3,7,1510,0,1962,0,98003,47.3304,-122.304,1510,12970,7,17,2014,UNK,0,2052
726059047,12/16/2014,310000.0,1,1.0,920,8282,1.5,0.0,0.0,3,6,920,0,1944,0,98011,47.761,-122.214,2260,14025,12,16,2014,UNK,-1340,-5743
5100403636,2/23/2015,400000.0,2,1.0,700,8120,1.0,0.0,0.0,3,7,700,0,1927,0,98115,47.6962,-122.321,1130,5599,2,23,2015,UNK,-430,2521
1535204365,11/24/2014,428000.0,2,1.75,1980,44550,2.0,0.0,1.0,5,7,1280,700,1977,0,98070,47.4193,-122.444,1680,25343,11,24,2014,UNK,300,19207
4240400155,8/12/2014,600000.0,3,1.0,1440,4300,1.5,0.0,0.0,3,8,1440,0,1929,0,98117,47.6847,-122.37200000000001,1640,4500,8,12,2014,UNK,-200,-200
5468750040,1/26/2015,415000.0,4,4.0,2740,8250,2.0,0.0,0.0,4,9,2740,0,1990,0,98042,47.3735,-122.156,2290,8250,1,26,2015,UNK,450,0
9158100040,8/8/2014,401000.0,2,1.0,1400,8220,1.0,0.0,0.0,3,7,1400,0,1949,0,98133,47.7228,-122.35700000000001,1760,8220,8,8,2014,UNK,-360,0
7460000040,12/15/2014,292000.0,3,1.75,2270,7156,1.0,0.0,0.0,3,7,1370,900,1948,0,98168,47.4864,-122.316,1210,7156,12,15,2014,UNK,1060,0
2927600155,7/22/2014,291750.0,3,2.25,1310,12825,1.0,0.0,0.0,3,7,1310,0,1950,2013,98166,47.4515,-122.368,1600,11250,7,22,2014,Y,-290,1575
8731950910,2/18/2015,227000.0,3,1.75,1680,7455,1.0,0.0,0.0,4,8,1680,0,1968,0,98023,47.3112,-122.37799999999999,2040,8214,2,18,2015,UNK,-360,-759
1726600110,7/17/2014,675000.0,3,2.25,2260,13209,1.0,0.0,0.0,3,9,2260,0,1977,0,98005,47.6385,-122.167,2820,12534,7,17,2014,UNK,-560,675
3320000212,10/6/2014,397500.0,3,2.25,1350,980,2.0,0.0,0.0,3,8,1050,300,2007,0,98144,47.5998,-122.31200000000001,1350,1245,10,6,2014,N,0,-265
1670400068,6/18/2014,206000.0,2,1.5,1820,8867,2.0,0.0,0.0,3,7,1820,0,1921,0,98168,47.4764,-122.26899999999999,1430,9288,6,18,2014,UNK,390,-421
7424700145,7/30/2014,1190000.0,3,3.5,3380,3333,3.0,0.0,0.0,3,10,2800,580,2008,0,98122,47.6162,-122.288,2790,5000,7,30,2014,N,590,-1667
2408800120,7/16/2014,360000.0,4,1.75,2140,49658,1.0,0.0,0.0,5,7,2140,0,1959,0,98010,47.3583,-121.92200000000001,1720,99316,7,16,2014,UNK,420,-49658
1776230180,10/8/2014,427500.0,4,2.5,2430,3249,2.0,0.0,0.0,3,8,2430,0,2010,0,98059,47.5048,-122.155,2650,3844,10,8,2014,N,-220,-595
7889601320,7/25/2014,115000.0,2,1.0,940,6000,1.0,0.0,0.0,3,6,940,0,1943,0,98146,47.4907,-122.336,1310,6000,7,25,2014,UNK,-370,0
7589200153,6/9/2014,559000.0,3,1.5,2070,5386,1.0,0.0,0.0,4,7,1140,930,1948,0,98117,47.6896,-122.374,1770,5386,6,9,2014,UNK,300,0
8032700175,10/27/2014,420000.0,4,1.0,1510,1501,1.5,0.0,0.0,3,7,1510,0,1906,0,98103,47.6526,-122.34200000000001,1560,1602,10,27,2014,UNK,-50,-101
9238430300,11/6/2014,550000.0,4,1.75,2550,39460,1.0,0.0,0.0,3,8,1890,660,1982,0,98072,47.7707,-122.12299999999999,2560,38638,11,6,2014,UNK,-10,822
6150700180,9/22/2014,282150.0,2,1.0,700,5940,1.0,0.0,0.0,3,7,700,0,1948,0,98133,47.7289,-122.337,1070,5995,9,22,2014,UNK,-370,-55
3330501645,2/23/2015,260000.0,3,1.0,1150,3090,1.0,0.0,0.0,3,6,1150,0,1910,0,98118,47.5506,-122.27600000000001,1150,5664,2,23,2015,UNK,0,-2574
7853210180,10/2/2014,428000.0,3,2.5,2340,3466,2.0,0.0,0.0,3,7,2340,0,2004,0,98065,47.5322,-121.851,1970,3739,10,2,2014,N,370,-273
6149700194,10/15/2014,319950.0,3,3.25,1510,1245,3.0,0.0,0.0,3,7,1510,0,2007,0,98133,47.7293,-122.34299999999999,1510,1245,10,15,2014,N,0,0
3625049079,8/1/2014,1350000.0,3,2.0,2070,9600,1.0,0.0,1.0,3,7,1590,480,1946,0,98039,47.61600000000001,-122.23899999999999,3000,16215,8,1,2014,UNK,-930,-6615
2979800750,9/11/2014,552000.0,2,1.0,1150,5000,1.0,0.0,0.0,4,7,1050,100,1924,0,98115,47.6846,-122.31700000000001,1463,4320,9,11,2014,UNK,-313,680
2887700970,2/9/2015,637000.0,4,2.75,2190,2867,1.5,0.0,0.0,5,7,1470,720,1929,0,98115,47.6868,-122.30799999999999,1600,3800,2,9,2015,UNK,590,-933
8732130940,6/9/2014,213000.0,4,1.75,1980,9000,1.0,0.0,0.0,2,7,1480,500,1978,0,98023,47.3071,-122.381,1980,9360,6,9,2014,UNK,0,-360
2968800645,4/28/2015,215000.0,3,1.0,960,7200,1.0,0.0,0.0,4,6,960,0,1958,0,98166,47.4583,-122.353,1060,7620,4,28,2015,UNK,-100,-420
2351800065,2/17/2015,590000.0,3,1.75,2180,6120,1.0,0.0,2.0,3,8,1380,800,1949,0,98199,47.6501,-122.405,2020,6122,2,17,2015,UNK,160,-2
2822069080,11/21/2014,390000.0,4,2.5,2560,43560,2.0,0.0,0.0,3,8,2560,0,1989,0,98038,47.3692,-122.04700000000001,2130,10150,11,21,2014,UNK,430,33410
5018200110,9/22/2014,287000.0,4,2.25,2270,11997,1.0,0.0,2.0,4,7,1540,730,1959,0,98198,47.4095,-122.296,1920,9634,9,22,2014,UNK,350,2363
1235100371,7/17/2014,580000.0,5,2.75,3550,9600,2.0,0.0,0.0,3,7,3550,0,1960,0,98033,47.6766,-122.186,3370,9600,7,17,2014,UNK,180,0
3904930410,10/28/2014,424000.0,3,2.0,1330,5632,1.0,0.0,0.0,3,8,1330,0,1988,0,98029,47.5745,-122.01700000000001,1900,4842,10,28,2014,UNK,-570,790
3529000880,3/9/2015,610000.0,4,2.5,2110,6360,2.0,0.0,0.0,3,8,2110,0,1988,0,98029,47.5641,-122.012,2050,7000,3,9,2015,UNK,60,-640
8081020330,7/29/2014,1320000.0,4,3.25,3470,11843,1.0,0.0,3.0,3,11,2270,1200,1989,0,98006,47.5513,-122.135,3910,13247,7,29,2014,UNK,-440,-1404
2516000515,12/18/2014,623500.0,4,3.0,1550,3350,1.0,0.0,0.0,3,7,860,690,1918,2014,98107,47.6583,-122.36200000000001,1310,5000,12,18,2014,Y,240,-1650
3223039010,8/4/2014,260000.0,2,1.0,570,81893,1.0,0.0,1.0,3,6,570,0,1936,0,98070,47.4433,-122.444,2040,115434,8,4,2014,UNK,-1470,-33541
9828702588,3/11/2015,906000.0,3,2.5,2030,1800,3.0,0.0,0.0,3,9,2030,0,2013,0,98112,47.6199,-122.3,1450,1441,3,11,2015,N,580,359
6672920150,4/6/2015,330000.0,3,2.0,1500,11233,1.0,0.0,0.0,3,7,1500,0,1987,0,98019,47.7279,-121.96700000000001,1580,14013,4,6,2015,UNK,-80,-2780
9485700150,3/4/2015,275000.0,2,1.0,920,7688,1.0,0.0,0.0,3,6,920,0,1955,0,98106,47.5281,-122.36200000000001,1040,7440,3,4,2015,UNK,-120,248
3500100208,11/19/2014,290000.0,3,1.0,1470,8200,1.0,0.0,0.0,3,7,1040,430,1953,0,98155,47.7347,-122.302,1420,8200,11,19,2014,UNK,50,0
4083302915,9/17/2014,599950.0,2,1.0,1150,3775,1.0,0.0,0.0,3,7,1150,0,1917,0,98103,47.6539,-122.329,2240,3753,9,17,2014,UNK,-1090,22
1560920450,9/24/2014,550000.0,4,3.0,4180,35169,2.0,0.0,0.0,3,11,4180,0,1986,1998,98038,47.4,-122.027,3010,35190,9,24,2014,Y,1170,-21
2475200930,7/22/2014,289000.0,3,1.75,1690,3449,1.0,0.0,0.0,3,7,1690,0,1987,0,98055,47.4719,-122.191,1530,4093,7,22,2014,UNK,160,-644
2064800120,6/2/2014,411000.0,4,2.75,2150,9915,1.0,0.0,0.0,5,8,1240,910,1976,0,98056,47.5378,-122.17,1980,9325,6,2,2014,UNK,170,590
272000945,3/25/2015,826000.0,3,3.25,2330,4000,1.0,0.0,2.0,3,10,1730,600,1964,2000,98144,47.5882,-122.295,2080,4000,3,25,2015,Y,250,0
9476700035,7/10/2014,400000.0,4,2.0,2680,13680,2.0,0.0,2.0,4,7,2350,330,1943,0,98056,47.4887,-122.19200000000001,1430,11000,7,10,2014,UNK,1250,2680
859000018,8/14/2014,342000.0,3,2.5,1740,2226,2.0,0.0,0.0,3,8,1320,420,2008,0,98106,47.525,-122.366,1740,1789,8,14,2014,N,0,437
4237900645,10/10/2014,475000.0,2,1.75,1320,3420,1.0,0.0,1.0,3,7,1080,240,1955,0,98199,47.6639,-122.399,2070,6000,10,10,2014,UNK,-750,-2580
2436200436,7/8/2014,1210000.0,4,3.5,3150,5500,2.0,0.0,0.0,3,9,3150,0,2014,0,98105,47.6644,-122.29299999999999,1550,4200,7,8,2014,N,1600,1300
7635801321,7/23/2014,455000.0,4,3.0,2480,9238,1.0,0.0,0.0,5,7,2050,430,1913,0,98166,47.4701,-122.36399999999999,1820,12214,7,23,2014,UNK,660,-2976
3975400085,6/24/2014,850000.0,4,3.0,3330,4000,1.0,0.0,0.0,3,8,1790,1540,1958,0,98103,47.6559,-122.344,1610,4000,6,24,2014,UNK,1720,0
1099600220,1/8/2015,185000.0,3,1.0,1010,6400,1.0,0.0,0.0,3,7,1010,0,1971,0,98023,47.3027,-122.376,1820,6500,1,8,2015,UNK,-810,-100
8952900245,7/15/2014,850000.0,6,3.25,4920,20590,1.0,0.0,3.0,4,9,2730,2190,1960,0,98118,47.5468,-122.26700000000001,3700,14994,7,15,2014,UNK,1220,5596
1622049140,8/5/2014,239900.0,4,1.75,1570,18730,1.0,0.0,0.0,3,7,1200,370,1960,0,98198,47.3999,-122.301,1920,18295,8,5,2014,UNK,-350,435
2824069373,5/15/2014,765000.0,5,3.75,3580,14275,2.0,0.0,0.0,3,10,3190,390,1999,0,98027,47.5322,-122.056,2740,14300,5,15,2014,UNK,840,-25
1774000330,7/7/2014,437000.0,3,1.75,2220,17568,1.0,0.0,0.0,4,8,2220,0,1967,0,98072,47.748999999999995,-122.083,2070,11745,7,7,2014,UNK,150,5823
1555300530,7/14/2014,240000.0,3,1.5,1010,10350,1.0,0.0,0.0,3,7,1010,0,1969,0,98032,47.379,-122.29,1640,7700,7,14,2014,UNK,-630,2650
4402700593,4/28/2015,395000.0,2,1.0,1440,7808,1.0,0.0,0.0,4,7,860,580,1949,0,98133,47.7431,-122.336,1550,7682,4,28,2015,UNK,-110,126
2556500040,1/6/2015,320000.0,3,1.0,1230,7492,1.0,0.0,0.0,3,7,1230,0,1955,0,98155,47.7633,-122.315,1710,7238,1,6,2015,UNK,-480,254
1737100040,10/22/2014,525000.0,3,1.75,1710,7350,1.0,0.0,0.0,3,8,1280,430,1981,0,98033,47.699,-122.167,2100,7560,10,22,2014,UNK,-390,-210
7575620120,4/22/2015,260000.0,3,3.0,2390,8993,2.0,0.0,0.0,3,8,1680,710,1988,0,98003,47.3532,-122.306,1820,10362,4,22,2015,UNK,570,-1369
2817900100,3/30/2015,450000.0,3,2.75,2840,39324,1.0,0.0,0.0,3,9,2200,640,1988,0,98092,47.3076,-122.101,2840,39413,3,30,2015,UNK,0,-89
1939100610,6/23/2014,560000.0,4,2.5,2300,7989,2.0,0.0,0.0,3,9,2300,0,1990,0,98074,47.6273,-122.03399999999999,2280,8835,6,23,2014,UNK,20,-846
4174600386,4/14/2015,310000.0,5,3.0,2270,5001,1.0,0.0,0.0,3,7,1360,910,1989,0,98108,47.5539,-122.3,1950,5500,4,14,2015,UNK,320,-499
1310440590,4/13/2015,440000.0,3,2.5,2290,6302,2.0,0.0,0.0,3,9,2290,0,1997,0,98058,47.435,-122.10700000000001,2700,7500,4,13,2015,UNK,-410,-1198
4037200690,12/8/2014,458450.0,4,1.0,1330,9715,1.0,0.0,0.0,4,7,970,360,1957,0,98008,47.6038,-122.12200000000001,1590,8400,12,8,2014,UNK,-260,1315
8072000035,3/26/2015,200000.0,3,1.0,1200,10703,1.5,0.0,0.0,2,7,1200,0,1918,0,98118,47.5209,-122.28,1380,8068,3,26,2015,UNK,-180,2635
2125410210,12/6/2014,430000.0,3,2.25,2160,6527,2.0,0.0,0.0,4,7,1580,580,1987,0,98034,47.7292,-122.212,1950,9675,12,6,2014,UNK,210,-3148
3755000120,2/26/2015,360000.0,3,1.0,1120,10500,1.0,0.0,0.0,4,7,1120,0,1966,0,98034,47.7267,-122.226,1320,10500,2,26,2015,UNK,-200,0
3598600088,1/9/2015,311000.0,4,2.5,2090,11645,1.0,0.0,0.0,3,7,1200,890,1962,0,98168,47.4759,-122.29899999999999,1450,9481,1,9,2015,UNK,640,2164
4083305633,7/22/2014,615000.0,3,3.25,1470,1152,3.0,0.0,0.0,3,8,1470,0,2003,0,98103,47.6516,-122.337,1470,1506,7,22,2014,UNK,0,-354
9545200180,11/26/2014,575000.0,3,1.75,2270,10136,2.0,0.0,0.0,3,8,2270,0,1979,0,98027,47.535,-122.056,2260,9600,11,26,2014,UNK,10,536
46100504,6/17/2014,2030000.0,4,3.75,4100,22798,1.5,0.0,3.0,5,11,2540,1560,1934,1979,98040,47.5648,-122.21,3880,18730,6,17,2014,Y,220,4068
952000925,9/22/2014,430000.0,3,1.75,1440,4025,1.0,0.0,0.0,4,6,720,720,1917,0,98126,47.567,-122.38,1500,5750,9,22,2014,UNK,-60,-1725
4039300490,6/3/2014,400000.0,3,1.5,1200,4800,1.0,0.0,0.0,4,7,1200,0,1962,0,98007,47.6084,-122.13600000000001,1510,7668,6,3,2014,UNK,-310,-2868
8151600941,8/28/2014,340000.0,3,1.75,1720,10710,1.0,0.0,0.0,3,7,860,860,1957,0,98146,47.5092,-122.36200000000001,1480,10359,8,28,2014,UNK,240,351
3448001975,5/4/2015,351000.0,1,0.75,930,6600,1.0,0.0,0.0,3,6,930,0,1924,0,98125,47.7127,-122.296,1590,6600,5,4,2015,UNK,-660,0
2141500040,9/12/2014,440000.0,4,2.5,2400,8038,2.0,0.0,0.0,3,8,2400,0,2002,0,98059,47.4881,-122.14299999999999,2040,7756,9,12,2014,UNK,360,282
2798600120,4/22/2015,298000.0,4,2.5,1960,11798,2.0,0.0,0.0,3,8,1960,0,1999,0,98092,47.3293,-122.205,2360,11785,4,22,2015,UNK,-400,13
2227900040,1/14/2015,300000.0,4,1.75,1890,9205,1.0,0.0,0.0,3,8,1260,630,1964,0,98133,47.773999999999994,-122.348,1430,6775,1,14,2015,UNK,460,2430
3395040580,10/23/2014,310000.0,3,2.25,1590,3056,2.0,0.0,0.0,3,7,1590,0,2001,0,98108,47.5432,-122.29299999999999,1540,2890,10,23,2014,UNK,50,166
6137610620,8/8/2014,500000.0,4,2.5,2590,9354,2.0,0.0,0.0,4,9,2590,0,1993,0,98011,47.7703,-122.193,2730,9264,8,8,2014,UNK,-140,90
7518505375,5/5/2015,399900.0,3,1.0,860,1664,1.5,0.0,0.0,3,7,860,0,1927,0,98117,47.6761,-122.384,1540,4080,5,5,2015,UNK,-680,-2416
9206950100,6/17/2014,343000.0,3,2.5,1270,2509,2.0,0.0,0.0,3,8,1270,0,2004,0,98106,47.5357,-122.365,1420,2206,6,17,2014,N,-150,303
9542890100,12/29/2014,415000.0,2,2.25,1130,2191,2.0,0.0,0.0,3,8,1130,0,2010,0,98052,47.6861,-122.103,1140,1710,12,29,2014,N,-10,481
4254000620,10/7/2014,410000.0,3,2.5,1860,15457,2.0,0.0,0.0,3,8,1860,0,1997,0,98019,47.7383,-121.955,2040,14055,10,7,2014,UNK,-180,1402
6414100026,1/8/2015,320000.0,2,1.0,1802,11225,1.0,0.0,0.0,3,7,1802,0,1961,0,98125,47.7205,-122.323,1810,7332,1,8,2015,UNK,-8,3893
1346300035,6/26/2014,1990000.0,5,3.0,4480,5000,2.5,0.0,0.0,5,12,3420,1060,1902,0,98112,47.6275,-122.315,3220,5600,6,26,2014,UNK,1260,-600
2212210360,7/2/2014,253000.0,2,1.0,1310,7128,1.0,0.0,0.0,4,7,940,370,1980,0,98031,47.3958,-122.189,1400,7161,7,2,2014,UNK,-90,-33
205000410,9/15/2014,630000.0,3,2.5,2320,32772,2.0,0.0,0.0,3,9,2320,0,1992,0,98053,47.6304,-121.988,2610,33305,9,15,2014,UNK,-290,-533
2892600056,1/6/2015,216000.0,2,1.0,1130,12500,1.0,0.0,0.0,4,7,1130,0,1953,0,98055,47.4514,-122.18700000000001,1270,10798,1,6,2015,UNK,-140,1702
3396800120,4/27/2015,540000.0,3,2.5,2180,11100,1.0,0.0,0.0,3,8,1230,950,1983,0,98052,47.717,-122.101,1930,12000,4,27,2015,UNK,250,-900
2320069089,9/30/2014,212000.0,3,1.5,1830,12233,1.5,0.0,0.0,4,5,1830,0,1930,0,98022,47.2057,-122.00299999999999,1520,12233,9,30,2014,UNK,310,0
4036400110,1/29/2015,300000.0,3,2.75,2340,12282,1.0,0.0,2.0,3,8,1470,870,1978,0,98155,47.7379,-122.289,2640,8887,1,29,2015,UNK,-300,3395
7518506716,8/27/2014,969950.0,3,2.5,2830,3750,3.0,0.0,0.0,3,10,2830,0,2014,0,98117,47.6798,-122.385,1780,5100,8,27,2014,N,1050,-1350
9826701765,8/8/2014,715000.0,3,1.0,1610,7680,1.0,0.0,0.0,3,6,900,710,1956,0,98122,47.6038,-122.303,1940,2880,8,8,2014,UNK,-330,4800
1438700040,8/25/2014,1320000.0,5,2.75,2410,19447,2.0,0.0,2.0,3,10,2290,120,1968,0,98040,47.5549,-122.211,2980,19447,8,25,2014,UNK,-570,0
5494000040,12/1/2014,1440000.0,4,2.75,2660,9547,1.0,0.0,1.0,3,8,1930,730,1968,2006,98004,47.61600000000001,-122.21799999999999,2410,10001,12,1,2014,Y,250,-454
7224500375,7/15/2014,305000.0,3,1.0,1030,5350,1.0,0.0,0.0,3,7,1030,0,1924,2009,98055,47.4905,-122.206,1030,5250,7,15,2014,Y,0,100
1025049254,12/4/2014,458000.0,3,4.0,1390,1569,2.0,0.0,0.0,3,9,1150,240,2006,0,98105,47.67100000000001,-122.26899999999999,1620,1855,12,4,2014,N,-230,-286
2407000110,4/14/2015,275000.0,3,1.75,1580,8775,1.0,0.0,0.0,3,6,1220,360,1942,0,98146,47.4845,-122.335,1180,8775,4,14,2015,UNK,400,0
7203600745,10/14/2014,550000.0,3,2.75,2330,4780,2.0,0.0,3.0,3,8,1730,600,1930,1988,98198,47.3459,-122.32600000000001,1100,5336,10,14,2014,Y,1230,-556
7234601198,6/4/2014,742000.0,3,3.25,1540,704,3.0,0.0,0.0,3,9,1540,0,2011,0,98122,47.6177,-122.30799999999999,1540,1456,6,4,2014,N,0,-752
1931300110,7/25/2014,700000.0,3,1.0,1570,4000,2.0,0.0,0.0,5,8,1570,0,1908,0,98103,47.6575,-122.346,1640,4000,7,25,2014,UNK,-70,0
8624700015,11/12/2014,640000.0,4,3.0,2940,5763,1.0,0.0,0.0,5,8,1640,1300,1955,0,98108,47.5589,-122.295,2020,7320,11,12,2014,UNK,920,-1557
6149700315,4/10/2015,352000.0,3,0.75,1240,7200,1.0,0.0,0.0,3,7,1240,0,1947,0,98133,47.7298,-122.34200000000001,1210,7200,4,10,2015,UNK,30,0
2064800880,2/1/2015,301500.0,3,1.0,1410,7419,1.0,0.0,0.0,3,7,1050,360,1969,0,98056,47.534,-122.17299999999999,1800,8000,2,1,2015,UNK,-390,-581
3902300450,7/2/2014,630000.0,4,2.5,2190,9880,1.0,0.0,0.0,4,8,1410,780,1979,0,98033,47.6926,-122.186,2190,9198,7,2,2014,UNK,0,682
1332300110,2/23/2015,340000.0,3,2.5,3040,6255,2.0,0.0,0.0,3,7,3040,0,1999,0,98030,47.3817,-122.206,2670,6259,2,23,2015,UNK,370,-4
7663700610,3/10/2015,477500.0,4,1.75,1860,9364,1.0,0.0,0.0,3,7,1080,780,1953,0,98125,47.731,-122.301,1800,9364,3,10,2015,UNK,60,0
7520000330,8/13/2014,285000.0,3,2.5,1690,7460,1.0,0.0,0.0,3,7,870,820,1997,0,98146,47.4964,-122.353,1900,7302,8,13,2014,UNK,-210,158
1521049156,10/10/2014,255000.0,3,2.75,1900,16117,1.0,0.0,0.0,4,7,1900,0,1958,0,98001,47.3144,-122.27799999999999,1640,19166,10,10,2014,UNK,260,-3049
6648760150,7/28/2014,315000.0,3,2.5,1600,7982,2.0,0.0,0.0,3,8,1600,0,1993,0,98001,47.3397,-122.266,1890,9830,7,28,2014,UNK,-290,-1848
1807900300,12/17/2014,830000.0,6,3.0,2530,9000,1.0,0.0,0.0,3,6,2530,0,1978,0,98033,47.6716,-122.199,1886,6000,12,17,2014,UNK,644,3000
4310700778,2/10/2015,539950.0,3,2.25,1860,1558,3.0,0.0,0.0,3,8,1860,0,2014,0,98103,47.7006,-122.339,1760,2456,2,10,2015,N,100,-898
5364200620,8/14/2014,980000.0,3,2.25,2390,4590,2.0,0.0,0.0,3,8,2090,300,1941,1998,98105,47.6615,-122.27600000000001,2280,5179,8,14,2014,Y,110,-589
1939130120,7/18/2014,735000.0,4,2.5,3100,8529,2.0,0.0,0.0,3,9,3100,0,1990,0,98074,47.6252,-122.029,2710,8344,7,18,2014,UNK,390,185
7280300375,1/22/2015,536000.0,5,2.25,2650,9140,1.0,0.0,1.0,3,8,1350,1300,1965,0,98177,47.7772,-122.387,2700,7800,1,22,2015,UNK,-50,1340
2767602720,2/23/2015,575000.0,3,2.0,1520,5000,1.5,0.0,0.0,3,7,1140,380,1945,0,98107,47.6733,-122.389,1530,4650,2,23,2015,UNK,-10,350
3300701185,9/25/2014,500000.0,2,1.0,1510,4000,1.0,0.0,0.0,3,6,930,580,1924,0,98117,47.6917,-122.38,1300,4000,9,25,2014,UNK,210,0
8731901910,6/16/2014,285500.0,4,1.75,1960,7950,1.0,0.0,0.0,4,8,1960,0,1967,0,98023,47.3109,-122.37700000000001,1960,8400,6,16,2014,UNK,0,-450
2558640110,5/14/2014,498000.0,4,2.75,2270,7375,1.0,0.0,0.0,4,7,1290,980,1973,0,98034,47.7222,-122.16799999999999,1750,7760,5,14,2014,UNK,520,-385
9465200405,8/21/2014,412000.0,2,1.0,910,6282,1.0,0.0,0.0,4,7,910,0,1939,0,98103,47.6967,-122.354,970,6281,8,21,2014,UNK,-60,1
2896000450,3/23/2015,607000.0,4,2.5,2100,8220,1.0,0.0,0.0,4,8,1300,800,1975,0,98052,47.6733,-122.145,2160,8348,3,23,2015,UNK,-60,-128
1320069255,6/24/2014,199000.0,3,1.0,1000,8512,1.0,0.0,0.0,3,6,1000,0,1991,0,98022,47.2151,-121.993,1490,10395,6,24,2014,UNK,-490,-1883
8651720150,7/21/2014,492500.0,4,2.75,2760,18306,1.0,0.0,0.0,3,7,1630,1130,1978,0,98034,47.7302,-122.215,2470,9856,7,21,2014,UNK,290,8450
3840700757,6/19/2014,585000.0,4,2.5,2840,11044,2.0,0.0,0.0,3,8,2840,0,2001,0,98034,47.7134,-122.23700000000001,1934,9605,6,19,2014,UNK,906,1439
8856970530,12/8/2014,326995.0,3,2.5,1860,5321,2.0,0.0,0.0,3,7,1860,0,2000,0,98038,47.3848,-122.03299999999999,1940,5205,12,8,2014,UNK,-80,116
2473351050,8/13/2014,372500.0,4,2.25,1920,9660,1.0,0.0,0.0,4,8,1920,0,1968,0,98058,47.4544,-122.14299999999999,1890,7800,8,13,2014,UNK,30,1860
7003200120,6/27/2014,528000.0,2,0.75,840,40642,1.0,1.0,4.0,4,6,840,0,1937,0,98070,47.403999999999996,-122.447,1850,64069,6,27,2014,UNK,-1010,-23427
1321059097,9/24/2014,400000.0,3,1.5,2390,32109,1.0,0.0,0.0,3,7,2390,0,1975,0,98092,47.3028,-122.102,1370,32109,9,24,2014,UNK,1020,0
2571910100,10/29/2014,344000.0,4,2.5,2100,8501,2.0,0.0,0.0,5,7,2100,0,1993,0,98022,47.1951,-122.01,2130,8560,10,29,2014,UNK,-30,-59
5104511050,9/2/2014,409950.0,4,3.0,2430,7163,2.0,0.0,0.0,3,8,2430,0,2003,0,98038,47.3558,-122.01299999999999,2430,6028,9,2,2014,UNK,0,1135
2771603990,7/15/2014,625000.0,3,2.0,1880,4000,1.0,0.0,2.0,3,8,1280,600,1950,0,98199,47.6375,-122.391,1920,4000,7,15,2014,UNK,-40,0
9407001770,5/12/2015,304950.0,3,1.75,1350,9000,1.0,0.0,0.0,3,7,1350,0,1987,0,98045,47.4487,-121.773,1370,9500,5,12,2015,UNK,-20,-500
3211230300,9/29/2014,381500.0,2,2.0,2160,35183,1.0,0.0,0.0,3,9,2160,0,1985,0,98092,47.312,-122.115,2450,34992,9,29,2014,UNK,-290,191
3229200040,7/23/2014,215000.0,3,1.75,1430,13399,1.0,0.0,0.0,4,7,900,530,1946,0,98168,47.4787,-122.275,1720,6415,7,23,2014,UNK,-290,6984
3810000843,4/27/2015,345000.0,5,1.75,2840,12870,2.0,0.0,2.0,4,7,2840,0,1925,0,98178,47.4961,-122.235,2170,9612,4,27,2015,UNK,670,3258
4045700455,3/16/2015,363000.0,3,0.75,2510,20000,2.0,0.0,0.0,4,7,2510,0,1961,0,98001,47.2871,-122.287,2130,20000,3,16,2015,UNK,380,0
3322049095,2/5/2015,240000.0,3,1.0,1690,20063,1.5,0.0,0.0,4,7,1690,0,1913,0,98001,47.3556,-122.294,1700,15899,2,5,2015,UNK,-10,4164
8682280970,2/4/2015,548050.0,2,2.0,1930,5479,1.0,0.0,0.0,3,8,1930,0,2005,0,98053,47.7054,-122.01100000000001,1900,5479,2,4,2015,N,30,0
9269200650,10/27/2014,314000.0,2,1.0,720,4920,1.0,0.0,0.0,3,6,720,0,1941,0,98126,47.5352,-122.37100000000001,670,4920,10,27,2014,UNK,50,0
7701961220,6/26/2014,800000.0,4,2.5,2990,16809,2.0,0.0,0.0,3,11,2990,0,1990,0,98077,47.7123,-122.073,3340,18752,6,26,2014,UNK,-350,-1943
7883603945,7/15/2014,400000.0,5,1.75,2300,6720,2.0,0.0,0.0,3,7,2300,0,1905,0,98108,47.528,-122.32,1200,6000,7,15,2014,UNK,1100,720
1352300580,11/14/2014,247000.0,1,1.0,460,4120,1.0,0.0,0.0,3,4,460,0,1937,0,98055,47.4868,-122.199,990,4120,11,14,2014,UNK,-530,0
8714600145,4/1/2015,540000.0,2,1.75,1240,4120,1.0,0.0,0.0,4,7,890,350,1906,0,98105,47.6689,-122.314,1640,3740,4,1,2015,UNK,-400,380
323089172,7/18/2014,410000.0,4,2.5,1900,15123,2.0,0.0,0.0,3,8,1900,0,1995,0,98045,47.5015,-121.772,1900,16477,7,18,2014,UNK,0,-1354
8651511030,10/2/2014,525000.0,3,1.75,2120,9146,1.0,0.0,0.0,3,8,1260,860,1981,0,98074,47.6475,-122.064,2040,10485,10,2,2014,UNK,80,-1339
7015200900,4/10/2015,820000.0,4,2.5,2440,5737,2.0,0.0,0.0,4,8,1700,740,1929,0,98119,47.6472,-122.367,2020,5543,4,10,2015,UNK,420,194
736100065,3/10/2015,1250000.0,4,2.25,3300,15375,1.5,0.0,3.0,3,8,2820,480,1933,1984,98040,47.526,-122.225,3250,15375,3,10,2015,Y,50,0
3123049131,12/18/2014,244000.0,2,1.0,1180,10200,1.0,0.0,0.0,4,7,1180,0,1955,0,98148,47.4358,-122.336,1330,10200,12,18,2014,UNK,-150,0
1773101530,12/18/2014,275000.0,1,1.0,520,4800,1.0,0.0,0.0,3,5,520,0,1930,0,98106,47.5533,-122.363,800,4960,12,18,2014,UNK,-280,-160
6917700650,10/8/2014,577000.0,2,1.75,2070,23160,1.0,0.0,0.0,3,7,1260,810,1946,0,98199,47.6551,-122.39399999999999,1690,5458,10,8,2014,UNK,380,17702
3574800090,12/2/2014,446950.0,5,2.5,2250,7945,1.0,0.0,0.0,4,7,1360,890,1977,0,98034,47.7316,-122.221,1820,7866,12,2,2014,UNK,430,79
7853220610,7/29/2014,457000.0,3,2.5,2050,5694,2.0,0.0,2.0,3,8,2050,0,2004,0,98065,47.5331,-121.855,2680,7187,7,29,2014,N,-630,-1493
9537200037,4/28/2015,320000.0,4,1.5,1310,137214,1.5,0.0,0.0,4,7,1310,0,1926,0,98198,47.361999999999995,-122.316,1310,9450,4,28,2015,UNK,0,127764
5470100090,9/5/2014,210000.0,3,1.5,1250,9484,1.0,0.0,0.0,4,7,1250,0,1969,0,98042,47.3675,-122.147,1320,9600,9,5,2014,UNK,-70,-116
3826500730,9/22/2014,220000.0,4,2.5,2130,9100,1.0,0.0,0.0,3,8,1290,840,1978,0,98030,47.3815,-122.169,1770,7700,9,22,2014,UNK,360,1400
2998800040,6/13/2014,589000.0,3,2.0,2250,8800,1.0,0.0,0.0,4,7,1250,1000,1925,0,98116,47.5737,-122.40899999999999,2250,4800,6,13,2014,UNK,0,4000
7658600150,6/30/2014,435000.0,4,2.0,1880,3840,1.0,0.0,0.0,3,7,970,910,1904,0,98144,47.5929,-122.303,1670,1820,6,30,2014,UNK,210,2020
3816300065,7/16/2014,375000.0,3,1.0,1520,10798,1.0,0.0,0.0,3,7,1520,0,1953,0,98028,47.7635,-122.262,1670,9876,7,16,2014,UNK,-150,922
1561600056,10/17/2014,1740000.0,4,3.5,4010,9654,2.0,0.0,0.0,3,10,4010,0,2007,0,98004,47.5891,-122.2,1870,9873,10,17,2014,N,2140,-219
8682261250,12/11/2014,545000.0,2,1.75,1660,5581,1.0,0.0,0.0,3,8,1660,0,2005,0,98053,47.713,-122.03299999999999,1670,4871,12,11,2014,N,-10,710
6392002550,10/22/2014,970000.0,3,2.25,3400,10000,2.0,0.0,0.0,3,10,3400,0,1983,0,98115,47.6846,-122.28399999999999,1860,5100,10,22,2014,UNK,1540,4900
1370803835,7/18/2014,705000.0,2,1.75,2320,6755,1.0,0.0,0.0,5,8,1380,940,1946,0,98199,47.6398,-122.40299999999999,1990,5000,7,18,2014,UNK,330,1755
7805450040,3/16/2015,915557.0,5,3.25,3740,11536,2.0,0.0,0.0,4,9,2540,1200,1984,0,98006,47.5599,-122.10799999999999,2920,11258,3,16,2015,UNK,820,278
8019200823,2/9/2015,259000.0,4,1.5,1810,9000,1.5,0.0,0.0,3,7,1810,0,1960,0,98168,47.4911,-122.322,1520,9780,2,9,2015,UNK,290,-780
5457800930,6/13/2014,1700000.0,2,2.25,3170,3000,2.0,0.0,2.0,5,10,1990,1180,1900,0,98109,47.6291,-122.351,2980,5061,6,13,2014,UNK,190,-2061
3715500110,12/1/2014,427000.0,3,1.75,1680,8610,1.0,0.0,0.0,4,7,1290,390,1969,0,98034,47.7246,-122.17299999999999,1640,8809,12,1,2014,UNK,40,-199
6058600385,8/11/2014,390000.0,2,1.0,930,3100,1.0,0.0,0.0,3,6,930,0,1911,0,98144,47.5943,-122.302,1670,3800,8,11,2014,UNK,-740,-700
7708250040,2/12/2015,363000.0,3,2.5,2390,8000,2.0,0.0,0.0,3,8,2390,0,1995,0,98042,47.3895,-122.154,2070,7585,2,12,2015,UNK,320,415
2769600035,8/7/2014,612000.0,4,2.5,2680,3626,1.5,0.0,3.0,4,7,1680,1000,1928,0,98107,47.6727,-122.361,1950,4500,8,7,2014,UNK,730,-874
5500100120,9/16/2014,380000.0,4,1.75,1790,10186,1.0,0.0,0.0,4,8,1790,0,1965,0,98177,47.7769,-122.376,1790,9142,9,16,2014,UNK,0,1044
4472000040,8/18/2014,230000.0,4,3.0,1680,6003,1.0,0.0,0.0,3,7,1150,530,1997,0,98002,47.2885,-122.21799999999999,1820,6207,8,18,2014,UNK,-140,-204
9376301591,4/14/2015,580000.0,3,1.75,1570,2600,1.5,0.0,0.0,4,8,1570,0,1931,0,98117,47.6867,-122.37,1490,4000,4,14,2015,UNK,80,-1400
4232903990,11/19/2014,770000.0,3,1.0,2230,3200,2.0,0.0,2.0,3,8,1630,600,1918,0,98109,47.6334,-122.35600000000001,2280,5400,11,19,2014,UNK,-50,-2200
7575500150,9/24/2014,207200.0,4,2.0,1260,8400,1.0,0.0,0.0,3,6,1260,0,1991,0,98022,47.1946,-122.0,1120,8400,9,24,2014,UNK,140,0
6817801430,3/5/2015,525000.0,3,2.0,1790,11430,1.0,0.0,0.0,3,7,1190,600,1985,0,98074,47.6319,-122.035,1700,12114,3,5,2015,UNK,90,-684
2883200760,2/9/2015,925000.0,3,2.5,2440,7419,1.0,0.0,0.0,3,7,1520,920,1961,0,98103,47.6857,-122.334,2440,4880,2,9,2015,UNK,0,2539
1797500985,9/2/2014,883000.0,4,2.25,2410,4000,2.0,0.0,0.0,5,8,1650,760,1910,0,98115,47.6727,-122.316,1820,4000,9,2,2014,UNK,590,0
2896400210,5/8/2015,455000.0,4,2.5,1780,2992,2.0,0.0,0.0,3,7,1780,0,2003,0,98072,47.7633,-122.149,1610,2961,5,8,2015,UNK,170,31
8691510150,9/22/2014,343500.0,3,2.5,1900,5194,2.0,0.0,0.0,3,7,1900,0,2004,0,98058,47.4391,-122.117,2230,5194,9,22,2014,N,-330,0
6163901380,11/14/2014,244000.0,2,1.0,960,8450,1.0,0.0,0.0,5,6,960,0,1950,0,98155,47.755,-122.316,1090,8450,11,14,2014,UNK,-130,0
9477000650,11/19/2014,397000.0,3,1.75,1640,11730,1.0,0.0,0.0,5,7,1640,0,1967,0,98034,47.7351,-122.189,1640,7770,11,19,2014,UNK,0,3960
2560800165,3/16/2015,180500.0,2,1.0,850,5000,1.0,0.0,0.0,3,6,850,0,1976,0,98198,47.3817,-122.314,1160,5000,3,16,2015,UNK,-310,0
5589300495,3/4/2015,310000.0,3,2.75,2150,6576,1.0,0.0,0.0,4,7,1900,250,1926,0,98155,47.7539,-122.30799999999999,2150,9071,3,4,2015,UNK,0,-2495
2517000600,1/28/2015,315000.0,4,2.5,2780,3969,2.0,0.0,0.0,3,7,2780,0,2005,0,98042,47.3992,-122.164,2260,4160,1,28,2015,N,520,-191
5364200477,6/3/2014,718000.0,3,1.0,1030,4958,1.0,0.0,0.0,5,7,1030,0,1952,0,98105,47.6647,-122.277,2230,6987,6,3,2014,UNK,-1200,-2029
7349400100,10/9/2014,279950.0,3,1.75,1930,7267,1.0,0.0,0.0,4,7,1330,600,1977,0,98002,47.3217,-122.205,1600,7698,10,9,2014,UNK,330,-431
1455600062,10/21/2014,689000.0,3,2.5,2080,9612,1.0,0.0,3.0,4,8,1700,380,1940,0,98125,47.7293,-122.28299999999999,2560,10202,10,21,2014,UNK,-480,-590
629810720,8/18/2014,828000.0,4,2.5,3520,9901,2.0,0.0,0.0,3,10,3520,0,1998,0,98074,47.6084,-122.01100000000001,3490,9667,8,18,2014,UNK,30,234
3395800455,6/25/2014,150000.0,2,1.0,890,8100,1.0,0.0,0.0,3,6,890,0,1942,0,98146,47.4839,-122.34,1260,8100,6,25,2014,UNK,-370,0
9191201385,3/1/2015,505400.0,3,1.75,1640,3400,1.0,0.0,0.0,4,7,930,710,1926,0,98105,47.6694,-122.3,1380,3750,3,1,2015,UNK,260,-350
6648150040,5/13/2014,1680000.0,5,3.25,4860,23723,2.0,0.0,2.0,4,11,3820,1040,1989,0,98040,47.5767,-122.215,4040,13860,5,13,2014,UNK,820,9863
7211400615,5/15/2014,217450.0,3,1.0,1040,5000,1.0,0.0,0.0,3,7,1040,0,1959,0,98146,47.5122,-122.35799999999999,1440,5000,5,15,2014,UNK,-400,0
6870000150,12/18/2014,677000.0,4,2.5,2820,4174,2.0,0.0,0.0,3,9,2820,0,2004,0,98034,47.7112,-122.226,2560,4853,12,18,2014,N,260,-679
3324079092,4/27/2015,361000.0,2,2.5,1320,48787,1.0,0.0,0.0,3,8,1320,0,2004,0,98027,47.5157,-121.92399999999999,1830,155073,4,27,2015,N,-510,-106286
8901000543,6/9/2014,620000.0,3,2.5,2590,7237,2.0,0.0,0.0,3,8,2590,0,2004,0,98125,47.7113,-122.309,1670,7648,6,9,2014,N,920,-411
7428000120,12/10/2014,176000.0,3,2.25,1540,5449,1.0,0.0,0.0,2,7,1180,360,1989,0,98023,47.29,-122.35799999999999,1460,6740,12,10,2014,UNK,80,-1291
6675500112,4/14/2015,330000.0,3,1.0,960,7218,1.0,0.0,0.0,4,7,960,0,1969,0,98034,47.7278,-122.226,1580,9104,4,14,2015,UNK,-620,-1886
8898701340,10/29/2014,290000.0,3,2.5,1190,8175,1.0,0.0,0.0,3,7,1190,0,1986,0,98055,47.4556,-122.20299999999999,2230,9520,10,29,2014,UNK,-1040,-1345
3904921120,7/15/2014,711000.0,4,2.5,2770,9532,2.0,0.0,0.0,4,9,2770,0,1988,0,98029,47.5688,-122.012,2770,9219,7,15,2014,UNK,0,313
1545806960,4/22/2015,295000.0,3,1.75,1060,8100,2.0,0.0,0.0,4,7,1060,0,1983,0,98038,47.3617,-122.04700000000001,1410,8100,4,22,2015,UNK,-350,0
3303990410,11/11/2014,1100000.0,5,3.25,4010,12110,2.0,0.0,0.0,3,11,4010,0,2003,0,98059,47.5228,-122.15100000000001,4010,12334,11,11,2014,UNK,0,-224
1862900690,9/25/2014,257500.0,3,2.0,1140,7078,1.0,0.0,0.0,4,7,1140,0,1991,0,98031,47.4057,-122.185,1460,7078,9,25,2014,UNK,-320,0
123039333,6/9/2014,240000.0,4,1.0,1910,16320,1.5,0.0,0.0,3,6,1910,0,1934,0,98106,47.5151,-122.366,1380,9000,6,9,2014,UNK,530,7320
8077210230,12/12/2014,645000.0,4,2.5,2340,8955,2.0,0.0,0.0,3,9,2340,0,1990,0,98074,47.6283,-122.02600000000001,2340,8955,12,12,2014,UNK,0,0
9550200650,5/6/2014,499000.0,2,1.75,1170,2400,1.0,0.0,0.0,4,7,740,430,1903,0,98103,47.6653,-122.333,1570,3919,5,6,2014,UNK,-400,-1519
4326000220,10/20/2014,321000.0,3,1.0,1290,9526,1.5,0.0,0.0,3,7,1290,0,1961,0,98034,47.7111,-122.213,1290,9508,10,20,2014,UNK,0,18
1862400522,8/22/2014,449000.0,3,2.5,1810,1658,3.0,0.0,0.0,3,8,1810,0,1998,0,98117,47.6955,-122.376,1470,1585,8,22,2014,UNK,340,73
7589200165,1/7/2015,515000.0,3,2.5,1820,5280,1.0,0.0,0.0,4,7,910,910,1949,0,98117,47.6892,-122.375,1600,4820,1,7,2015,UNK,220,460
925059042,10/2/2014,456000.0,4,1.5,2220,12385,1.0,0.0,0.0,3,8,1270,950,1978,0,98033,47.6734,-122.185,2030,8831,10,2,2014,UNK,190,3554
2924079044,7/23/2014,865000.0,3,3.75,3830,219106,2.0,0.0,0.0,3,9,3830,0,1977,1999,98027,47.5432,-121.95200000000001,2440,219106,7,23,2014,Y,1390,0
5535600110,6/18/2014,515500.0,4,2.5,2920,7700,2.0,0.0,0.0,3,9,2920,0,2003,0,98019,47.7351,-121.975,2920,8943,6,18,2014,UNK,0,-1243
1428900033,11/19/2014,576925.0,4,2.5,2630,6100,2.0,0.0,0.0,3,8,2630,0,2004,0,98072,47.7735,-122.167,2360,5765,11,19,2014,N,270,335
1822059382,1/2/2015,243000.0,3,1.75,1320,10416,1.0,0.0,0.0,3,7,1320,0,1996,0,98031,47.3902,-122.208,1670,7991,1,2,2015,UNK,-350,2425
3584000180,5/28/2014,253400.0,3,2.0,1400,8640,1.0,0.0,0.0,5,7,1400,0,1968,0,98003,47.3182,-122.319,1270,9375,5,28,2014,UNK,130,-735
7812500180,4/13/2015,292000.0,3,2.5,1600,3580,2.0,0.0,0.0,3,7,1600,0,2000,0,98178,47.4939,-122.26100000000001,2020,4327,4,13,2015,UNK,-420,-747
984210220,12/3/2014,271500.0,3,2.5,1490,8005,1.0,0.0,0.0,3,7,1090,400,1976,0,98058,47.4359,-122.165,1880,7905,12,3,2014,UNK,-390,100
8682310220,8/27/2014,765000.0,2,2.5,2170,6750,1.0,0.0,0.0,3,8,2170,0,2012,0,98053,47.7115,-122.014,2150,6074,8,27,2014,N,20,676
7586200061,3/12/2015,375000.0,3,3.25,1280,1730,2.0,0.0,0.0,3,8,1090,190,2005,0,98177,47.7032,-122.36,1280,2121,3,12,2015,N,0,-391
5127100100,5/11/2015,382880.0,3,2.0,1620,9566,1.0,0.0,0.0,4,7,1620,0,1968,0,98059,47.474,-122.146,1660,10011,5,11,2015,UNK,-40,-445
7856000150,6/9/2014,852500.0,3,2.5,2630,10100,1.0,0.0,0.0,4,9,1580,1050,1967,0,98006,47.5638,-122.15299999999999,2400,9700,6,9,2014,UNK,230,400
5076700025,11/24/2014,475000.0,3,1.5,1240,8738,1.0,0.0,0.0,3,7,1240,0,1959,0,98005,47.5849,-122.17,1440,9344,11,24,2014,UNK,-200,-606
9221400600,5/23/2014,462000.0,3,1.75,1300,2580,1.0,0.0,0.0,5,7,820,480,1919,0,98115,47.674,-122.319,1180,2820,5,23,2014,UNK,120,-240
1924059278,6/11/2014,762400.0,3,1.75,2430,14607,1.0,0.0,1.0,3,8,1230,1200,1949,1970,98040,47.5588,-122.211,2750,17425,6,11,2014,Y,-320,-2818
6163901283,1/30/2015,330000.0,4,1.5,1890,7540,1.0,0.0,0.0,4,7,1890,0,1967,0,98155,47.7534,-122.318,1890,8515,1,30,2015,UNK,0,-975
7504460090,7/25/2014,473000.0,3,2.25,1890,12236,1.0,0.0,0.0,3,8,1890,0,1978,0,98074,47.6232,-122.04700000000001,2390,12323,7,25,2014,UNK,-500,-87
4154302560,11/21/2014,550000.0,3,1.5,2440,7200,1.0,0.0,0.0,3,7,2440,0,1949,0,98118,47.5604,-122.274,1920,6900,11,21,2014,UNK,520,300
7905390220,6/23/2014,449500.0,3,2.25,1780,7280,1.0,0.0,2.0,3,7,1340,440,1972,0,98034,47.723,-122.215,2060,7280,6,23,2014,UNK,-280,0
8691330910,5/21/2014,744000.0,4,2.75,2830,13059,2.0,0.0,0.0,3,10,2830,0,1998,0,98075,47.595,-121.986,3840,11596,5,21,2014,UNK,-1010,1463
9169100175,5/7/2015,700000.0,4,2.0,2490,4700,1.0,0.0,0.0,4,7,1690,800,1952,0,98136,47.5254,-122.39200000000001,2240,5000,5,7,2015,UNK,250,-300
5706202070,9/30/2014,511100.0,4,2.5,1560,12220,1.5,0.0,0.0,4,7,1560,0,1965,0,98027,47.5287,-122.053,1920,12220,9,30,2014,UNK,-360,0
9478501020,9/16/2014,317950.0,3,2.5,1980,4500,2.0,0.0,0.0,3,7,1980,0,2012,0,98042,47.3671,-122.113,2200,4500,9,16,2014,N,-220,0
426069095,10/14/2014,542950.0,3,2.5,2070,39768,2.0,0.0,0.0,3,8,2070,0,1988,0,98077,47.7696,-122.036,2740,44866,10,14,2014,UNK,-670,-5098
6752000330,8/15/2014,490000.0,3,1.75,1490,11360,1.0,0.0,0.0,3,8,1490,0,1975,0,98008,47.5896,-122.12,2350,10320,8,15,2014,UNK,-860,1040
9834200555,2/19/2015,760000.0,4,3.5,3090,4060,2.0,0.0,0.0,3,8,2420,670,1992,0,98144,47.5733,-122.287,1720,4080,2,19,2015,UNK,1370,-20
726059344,4/21/2015,475000.0,3,2.25,1580,8659,1.0,0.0,0.0,4,7,1220,360,1961,0,98011,47.7599,-122.215,1970,9650,4,21,2015,UNK,-390,-991
8106100085,5/9/2014,1700000.0,5,4.5,5190,23716,2.0,0.0,2.0,3,11,3390,1800,1987,2000,98040,47.5846,-122.223,4460,22748,5,9,2014,Y,730,968
3831250150,3/26/2015,435000.0,3,2.75,2692,6197,2.0,0.0,0.0,3,9,2692,0,2007,0,98030,47.3569,-122.20200000000001,2336,5700,3,26,2015,N,356,497
7852020760,11/1/2014,399000.0,3,2.5,1740,3690,2.0,0.0,0.0,3,8,1740,0,2000,0,98065,47.5345,-121.867,2100,4944,11,1,2014,UNK,-360,-1254
3142600120,8/26/2014,627000.0,3,2.0,1940,3800,1.0,0.0,0.0,4,7,1050,890,1927,0,98115,47.6842,-122.309,1700,3800,8,26,2014,UNK,240,0
7831800495,10/2/2014,346500.0,4,2.5,2150,5100,1.5,0.0,0.0,3,7,1290,860,1991,0,98106,47.5338,-122.36,1920,5100,10,2,2014,UNK,230,0
4037000065,4/14/2015,412000.0,3,1.5,1320,8000,1.0,0.0,0.0,3,7,1320,0,1957,0,98008,47.6027,-122.12200000000001,1720,8100,4,14,2015,UNK,-400,-100
7574910450,2/3/2015,845000.0,4,2.5,3360,40471,2.0,0.0,0.0,4,10,3360,0,1994,0,98077,47.742,-122.035,3150,36823,2,3,2015,UNK,210,3648
6703700025,11/5/2014,373000.0,3,1.75,1850,9655,1.0,0.0,0.0,3,7,1100,750,1959,0,98155,47.7358,-122.319,1480,8683,11,5,2014,UNK,370,972
5418500970,8/8/2014,725000.0,4,2.25,2880,8882,2.0,0.0,0.0,4,8,2480,400,1965,0,98115,47.6999,-122.28399999999999,2460,9610,8,8,2014,UNK,420,-728
5379806180,8/13/2014,376000.0,6,2.5,2420,11662,1.0,0.0,2.0,4,7,1420,1000,1965,0,98188,47.4459,-122.27799999999999,1630,11662,8,13,2014,UNK,790,0
3332000061,8/5/2014,552500.0,3,1.0,2020,4120,1.5,0.0,0.0,4,7,1520,500,1929,0,98118,47.5514,-122.271,1200,4635,8,5,2014,UNK,820,-515
7635800600,6/26/2014,365000.0,5,2.0,2280,19000,1.5,0.0,0.0,3,6,2280,0,1924,0,98166,47.4683,-122.359,1790,11800,6,26,2014,UNK,490,7200
1825079086,5/21/2014,700000.0,4,2.5,3010,46173,2.0,0.0,0.0,3,9,3010,0,1996,0,98053,47.6471,-121.964,2590,49222,5,21,2014,UNK,420,-3049
4399200085,3/5/2015,315000.0,4,2.25,2550,9736,1.0,0.0,0.0,4,8,2550,0,1967,0,98002,47.3193,-122.212,1770,9686,3,5,2015,UNK,780,50
7131300031,3/31/2015,262500.0,4,2.0,1540,5110,1.0,0.0,0.0,3,7,1540,0,1957,0,98118,47.5164,-122.26799999999999,1540,5110,3,31,2015,UNK,0,0
2719100355,11/4/2014,660000.0,3,2.25,2280,6150,2.0,0.0,2.0,3,8,2280,0,1984,0,98136,47.5423,-122.385,1920,6150,11,4,2014,UNK,360,0
2517010120,4/13/2015,340000.0,4,2.5,2450,6941,2.0,0.0,0.0,3,7,2450,0,2006,0,98042,47.4006,-122.162,3300,6941,4,13,2015,N,-850,0
5700000600,7/2/2014,660500.0,5,2.5,2950,5500,1.5,0.0,0.0,5,7,1720,1230,1918,0,98144,47.5785,-122.29299999999999,2200,5000,7,2,2014,UNK,750,500
5075400035,6/27/2014,280000.0,1,1.0,690,1950,1.0,0.0,0.0,3,6,690,0,1928,0,98117,47.6849,-122.374,1650,4864,6,27,2014,UNK,-960,-2914
5141000571,8/25/2014,267000.0,1,1.0,800,2480,1.0,0.0,0.0,4,6,800,0,1919,0,98108,47.5581,-122.316,1490,4650,8,25,2014,UNK,-690,-2170
3664500300,11/6/2014,230000.0,2,1.0,1470,25661,1.5,0.0,0.0,3,4,1470,0,1932,0,98059,47.4878,-122.13,1670,43301,11,6,2014,UNK,-200,-17640
2607730490,9/22/2014,417000.0,3,2.25,1840,11403,2.0,0.0,0.0,3,8,1840,0,1993,0,98045,47.4862,-121.79700000000001,2150,11403,9,22,2014,UNK,-310,0
88000790,7/14/2014,252000.0,3,1.0,1170,9730,1.0,0.0,0.0,3,7,1170,0,1968,1986,98055,47.4562,-122.196,1680,10125,7,14,2014,Y,-510,-395
4083303540,3/20/2015,791000.0,5,1.75,2344,4800,1.5,0.0,0.0,4,7,1544,800,1921,0,98103,47.6537,-122.335,1770,4200,3,20,2015,UNK,574,600
6430500219,9/10/2014,415000.0,1,1.0,1230,3774,1.0,0.0,0.0,4,6,830,400,1924,0,98103,47.6886,-122.354,1300,3774,9,10,2014,UNK,-70,0
203900610,7/24/2014,339000.0,3,1.75,1150,13278,1.0,0.0,0.0,5,7,1150,0,1966,0,98053,47.6384,-121.969,1560,12400,7,24,2014,UNK,-410,878
6083000123,5/4/2015,158000.0,3,1.0,1140,10477,1.0,0.0,0.0,3,6,1140,0,1942,0,98168,47.4874,-122.306,1190,9750,5,4,2015,UNK,-50,727
2490200620,8/11/2014,535000.0,3,1.0,1660,5100,1.0,0.0,0.0,3,7,1260,400,1957,0,98136,47.5323,-122.383,1230,5100,8,11,2014,UNK,430,0
9528102870,3/4/2015,818900.0,3,1.0,1080,4120,1.0,0.0,0.0,3,7,980,100,1919,0,98115,47.6771,-122.319,1280,3090,3,4,2015,UNK,-200,1030
2436700610,4/22/2015,550000.0,4,2.0,1720,4000,1.0,0.0,0.0,3,7,1420,300,1950,0,98105,47.6651,-122.285,1350,1281,4,22,2015,UNK,370,2719
7655900031,3/6/2015,240000.0,2,1.0,590,8717,1.0,0.0,0.0,3,6,590,0,1953,0,98133,47.7343,-122.335,1370,6760,3,6,2015,UNK,-780,1957
7011201333,9/17/2014,590000.0,3,3.25,1290,1230,2.0,0.0,2.0,3,9,1090,200,2008,0,98119,47.6367,-122.37,1710,1797,9,17,2014,N,-420,-567
9412200730,2/24/2015,369300.0,3,1.5,1480,21320,1.0,0.0,0.0,4,7,1480,0,1967,0,98027,47.5234,-122.04299999999999,1850,17825,2,24,2015,UNK,-370,3495
3024079096,4/14/2015,510000.0,4,2.5,2600,118666,1.0,0.0,0.0,3,7,1400,1200,1981,0,98027,47.54,-121.97,2440,131116,4,14,2015,UNK,160,-12450
5423600040,7/7/2014,542500.0,3,2.5,2040,10086,2.0,0.0,0.0,3,8,2040,0,1987,0,98052,47.678999999999995,-122.113,1940,10272,7,7,2014,UNK,100,-186
3291800120,1/2/2015,262500.0,3,1.0,970,7854,1.0,0.0,0.0,4,7,970,0,1980,0,98056,47.4899,-122.185,1480,7800,1,2,2015,UNK,-510,54
3052700921,2/11/2015,900000.0,6,3.0,2620,4350,1.0,0.0,0.0,3,7,1760,860,1957,0,98117,47.678000000000004,-122.37299999999999,1760,4300,2,11,2015,UNK,860,50
2424059119,10/14/2014,1100000.0,4,3.5,4560,41636,2.0,0.0,0.0,3,9,4170,390,1995,0,98006,47.5589,-122.116,2990,11381,10,14,2014,UNK,1570,30255
4335000145,8/13/2014,368000.0,3,1.75,1750,14400,1.0,0.0,0.0,4,7,1750,0,1951,0,98166,47.4535,-122.361,2030,14400,8,13,2014,UNK,-280,0
1980200384,10/22/2014,825000.0,4,3.5,3620,6499,2.5,0.0,0.0,3,9,3620,0,2003,2009,98177,47.7326,-122.36,2330,7200,10,22,2014,Y,1290,-701
5637200150,1/14/2015,343500.0,3,2.0,1660,7509,1.0,0.0,0.0,3,7,1660,0,2002,0,98059,47.4872,-122.14399999999999,2380,8598,1,14,2015,UNK,-720,-1089
8864000970,12/4/2014,273500.0,4,1.0,1360,6000,1.0,0.0,0.0,4,6,1020,340,1944,0,98168,47.4783,-122.285,1230,6000,12,4,2014,UNK,130,0
3885808210,1/20/2015,1000000.0,3,2.5,2044,5610,2.0,0.0,0.0,4,9,2044,0,1996,0,98033,47.6791,-122.209,2440,5610,1,20,2015,UNK,-396,0
7986400265,10/29/2014,770000.0,5,3.0,2370,6000,1.5,0.0,2.0,3,8,1340,1030,1926,2003,98107,47.6645,-122.35799999999999,1350,4500,10,29,2014,Y,1020,1500
9459200120,3/4/2015,400000.0,3,2.0,1170,3868,1.5,0.0,0.0,4,7,1170,0,1925,0,98118,47.5543,-122.29,1400,3800,3,4,2015,UNK,-230,68
1311200120,5/13/2014,225000.0,3,1.0,1660,7210,1.0,0.0,0.0,3,7,1100,560,1963,0,98001,47.3394,-122.281,1660,7245,5,13,2014,UNK,0,-35
3649100031,3/5/2015,345000.0,4,1.0,2020,18150,1.0,0.0,0.0,4,7,2020,0,1955,0,98028,47.739,-122.249,1530,11970,3,5,2015,UNK,490,6180
2475400120,10/1/2014,450000.0,3,2.5,2530,8116,2.0,0.0,0.0,3,8,2530,0,2001,0,98011,47.7597,-122.167,2280,8791,10,1,2014,UNK,250,-675
6365900065,7/18/2014,334850.0,2,1.0,870,5635,1.0,0.0,0.0,3,7,870,0,1948,0,98116,47.5676,-122.398,1310,5750,7,18,2014,UNK,-440,-115
3959400645,1/7/2015,605000.0,5,3.0,3670,9600,1.0,0.0,1.0,3,8,1980,1690,1955,0,98108,47.5648,-122.316,1730,4933,1,7,2015,UNK,1940,4667
4139660040,11/21/2014,760000.0,5,3.5,3180,14000,2.0,0.0,0.0,5,10,3180,0,1997,0,98006,47.5501,-122.12799999999999,3670,14450,11,21,2014,UNK,-490,-450
3241600027,10/6/2014,390000.0,2,1.5,1870,12960,1.5,0.0,0.0,4,6,1350,520,1926,0,98118,47.5234,-122.288,1380,7800,10,6,2014,UNK,490,5160
8946400100,8/4/2014,488000.0,3,2.5,1940,5660,2.0,0.0,0.0,3,8,1940,0,2001,0,98072,47.7511,-122.17,2110,4581,8,4,2014,UNK,-170,1079
3625059152,12/30/2014,3300000.0,3,3.25,4220,41300,1.0,1.0,4.0,4,11,2460,1760,1958,1987,98008,47.6083,-122.11,3810,30401,12,30,2014,Y,410,10899
624110110,2/22/2015,1060000.0,5,4.5,4820,13165,2.0,0.0,0.0,4,11,3950,870,1990,0,98077,47.7295,-122.057,3880,13810,2,22,2015,UNK,940,-645
522079015,3/22/2015,608000.0,3,2.0,2400,217800,2.0,0.0,0.0,3,8,1590,810,1975,0,98038,47.4166,-121.94,2340,207781,3,22,2015,UNK,60,10019
3204300455,8/22/2014,1390000.0,3,2.25,2930,6000,2.0,0.0,2.0,3,11,1920,1010,2000,0,98112,47.6301,-122.301,1870,5040,8,22,2014,UNK,1060,960
5414100040,9/15/2014,299950.0,2,1.0,800,3000,1.0,0.0,0.0,3,6,800,0,1904,0,98118,47.5602,-122.292,1640,3400,9,15,2014,UNK,-840,-400
1930301015,4/28/2015,818000.0,3,3.25,2200,4800,2.0,0.0,2.0,3,7,1910,290,1943,1996,98103,47.6551,-122.353,1410,4800,4,28,2015,Y,790,0
1898200100,5/28/2014,355000.0,3,2.5,2400,9701,1.0,0.0,0.0,3,9,2400,0,1990,0,98023,47.3081,-122.39200000000001,2400,8258,5,28,2014,UNK,0,1443
9471200065,10/15/2014,1860000.0,5,3.25,5570,9600,2.0,0.0,0.0,5,9,3860,1710,1952,0,98105,47.6708,-122.262,3170,10400,10,15,2014,UNK,2400,-800
510003085,6/23/2014,660000.0,3,3.25,1980,2850,3.0,0.0,0.0,3,7,1980,0,1987,0,98103,47.6597,-122.331,1630,4560,6,23,2014,UNK,350,-1710
2579500110,7/1/2014,2370000.0,3,2.25,3530,17450,1.0,0.0,3.0,3,9,1840,1690,1930,1993,98040,47.5358,-122.213,3530,17310,7,1,2014,Y,0,140
1762600090,4/24/2015,1210000.0,4,2.5,3430,35120,2.0,0.0,0.0,3,10,3430,0,1984,0,98033,47.6484,-122.182,3920,35230,4,24,2015,UNK,-490,-110
6700390090,6/25/2014,255950.0,3,2.5,1720,3676,2.0,0.0,0.0,3,7,1720,0,1992,0,98031,47.4039,-122.18799999999999,1720,3510,6,25,2014,UNK,0,166
6817801020,8/21/2014,475000.0,3,1.5,1930,11092,1.0,0.0,0.0,3,7,1500,430,1983,0,98074,47.63399999999999,-122.03299999999999,1230,10964,8,21,2014,UNK,700,128
7931000053,12/29/2014,362950.0,4,1.75,2140,159865,1.0,0.0,0.0,4,7,1140,1000,1960,0,98031,47.4235,-122.21799999999999,1830,15569,12,29,2014,UNK,310,144296
1828000620,7/1/2014,452000.0,3,1.75,1110,9012,1.0,0.0,0.0,4,7,1110,0,1966,0,98052,47.6563,-122.131,1800,8679,7,1,2014,UNK,-690,333
2423400040,8/4/2014,315000.0,3,1.75,1970,8200,1.0,0.0,0.0,3,7,1270,700,1964,0,98168,47.4731,-122.32700000000001,1890,8348,8,4,2014,UNK,80,-148
6064800730,1/29/2015,330950.0,3,2.5,1630,2844,2.0,0.0,0.0,3,7,1630,0,2003,0,98118,47.5413,-122.288,1610,2582,1,29,2015,UNK,20,262
3388300590,6/11/2014,535000.0,5,2.25,2520,49222,2.0,0.0,0.0,4,8,2520,0,1978,0,98027,47.4918,-122.064,2780,55321,6,11,2014,UNK,-260,-6099
1591600506,2/25/2015,479000.0,4,2.25,2270,9464,1.5,0.0,0.0,4,7,1520,750,1940,0,98146,47.5007,-122.359,1770,9464,2,25,2015,UNK,500,0
6798100661,6/16/2014,340000.0,3,2.5,1212,1174,3.0,0.0,0.0,3,7,1212,0,2004,0,98125,47.7145,-122.311,1256,1226,6,16,2014,N,-44,-52
8732800100,9/16/2014,312000.0,4,2.0,1890,8362,1.0,0.0,0.0,3,7,1890,0,1966,0,98188,47.4377,-122.279,1600,9257,9,16,2014,UNK,290,-895
2025701080,3/18/2015,305000.0,3,2.25,1370,6600,2.0,0.0,0.0,4,7,1370,0,1993,0,98038,47.3504,-122.035,1370,6600,3,18,2015,UNK,0,0
4345000490,12/2/2014,270000.0,3,2.5,1770,7336,2.0,0.0,0.0,3,7,1770,0,1996,0,98030,47.3639,-122.185,1770,7349,12,2,2014,UNK,0,-13
2771104010,6/5/2014,529999.0,3,2.5,1710,1664,2.0,0.0,0.0,5,8,1300,410,2003,0,98199,47.6456,-122.383,1470,5400,6,5,2014,UNK,240,-3736
3307700405,7/23/2014,587100.0,2,1.0,1190,6967,1.0,0.0,0.0,3,7,1190,0,1946,0,98040,47.5896,-122.243,1700,6968,7,23,2014,UNK,-510,-1
6817800910,11/18/2014,459800.0,3,2.0,1690,16061,1.0,0.0,0.0,3,7,1690,0,1984,0,98074,47.6359,-122.035,1280,12436,11,18,2014,UNK,410,3625
259801140,12/12/2014,451000.0,4,1.75,1680,7800,1.0,0.0,0.0,3,7,1330,350,1966,0,98008,47.6286,-122.118,1680,7210,12,12,2014,UNK,0,590
1176001293,6/17/2014,2480000.0,3,3.25,4340,4947,2.0,0.0,3.0,3,11,3060,1280,1993,0,98107,47.6709,-122.406,1680,5250,6,17,2014,UNK,2660,-303
820079101,12/22/2014,525000.0,3,2.25,2040,435600,2.0,0.0,2.0,4,7,2040,0,1983,0,98022,47.2328,-121.945,2020,223027,12,22,2014,UNK,20,212573
40001065,5/29/2014,250000.0,2,1.0,1110,26051,1.0,0.0,0.0,3,6,1110,0,1951,0,98168,47.4711,-122.291,2240,12255,5,29,2014,UNK,-1130,13796
3330501975,11/17/2014,475000.0,5,2.0,2040,6180,2.0,0.0,0.0,4,7,2040,0,1908,0,98118,47.5503,-122.28,1870,4365,11,17,2014,UNK,170,1815
3021059175,3/12/2015,235000.0,4,1.5,1920,11595,1.0,0.0,0.0,4,7,1920,0,1962,0,98002,47.2858,-122.212,1400,10550,3,12,2015,UNK,520,1045
8092500720,7/11/2014,230000.0,3,1.5,1330,9548,1.0,0.0,0.0,5,7,1330,0,1967,0,98042,47.3675,-122.11,1420,9548,7,11,2014,UNK,-90,0
9828702120,7/1/2014,581000.0,4,1.0,1630,2566,1.5,0.0,0.0,3,7,1630,0,1921,0,98122,47.6183,-122.3,1220,2314,7,1,2014,UNK,410,252
6751300375,7/2/2014,415000.0,3,1.0,1520,9030,1.0,0.0,0.0,3,7,1520,0,1956,0,98007,47.586999999999996,-122.134,1470,8712,7,2,2014,UNK,50,318
6751300375,10/16/2014,522500.0,3,1.0,1520,9030,1.0,0.0,0.0,3,7,1520,0,1956,0,98007,47.586999999999996,-122.134,1470,8712,10,16,2014,UNK,50,318
6073300790,1/5/2015,383000.0,3,1.5,1340,7725,1.0,0.0,0.0,4,8,1340,0,1967,0,98056,47.5389,-122.17299999999999,1990,7725,1,5,2015,UNK,-650,0
8074400035,10/30/2014,315000.0,3,1.75,2500,8289,1.0,0.0,0.0,4,7,1250,1250,1958,0,98056,47.4973,-122.177,1710,8205,10,30,2014,UNK,790,84
2254501335,9/22/2014,591000.0,3,2.0,1460,3600,2.0,0.0,0.0,3,7,1460,0,1902,0,98122,47.6123,-122.314,1590,1210,9,22,2014,UNK,-130,2390
7504021510,12/19/2014,750000.0,4,2.25,3140,12150,2.0,0.0,0.0,3,9,3140,0,1979,0,98074,47.6361,-122.04700000000001,2370,12054,12,19,2014,UNK,770,96
7625701386,5/16/2014,430000.0,3,1.75,2150,4333,1.0,0.0,0.0,3,7,1200,950,1956,0,98136,47.5537,-122.38799999999999,1480,6500,5,16,2014,UNK,670,-2167
1775500371,5/1/2015,712000.0,4,2.5,3140,32336,1.5,0.0,0.0,3,10,3140,0,1995,0,98072,47.7412,-122.087,2340,19965,5,1,2015,UNK,800,12371
3244500037,4/6/2015,510000.0,3,2.5,2310,53578,1.0,0.0,0.0,4,8,1340,970,1981,0,98072,47.7677,-122.135,2660,49658,4,6,2015,UNK,-350,3920
9828701745,1/23/2015,480000.0,2,1.0,710,4800,1.0,0.0,0.0,2,6,710,0,1950,0,98112,47.6212,-122.29799999999999,1480,1721,1,23,2015,UNK,-770,3079
1994200040,6/13/2014,538000.0,3,1.0,1460,7200,1.0,0.0,0.0,3,7,1260,200,1906,0,98103,47.6875,-122.336,1430,4650,6,13,2014,UNK,30,2550
8122100265,12/5/2014,464000.0,2,2.75,730,5000,1.0,0.0,0.0,3,7,730,0,1929,0,98126,47.5381,-122.374,980,5000,12,5,2014,UNK,-250,0
7202290180,1/2/2015,476000.0,3,2.5,1440,3840,2.0,0.0,0.0,3,7,1440,0,2001,0,98053,47.6873,-122.04299999999999,1600,3131,1,2,2015,UNK,-160,709
4025300360,3/26/2015,349500.0,3,2.0,1130,16875,1.0,0.0,0.0,4,7,1130,0,1947,0,98155,47.7489,-122.3,1600,14300,3,26,2015,UNK,-470,2575
2557000540,2/7/2015,270000.0,3,2.25,1810,8262,2.0,0.0,0.0,4,8,1810,0,1981,0,98023,47.2994,-122.37,1820,8262,2,7,2015,UNK,-10,0
9388100015,11/19/2014,740000.0,3,2.5,2710,18480,2.0,0.0,2.0,3,10,2000,710,1978,0,98034,47.7256,-122.259,2710,18077,11,19,2014,UNK,0,403
6305900300,10/13/2014,395000.0,4,2.5,2740,8336,2.0,0.0,0.0,4,9,2740,0,1990,0,98031,47.3904,-122.176,2460,9189,10,13,2014,UNK,280,-853
7202340530,4/10/2015,498000.0,3,2.5,1690,4088,2.0,0.0,0.0,3,7,1690,0,2004,0,98053,47.6779,-122.03399999999999,1950,4088,4,10,2015,N,-260,0
7849202296,1/30/2015,339900.0,3,2.5,1470,4675,2.0,0.0,0.0,3,7,1470,0,1999,0,98065,47.5261,-121.82700000000001,1500,4385,1,30,2015,UNK,-30,290
255520150,9/2/2014,539000.0,3,2.5,2830,9972,2.0,0.0,0.0,3,9,2830,0,2006,0,98019,47.7382,-121.975,3557,9159,9,2,2014,N,-727,813
3578401770,2/26/2015,400000.0,3,1.0,1410,9704,1.0,0.0,0.0,3,8,1140,270,1983,0,98074,47.6203,-122.036,1910,13639,2,26,2015,UNK,-500,-3935
984000410,2/18/2015,225000.0,3,2.5,2170,11745,1.0,0.0,0.0,4,7,1410,760,1967,0,98058,47.4342,-122.17,1860,8643,2,18,2015,UNK,310,3102
9834200925,9/10/2014,330000.0,3,2.25,1340,4080,1.5,0.0,0.0,3,6,1170,170,1907,0,98144,47.5722,-122.291,1670,4080,9,10,2014,UNK,-330,0
2225039103,6/26/2014,1390000.0,3,3.0,2480,5500,2.0,0.0,3.0,3,10,1730,750,1950,2005,98199,47.6466,-122.404,2950,5670,6,26,2014,Y,-470,-170
6445800015,4/30/2015,490000.0,3,2.75,1990,31200,1.0,0.0,0.0,3,8,1990,0,1986,0,98029,47.5544,-122.035,3120,29625,4,30,2015,UNK,-1130,1575
1311800040,12/20/2014,260000.0,4,2.75,2240,7200,1.0,0.0,0.0,3,7,1140,1100,1967,0,98001,47.3357,-122.275,1580,7416,12,20,2014,UNK,660,-216
1473120730,6/27/2014,469900.0,4,2.5,2990,8913,2.0,0.0,0.0,4,9,2990,0,1991,0,98058,47.4353,-122.15899999999999,2740,8030,6,27,2014,UNK,250,883
6820100035,11/12/2014,493000.0,6,1.75,2120,3801,1.5,0.0,0.0,4,7,1220,900,1925,0,98115,47.6832,-122.311,1850,4181,11,12,2014,UNK,270,-380
1824079107,5/28/2014,740000.0,4,2.25,2920,46355,2.0,0.0,0.0,4,9,2920,0,1998,0,98024,47.568999999999996,-121.962,2310,184694,5,28,2014,UNK,610,-138339
2891000610,12/11/2014,148900.0,4,1.75,1700,6000,1.0,0.0,0.0,3,7,1700,0,1967,0,98002,47.3252,-122.208,1280,6000,12,11,2014,UNK,420,0
6600220090,11/18/2014,475000.0,2,2.5,1620,14467,2.0,0.0,0.0,3,7,1620,0,1981,0,98074,47.6306,-122.035,1470,13615,11,18,2014,UNK,150,852
4447300165,12/23/2014,415000.0,2,1.0,760,4000,1.0,0.0,0.0,3,7,760,0,1944,0,98117,47.6896,-122.396,1520,4000,12,23,2014,UNK,-760,0
2891000450,7/7/2014,229500.0,3,1.0,1230,6000,1.0,0.0,0.0,4,7,1230,0,1967,0,98002,47.3256,-122.209,1240,6000,7,7,2014,UNK,-10,0
9286000110,8/14/2014,1360000.0,5,3.75,4960,13990,2.0,0.0,2.0,3,11,3760,1200,2001,0,98006,47.5491,-122.137,5200,18116,8,14,2014,UNK,-240,-4126
2558160220,12/10/2014,385000.0,4,2.5,2030,11375,1.0,0.0,0.0,3,7,1330,700,1969,0,98028,47.7765,-122.26100000000001,1500,9160,12,10,2014,UNK,530,2215
2422000067,4/27/2015,230000.0,3,2.25,1830,11331,1.0,0.0,0.0,3,7,1250,580,1965,0,98001,47.2899,-122.287,2240,16433,4,27,2015,UNK,-410,-5102
2887701970,8/8/2014,425000.0,2,1.0,970,2700,1.0,0.0,0.0,4,7,770,200,1926,0,98115,47.6852,-122.31200000000001,1570,3348,8,8,2014,UNK,-600,-648
8581400015,7/22/2014,189900.0,2,1.0,1000,4179,1.0,0.0,0.0,5,5,1000,0,1914,0,98002,47.297,-122.227,1010,6327,7,22,2014,UNK,-10,-2148
7972603950,1/2/2015,238000.0,2,1.0,750,6480,1.0,0.0,0.0,3,6,750,0,1943,0,98106,47.5195,-122.35,1050,6390,1,2,2015,UNK,-300,90
7882600332,8/19/2014,968060.0,4,2.5,2620,16200,1.0,0.0,2.0,4,7,1570,1050,1950,1993,98033,47.6623,-122.196,3050,11875,8,19,2014,Y,-430,4325
5078400210,6/16/2014,921000.0,4,1.5,2220,9496,1.0,0.0,0.0,4,7,1490,730,1954,0,98004,47.6233,-122.206,1800,8286,6,16,2014,UNK,420,1210
1180008355,5/7/2014,380000.0,5,1.75,3000,6000,1.0,0.0,0.0,5,7,1500,1500,1958,0,98178,47.492,-122.225,2230,7125,5,7,2014,UNK,770,-1125
2781600195,11/17/2014,285000.0,1,1.0,1060,54846,1.0,1.0,4.0,3,5,1060,0,1935,0,98070,47.4716,-122.445,2258,31762,11,17,2014,UNK,-1198,23084
3342100995,10/22/2014,449000.0,4,2.5,1980,5400,2.0,0.0,0.0,3,8,1980,0,1998,0,98056,47.5182,-122.20700000000001,1980,5400,10,22,2014,UNK,0,0
2818600115,7/9/2014,625000.0,4,1.0,1600,5500,1.5,0.0,0.0,4,7,1600,0,1946,0,98117,47.6983,-122.39299999999999,1900,5500,7,9,2014,UNK,-300,0
8732020720,5/21/2014,318989.0,4,2.25,2000,9000,1.0,0.0,0.0,4,8,2000,0,1978,0,98023,47.3125,-122.387,2190,8374,5,21,2014,UNK,-190,626
1563100557,10/10/2014,445000.0,3,1.5,1310,1266,2.0,0.0,0.0,3,8,1120,190,2002,0,98116,47.5663,-122.40799999999999,1310,1378,10,10,2014,UNK,0,-112
9533100145,2/5/2015,750000.0,3,1.0,1120,8549,1.0,0.0,0.0,3,7,1120,0,1952,0,98004,47.6294,-122.205,1440,8640,2,5,2015,UNK,-320,-91
3761700067,3/6/2015,959000.0,3,2.5,3320,11875,1.0,0.0,0.0,5,10,3320,0,1979,0,98034,47.7212,-122.26,3730,11875,3,6,2015,UNK,-410,0
8029500360,12/2/2014,330000.0,3,2.5,2370,9102,2.0,0.0,0.0,3,9,2370,0,1990,0,98023,47.3067,-122.39399999999999,2530,9883,12,2,2014,UNK,-160,-781
7011201106,2/16/2015,425000.0,2,1.5,830,1241,2.0,0.0,0.0,3,7,830,0,2005,0,98119,47.6363,-122.368,1610,2666,2,16,2015,N,-780,-1425
3235100110,12/2/2014,280000.0,3,1.0,940,7913,1.0,0.0,0.0,3,6,940,0,1948,0,98155,47.7657,-122.321,940,7913,12,2,2014,UNK,0,0
2623089141,10/23/2014,476500.0,4,2.5,2250,50155,2.0,0.0,0.0,3,8,2250,0,1998,0,98045,47.449,-121.756,2040,57857,10,23,2014,UNK,210,-7702
1241500147,5/21/2014,556000.0,3,2.25,2020,3600,2.0,0.0,0.0,3,8,2020,0,1998,0,98033,47.6678,-122.165,2070,3699,5,21,2014,UNK,-50,-99
1524079188,7/29/2014,1860000.0,4,5.25,5240,320917,2.0,0.0,2.0,3,10,5240,0,2006,0,98024,47.5605,-121.905,1930,68824,7,29,2014,N,3310,252093
9262800208,9/19/2014,637000.0,4,3.5,4083,68377,2.0,0.0,0.0,3,10,4083,0,2005,0,98001,47.3114,-122.262,2430,41382,9,19,2014,N,1653,26995
1062100115,12/4/2014,405000.0,3,2.0,1450,6081,1.0,0.0,0.0,4,7,1450,0,1969,0,98155,47.7522,-122.27799999999999,1880,6000,12,4,2014,UNK,-430,81
6381500265,6/27/2014,397000.0,5,1.0,1170,6757,1.0,0.0,0.0,4,6,800,370,1944,0,98125,47.7332,-122.304,1590,6794,6,27,2014,UNK,-420,-37
7203220300,7/24/2014,895990.0,4,2.75,3555,6565,2.0,0.0,0.0,3,9,3555,0,2014,0,98053,47.6847,-122.01700000000001,3625,5637,7,24,2014,N,-70,928
4027701220,8/28/2014,259000.0,3,2.0,1610,14046,2.0,0.0,0.0,3,7,1610,0,1933,1988,98028,47.7704,-122.264,2410,9000,8,28,2014,Y,-800,5046
114100758,10/22/2014,420000.0,2,1.0,960,112384,1.0,0.0,0.0,3,7,960,0,1955,0,98028,47.7642,-122.234,1210,24875,10,22,2014,UNK,-250,87509
9376301110,5/19/2014,518000.0,3,2.5,1680,2096,2.0,0.0,0.0,3,8,1380,300,2008,0,98117,47.6904,-122.37,1360,2096,5,19,2014,N,320,0
9371700085,7/22/2014,425000.0,3,1.75,1380,8182,1.0,0.0,0.0,5,7,1380,0,1942,0,98133,47.7513,-122.34899999999999,1300,8188,7,22,2014,UNK,80,-6
2122049096,8/8/2014,182500.0,2,1.0,1040,13920,1.0,0.0,0.0,3,6,1040,0,1973,0,98198,47.3756,-122.306,1100,7575,8,8,2014,UNK,-60,6345
546000245,7/16/2014,549900.0,3,1.5,1380,3031,1.5,0.0,0.0,4,7,1380,0,1929,0,98117,47.6889,-122.38,1440,4005,7,16,2014,UNK,-60,-974
2783600210,9/16/2014,445000.0,3,1.75,1850,16863,1.0,0.0,0.0,4,7,1280,570,1980,0,98034,47.7166,-122.225,1790,9000,9,16,2014,UNK,60,7863
5210200184,6/6/2014,452000.0,2,1.75,1740,5400,1.0,0.0,0.0,4,7,990,750,1946,0,98115,47.6971,-122.28200000000001,1980,5400,6,6,2014,UNK,-240,0
2125049133,11/4/2014,715000.0,5,1.75,1920,6500,1.0,0.0,0.0,3,7,1260,0,1951,0,98112,47.6394,-122.30799999999999,1970,5500,11,4,2014,UNK,-50,1000
7940710100,9/11/2014,559000.0,3,2.5,2010,5200,2.0,0.0,0.0,3,8,2010,0,1989,0,98034,47.7142,-122.20299999999999,1860,4400,9,11,2014,UNK,150,800
6072800246,7/2/2014,3300000.0,5,6.25,8020,21738,2.0,0.0,0.0,3,11,8020,0,2001,0,98006,47.5675,-122.189,4160,18969,7,2,2014,UNK,3860,2769
5466700450,10/15/2014,250000.0,4,1.75,1860,7350,1.0,0.0,0.0,4,7,1090,770,1977,0,98031,47.3979,-122.17399999999999,1710,7350,10,15,2014,UNK,150,0
1425039029,9/23/2014,1230000.0,5,4.0,4390,6656,2.0,0.0,0.0,3,9,2930,1460,2008,0,98199,47.648,-122.397,1560,6656,9,23,2014,N,2830,0
422069067,5/12/2015,276500.0,4,2.25,2380,128937,1.0,0.0,0.0,4,7,2380,0,1960,0,98038,47.4253,-122.04299999999999,1030,114998,5,12,2015,UNK,1350,13939
2472920740,11/14/2014,440000.0,4,2.5,2880,7386,2.0,0.0,0.0,4,9,2880,0,1987,0,98058,47.4397,-122.15,2420,7663,11,14,2014,UNK,460,-277
2338800100,5/8/2014,543200.0,6,2.25,2820,15600,1.5,0.0,2.0,5,7,1970,850,1940,0,98166,47.4635,-122.36200000000001,2520,7797,5,8,2014,UNK,300,7803
3524039060,6/1/2014,250000.0,1,1.0,750,4000,1.0,0.0,0.0,3,6,750,0,1918,0,98136,47.5243,-122.39,1770,4850,6,1,2014,UNK,-1020,-850
7539900040,7/28/2014,625000.0,4,2.5,1750,9000,1.0,0.0,0.0,3,8,1410,340,1977,2003,98052,47.6403,-122.105,2120,9600,7,28,2014,Y,-370,-600
1646502055,6/13/2014,530100.0,3,1.0,1540,3399,1.5,0.0,0.0,3,7,1200,340,1926,0,98117,47.6853,-122.359,1500,3914,6,13,2014,UNK,40,-515
1025049268,7/21/2014,549900.0,2,1.75,1140,936,2.0,0.0,0.0,3,8,940,200,2014,0,98105,47.6647,-122.28399999999999,1160,1327,7,21,2014,N,-20,-391
324059076,3/11/2015,430000.0,4,1.5,1560,6534,1.0,0.0,0.0,4,7,1560,0,1962,0,98007,47.6012,-122.152,1560,6969,3,11,2015,UNK,0,-435
1853080730,12/10/2014,835000.0,3,2.5,2960,6856,2.0,0.0,0.0,3,10,2960,0,2009,0,98074,47.5906,-122.057,3320,6856,12,10,2014,N,-360,0
6708200040,5/7/2014,409500.0,4,2.75,2140,13000,1.0,0.0,0.0,3,7,1320,820,1968,0,98028,47.7683,-122.25200000000001,2360,11000,5,7,2014,UNK,-220,2000
3438501452,5/20/2014,329000.0,4,2.5,1600,6765,1.0,0.0,0.0,3,7,830,770,1947,2011,98106,47.5469,-122.365,1600,8942,5,20,2014,Y,0,-2177
9287802380,5/22/2014,940000.0,4,2.75,2080,4000,1.5,0.0,0.0,3,8,2080,0,1912,2000,98107,47.6737,-122.35799999999999,1730,5000,5,22,2014,Y,350,-1000
2652501513,8/13/2014,539950.0,3,2.0,1560,3200,1.5,0.0,0.0,3,7,1560,0,1910,2007,98109,47.6398,-122.35600000000001,1240,3600,8,13,2014,Y,320,-400
2421059125,4/14/2015,579950.0,4,2.5,2880,213444,1.0,0.0,0.0,5,8,2140,740,1984,0,98092,47.2887,-122.109,2810,213444,4,14,2015,UNK,70,0
1250202990,6/11/2014,881000.0,5,3.0,2510,4125,1.5,0.0,3.0,5,8,1590,920,1925,0,98144,47.5968,-122.29,2190,5415,6,11,2014,UNK,320,-1290
6914700165,8/4/2014,362500.0,3,1.0,960,5424,1.5,0.0,0.0,3,6,960,0,1916,0,98115,47.6997,-122.32,1550,5687,8,4,2014,UNK,-590,-263
920069052,4/21/2015,243950.0,2,1.0,1120,35500,1.0,0.0,0.0,5,6,1120,0,1961,0,98022,47.2411,-122.04299999999999,1680,66022,4,21,2015,UNK,-560,-30522
7853310590,5/29/2014,658000.0,4,2.75,3310,6166,2.0,0.0,0.0,3,9,3310,0,2008,0,98065,47.521,-121.87700000000001,3200,7027,5,29,2014,N,110,-861
1898600100,11/24/2014,218250.0,3,1.5,1080,9774,1.0,0.0,0.0,3,7,1080,0,1968,0,98023,47.3155,-122.40100000000001,1190,9611,11,24,2014,UNK,-110,163
5611500100,5/22/2014,655000.0,4,2.5,2860,12394,2.0,0.0,0.0,3,10,2860,0,1999,0,98075,47.5832,-122.02600000000001,3070,8515,5,22,2014,UNK,-210,3879
1796370590,3/5/2015,255000.0,3,2.0,1490,7599,1.0,0.0,0.0,3,7,1490,0,1990,0,98042,47.3687,-122.088,1560,7710,3,5,2015,UNK,-70,-111
7831800110,1/15/2015,215000.0,3,1.0,1210,7175,1.0,0.0,0.0,3,7,1210,0,1918,0,98106,47.5339,-122.35600000000001,1640,5850,1,15,2015,UNK,-430,1325
4218400175,2/23/2015,1270000.0,3,1.75,2240,5657,1.5,0.0,2.0,4,8,1910,330,1941,0,98105,47.6621,-122.27,2970,5657,2,23,2015,UNK,-730,0
5317100750,7/11/2014,2920000.0,4,4.75,4575,24085,2.5,0.0,2.0,5,10,3905,670,1926,0,98112,47.6263,-122.28399999999999,3900,9687,7,11,2014,UNK,675,14398
3365900175,4/2/2015,424305.0,3,2.5,1600,5960,2.0,0.0,2.0,5,8,1600,0,1910,0,98168,47.4758,-122.265,1410,13056,4,2,2015,UNK,190,-7096
7649900175,5/20/2014,494000.0,4,1.75,2090,4300,1.5,0.0,0.0,4,7,1250,0,1925,0,98136,47.5555,-122.397,1670,5000,5,20,2014,UNK,420,-700
8159600360,6/5/2014,560000.0,4,2.5,2260,3713,2.0,0.0,0.0,3,9,2260,0,2003,0,98034,47.7247,-122.165,2260,3713,6,5,2014,UNK,0,0
9272202260,9/24/2014,130000.0,3,1.0,1200,7000,2.0,0.0,0.0,1,7,1200,0,1908,0,98116,47.5883,-122.384,3290,6000,9,24,2014,UNK,-2090,1000
2820069048,5/4/2015,468000.0,4,2.5,2480,176418,1.5,0.0,3.0,5,8,2480,0,1927,0,98022,47.1941,-122.038,1640,112384,5,4,2015,UNK,840,64034
6744700343,12/9/2014,480000.0,5,3.0,2240,15435,1.0,0.0,1.0,5,7,1390,850,1952,0,98155,47.7426,-122.288,2240,10750,12,9,2014,UNK,0,4685
925049318,8/11/2014,475000.0,3,1.75,1550,4054,1.5,0.0,0.0,4,7,1550,0,1926,0,98115,47.6743,-122.301,1510,3889,8,11,2014,UNK,40,165
6648700150,2/25/2015,285000.0,4,1.75,2130,8151,1.0,0.0,0.0,4,7,1330,800,1967,0,98031,47.3932,-122.20100000000001,1600,8587,2,25,2015,UNK,530,-436
510001400,6/30/2014,765000.0,5,3.0,2870,5700,1.0,0.0,0.0,3,7,1950,920,1964,0,98103,47.6621,-122.33,1730,5529,6,30,2014,UNK,1140,171
7606200090,3/27/2015,208000.0,2,1.0,1160,5750,1.0,0.0,0.0,4,6,1160,0,1924,0,98065,47.5322,-121.829,1160,8250,3,27,2015,UNK,0,-2500
8562890590,10/3/2014,372000.0,3,2.5,2430,5000,2.0,0.0,0.0,3,8,2430,0,2001,0,98042,47.3786,-122.12700000000001,2910,5620,10,3,2014,UNK,-480,-620
441000115,12/9/2014,470000.0,2,1.0,900,5512,1.0,0.0,0.0,3,7,900,0,1947,0,98115,47.6877,-122.289,1270,5512,12,9,2014,UNK,-370,0
3876200330,6/26/2014,451000.0,5,2.75,2830,8925,1.5,0.0,0.0,3,7,2830,0,1967,0,98034,47.731,-122.179,1700,8539,6,26,2014,UNK,1130,386
1508210100,8/27/2014,442200.0,4,1.75,1620,8132,1.0,0.0,0.0,3,8,1620,0,1974,0,98052,47.6788,-122.11,1920,8400,8,27,2014,UNK,-300,-268
2944500330,8/25/2014,330000.0,4,2.5,2510,8580,2.0,0.0,0.0,4,8,2510,0,1991,0,98023,47.295,-122.37,2290,7809,8,25,2014,UNK,220,771
4302200625,9/24/2014,335000.0,3,1.75,1790,5120,1.0,0.0,0.0,4,6,940,850,1949,0,98106,47.5277,-122.355,1160,5120,9,24,2014,UNK,630,0
2722049246,11/14/2014,280000.0,3,2.0,1640,13249,1.0,0.0,0.0,3,7,1640,0,1995,0,98032,47.3589,-122.281,1640,9240,11,14,2014,UNK,0,4009
142000175,8/22/2014,625000.0,3,1.75,2240,6050,1.0,0.0,0.0,4,8,1250,990,1950,0,98116,47.5658,-122.4,1720,6050,8,22,2014,UNK,520,0
9558041130,9/3/2014,345000.0,3,2.5,1870,3584,2.0,0.0,0.0,3,8,1870,0,2003,0,98058,47.4521,-122.12100000000001,1900,3920,9,3,2014,UNK,-30,-336
5112800210,10/24/2014,255950.0,4,1.0,1500,11050,1.0,0.0,0.0,5,7,1500,0,1964,0,98058,47.4509,-122.088,1970,20800,10,24,2014,UNK,-470,-9750
2461900850,1/5/2015,570000.0,4,1.0,1490,6000,1.5,0.0,0.0,3,7,1490,0,1918,0,98136,47.5518,-122.385,1700,6000,1,5,2015,UNK,-210,0
647100096,3/31/2015,685000.0,3,1.5,2230,8558,2.0,0.0,0.0,3,8,2230,0,1960,0,98040,47.5833,-122.219,2200,8558,3,31,2015,UNK,30,0
2787311110,9/2/2014,273148.0,3,1.75,1710,7210,1.0,0.0,0.0,4,7,1240,470,1974,0,98031,47.4094,-122.175,1840,7245,9,2,2014,UNK,-130,-35
1545801500,6/25/2014,246500.0,3,2.5,1620,7686,2.0,0.0,0.0,3,7,1620,0,1989,0,98038,47.3613,-122.053,1370,7686,6,25,2014,UNK,250,0
3811300110,4/6/2015,349950.0,5,2.5,2250,7176,1.0,0.0,0.0,3,7,1310,940,1983,0,98055,47.4486,-122.194,1550,9081,4,6,2015,UNK,700,-1905
7519001321,2/10/2015,545000.0,4,2.0,1700,2350,1.0,0.0,0.0,3,6,850,850,1926,2014,98117,47.6865,-122.366,1600,4160,2,10,2015,Y,100,-1810
8641500252,2/27/2015,403000.0,3,2.5,1502,1400,3.0,0.0,0.0,3,7,1502,0,2005,0,98115,47.6951,-122.305,1377,1466,2,27,2015,N,125,-66
8562891240,2/11/2015,299950.0,4,2.5,1900,4054,2.0,0.0,0.0,3,7,1900,0,2003,0,98042,47.3767,-122.124,2520,4085,2,11,2015,UNK,-620,-31
8644210110,5/1/2015,792000.0,3,2.5,3320,12840,1.0,0.0,0.0,3,10,2600,720,1990,0,98075,47.5783,-121.994,3230,14933,5,1,2015,UNK,90,-2093
8024202380,10/2/2014,418000.0,5,2.5,1980,10205,1.0,0.0,0.0,4,7,1080,900,1929,0,98115,47.699,-122.307,1310,5413,10,2,2014,UNK,670,4792
5006000035,4/27/2015,332500.0,4,1.0,1670,8102,1.5,0.0,0.0,3,6,1670,0,1944,0,98166,47.4692,-122.355,1310,7906,4,27,2015,UNK,360,196
421069081,1/27/2015,337000.0,3,2.5,2235,43560,1.0,0.0,0.0,5,7,990,1245,1975,0,98010,47.3326,-122.046,1460,29621,1,27,2015,UNK,775,13939
5053300015,1/21/2015,212000.0,2,1.0,1070,7386,1.0,0.0,0.0,3,6,1070,0,1949,0,98108,47.5434,-122.29799999999999,1330,6351,1,21,2015,UNK,-260,1035
8857320120,3/10/2015,542000.0,2,2.25,1800,2819,2.0,0.0,2.0,4,9,1800,0,1979,0,98008,47.6104,-122.113,1800,2755,3,10,2015,UNK,0,64
7852110690,5/22/2014,622500.0,4,2.5,2980,8107,2.0,0.0,0.0,3,9,2980,0,2000,0,98065,47.5389,-121.876,2750,7760,5,22,2014,UNK,230,347
6084600330,8/29/2014,260000.0,3,1.75,1670,8511,1.0,0.0,0.0,3,7,1340,330,1985,0,98001,47.3257,-122.27600000000001,1580,7218,8,29,2014,UNK,90,1293
5561000330,5/5/2015,525000.0,3,1.75,2620,38350,1.0,0.0,0.0,4,8,1320,1300,1977,0,98027,47.4619,-121.991,2170,36962,5,5,2015,UNK,450,1388
2225059273,11/14/2014,975000.0,5,3.5,5470,35071,2.0,0.0,0.0,3,11,4590,880,1976,0,98005,47.6368,-122.15899999999999,3600,35074,11,14,2014,UNK,1870,-3
1370803445,9/9/2014,1140000.0,4,1.75,3080,6500,1.0,0.0,0.0,4,9,1700,1380,1941,0,98199,47.6353,-122.402,2960,5711,9,9,2014,UNK,120,789
1236300268,3/3/2015,500000.0,3,1.0,940,10360,1.0,0.0,0.0,4,7,940,0,1964,0,98033,47.688,-122.19,2019,10360,3,3,2015,UNK,-1079,0
7752700110,6/18/2014,554000.0,5,2.25,1870,11411,1.0,0.0,0.0,4,8,1170,700,1961,0,98155,47.7445,-122.289,2420,10793,6,18,2014,UNK,-550,618
2781250230,6/5/2014,343000.0,4,2.5,2070,4500,2.0,0.0,0.0,3,7,2070,0,2004,0,98038,47.3497,-122.02600000000001,2760,5173,6,5,2014,N,-690,-673
4027701055,4/24/2015,515000.0,2,1.75,950,15219,1.0,0.0,0.0,3,8,950,0,2009,0,98028,47.7723,-122.262,1560,12416,4,24,2015,N,-610,2803
2755200040,7/12/2014,492000.0,2,1.0,1290,6272,1.0,0.0,0.0,4,6,890,400,1922,0,98115,47.6777,-122.305,1260,5376,7,12,2014,UNK,30,896
2193320450,2/13/2015,655000.0,4,3.0,2570,8022,1.0,0.0,0.0,4,8,1370,1200,1984,0,98052,47.6956,-122.09899999999999,2090,8022,2,13,2015,UNK,480,0
2895550330,5/6/2015,290000.0,3,2.5,1600,6848,2.0,0.0,0.0,3,7,1600,0,2000,0,98001,47.3303,-122.271,1700,7210,5,6,2015,UNK,-100,-362
8712100790,7/1/2014,952500.0,4,1.5,2550,5055,2.0,0.0,0.0,4,10,2550,0,1910,0,98112,47.636,-122.301,1970,4431,7,1,2014,UNK,580,624
7883603700,8/22/2014,235000.0,2,1.0,1010,7500,1.0,0.0,0.0,3,7,1010,0,1941,0,98108,47.5283,-122.32,1220,6000,8,22,2014,UNK,-210,1500
3438502731,4/1/2015,323000.0,3,1.5,1720,7110,1.0,0.0,0.0,3,8,1720,0,1955,0,98106,47.5417,-122.355,1730,6840,4,1,2015,UNK,-10,270
2025049161,5/6/2014,1050000.0,3,2.5,2200,1970,2.0,0.0,0.0,3,9,1610,590,2008,0,98102,47.6426,-122.32700000000001,1890,3505,5,6,2014,N,310,-1535
5706500385,1/29/2015,200000.0,2,1.0,1400,9600,1.5,0.0,0.0,4,6,1400,0,1941,0,98022,47.2113,-121.993,1230,9600,1,29,2015,UNK,170,0
4024101254,12/4/2014,419995.0,3,2.25,1830,7500,1.0,0.0,0.0,4,7,1330,500,1968,0,98155,47.7574,-122.31,1830,8720,12,4,2014,UNK,0,-1220
7923250090,3/10/2015,1500000.0,3,3.0,3110,9015,1.0,0.0,4.0,4,10,1590,1520,1980,0,98033,47.6624,-122.20200000000001,3150,11447,3,10,2015,UNK,-40,-2432
6675500082,8/12/2014,455000.0,3,2.5,1600,7829,2.0,0.0,0.0,3,7,1600,0,1987,0,98034,47.7288,-122.227,1580,9104,8,12,2014,UNK,20,-1275
4046710180,3/25/2015,660000.0,3,3.5,3600,37982,2.0,0.0,0.0,4,8,3600,0,1996,0,98014,47.6982,-121.917,2050,18019,3,25,2015,UNK,1550,19963
1771000760,5/13/2014,319000.0,3,1.0,1390,12823,1.0,0.0,0.0,4,7,1390,0,1968,0,98077,47.7438,-122.075,1390,10095,5,13,2014,UNK,0,2728
3421069044,12/23/2014,390000.0,3,1.75,2092,250905,1.0,0.0,0.0,3,7,2092,0,1981,0,98022,47.2664,-122.027,2092,217800,12,23,2014,UNK,0,33105
6600000330,6/27/2014,718500.0,3,1.5,1200,6240,1.0,0.0,0.0,3,8,1030,170,1952,0,98112,47.6222,-122.287,2810,6240,6,27,2014,UNK,-1610,0
2041000025,12/3/2014,474000.0,2,1.0,1090,3160,1.0,0.0,0.0,3,7,840,250,1926,0,98109,47.6385,-122.344,1070,3160,12,3,2014,UNK,20,0
2215500230,8/25/2014,615750.0,4,2.0,2140,6360,2.0,0.0,0.0,3,7,1840,300,1945,0,98115,47.687,-122.286,1690,6360,8,25,2014,UNK,450,0
6639900176,11/14/2014,551000.0,3,2.5,2010,17362,2.0,0.0,0.0,3,8,2010,0,1994,0,98033,47.6904,-122.176,1920,7200,11,14,2014,UNK,90,10162
104510180,2/11/2015,230000.0,3,2.25,1500,7210,1.0,0.0,0.0,3,7,1150,350,1984,0,98023,47.3124,-122.352,1500,7210,2,11,2015,UNK,0,0
7202360760,7/11/2014,790000.0,4,2.5,3500,9198,2.0,0.0,0.0,3,9,3500,0,2004,0,98053,47.6785,-122.025,3990,8598,7,11,2014,N,-490,600
3879901285,3/26/2015,1230000.0,3,2.5,2660,1967,3.0,0.0,3.0,3,9,1870,790,2007,0,98119,47.6264,-122.363,1640,1369,3,26,2015,N,1020,598
1559900110,12/23/2014,325000.0,3,2.25,1440,6443,2.0,0.0,0.0,3,7,1440,0,1995,0,98019,47.7471,-121.979,1700,6749,12,23,2014,UNK,-260,-306
7202260040,8/1/2014,705000.0,4,2.75,2780,6207,2.0,0.0,0.0,3,8,2780,0,2001,0,98053,47.6867,-122.038,2660,5592,8,1,2014,UNK,120,615
7334600730,12/11/2014,259000.0,4,1.75,1580,8856,2.0,0.0,0.0,3,7,1580,0,1979,0,98045,47.4694,-121.745,1390,9490,12,11,2014,UNK,190,-634
1723049419,12/4/2014,306000.0,3,1.5,1250,8700,1.0,0.0,0.0,4,7,1250,0,1959,0,98168,47.4744,-122.32799999999999,1300,8700,12,4,2014,UNK,-50,0
3438501081,12/15/2014,315000.0,3,1.0,970,6828,1.0,0.0,0.0,3,6,970,0,1928,0,98106,47.5476,-122.36,1160,11666,12,15,2014,UNK,-190,-4838
2916200054,4/13/2015,392500.0,3,1.0,1100,7650,1.0,0.0,0.0,3,7,1100,0,1952,0,98133,47.7219,-122.354,1430,7650,4,13,2015,UNK,-330,0
3024059149,11/12/2014,1070000.0,4,2.25,3240,12930,2.0,0.0,0.0,4,9,2730,510,1968,0,98040,47.5373,-122.22,2610,12884,11,12,2014,UNK,630,46
1862400528,7/16/2014,350500.0,2,2.5,1290,1445,3.0,0.0,0.0,3,8,1290,0,1999,0,98117,47.6955,-122.376,1470,1503,7,16,2014,UNK,-180,-58
6329000385,6/18/2014,825000.0,4,3.5,3810,9792,2.0,0.0,0.0,3,9,3810,0,1938,2013,98146,47.5018,-122.38,1950,9792,6,18,2014,Y,1860,0
7812800215,8/8/2014,235000.0,4,1.0,1500,6360,1.5,0.0,0.0,3,6,1500,0,1944,0,98178,47.4979,-122.24,1190,6360,8,8,2014,UNK,310,0
2324079057,3/2/2015,650000.0,3,2.0,2660,257875,1.0,0.0,2.0,4,8,1530,1130,1976,0,98024,47.553000000000004,-121.887,1710,64033,3,2,2015,UNK,950,193842
1982201485,5/12/2014,675000.0,4,3.0,2400,3340,1.0,0.0,0.0,4,7,1200,1200,1964,0,98107,47.6646,-122.365,1520,3758,5,12,2014,UNK,880,-418
740500040,10/1/2014,265000.0,4,1.0,1860,8505,1.0,0.0,0.0,4,7,1860,0,1955,0,98055,47.4406,-122.194,1560,8505,10,1,2014,UNK,300,0
3025049052,8/12/2014,822500.0,2,1.0,1450,7098,1.0,0.0,4.0,3,7,1450,0,1924,0,98109,47.63,-122.34899999999999,2390,6098,8,12,2014,UNK,-940,1000
5244801255,4/28/2015,705000.0,3,2.75,2260,4000,2.0,0.0,0.0,4,8,1540,720,1956,0,98109,47.6435,-122.353,2120,4000,4,28,2015,UNK,140,0
2397101606,12/8/2014,2630000.0,6,4.75,5540,7200,2.5,0.0,2.0,4,11,3950,1590,1909,0,98119,47.6361,-122.366,2930,7200,12,8,2014,UNK,2610,0
7234601445,6/23/2014,685000.0,2,1.5,1300,1676,1.0,0.0,2.0,3,7,1300,0,1943,0,98122,47.6133,-122.30799999999999,1260,1740,6,23,2014,UNK,40,-64
3693901105,10/20/2014,630000.0,4,2.0,1610,5000,2.0,0.0,0.0,5,7,1610,0,1946,0,98117,47.6775,-122.398,1300,4950,10,20,2014,UNK,310,50
3124059006,5/8/2014,1250000.0,4,3.25,3820,24166,2.0,0.0,1.0,4,11,3310,510,1990,0,98040,47.5263,-122.227,2900,18786,5,8,2014,UNK,920,5380
2523039310,1/12/2015,359000.0,4,2.5,1820,11325,1.0,0.0,0.0,3,8,1390,430,1976,0,98166,47.4574,-122.361,1990,10802,1,12,2015,UNK,-170,523
5469650040,3/16/2015,784500.0,4,5.0,5820,13906,2.0,0.0,0.0,3,11,3750,2070,1993,0,98042,47.3814,-122.164,2980,13000,3,16,2015,UNK,2840,906
5021900945,7/3/2014,850000.0,3,2.0,2470,8800,2.0,0.0,0.0,3,9,2470,0,1961,2004,98040,47.5753,-122.22200000000001,2340,10980,7,3,2014,Y,130,-2180
1152700220,9/3/2014,410000.0,3,2.5,3040,6054,2.0,0.0,0.0,3,9,3040,0,2005,0,98042,47.3508,-122.163,2650,6054,9,3,2014,N,390,0
1423900220,7/9/2014,252000.0,4,1.75,1120,8250,1.0,0.0,0.0,4,7,1120,0,1966,0,98058,47.4555,-122.177,1330,7975,7,9,2014,UNK,-210,275
3425059066,8/12/2014,618000.0,5,1.75,1880,18295,1.0,0.0,0.0,4,7,1880,0,1955,0,98005,47.6059,-122.154,2180,20674,8,12,2014,UNK,-300,-2379
5347200165,10/2/2014,265000.0,3,1.0,1070,4800,1.0,0.0,0.0,3,6,970,100,1947,0,98126,47.5187,-122.37700000000001,1120,1198,10,2,2014,UNK,-50,3602
5145100300,9/18/2014,465000.0,3,2.0,1560,8509,1.0,0.0,0.0,3,8,790,770,1969,0,98034,47.7261,-122.22,1410,7428,9,18,2014,UNK,150,1081
6141100395,2/4/2015,240000.0,2,1.0,870,6552,1.0,0.0,0.0,3,6,870,0,1947,0,98133,47.7188,-122.353,1500,6678,2,4,2015,UNK,-630,-126
5153200506,7/31/2014,217000.0,3,1.0,1000,12000,1.0,0.0,0.0,3,7,1000,0,1959,0,98023,47.3321,-122.346,1490,14940,7,31,2014,UNK,-490,-2940
9122000385,8/6/2014,415000.0,4,2.25,2520,4200,1.5,0.0,0.0,4,7,1510,1010,1909,0,98144,47.5814,-122.31200000000001,1460,4200,8,6,2014,UNK,1060,0
3279000120,12/22/2014,274000.0,2,2.0,1700,7992,1.0,0.0,0.0,4,7,950,750,1980,0,98023,47.3031,-122.385,1700,8030,12,22,2014,UNK,0,-38
3438503223,2/23/2015,420000.0,5,3.0,2150,6117,1.0,0.0,0.0,3,7,1370,780,2003,0,98106,47.538000000000004,-122.35600000000001,1990,6064,2,23,2015,UNK,160,53
6788201240,3/18/2015,1060000.0,4,2.75,1590,6000,1.5,0.0,0.0,4,8,1590,0,1925,0,98112,47.6401,-122.29899999999999,1590,4000,3,18,2015,UNK,0,2000
4139900120,6/5/2014,1420000.0,4,5.25,4670,43950,2.0,0.0,0.0,3,12,4670,0,1989,0,98006,47.5456,-122.126,4900,35000,6,5,2014,UNK,-230,8950
1868900775,5/5/2014,618500.0,3,2.0,1800,5000,1.0,0.0,0.0,4,7,1080,0,1942,0,98115,47.6738,-122.29700000000001,1800,5000,5,5,2014,UNK,0,0
764000180,1/9/2015,295000.0,3,1.5,1670,10800,1.0,0.0,0.0,4,8,1670,0,1956,0,98022,47.2004,-122.00299999999999,1670,9169,1,9,2015,UNK,0,1631
3578400910,3/16/2015,400000.0,3,2.0,1010,12252,1.0,0.0,0.0,3,8,1010,0,1980,0,98074,47.6224,-122.045,1840,11497,3,16,2015,UNK,-830,755
5631500191,3/26/2015,595000.0,3,2.5,2550,6677,2.0,0.0,0.0,3,8,2550,0,2002,0,98028,47.7336,-122.23200000000001,1930,7217,3,26,2015,UNK,620,-540
6448000100,6/17/2014,1730000.0,4,3.0,3700,20570,1.0,0.0,0.0,4,10,1850,1850,1976,0,98004,47.6212,-122.22399999999999,3080,17595,6,17,2014,UNK,620,2975
1545801340,12/31/2014,261000.0,3,1.75,1350,7686,1.0,0.0,0.0,3,7,1350,0,1987,0,98038,47.3617,-122.052,1370,7686,12,31,2014,UNK,-20,0
5244800915,10/16/2014,780000.0,5,2.5,1660,4000,1.5,0.0,0.0,5,8,1660,0,1929,0,98109,47.6452,-122.352,1210,4000,10,16,2014,UNK,450,0
4217400590,11/18/2014,589000.0,3,1.5,1390,5040,1.0,0.0,0.0,3,7,1090,300,1947,0,98105,47.6611,-122.28200000000001,1910,4800,11,18,2014,UNK,-520,240
1683600110,3/5/2015,230000.0,3,1.75,1720,9125,1.0,0.0,0.0,4,7,1140,580,1981,0,98092,47.3173,-122.181,1120,7506,3,5,2015,UNK,600,1619
3630090110,10/18/2014,690000.0,4,3.5,2980,2147,2.5,0.0,0.0,3,10,2490,490,2006,0,98029,47.5463,-121.995,2880,2428,10,18,2014,N,100,-281
1785400210,1/29/2015,524000.0,4,2.25,2190,15491,2.0,0.0,0.0,3,8,2190,0,1981,0,98074,47.6299,-122.039,2090,15039,1,29,2015,UNK,100,452
3319500317,5/22/2014,380000.0,2,2.5,1230,987,2.0,0.0,0.0,3,7,1060,170,2011,0,98144,47.6007,-122.305,1290,1328,5,22,2014,N,-60,-341
2492200256,11/12/2014,357500.0,3,1.0,1000,4080,1.0,0.0,0.0,4,7,740,260,1945,0,98126,47.5351,-122.381,1480,4080,11,12,2014,UNK,-480,0
3797300110,10/27/2014,330000.0,3,2.0,2500,10697,1.0,0.0,0.0,3,8,2500,0,1994,0,98022,47.1927,-122.01,2560,9772,10,27,2014,UNK,-60,925
1870400615,3/9/2015,635000.0,5,1.75,2240,4750,1.0,0.0,0.0,4,7,1120,1120,1920,0,98115,47.6727,-122.29299999999999,1980,4750,3,9,2015,UNK,260,0
8823901445,3/13/2015,934000.0,9,3.0,2820,4480,2.0,0.0,0.0,3,7,1880,940,1918,0,98105,47.6654,-122.307,2460,4400,3,13,2015,UNK,360,80
3630000150,1/28/2015,358500.0,2,1.75,1400,865,2.0,0.0,0.0,3,8,1110,0,2005,0,98029,47.5478,-121.999,1380,1107,1,28,2015,N,20,-242
5727500301,10/6/2014,401000.0,3,1.5,1470,6867,1.0,0.0,0.0,3,8,1470,0,1955,0,98155,47.7495,-122.32700000000001,1470,6523,10,6,2014,UNK,0,344
4167960330,1/9/2015,270000.0,3,2.0,1820,7750,1.0,0.0,0.0,3,8,1820,0,1992,0,98023,47.3169,-122.352,2080,8084,1,9,2015,UNK,-260,-334
2484700155,10/14/2014,705000.0,4,2.0,2060,6000,1.0,0.0,1.0,4,8,1370,690,1954,0,98136,47.5237,-122.383,2060,6600,10,14,2014,UNK,0,-600
4046700300,10/30/2014,325000.0,3,2.0,1670,17071,1.0,0.0,0.0,3,7,1100,570,1988,0,98014,47.69,-121.913,1660,15593,10,30,2014,UNK,10,1478
4365200865,9/2/2014,384950.0,3,1.0,1540,7740,1.0,0.0,0.0,4,7,1540,0,1909,0,98126,47.522,-122.375,1220,7740,9,2,2014,UNK,320,0
6713700205,7/15/2014,310000.0,3,1.0,1210,9730,1.0,0.0,0.0,4,7,1210,0,1953,0,98133,47.762,-122.355,1470,9730,7,15,2014,UNK,-260,0
293800900,10/6/2014,829950.0,4,2.5,3430,42775,2.0,0.0,0.0,3,10,3430,0,1992,0,98077,47.765,-122.045,3190,36820,10,6,2014,UNK,240,5955
3375800220,3/30/2015,353000.0,3,2.5,2550,6021,2.0,0.0,0.0,3,7,2550,0,2002,0,98030,47.3828,-122.211,2080,6021,3,30,2015,UNK,470,0
8898700820,7/7/2014,170500.0,2,1.0,1060,7700,1.0,0.0,0.0,3,7,820,240,1981,0,98055,47.4599,-122.205,1370,8833,7,7,2014,UNK,-310,-1133
2725069156,7/16/2014,885250.0,4,2.5,3670,49658,2.0,0.0,0.0,3,10,3670,0,1999,0,98074,47.6219,-122.015,3040,49658,7,16,2014,UNK,630,0
8043700300,6/8/2014,2700000.0,4,3.25,4420,7850,2.0,1.0,4.0,3,11,3150,1270,2001,0,98008,47.571999999999996,-122.102,2760,8525,6,8,2014,UNK,1660,-675
2372800100,9/25/2014,245000.0,3,1.5,1550,9126,1.0,0.0,0.0,5,7,1550,0,1957,0,98022,47.2012,-122.0,1450,9282,9,25,2014,UNK,100,-156
7518501822,10/17/2014,469000.0,3,2.5,1190,1290,3.0,0.0,0.0,3,8,1190,0,2008,0,98107,47.6762,-122.37799999999999,1410,1923,10,17,2014,N,-220,-633
1928300620,6/8/2014,455000.0,3,1.0,1300,3550,1.5,0.0,0.0,3,7,1300,0,1927,0,98105,47.6696,-122.32,1410,4080,6,8,2014,UNK,-110,-530
1402950100,11/21/2014,305000.0,4,2.5,2430,5959,2.0,0.0,0.0,3,8,2430,0,2002,0,98092,47.3348,-122.19,2100,5414,11,21,2014,UNK,330,545
2616800600,5/30/2014,840000.0,7,4.5,4290,37607,1.5,0.0,0.0,5,10,4290,0,1982,0,98027,47.4812,-122.03299999999999,2810,40510,5,30,2014,UNK,1480,-2903
2597530760,6/23/2014,905000.0,5,3.5,3500,10155,2.0,0.0,0.0,3,10,2570,930,1996,0,98006,47.5415,-122.133,2940,10753,6,23,2014,UNK,560,-598
7345200650,12/31/2014,219200.0,3,2.0,1680,7000,1.5,0.0,0.0,4,7,1680,0,1968,0,98002,47.2775,-122.20299999999999,1540,7480,12,31,2014,UNK,140,-480
259800750,2/23/2015,455000.0,3,1.5,1250,8004,1.0,0.0,0.0,3,7,1250,0,1965,0,98008,47.6285,-122.117,1450,7931,2,23,2015,UNK,-200,73
723049197,6/27/2014,195000.0,2,1.0,1020,8100,1.0,0.0,0.0,3,6,1020,0,1940,0,98168,47.4971,-122.334,1200,12500,6,27,2014,UNK,-180,-4400
2883200775,11/13/2014,799000.0,3,1.0,1510,4178,2.0,0.0,0.0,3,8,1510,0,1902,0,98103,47.6849,-122.335,2140,4916,11,13,2014,UNK,-630,-738
3995700245,6/27/2014,285000.0,2,1.0,910,8155,1.0,0.0,0.0,4,6,910,0,1948,0,98155,47.7399,-122.3,1240,8155,6,27,2014,UNK,-330,0
1775900220,9/22/2014,300000.0,3,1.5,1320,15053,1.0,0.0,0.0,3,7,1320,0,1979,0,98072,47.7405,-122.095,1250,13368,9,22,2014,UNK,70,1685
7999600180,5/29/2014,83000.0,2,1.0,900,8580,1.0,0.0,0.0,3,5,900,0,1918,0,98168,47.4727,-122.27,2060,6533,5,29,2014,UNK,-1160,2047
6145601745,4/14/2015,220000.0,2,1.0,890,4804,1.0,0.0,0.0,4,7,890,0,1928,0,98133,47.7027,-122.346,1010,3844,4,14,2015,UNK,-120,960
818500100,6/3/2014,174500.0,2,2.5,1240,2689,2.0,0.0,0.0,3,7,1240,0,1986,0,98003,47.3236,-122.323,1430,3609,6,3,2014,UNK,-190,-920
3904920730,4/27/2015,695000.0,4,2.5,2960,10760,2.0,0.0,0.0,3,9,2960,0,1987,0,98029,47.5677,-122.01299999999999,2480,9528,4,27,2015,UNK,480,1232
3211000040,12/4/2014,255000.0,3,1.5,1020,11410,1.0,0.0,0.0,3,7,1020,0,1959,0,98059,47.4811,-122.162,1290,8400,12,4,2014,UNK,-270,3010
9557300040,2/25/2015,539000.0,5,2.25,2590,7245,1.0,0.0,0.0,3,8,1510,1080,1973,0,98008,47.6398,-122.111,1930,7245,2,25,2015,UNK,660,0
7011201482,3/17/2015,552700.0,2,1.0,1100,2800,1.0,0.0,0.0,3,7,1100,0,1925,0,98119,47.6361,-122.37100000000001,1110,1673,3,17,2015,UNK,-10,1127
5315100667,6/3/2014,571500.0,3,1.0,1300,6710,1.0,0.0,0.0,4,6,1300,0,1952,0,98040,47.5851,-122.242,1630,9946,6,3,2014,UNK,-330,-3236
8598900157,3/13/2015,263700.0,3,1.0,1200,6561,1.0,0.0,0.0,3,6,1200,0,1950,1968,98177,47.7763,-122.36,1340,9450,3,13,2015,Y,-140,-2889
1346300150,10/20/2014,3300000.0,8,4.0,7710,11750,3.5,0.0,0.0,5,12,6090,1620,1904,0,98112,47.6263,-122.314,4210,8325,10,20,2014,UNK,3500,3425
9268710220,5/28/2014,186950.0,2,2.0,1390,1302,2.0,0.0,0.0,3,7,1390,0,1986,0,98003,47.3089,-122.33,1390,1302,5,28,2014,UNK,0,0
2224079086,11/10/2014,520000.0,3,1.75,1430,53628,2.0,0.0,0.0,3,8,1430,0,1985,0,98024,47.5577,-121.891,2100,53628,11,10,2014,UNK,-670,0
1761600150,7/30/2014,358000.0,3,1.5,1250,7194,1.0,0.0,0.0,4,7,1250,0,1969,0,98034,47.7298,-122.23100000000001,1340,7242,7,30,2014,UNK,-90,-48
2123049086,8/7/2014,210000.0,2,0.75,840,49658,1.0,0.0,0.0,2,6,840,0,1948,0,98168,47.4727,-122.292,1240,11000,8,7,2014,UNK,-400,38658
4389201095,5/11/2015,3650000.0,5,3.75,5020,8694,2.0,0.0,1.0,3,12,3970,1050,2007,0,98004,47.6146,-122.213,4190,11275,5,11,2015,N,830,-2581
2802200100,8/11/2014,543000.0,4,2.25,2060,8767,2.0,0.0,0.0,3,8,2060,0,1983,0,98052,47.7228,-122.103,1610,8062,8,11,2014,UNK,450,705
6706000040,4/23/2015,330000.0,4,2.25,2000,10679,1.0,0.0,0.0,3,7,1350,650,1960,0,98148,47.4238,-122.329,1650,8875,4,23,2015,UNK,350,1804
9828701690,8/6/2014,529000.0,3,2.0,1530,3400,1.0,0.0,0.0,3,7,990,540,1907,2014,98112,47.6204,-122.296,1880,4212,8,6,2014,Y,-350,-812
7891600165,6/27/2014,295000.0,1,1.0,700,2500,1.0,0.0,0.0,4,7,700,0,1907,0,98106,47.5662,-122.36399999999999,1340,5000,6,27,2014,UNK,-640,-2500
1238500978,9/22/2014,365000.0,3,1.0,950,8450,1.0,0.0,0.0,3,7,950,0,1962,0,98033,47.6884,-122.186,1610,10080,9,22,2014,UNK,-660,-1630
8673400141,10/15/2014,473000.0,3,3.0,1380,1081,3.0,0.0,0.0,3,8,1380,0,2005,0,98107,47.6692,-122.39,1390,1140,10,15,2014,N,-10,-59
9421500150,6/23/2014,403500.0,3,1.0,1830,8004,1.0,0.0,0.0,3,8,1200,630,1960,0,98125,47.7259,-122.29700000000001,1860,7971,6,23,2014,UNK,-30,33
148000035,6/2/2014,544000.0,3,1.5,1790,8203,1.5,0.0,1.0,3,7,1790,0,1910,0,98116,47.5768,-122.40299999999999,1960,6047,6,2,2014,UNK,-170,2156
2436700395,10/23/2014,621000.0,3,1.0,1340,4000,1.5,0.0,0.0,4,7,1340,0,1927,0,98105,47.6652,-122.288,1510,4000,10,23,2014,UNK,-170,0
8010100040,8/1/2014,672600.0,3,2.25,1520,5750,2.0,0.0,0.0,3,8,1400,120,1908,2006,98116,47.5787,-122.38799999999999,1420,5650,8,1,2014,Y,100,100
1193000220,4/7/2015,689800.0,2,1.75,1370,3125,1.0,0.0,0.0,3,7,1090,280,1950,0,98199,47.6492,-122.391,1730,5966,4,7,2015,UNK,-360,-2841
8827901415,5/7/2015,613000.0,3,1.5,1470,4480,1.0,0.0,0.0,4,7,1130,340,1918,0,98105,47.6693,-122.291,2120,4480,5,7,2015,UNK,-650,0
7732410220,7/1/2014,808000.0,4,2.25,2500,8866,2.0,0.0,0.0,4,9,2500,0,1987,0,98007,47.6604,-122.146,2630,8847,7,1,2014,UNK,-130,19
415100015,7/25/2014,301000.0,3,1.0,1060,9241,1.0,0.0,0.0,4,7,1060,0,1956,0,98133,47.7465,-122.339,1900,6484,7,25,2014,UNK,-840,2757
2130400150,9/25/2014,340000.0,3,1.75,1210,9635,1.0,0.0,0.0,4,7,1210,0,1987,0,98019,47.7382,-121.98,1550,10707,9,25,2014,UNK,-340,-1072
1555200590,12/23/2014,206000.0,3,1.0,920,8400,1.0,0.0,0.0,3,7,920,0,1963,0,98032,47.3771,-122.287,1260,8400,12,23,2014,UNK,-340,0
2174503500,11/3/2014,550000.0,3,1.5,1340,6000,1.0,0.0,0.0,4,7,1340,0,1960,0,98040,47.5866,-122.25,1590,9000,11,3,2014,UNK,-250,-3000
6371500120,12/24/2014,325000.0,2,1.0,960,4800,1.5,0.0,0.0,2,6,960,0,1912,0,98116,47.5752,-122.411,1440,4800,12,24,2014,UNK,-480,0
3904900610,10/12/2014,475000.0,3,2.5,1630,7586,2.0,0.0,0.0,3,8,1630,0,1986,0,98029,47.5689,-122.023,2090,7330,10,12,2014,UNK,-460,256
9527000490,7/30/2014,432100.0,3,1.75,1840,7350,1.0,0.0,0.0,3,8,1310,530,1976,0,98034,47.7089,-122.23,1860,7000,7,30,2014,UNK,-20,350
2457200120,3/3/2015,359000.0,3,2.0,3085,7280,1.0,0.0,0.0,4,7,1560,1525,1959,0,98056,47.4956,-122.181,1480,7900,3,3,2015,UNK,1605,-620
3501600100,1/5/2015,490000.0,3,1.0,920,4800,1.0,0.0,0.0,4,6,780,140,1926,0,98117,47.6937,-122.36200000000001,1370,4800,1,5,2015,UNK,-450,0
1245001295,5/22/2014,648360.0,4,1.75,2260,7005,1.0,0.0,1.0,4,7,1130,1130,1947,0,98033,47.6895,-122.20700000000001,2330,9180,5,22,2014,UNK,-70,-2175
9536601295,10/7/2014,340000.0,3,1.75,1730,11986,1.0,0.0,3.0,5,6,1730,0,1918,0,98198,47.3595,-122.323,2490,9264,10,7,2014,UNK,-760,2722
2205700180,4/3/2015,545000.0,3,2.0,1610,8069,1.0,0.0,0.0,5,7,1090,520,1955,0,98006,47.5754,-122.15,1510,8803,4,3,2015,UNK,100,-734
623049232,7/15/2014,115000.0,2,0.75,550,7980,1.0,0.0,0.0,3,5,550,0,1952,0,98146,47.511,-122.348,1330,7980,7,15,2014,UNK,-780,0
9413600100,2/19/2015,705640.0,3,2.25,2400,12350,1.0,0.0,0.0,4,8,1420,980,1968,0,98033,47.6533,-122.19200000000001,2615,12043,2,19,2015,UNK,-215,307
6064800410,7/30/2014,300000.0,3,2.25,1960,1585,2.0,0.0,0.0,3,7,1750,210,2003,0,98118,47.5414,-122.288,1760,1958,7,30,2014,UNK,200,-373
8964800975,7/31/2014,1650000.0,4,2.75,3190,14904,1.0,0.0,3.0,4,9,1940,1250,1949,1992,98004,47.6178,-122.214,2600,11195,7,31,2014,Y,590,3709
4473400155,4/17/2015,1140000.0,4,3.5,3160,4200,2.0,0.0,4.0,3,8,2180,980,1999,0,98144,47.5963,-122.292,2180,5200,4,17,2015,UNK,980,-1000
7657000210,8/18/2014,280000.0,3,1.75,1550,7410,1.5,0.0,0.0,5,7,1550,0,1944,0,98178,47.4951,-122.23700000000001,1250,7467,8,18,2014,UNK,300,-57
8732040180,12/19/2014,245000.0,4,1.75,1930,7650,1.0,0.0,0.0,4,8,1280,650,1981,0,98023,47.3078,-122.38600000000001,1860,8800,12,19,2014,UNK,70,-1150
9547202950,10/30/2014,564000.0,4,1.0,1170,4590,1.5,0.0,0.0,4,7,1170,0,1925,0,98115,47.6804,-122.311,1430,4080,10,30,2014,UNK,-260,510
1370802770,9/19/2014,849000.0,3,1.75,2520,4534,1.0,0.0,0.0,5,9,1460,1060,1954,0,98199,47.6381,-122.40100000000001,1870,5023,9,19,2014,UNK,650,-489
3885803465,4/9/2015,698000.0,3,1.75,1220,7447,1.0,0.0,0.0,4,7,1220,0,1964,0,98033,47.6886,-122.211,1340,7200,4,9,2015,UNK,-120,247
2896610210,9/25/2014,319000.0,3,1.0,960,8556,1.0,0.0,0.0,3,7,960,0,1971,0,98034,47.7245,-122.22,1320,7528,9,25,2014,UNK,-360,1028
3760500455,2/24/2015,1450000.0,3,3.5,4110,15720,1.0,0.0,1.0,3,10,2230,1880,2000,0,98034,47.6996,-122.229,2500,15400,2,24,2015,UNK,1610,320
3324069541,7/10/2014,695000.0,4,3.5,3310,21050,2.0,0.0,0.0,5,9,2400,910,1992,0,98027,47.5197,-122.041,2260,23400,7,10,2014,UNK,1050,-2350
3600072,3/30/2015,680000.0,4,2.75,2220,5310,1.0,0.0,0.0,5,7,1170,1050,1951,0,98144,47.5801,-122.294,1540,4200,3,30,2015,UNK,680,1110
2722049218,10/27/2014,287500.0,4,2.25,2250,12000,2.0,0.0,0.0,3,8,2250,0,1985,0,98032,47.3715,-122.274,2140,11871,10,27,2014,UNK,110,129
1225039052,11/12/2014,465000.0,3,3.25,1510,1850,2.0,0.0,2.0,3,8,1230,280,2001,0,98107,47.6683,-122.36200000000001,1540,1840,11,12,2014,UNK,-30,10
8807810090,9/25/2014,335000.0,3,1.0,1350,14212,1.0,0.0,0.0,4,6,1350,0,1981,0,98053,47.6606,-122.06,1520,14404,9,25,2014,UNK,-170,-192
9508850120,6/27/2014,602000.0,4,1.75,2420,37800,1.0,0.0,0.0,4,8,1880,540,1981,0,98053,47.6688,-122.024,2780,35532,6,27,2014,UNK,-360,2268
5126300650,2/25/2015,482000.0,3,2.5,2950,6545,2.0,0.0,0.0,3,8,2950,0,2003,0,98059,47.4828,-122.139,2400,6550,2,25,2015,UNK,550,-5
6303400965,9/9/2014,220000.0,5,1.0,1260,8382,1.5,0.0,0.0,3,7,1260,0,1918,0,98146,47.5058,-122.355,910,8382,9,9,2014,UNK,350,0
7116500925,5/20/2014,206000.0,4,2.0,1700,6025,1.0,0.0,0.0,3,6,1700,0,1978,0,98002,47.3029,-122.221,1320,5956,5,20,2014,UNK,380,69
9241900115,3/24/2015,1100000.0,4,3.0,3320,5760,2.0,0.0,0.0,3,9,2120,1200,1954,2007,98199,47.6474,-122.389,2400,6144,3,24,2015,Y,920,-384
7202330410,3/20/2015,491150.0,3,2.5,1470,3971,2.0,0.0,0.0,3,7,1470,0,2003,0,98053,47.6816,-122.035,1650,3148,3,20,2015,UNK,-180,823
5151600300,8/12/2014,390000.0,4,2.75,2500,12848,1.0,0.0,1.0,3,8,2120,380,1975,0,98003,47.3364,-122.321,2370,12497,8,12,2014,UNK,130,351
1332200100,5/7/2015,393000.0,4,2.5,2641,8091,2.0,0.0,0.0,3,7,2641,0,1998,0,98031,47.4043,-122.213,2641,8535,5,7,2015,UNK,0,-444
1939130730,7/17/2014,635000.0,4,2.0,2260,8457,2.0,0.0,0.0,3,9,2260,0,1992,0,98074,47.6251,-122.03,2410,7713,7,17,2014,UNK,-150,744
472000015,5/16/2014,490000.0,2,1.0,1160,5000,1.0,0.0,0.0,4,8,1160,0,1937,0,98117,47.6865,-122.399,1750,5000,5,16,2014,UNK,-590,0
3667500015,9/25/2014,770000.0,4,3.5,3680,2242,2.5,0.0,0.0,3,9,2670,1010,1930,0,98112,47.6192,-122.307,1350,1288,9,25,2014,UNK,2330,954
6430000945,12/4/2014,665000.0,2,2.0,1615,4590,1.5,0.0,0.0,5,8,1615,0,1906,0,98103,47.6886,-122.348,1470,4590,12,4,2014,UNK,145,0
322059161,10/1/2014,287000.0,3,1.0,1250,26862,1.0,0.0,0.0,3,7,1250,0,1965,0,98058,47.426,-122.154,1530,24463,10,1,2014,UNK,-280,2399
7905200205,10/21/2014,410000.0,3,1.0,1230,7020,1.0,0.0,0.0,3,7,1090,140,1924,0,98116,47.5719,-122.39,1390,5850,10,21,2014,UNK,-160,1170
1772600665,2/25/2015,562000.0,3,2.0,2510,5200,1.0,0.0,0.0,5,8,1470,1040,1925,0,98106,47.5631,-122.366,990,5400,2,25,2015,UNK,1520,-200
203101530,5/30/2014,475000.0,2,2.0,1540,54450,2.0,0.0,0.0,3,7,1540,0,1983,0,98053,47.63800000000001,-121.95299999999999,2280,29918,5,30,2014,UNK,-740,24532
820000018,10/14/2014,387500.0,3,3.25,1860,2218,3.0,0.0,0.0,3,8,1860,0,2001,0,98125,47.7185,-122.31299999999999,1860,2218,10,14,2014,UNK,0,0
1560800110,6/17/2014,580000.0,5,2.0,2700,10875,1.0,0.0,0.0,4,7,1540,1160,1962,0,98007,47.6163,-122.13799999999999,2040,7464,6,17,2014,UNK,660,3411
2869200110,6/21/2014,930000.0,3,2.5,3290,6830,2.0,0.0,0.0,3,10,3290,0,2000,0,98052,47.6702,-122.14200000000001,3200,6227,6,21,2014,UNK,90,603
6151800300,2/13/2015,625000.0,3,1.75,2700,18893,1.0,0.0,0.0,4,7,2110,590,1948,1983,98010,47.3397,-122.04799999999999,2260,17494,2,13,2015,Y,440,1399
4475000180,12/3/2014,325000.0,3,2.0,1570,5600,1.0,0.0,0.0,3,8,1570,0,1999,0,98058,47.4286,-122.185,2010,5600,12,3,2014,UNK,-440,0
3223059206,6/27/2014,235000.0,3,1.75,1950,8712,1.0,0.0,0.0,3,7,1950,0,1960,0,98055,47.4391,-122.189,1820,11520,6,27,2014,UNK,130,-2808
5102400025,6/25/2014,450000.0,2,1.0,1380,4390,1.0,0.0,0.0,4,8,880,500,1931,0,98115,47.6947,-122.323,1390,5234,6,25,2014,UNK,-10,-844
194000145,3/12/2015,745000.0,4,2.75,2410,5650,1.5,0.0,0.0,5,8,2070,340,1909,0,98116,47.5651,-122.391,1960,5650,3,12,2015,UNK,450,0
5560000540,7/23/2014,223000.0,4,2.0,1200,8470,1.0,0.0,0.0,4,7,1200,0,1961,0,98023,47.3262,-122.338,1110,8400,7,23,2014,UNK,90,70
3326049077,7/28/2014,630000.0,4,1.75,1770,12278,1.0,0.0,0.0,3,7,1350,420,1937,0,98115,47.7004,-122.295,1670,9336,7,28,2014,UNK,100,2942
3126049517,5/8/2014,413450.0,3,2.5,1540,1614,3.0,0.0,0.0,3,8,1470,70,2008,0,98103,47.6961,-122.34100000000001,1540,1418,5,8,2014,N,0,196
2568200740,8/11/2014,720000.0,5,2.75,2860,5379,2.0,0.0,0.0,3,9,2860,0,2005,0,98052,47.7082,-122.104,2980,6018,8,11,2014,N,-120,-639
2622059138,4/16/2015,339000.0,3,1.5,1740,21980,1.0,0.0,0.0,4,7,1740,0,1973,0,98042,47.3644,-122.132,1400,16100,4,16,2015,UNK,340,5880
6738700205,5/5/2015,1120000.0,4,3.5,2830,4000,1.5,0.0,0.0,3,7,1840,990,1919,2014,98144,47.5842,-122.292,2340,4000,5,5,2015,Y,490,0
1778350150,8/11/2014,839000.0,5,4.0,4280,11307,2.0,0.0,0.0,3,10,2710,1570,1996,0,98027,47.5503,-122.081,3080,11307,8,11,2014,UNK,1200,0
6613000930,9/2/2014,2950000.0,4,3.25,3890,25470,2.0,1.0,3.0,5,10,3030,860,1923,0,98105,47.6608,-122.26899999999999,4140,19281,9,2,2014,UNK,-250,6189
324069058,5/30/2014,568000.0,4,2.0,2340,50233,1.0,0.0,0.0,4,7,1170,1170,1966,0,98075,47.5905,-122.022,2470,62290,5,30,2014,UNK,-130,-12057
4345300180,4/6/2015,269000.0,3,2.0,1410,10577,1.0,0.0,0.0,3,7,1410,0,1994,0,98030,47.3642,-122.18700000000001,1660,6757,4,6,2015,UNK,-250,3820
7525100590,4/6/2015,382000.0,2,2.0,1350,2560,1.0,0.0,0.0,4,8,1350,0,1974,0,98052,47.6338,-122.10600000000001,1800,2560,4,6,2015,UNK,-450,0
955000453,4/13/2015,574000.0,2,2.25,1100,1114,2.0,0.0,0.0,3,8,900,200,2009,0,98122,47.6199,-122.304,1230,1800,4,13,2015,N,-130,-686
7852150720,9/22/2014,405000.0,3,2.5,2070,4697,2.0,0.0,0.0,3,7,2070,0,2002,0,98065,47.5307,-121.875,2230,4437,9,22,2014,UNK,-160,260
9545220100,7/28/2014,572000.0,3,2.5,2360,9938,1.0,0.0,0.0,3,8,1690,670,1987,0,98027,47.5374,-122.053,2280,9626,7,28,2014,UNK,80,312
7504000230,12/5/2014,675000.0,4,2.25,2760,12100,2.0,0.0,0.0,4,9,2760,0,1976,0,98074,47.6285,-122.05799999999999,2850,12410,12,5,2014,UNK,-90,-310
7657000540,9/2/2014,165000.0,4,1.0,1220,7980,1.5,0.0,0.0,3,6,1220,0,1944,0,98178,47.4924,-122.23700000000001,1210,7920,9,2,2014,UNK,10,60
7657000540,3/4/2015,260000.0,4,1.0,1220,7980,1.5,0.0,0.0,3,6,1220,0,1944,0,98178,47.4924,-122.23700000000001,1210,7920,3,4,2015,UNK,10,60
7893203770,3/4/2015,196000.0,3,1.0,1220,6719,1.0,0.0,0.0,3,6,1220,0,1953,0,98198,47.4187,-122.329,1580,7200,3,4,2015,UNK,-360,-481
8035350120,2/24/2015,515000.0,3,2.5,3020,12184,2.0,0.0,0.0,3,8,3020,0,2003,0,98019,47.744,-121.976,2980,10029,2,24,2015,UNK,40,2155
8820902350,12/3/2014,810000.0,4,3.5,3470,7396,2.0,0.0,3.0,3,8,2520,950,1979,0,98125,47.7146,-122.279,2360,10541,12,3,2014,UNK,1110,-3145
5089700300,3/11/2015,365650.0,4,2.25,2380,7700,2.0,0.0,0.0,4,8,2380,0,1977,0,98055,47.4391,-122.194,2100,7700,3,11,2015,UNK,280,0
7234601541,7/28/2014,651000.0,3,3.0,2260,1834,2.0,0.0,0.0,3,8,1660,600,2002,0,98122,47.6111,-122.30799999999999,2260,1834,7,28,2014,UNK,0,0
7972603931,10/9/2014,240000.0,2,1.0,720,6345,1.0,0.0,0.0,3,6,720,0,1943,0,98106,47.5201,-122.35,720,6345,10,9,2014,UNK,0,0
318390180,10/29/2014,299000.0,3,2.0,1730,6007,1.0,0.0,0.0,3,8,1730,0,2004,0,98030,47.3573,-122.2,2000,6245,10,29,2014,N,-270,-238
2597520900,8/4/2014,768000.0,3,2.5,2660,10928,2.0,0.0,0.0,3,9,1830,830,1988,0,98006,47.5442,-122.141,2800,10025,8,4,2014,UNK,-140,903
5652600556,10/28/2014,397380.0,2,1.0,1030,5072,1.0,0.0,0.0,3,6,1030,0,1924,1958,98115,47.6962,-122.294,1220,6781,10,28,2014,Y,-190,-1709
8935100100,7/1/2014,476000.0,4,3.0,2890,6885,1.0,0.0,0.0,3,7,1590,1300,1945,2015,98115,47.6763,-122.28200000000001,2180,6885,7,1,2014,Y,710,0
4154301371,1/6/2015,315000.0,3,1.0,890,5200,1.0,0.0,0.0,3,7,890,0,1957,0,98118,47.559,-122.277,1420,6000,1,6,2015,UNK,-530,-800
1105000787,9/26/2014,240000.0,3,2.25,1410,7290,1.0,0.0,0.0,3,7,940,470,1980,0,98118,47.5396,-122.274,1550,7375,9,26,2014,UNK,-140,-85
2492201005,7/8/2014,325000.0,2,1.0,810,4080,1.0,0.0,0.0,4,6,810,0,1941,0,98126,47.5337,-122.37899999999999,1400,4080,7,8,2014,UNK,-590,0
9265410090,10/8/2014,160000.0,3,1.75,1370,8006,2.0,0.0,0.0,3,7,1370,0,1990,0,98001,47.258,-122.25200000000001,1530,8006,10,8,2014,UNK,-160,0
2619950740,1/9/2015,435000.0,3,2.5,2260,5100,2.0,0.0,0.0,3,8,2260,0,2007,0,98019,47.7341,-121.96799999999999,2260,5100,1,9,2015,N,0,0
9412200330,4/10/2015,427500.0,3,1.75,1430,16200,1.0,0.0,0.0,4,7,1430,0,1967,0,98027,47.5223,-122.04299999999999,1690,13125,4,10,2015,UNK,-260,3075
1079450410,4/17/2015,450000.0,5,2.5,2510,10240,1.0,0.0,0.0,4,8,1410,1100,1984,0,98059,47.4732,-122.141,2170,10500,4,17,2015,UNK,340,-260
9238900850,9/19/2014,688000.0,3,1.5,1760,4880,1.5,0.0,3.0,3,8,1290,470,1928,0,98136,47.5334,-122.38799999999999,1840,4998,9,19,2014,UNK,-80,-118
2112701165,4/8/2015,285000.0,4,1.0,1430,3600,1.0,0.0,0.0,3,6,980,450,1947,0,98106,47.5343,-122.355,1170,4000,4,8,2015,UNK,260,-400
2767604067,8/20/2014,530000.0,3,3.25,1510,1125,3.0,0.0,0.0,3,8,1510,0,2006,0,98107,47.6711,-122.39,1390,1174,8,20,2014,N,120,-49
522049122,4/2/2015,195000.0,4,1.75,1320,7694,1.0,0.0,0.0,3,7,1320,0,1928,1972,98148,47.4297,-122.325,1620,8468,4,2,2015,Y,-300,-774
8857600360,8/28/2014,250200.0,3,1.5,1180,7384,1.0,0.0,0.0,5,7,1180,0,1959,0,98032,47.3838,-122.287,1150,7455,8,28,2014,UNK,30,-71
4389200761,1/28/2015,1100000.0,3,2.25,1560,8570,1.0,0.0,0.0,5,7,1080,480,1977,0,98004,47.6155,-122.21,2660,9621,1,28,2015,UNK,-1100,-1051
6421000330,11/12/2014,732500.0,3,2.5,2470,10321,2.0,0.0,0.0,3,9,2470,0,1988,0,98052,47.6694,-122.141,2450,8440,11,12,2014,UNK,20,1881
2154900040,10/30/2014,194250.0,3,2.25,2190,8834,1.0,0.0,0.0,3,7,1390,800,1987,0,98001,47.2633,-122.244,1490,8766,10,30,2014,UNK,700,68
259801030,3/9/2015,526000.0,4,2.0,1610,8000,1.0,0.0,0.0,3,7,1190,420,1966,0,98008,47.6301,-122.118,1560,7896,3,9,2015,UNK,50,104
326049038,5/4/2015,520000.0,4,2.75,2700,9882,2.0,0.0,0.0,3,7,2700,0,1958,1989,98155,47.7671,-122.291,2250,10797,5,4,2015,Y,450,-915
6384500590,11/13/2014,526000.0,3,1.75,1530,6125,1.0,0.0,0.0,3,7,1120,410,1958,0,98116,47.5687,-122.397,1360,6125,11,13,2014,UNK,170,0
3023069166,7/8/2014,1140000.0,5,4.0,7320,217800,2.0,0.0,0.0,3,11,7320,0,1992,0,98058,47.4473,-122.086,3270,34500,7,8,2014,UNK,4050,183300
3826000735,6/26/2014,202000.0,2,1.0,920,7569,1.0,0.0,0.0,4,6,920,0,1950,0,98168,47.4951,-122.302,1280,7627,6,26,2014,UNK,-360,-58
7852110740,11/12/2014,645500.0,4,2.5,2990,8622,2.0,0.0,0.0,3,9,2990,0,2000,0,98065,47.5394,-121.875,2980,8622,11,12,2014,UNK,10,0
3222049087,4/22/2015,570000.0,1,1.0,720,7540,1.0,1.0,4.0,4,6,720,0,1905,0,98198,47.3509,-122.323,1120,9736,4,22,2015,UNK,-400,-2196
726049131,3/20/2015,325000.0,3,2.0,1750,9000,1.5,0.0,0.0,4,5,1750,0,1936,0,98133,47.7489,-122.35,1830,8100,3,20,2015,UNK,-80,900
9424400110,12/16/2014,725000.0,2,1.0,2410,5930,2.0,0.0,0.0,3,9,1930,480,2007,0,98116,47.5657,-122.395,1540,5892,12,16,2014,N,870,38
193300120,11/26/2014,192000.0,3,1.75,1240,10361,1.0,0.0,0.0,3,6,1240,0,1987,0,98042,47.37,-122.15100000000001,1240,8834,11,26,2014,UNK,0,1527
1245001751,7/9/2014,560000.0,2,1.0,1010,9219,1.0,0.0,0.0,4,7,1010,0,1960,0,98033,47.6886,-122.20200000000001,1610,9219,7,9,2014,UNK,-600,0
1386800054,12/1/2014,283450.0,5,2.75,2770,6116,1.0,0.0,0.0,3,7,1490,1280,1979,0,98168,47.4847,-122.291,1920,6486,12,1,2014,UNK,850,-370
6814600150,9/5/2014,863000.0,4,1.75,2800,5400,1.0,0.0,0.0,3,9,1400,1400,1924,2006,98115,47.6803,-122.31299999999999,1490,5400,9,5,2014,Y,1310,0
9828200790,10/28/2014,815000.0,4,2.0,1400,4800,2.0,0.0,0.0,3,7,1400,0,1986,0,98122,47.6168,-122.29799999999999,1620,2595,10,28,2014,UNK,-220,2205
9476200650,4/16/2015,245000.0,2,1.0,1020,7679,1.0,0.0,0.0,5,6,1020,0,1942,0,98056,47.4915,-122.18799999999999,1280,6497,4,16,2015,UNK,-260,1182
9533600100,12/8/2014,1320000.0,4,3.0,2860,10292,1.0,0.0,0.0,4,8,2860,0,1953,1999,98004,47.6286,-122.206,1840,10273,12,8,2014,Y,1020,19
4139430410,11/7/2014,1160000.0,4,3.5,4270,12305,2.0,0.0,2.0,3,10,4270,0,1994,0,98006,47.5489,-122.118,4190,13137,11,7,2014,UNK,80,-832
7852030330,9/3/2014,480000.0,3,2.5,2270,4488,2.0,0.0,0.0,3,7,2270,0,1999,0,98065,47.5329,-121.87899999999999,2360,4427,9,3,2014,UNK,-90,61
7202270930,6/6/2014,600000.0,4,2.5,2560,5593,2.0,0.0,0.0,3,7,2560,0,2001,0,98053,47.6886,-122.037,2800,5890,6,6,2014,UNK,-240,-297
223039254,6/24/2014,329950.0,2,1.0,900,5220,1.0,0.0,0.0,4,6,900,0,1956,0,98146,47.5105,-122.387,1480,6660,6,24,2014,UNK,-580,-1440
7843500090,8/22/2014,299500.0,4,2.5,2010,12085,2.0,0.0,0.0,3,8,2010,0,1986,0,98042,47.3406,-122.057,1910,12133,8,22,2014,UNK,100,-48
2491200330,9/18/2014,460000.0,3,2.5,1690,5131,1.0,0.0,0.0,3,7,1690,0,1941,1998,98126,47.5234,-122.38,860,5137,9,18,2014,Y,830,-6
8113101582,4/15/2015,515000.0,5,3.5,2310,5249,2.0,0.0,0.0,3,8,1560,750,2000,0,98118,47.5463,-122.272,1900,7296,4,15,2015,UNK,410,-2047
993002225,6/23/2014,405000.0,3,2.25,1520,1245,3.0,0.0,0.0,3,8,1520,0,2004,0,98103,47.6907,-122.34,1520,1470,6,23,2014,N,0,-225
9530100921,10/27/2014,483000.0,4,1.5,1220,3780,1.5,0.0,0.0,3,7,1220,0,1927,0,98107,47.6667,-122.36,1400,3185,10,27,2014,UNK,-180,595
3235390100,2/3/2015,377000.0,4,2.5,2170,11511,2.0,0.0,0.0,3,8,2170,0,1992,0,98031,47.3886,-122.18799999999999,1900,8961,2,3,2015,UNK,270,2550
5122400025,7/8/2014,568000.0,4,1.75,2790,17476,1.0,0.0,2.0,3,7,1450,1340,1956,0,98166,47.4556,-122.369,2790,16401,7,8,2014,UNK,0,1075
9297300750,11/5/2014,355000.0,2,1.75,1760,4600,1.0,0.0,0.0,4,7,850,910,1926,0,98126,47.5654,-122.37200000000001,1150,4800,11,5,2014,UNK,610,-200
3856900590,8/6/2014,640000.0,4,1.75,2100,3000,1.5,0.0,0.0,4,7,1500,600,1911,0,98103,47.6721,-122.329,1690,4000,8,6,2014,UNK,410,-1000
4024700100,1/21/2015,270000.0,4,1.0,1430,5909,1.0,0.0,0.0,3,6,1070,360,1947,0,98155,47.7623,-122.31299999999999,1460,8433,1,21,2015,UNK,-30,-2524
114100131,1/14/2015,559950.0,5,3.5,2450,8193,2.0,0.0,0.0,3,9,2450,0,2005,0,98028,47.7721,-122.241,2310,8193,1,14,2015,N,140,0
2296700330,10/14/2014,515000.0,4,3.0,1820,8261,1.0,0.0,0.0,3,7,1420,400,1969,0,98034,47.7197,-122.219,1920,7961,10,14,2014,UNK,-100,300
1995200215,8/26/2014,352000.0,4,1.75,1850,5712,1.0,0.0,0.0,3,7,1850,0,1954,0,98115,47.6966,-122.324,1510,6038,8,26,2014,UNK,340,-326
2287600035,6/25/2014,595888.0,3,1.75,1870,9000,1.0,0.0,0.0,5,9,1870,0,1958,0,98177,47.7203,-122.361,2030,8160,6,25,2014,UNK,-160,840
2923501130,7/22/2014,588000.0,4,2.25,2580,7344,2.0,0.0,0.0,3,8,2580,0,1977,0,98027,47.5647,-122.09,2390,7507,7,22,2014,UNK,190,-163
2485000076,1/22/2015,1050000.0,4,3.25,3680,8580,1.0,0.0,0.0,5,10,1840,1840,1959,0,98136,47.5266,-122.387,2700,9100,1,22,2015,UNK,980,-520
9264921020,9/8/2014,260000.0,3,1.5,1750,7000,2.0,0.0,0.0,3,8,1750,0,1983,0,98023,47.3108,-122.346,1840,9305,9,8,2014,UNK,-90,-2305
5318100965,2/17/2015,1600000.0,4,3.5,3890,3600,2.0,0.0,0.0,3,9,2860,1030,2005,0,98112,47.6342,-122.28200000000001,2460,6050,2,17,2015,N,1430,-2450
3501600215,4/14/2015,380000.0,2,1.0,1000,4800,1.0,0.0,0.0,3,6,1000,0,1952,0,98117,47.6926,-122.36200000000001,1000,4800,4,14,2015,UNK,0,0
8682230610,6/2/2014,802000.0,2,2.5,2210,6327,1.0,0.0,0.0,3,8,2210,0,2003,0,98053,47.7114,-122.03,2170,6327,6,2,2014,UNK,40,0
1337800665,8/11/2014,1330000.0,4,3.25,2850,4800,2.5,0.0,0.0,5,10,2700,0,1905,0,98112,47.6292,-122.31200000000001,2850,4800,8,11,2014,UNK,0,0
7960100220,4/16/2015,710000.0,4,2.75,2460,3600,2.0,0.0,0.0,3,8,1640,820,1907,2007,98122,47.6093,-122.29700000000001,1890,3600,4,16,2015,Y,570,0
1549500272,6/9/2014,600000.0,3,2.5,2630,77972,2.0,0.0,0.0,3,9,2630,0,2004,0,98019,47.745,-121.916,2250,75794,6,9,2014,N,380,2178
9547202380,9/2/2014,707900.0,3,1.0,1750,5355,2.0,0.0,0.0,4,7,1750,0,1929,0,98115,47.6792,-122.31,2240,4590,9,2,2014,UNK,-490,765
3518000180,11/20/2014,179950.0,2,1.0,1100,7323,1.0,0.0,0.0,3,7,780,320,1982,0,98023,47.2874,-122.37,1410,7227,11,20,2014,UNK,-310,96
6792100090,9/14/2014,683000.0,4,2.5,2620,10489,2.0,0.0,0.0,3,9,2620,0,1990,0,98052,47.6732,-122.14299999999999,2430,7701,9,14,2014,UNK,190,2788
5702330120,6/3/2014,222400.0,3,2.0,1200,9566,1.0,0.0,0.0,3,7,1200,0,1995,0,98001,47.2649,-122.25200000000001,1590,9518,6,3,2014,UNK,-390,48
1189000910,7/8/2014,517000.0,2,1.5,1920,3408,1.0,0.0,0.0,4,7,960,960,1912,0,98122,47.6118,-122.29899999999999,1130,3408,7,8,2014,UNK,790,0
6204200590,10/29/2014,410000.0,3,2.75,1690,5763,1.0,0.0,0.0,5,7,1180,510,1985,0,98011,47.7336,-122.20200000000001,1560,7518,10,29,2014,UNK,130,-1755
4443801340,10/6/2014,480000.0,3,1.75,1680,2552,1.0,0.0,0.0,4,7,840,840,1952,0,98117,47.6848,-122.391,1220,3880,10,6,2014,UNK,460,-1328
2473370750,2/24/2015,430000.0,3,1.75,3440,10428,1.5,0.0,0.0,5,8,3440,0,1974,0,98058,47.449,-122.12799999999999,2160,8400,2,24,2015,UNK,1280,2028
2644900109,4/27/2015,439950.0,5,1.75,2190,7500,1.0,0.0,0.0,3,7,1290,900,1979,0,98133,47.7766,-122.355,1790,8820,4,27,2015,UNK,400,-1320
293620220,4/21/2015,797500.0,4,2.5,3270,8223,2.0,0.0,0.0,3,10,3270,0,1998,0,98075,47.6018,-122.073,3460,8872,4,21,2015,UNK,-190,-649
2624049115,7/10/2014,379000.0,4,1.5,1280,5460,1.5,0.0,0.0,5,7,1080,200,1920,0,98118,47.5348,-122.26799999999999,1470,5934,7,10,2014,UNK,-190,-474
7942600910,12/16/2014,575000.0,1,1.0,1310,8667,1.5,0.0,0.0,1,6,1310,0,1918,0,98122,47.6059,-122.31299999999999,1130,4800,12,16,2014,UNK,180,3867
643000110,3/25/2015,247500.0,3,1.0,1660,11060,1.0,0.0,0.0,4,7,1110,550,1962,0,98003,47.3311,-122.32600000000001,1890,11060,3,25,2015,UNK,-230,0
9485951460,6/23/2014,385000.0,4,2.75,2700,37011,2.0,0.0,0.0,3,9,2700,0,1984,0,98042,47.3496,-122.088,2700,37457,6,23,2014,UNK,0,-446
6378500230,5/20/2014,423000.0,4,1.75,1940,6909,1.0,0.0,0.0,4,7,970,970,1941,0,98133,47.7108,-122.352,1460,6906,5,20,2014,UNK,480,3
430000175,12/15/2014,550000.0,3,1.75,1520,5618,1.0,0.0,0.0,3,7,1170,350,1953,0,98115,47.68,-122.28399999999999,1550,5618,12,15,2014,UNK,-30,0
1493300115,9/10/2014,415000.0,4,1.0,1620,4329,1.5,0.0,0.0,3,7,1620,0,1927,0,98116,47.5728,-122.38799999999999,1220,5520,9,10,2014,UNK,400,-1191
2024059059,10/10/2014,693000.0,3,2.25,2090,45535,1.0,0.0,2.0,5,8,1280,810,1952,0,98006,47.5538,-122.191,3090,12889,10,10,2014,UNK,-1000,32646
2922701085,3/27/2015,543000.0,2,1.0,1070,4700,1.0,0.0,0.0,5,7,1070,0,1910,0,98117,47.6887,-122.368,1370,4700,3,27,2015,UNK,-300,0
4058801780,3/27/2015,465000.0,5,1.75,2000,10246,1.0,0.0,2.0,3,7,1200,800,1953,0,98178,47.5084,-122.24600000000001,2340,9030,3,27,2015,UNK,-340,1216
2114700384,4/27/2015,280000.0,3,2.5,1020,2217,2.0,0.0,0.0,3,7,720,300,2004,0,98106,47.5343,-122.348,1060,1524,4,27,2015,N,-40,693
9829201020,11/18/2014,1390000.0,3,1.25,2400,6653,3.0,0.0,2.0,3,11,2400,0,1992,0,98122,47.6019,-122.29,1910,6653,11,18,2014,UNK,490,0
6918720100,1/30/2015,665000.0,6,3.0,2480,9720,2.0,0.0,0.0,3,8,2480,0,1972,0,98007,47.6127,-122.145,2480,9200,1,30,2015,UNK,0,520
1450100330,3/12/2015,237950.0,3,1.75,1310,7314,1.0,0.0,0.0,5,6,1310,0,1960,0,98002,47.2888,-122.221,1010,7314,3,12,2015,UNK,300,0
518000040,1/2/2015,440000.0,4,2.75,2420,10200,1.0,0.0,0.0,3,8,1220,1200,1962,0,98034,47.72,-122.236,2240,9750,1,2,2015,UNK,180,450
4242900245,1/12/2015,618000.0,2,1.0,1890,4700,1.0,0.0,0.0,4,7,1030,860,1928,0,98107,47.6747,-122.391,2150,4700,1,12,2015,UNK,-260,0
1231001130,11/13/2014,572000.0,3,2.25,1860,4000,1.5,0.0,0.0,5,7,1020,840,1920,0,98118,47.5539,-122.26700000000001,1180,4000,11,13,2014,UNK,680,0
7445000115,5/27/2014,725000.0,3,1.5,2500,4774,1.5,0.0,2.0,3,7,1450,1050,1940,0,98107,47.6567,-122.35799999999999,1300,4000,5,27,2014,UNK,1200,774
7802900504,6/25/2014,454000.0,3,1.0,1970,22144,1.0,0.0,0.0,4,7,1970,0,1970,0,98065,47.5234,-121.84100000000001,1970,13500,6,25,2014,UNK,0,8644
4317700085,1/22/2015,535000.0,4,1.0,1660,10656,1.5,0.0,0.0,4,7,1180,480,1920,0,98136,47.5391,-122.385,1120,8816,1,22,2015,UNK,540,1840
8732040580,12/18/2014,249000.0,3,2.5,1850,7200,1.0,0.0,0.0,3,7,1500,350,1979,0,98023,47.3063,-122.384,2140,7500,12,18,2014,UNK,-290,-300
3223039149,7/9/2014,395000.0,4,2.75,1970,37026,1.0,0.0,0.0,4,8,1970,0,1961,0,98070,47.4375,-122.446,1970,51836,7,9,2014,UNK,0,-14810
4073200757,12/31/2014,690000.0,3,2.0,1890,6620,1.0,0.0,3.0,4,8,1890,0,1954,0,98125,47.7016,-122.274,2590,7188,12,31,2014,UNK,-700,-568
3226049054,10/3/2014,526500.0,3,1.5,1310,7236,1.0,0.0,0.0,4,7,1170,140,1928,0,98103,47.6944,-122.333,1680,8431,10,3,2014,UNK,-370,-1195
5490700035,8/7/2014,325000.0,4,1.5,1870,7220,2.0,0.0,0.0,3,7,1870,0,1956,0,98155,47.77,-122.319,1550,7592,8,7,2014,UNK,320,-372
9834200975,2/10/2015,495000.0,3,3.0,1520,4080,2.0,0.0,0.0,5,7,1520,0,1948,0,98144,47.571999999999996,-122.29,1320,4080,2,10,2015,UNK,200,0
3305100210,10/21/2014,825000.0,5,3.0,3070,8474,2.0,0.0,0.0,3,9,3070,0,2011,0,98033,47.6852,-122.184,3070,8527,10,21,2014,N,0,-53
3123039042,12/23/2014,383000.0,3,1.5,1400,14850,1.5,0.0,0.0,4,7,1400,0,1910,0,98070,47.4471,-122.464,1350,14850,12,23,2014,UNK,50,0
1105000360,4/28/2015,320000.0,3,1.75,1960,11931,1.0,0.0,0.0,3,7,980,980,1954,0,98118,47.5432,-122.272,1460,4498,4,28,2015,UNK,500,7433
1724079048,12/8/2014,475000.0,3,2.5,2680,87117,1.0,0.0,0.0,3,7,1340,1340,1989,0,98024,47.5646,-121.935,2580,87117,12,8,2014,UNK,100,0
7437100770,5/21/2014,275000.0,3,2.5,2030,6326,2.0,0.0,0.0,3,7,2030,0,1993,0,98038,47.3491,-122.029,1810,6825,5,21,2014,UNK,220,-499
8925100115,10/15/2014,1150000.0,2,2.25,2320,9300,1.5,0.0,4.0,5,9,1920,400,1937,0,98115,47.681000000000004,-122.273,2790,9300,10,15,2014,UNK,-470,0
4019300051,11/25/2014,455000.0,3,1.75,1760,11371,1.0,0.0,0.0,5,8,1760,0,1959,0,98155,47.7616,-122.273,2220,19884,11,25,2014,UNK,-460,-8513
5300200085,7/2/2014,262000.0,5,1.0,1870,7800,1.0,0.0,0.0,3,7,1580,290,1962,0,98168,47.5127,-122.321,1740,7808,7,2,2014,UNK,130,-8
9417400110,9/15/2014,390000.0,4,1.0,1280,4840,1.0,0.0,0.0,3,7,940,340,1950,0,98136,47.5477,-122.395,1360,4840,9,15,2014,UNK,-80,0
9264920870,10/23/2014,300000.0,3,2.25,1730,10030,1.0,0.0,0.0,4,8,1730,0,1985,0,98023,47.3108,-122.345,2090,8823,10,23,2014,UNK,-360,1207
9169600209,8/20/2014,746300.0,3,1.75,2060,5721,1.0,0.0,2.0,3,9,1140,920,1964,0,98136,47.5268,-122.38799999999999,2060,8124,8,20,2014,UNK,0,-2403
6123000090,9/8/2014,267000.0,3,1.5,1030,8223,1.0,0.0,0.0,4,7,1030,0,1952,0,98148,47.4282,-122.331,1460,9463,9,8,2014,UNK,-430,-1240
2592401080,4/2/2015,525000.0,3,2.5,1720,7950,1.5,0.0,0.0,4,7,1720,0,1972,0,98034,47.7178,-122.16799999999999,1790,7030,4,2,2015,UNK,-70,920
2423020090,4/24/2015,570000.0,3,1.75,1210,7350,1.0,0.0,0.0,3,7,1210,0,1977,0,98033,47.7,-122.17200000000001,1610,7313,4,24,2015,UNK,-400,37
2968801130,10/27/2014,360000.0,4,2.25,2620,8100,1.0,0.0,0.0,4,7,1550,1070,1964,0,98166,47.4564,-122.351,1650,8100,10,27,2014,UNK,970,0
3325069064,3/26/2015,1050000.0,3,1.0,1860,44431,1.0,0.0,0.0,4,6,1860,0,1947,0,98074,47.6057,-122.038,2000,44431,3,26,2015,UNK,-140,0
3629910210,11/3/2014,699950.0,3,2.5,2510,4106,2.0,0.0,0.0,3,9,2510,0,2003,0,98029,47.5494,-121.994,2470,4106,11,3,2014,UNK,40,0
622079089,6/16/2014,375000.0,4,2.5,2040,109336,1.5,0.0,0.0,4,8,2040,0,1973,0,98038,47.4193,-121.958,2370,133729,6,16,2014,UNK,-330,-24393
1919800090,12/15/2014,625000.0,4,1.75,2410,6770,1.0,0.0,0.0,4,7,1220,1190,1924,0,98103,47.6946,-122.336,1440,6770,12,15,2014,UNK,970,0
9274200850,10/16/2014,464050.0,2,1.0,780,2750,1.0,0.0,0.0,4,7,780,0,1928,0,98116,47.5842,-122.38799999999999,1320,4440,10,16,2014,UNK,-540,-1690
1737320120,5/2/2014,470000.0,5,2.5,2210,9655,1.0,0.0,0.0,3,8,1460,750,1976,0,98011,47.7698,-122.22200000000001,2080,8633,5,2,2014,UNK,130,1022
2473100450,9/9/2014,330000.0,4,2.0,1590,9100,1.0,0.0,0.0,3,7,1040,550,1967,0,98058,47.4465,-122.156,1670,9100,9,9,2014,UNK,-80,0
7923200150,9/15/2014,537000.0,4,1.75,2230,7957,1.0,0.0,0.0,4,7,2230,0,1967,0,98008,47.5859,-122.12200000000001,2230,8040,9,15,2014,UNK,0,-83
7524600120,3/5/2015,250000.0,3,2.0,1560,32137,1.0,0.0,0.0,5,7,910,650,1976,0,98092,47.3197,-122.117,1470,29150,3,5,2015,UNK,90,2987
424069206,1/12/2015,835000.0,4,2.5,2950,48351,2.0,0.0,0.0,3,10,2950,0,1986,0,98075,47.5938,-122.04799999999999,2870,34417,1,12,2015,UNK,80,13934
9523103590,3/16/2015,770000.0,4,1.0,1480,3750,1.5,0.0,0.0,4,7,1480,0,1912,0,98103,47.6737,-122.354,1570,3750,3,16,2015,UNK,-90,0
161000120,11/18/2014,650000.0,4,2.0,2850,4497,1.5,0.0,1.0,3,7,1730,1120,1910,0,98144,47.5876,-122.292,2450,6000,11,18,2014,UNK,400,-1503
1623049241,11/7/2014,335000.0,3,1.75,2390,30409,1.0,0.0,0.0,3,7,1560,830,1953,0,98168,47.4789,-122.296,1750,13500,11,7,2014,UNK,640,16909
7229700165,12/2/2014,350000.0,3,1.75,1740,29597,1.0,0.0,0.0,4,7,1740,0,1965,0,98059,47.481,-122.115,1560,20741,12,2,2014,UNK,180,8856
3031200205,7/24/2014,415000.0,5,2.75,2060,8906,1.0,0.0,0.0,4,7,1220,840,1978,0,98118,47.5358,-122.289,1840,8906,7,24,2014,UNK,220,0
2600100110,11/19/2014,788000.0,4,2.5,2680,8778,2.0,0.0,0.0,4,8,2680,0,1977,0,98006,47.5516,-122.161,2680,10020,11,19,2014,UNK,0,-1242
5652601140,10/14/2014,640000.0,4,2.75,3150,7379,1.5,0.0,0.0,4,7,2430,720,1915,0,98115,47.6968,-122.3,1990,7379,10,14,2014,UNK,1160,0
2473530100,5/23/2014,388000.0,4,2.5,2440,7155,2.0,0.0,0.0,3,8,2440,0,1993,0,98058,47.4501,-122.126,2450,8109,5,23,2014,UNK,-10,-954
3558900590,11/25/2014,360000.0,6,1.75,2230,10080,1.0,0.0,0.0,3,7,1390,840,1969,0,98034,47.7089,-122.20100000000001,2110,8475,11,25,2014,UNK,120,1605
3558900590,3/24/2015,692500.0,6,1.75,2230,10080,1.0,0.0,0.0,3,7,1390,840,1969,0,98034,47.7089,-122.20100000000001,2110,8475,3,24,2015,UNK,120,1605
8121100395,6/24/2014,425000.0,4,1.5,1600,6180,1.5,0.0,0.0,3,6,1600,0,1946,0,98118,47.5681,-122.285,1410,6180,6,24,2014,UNK,190,0
8121100395,3/11/2015,645000.0,4,1.5,1600,6180,1.5,0.0,0.0,3,6,1600,0,1946,0,98118,47.5681,-122.285,1410,6180,3,11,2015,UNK,190,0
7100000110,1/14/2015,340000.0,3,1.0,1580,8308,1.5,0.0,0.0,3,7,1580,0,1948,0,98146,47.5075,-122.37899999999999,1200,8308,1,14,2015,UNK,380,0
925069042,1/5/2015,713000.0,4,3.25,2840,54400,1.0,0.0,0.0,4,8,2840,0,1984,0,98053,47.6707,-122.045,2550,43560,1,5,2015,UNK,290,10840
7568700740,5/21/2014,430000.0,3,2.75,2550,11160,2.0,0.0,0.0,3,8,2550,0,1994,0,98155,47.7351,-122.323,1020,7440,5,21,2014,UNK,1530,3720
7205510230,3/6/2015,280000.0,3,2.25,1700,7210,1.0,0.0,0.0,4,7,1250,450,1974,0,98003,47.3546,-122.318,2070,7300,3,6,2015,UNK,-370,-90
9268700040,2/26/2015,215000.0,3,2.0,1470,2052,1.5,0.0,0.0,3,7,1470,0,1986,0,98003,47.3084,-122.331,1390,2052,2,26,2015,UNK,80,0
2473480210,5/28/2014,306000.0,3,2.5,1680,11193,2.0,0.0,0.0,3,8,1680,0,1984,0,98058,47.4482,-122.125,2080,8084,5,28,2014,UNK,-400,3109
4024100120,6/25/2014,299900.0,3,1.0,1110,8593,1.0,0.0,0.0,3,7,1110,0,1979,0,98155,47.7595,-122.309,1780,8593,6,25,2014,UNK,-670,0
4038200120,8/25/2014,534000.0,5,1.75,2120,8625,1.0,0.0,0.0,3,7,1200,920,1959,0,98008,47.6118,-122.131,1930,8625,8,25,2014,UNK,190,0
4218400395,7/28/2014,1160000.0,3,2.75,2380,5572,2.0,0.0,4.0,3,9,1930,450,1939,0,98105,47.6626,-122.271,3370,5500,7,28,2014,UNK,-990,72
669000210,7/16/2014,1170000.0,3,2.5,2670,5000,2.0,0.0,3.0,5,9,2000,670,1942,1995,98144,47.5855,-122.292,2320,5000,7,16,2014,Y,350,0
6018500015,7/11/2014,199990.0,2,1.0,890,6430,1.0,0.0,0.0,3,6,890,0,1935,1997,98022,47.2003,-121.99600000000001,1460,6430,7,11,2014,Y,-570,0
2600140120,8/12/2014,946000.0,4,3.0,3140,9058,1.0,0.0,0.0,3,9,2140,1000,1989,0,98006,47.5462,-122.154,2760,10018,8,12,2014,UNK,380,-960
6381500090,2/20/2015,295000.0,4,1.0,1260,7800,1.5,0.0,0.0,3,7,1260,0,1947,2007,98125,47.7334,-122.307,1639,7492,2,20,2015,Y,-379,308
4109600306,2/18/2015,475000.0,2,1.0,920,5157,1.0,0.0,0.0,3,6,920,0,1909,0,98118,47.5499,-122.26899999999999,1700,5150,2,18,2015,UNK,-780,7
2624079010,4/29/2015,750000.0,5,3.5,2990,212137,2.0,0.0,0.0,3,8,2450,540,1994,0,98024,47.5298,-121.887,1060,69260,4,29,2015,UNK,1930,142877
7204200025,10/28/2014,1230000.0,4,2.5,3120,49456,2.0,1.0,4.0,4,9,2590,530,1974,1989,98198,47.3535,-122.323,2030,32181,10,28,2014,Y,1090,17275
8856003525,3/23/2015,183500.0,3,1.0,1010,7520,1.0,0.0,0.0,4,6,1010,0,1975,0,98001,47.2699,-122.255,1370,8469,3,23,2015,UNK,-360,-949
1695900025,3/27/2015,450000.0,2,1.0,1010,3627,1.0,0.0,2.0,4,6,1010,0,1924,0,98144,47.5873,-122.294,1630,4040,3,27,2015,UNK,-620,-413
3331001285,1/8/2015,180000.0,3,1.0,1020,5500,1.5,0.0,0.0,3,7,1020,0,1961,0,98118,47.5502,-122.286,1160,5500,1,8,2015,UNK,-140,0
239000155,1/5/2015,707000.0,5,4.5,3540,21217,2.0,0.0,0.0,4,8,2940,600,1926,0,98188,47.4274,-122.28,1290,12040,1,5,2015,UNK,2250,9177
1721801280,3/4/2015,230000.0,2,0.75,900,3527,1.0,0.0,0.0,3,6,900,0,1939,0,98146,47.5083,-122.336,1220,4080,3,4,2015,UNK,-320,-553
5557700210,12/9/2014,192500.0,3,1.0,1100,9750,1.0,0.0,0.0,4,7,1100,0,1966,0,98023,47.3248,-122.345,1190,9750,12,9,2014,UNK,-90,0
5416500040,10/17/2014,309000.0,3,2.5,1990,3614,2.0,0.0,0.0,3,7,1990,0,2005,0,98038,47.36,-122.039,1980,3800,10,17,2014,N,10,-186
3271300155,10/1/2014,759000.0,3,1.5,1980,5800,1.0,0.0,0.0,4,8,1520,460,1949,0,98199,47.6499,-122.413,2280,5800,10,1,2014,UNK,-300,0
3303980210,4/27/2015,1120000.0,4,3.75,4040,14212,2.0,0.0,0.0,3,11,4040,0,2002,0,98059,47.5189,-122.147,3940,14212,4,27,2015,UNK,100,0
1944900090,5/19/2014,462000.0,5,1.75,1250,10530,1.0,0.0,0.0,4,7,1250,0,1966,0,98007,47.6101,-122.13799999999999,1560,8190,5,19,2014,UNK,-310,2340
7663700401,12/20/2014,229000.0,4,1.5,1820,22814,1.5,0.0,0.0,3,7,1820,0,1920,0,98125,47.7321,-122.296,1770,9150,12,20,2014,UNK,50,13664
5694500386,10/20/2014,399950.0,2,2.25,1140,1184,2.0,0.0,0.0,3,8,1010,130,1999,0,98103,47.659,-122.346,1140,1339,10,20,2014,UNK,0,-155
7227800180,4/3/2015,325000.0,5,2.0,1730,10532,1.0,0.0,0.0,4,5,1730,0,1943,0,98056,47.5076,-122.178,1940,8501,4,3,2015,UNK,-210,2031
2767604558,7/21/2014,512000.0,2,2.25,1170,1313,3.0,0.0,0.0,3,8,1170,0,2007,0,98107,47.6712,-122.37799999999999,1310,1304,7,21,2014,N,-140,9
5422950040,7/25/2014,410000.0,5,2.75,2910,5802,2.0,0.0,0.0,3,7,2910,0,2006,0,98038,47.3591,-122.036,2910,5000,7,25,2014,N,0,802
2660500283,6/24/2014,210000.0,2,1.0,970,5500,1.0,0.0,0.0,3,7,970,0,1956,0,98118,47.556000000000004,-122.291,1180,6000,6,24,2014,UNK,-210,-500
3308010040,9/25/2014,325000.0,4,2.25,2130,8499,1.0,0.0,0.0,4,7,1600,0,1975,0,98030,47.3657,-122.21,1890,11368,9,25,2014,UNK,240,-2869
5423030040,4/6/2015,685000.0,3,2.5,2520,10175,1.0,0.0,0.0,3,8,1630,890,1979,0,98027,47.5652,-122.089,2220,8388,4,6,2015,UNK,300,1787
8604900245,5/18/2014,488000.0,2,2.0,1360,4688,1.0,0.0,0.0,3,7,780,580,1944,0,98115,47.6874,-122.315,1340,4750,5,18,2014,UNK,20,-62
7349650230,3/2/2015,247500.0,3,2.25,1620,6000,1.0,0.0,0.0,3,7,1280,340,1998,0,98002,47.2835,-122.2,1710,6318,3,2,2015,UNK,-90,-318
8902000175,6/20/2014,489000.0,4,2.0,2120,11479,1.0,0.0,0.0,4,7,1060,1060,1940,0,98125,47.7084,-122.303,1540,11000,6,20,2014,UNK,580,479
582000065,11/25/2014,725000.0,4,1.75,2700,6000,1.0,0.0,0.0,4,8,1450,1250,1953,0,98199,47.6539,-122.395,2080,6000,11,25,2014,UNK,620,0
2123049194,4/9/2015,199950.0,3,1.5,1370,10317,1.5,0.0,0.0,3,6,1370,0,1958,0,98168,47.4731,-122.29799999999999,1370,9884,4,9,2015,UNK,0,433
1830300090,4/1/2015,670000.0,5,3.0,2520,13001,2.0,0.0,1.0,3,8,2010,510,1973,0,98008,47.6385,-122.11399999999999,2170,8215,4,1,2015,UNK,350,4786
7522600110,12/29/2014,275000.0,3,2.0,1540,10410,1.0,0.0,0.0,4,7,1540,0,1967,0,98198,47.3662,-122.315,1590,7725,12,29,2014,UNK,-50,2685
5457800740,4/7/2015,1000000.0,3,1.75,2610,6360,2.0,0.0,2.0,3,8,2130,480,1924,0,98109,47.6287,-122.351,3010,6000,4,7,2015,UNK,-400,360
5115000100,5/23/2014,255000.0,3,2.0,1490,8371,1.5,0.0,0.0,3,7,1490,0,1984,0,98031,47.3962,-122.189,1350,7846,5,23,2014,UNK,140,525
4038400150,11/13/2014,465000.0,3,1.75,2760,9137,1.0,0.0,0.0,3,7,1380,1380,1960,0,98007,47.6079,-122.132,1980,9137,11,13,2014,UNK,780,0
1796500100,2/11/2015,259000.0,3,1.75,1260,3604,1.0,0.0,0.0,3,7,1260,0,2012,0,98042,47.3612,-122.103,1430,3767,2,11,2015,N,-170,-163
8956000100,11/21/2014,695000.0,3,3.5,2630,4713,2.0,0.0,2.0,3,9,2030,600,2008,0,98027,47.5473,-122.016,2450,4187,11,21,2014,N,180,526
3876313120,5/1/2015,505000.0,3,1.75,1800,7210,1.0,0.0,0.0,3,7,1370,430,1976,0,98072,47.7346,-122.17,1820,8100,5,1,2015,UNK,-20,-890
6819100040,6/24/2014,631500.0,2,1.0,1130,2640,1.0,0.0,0.0,4,8,1130,0,1927,0,98109,47.6438,-122.35700000000001,1680,3200,6,24,2014,UNK,-550,-560
5318101185,10/16/2014,630500.0,3,1.0,1180,3600,1.5,0.0,0.0,3,7,1180,0,1926,0,98112,47.6337,-122.28,1900,3600,10,16,2014,UNK,-720,0
424069112,6/16/2014,999000.0,4,2.75,2800,19168,2.0,0.0,0.0,3,10,2800,0,1992,0,98075,47.5911,-122.037,2010,16020,6,16,2014,UNK,790,3148
2533300025,7/10/2014,740000.0,3,1.5,1830,4000,1.0,0.0,0.0,4,7,1350,480,1910,0,98119,47.6453,-122.37100000000001,1570,3672,7,10,2014,UNK,260,328
5101404482,9/29/2014,650000.0,3,2.5,2220,6380,1.5,0.0,0.0,4,8,1660,560,1931,0,98115,47.6974,-122.31299999999999,950,6380,9,29,2014,UNK,1270,0
8682231210,8/5/2014,554000.0,2,2.0,1870,5580,1.0,0.0,0.0,3,8,1870,0,2004,0,98053,47.7101,-122.031,1670,4500,8,5,2014,N,200,1080
1525069021,12/1/2014,400000.0,3,2.5,2580,214315,1.5,0.0,0.0,3,8,2580,0,1946,1986,98053,47.6465,-122.024,2580,70131,12,1,2014,Y,0,144184
5076700115,2/23/2015,529941.0,3,2.0,1660,10000,1.0,0.0,0.0,4,7,1010,650,1961,0,98005,47.5852,-122.17399999999999,2020,9720,2,23,2015,UNK,-360,280
3332000615,10/20/2014,310000.0,3,1.0,1330,3740,1.5,0.0,0.0,3,6,1330,0,1903,0,98118,47.5502,-122.274,1330,5053,10,20,2014,UNK,0,-1313
3332000615,4/22/2015,389000.0,3,1.0,1330,3740,1.5,0.0,0.0,3,6,1330,0,1903,0,98118,47.5502,-122.274,1330,5053,4,22,2015,UNK,0,-1313
5569620410,9/9/2014,731781.0,3,3.0,2630,4972,2.0,0.0,0.0,3,9,2630,0,2006,0,98052,47.69300000000001,-122.133,2880,4972,9,9,2014,N,-250,0
3009800015,4/22/2015,502501.0,2,1.0,1100,4750,1.0,0.0,0.0,3,7,1100,0,1946,0,98116,47.5772,-122.381,1830,4750,4,22,2015,UNK,-730,0
6189600040,11/17/2014,443000.0,3,1.75,1810,7950,1.0,0.0,0.0,4,7,1810,0,1968,0,98008,47.6236,-122.117,1680,7725,11,17,2014,UNK,130,225
9834200365,8/15/2014,607000.0,3,2.0,2060,4080,1.0,0.0,0.0,5,7,1060,1000,1921,0,98144,47.574,-122.289,1400,4080,8,15,2014,UNK,660,0
1959701800,7/2/2014,2150000.0,3,3.5,4660,5500,2.0,0.0,4.0,5,10,3040,1620,1909,0,98102,47.6465,-122.319,2980,5500,7,2,2014,UNK,1680,0
8917100153,9/10/2014,585000.0,4,2.5,2370,15200,1.0,0.0,0.0,3,8,1660,710,1975,0,98052,47.6295,-122.089,2360,13879,9,10,2014,UNK,10,1321
2344300180,6/19/2014,1030000.0,3,2.5,2430,10500,2.0,0.0,1.0,3,9,2430,0,1989,0,98004,47.5818,-122.198,3440,12842,6,19,2014,UNK,-1010,-2342
3216900100,6/12/2014,315000.0,3,2.5,1880,7000,2.0,0.0,0.0,3,8,1880,0,1993,0,98031,47.4206,-122.184,1880,7000,6,12,2014,UNK,0,0
425000065,10/21/2014,180000.0,2,1.0,1150,5695,1.0,0.0,0.0,4,6,1150,0,1958,0,98056,47.4989,-122.171,1150,5695,10,21,2014,UNK,0,0
2426069085,5/13/2014,322500.0,3,2.0,1350,14200,1.0,0.0,0.0,3,7,1350,0,1989,0,98019,47.7315,-121.97200000000001,2100,15101,5,13,2014,UNK,-750,-901
7199350600,6/2/2014,568500.0,3,2.75,2180,7519,1.0,0.0,0.0,4,7,1310,870,1981,0,98052,47.6959,-122.125,1510,7107,6,2,2014,UNK,670,412
6909700040,6/11/2014,813000.0,4,2.75,3370,6675,1.0,0.0,3.0,4,8,1920,1450,1948,0,98144,47.5887,-122.291,2250,5550,6,11,2014,UNK,1120,1125
4147200040,4/14/2015,1090000.0,5,2.25,3650,13068,1.0,0.0,0.0,4,10,1850,1800,1976,0,98040,47.5458,-122.23100000000001,2760,13927,4,14,2015,UNK,890,-859
1062100100,6/26/2014,424000.0,4,2.0,2100,4857,2.0,0.0,0.0,3,8,2100,0,1965,1984,98155,47.7521,-122.279,1450,5965,6,26,2014,Y,650,-1108
2124049254,7/17/2014,235000.0,2,1.0,670,5600,1.0,0.0,0.0,3,6,670,0,1903,0,98108,47.5498,-122.304,1960,7176,7,17,2014,UNK,-1290,-1576
6841700100,9/29/2014,740000.0,3,3.5,2420,4000,2.0,0.0,0.0,5,9,1820,600,1907,0,98122,47.6054,-122.295,2030,4550,9,29,2014,UNK,390,-550
7544800195,8/13/2014,415000.0,1,1.0,760,3000,1.0,0.0,0.0,3,7,760,0,1900,0,98122,47.6059,-122.303,1270,3000,8,13,2014,UNK,-510,0
8807810110,5/22/2014,432000.0,3,2.75,2200,14925,1.0,0.0,0.0,3,6,1100,1100,1982,0,98053,47.6606,-122.059,1520,14212,5,22,2014,UNK,680,713
1126059201,5/4/2015,1270000.0,5,3.25,4410,35192,2.0,0.0,2.0,3,12,3880,530,1990,0,98072,47.7522,-122.13,4410,59677,5,4,2015,UNK,0,-24485
1422200090,9/15/2014,676500.0,3,1.75,1300,2446,1.0,0.0,3.0,3,8,880,420,1961,0,98122,47.6071,-122.285,2440,5051,9,15,2014,UNK,-1140,-2605
871000065,11/20/2014,419000.0,2,1.0,720,4592,1.0,0.0,0.0,4,6,720,0,1943,0,98199,47.6534,-122.404,1030,5816,11,20,2014,UNK,-310,-1224
4054710090,3/20/2015,650000.0,3,2.5,2180,37042,2.0,0.0,0.0,3,9,2180,0,1998,0,98077,47.722,-122.02600000000001,2880,32688,3,20,2015,UNK,-700,4354
8075400360,8/22/2014,239000.0,2,1.0,1130,15190,1.0,0.0,0.0,4,7,1130,0,1954,0,98032,47.3902,-122.28299999999999,1490,16920,8,22,2014,UNK,-360,-1730
9551202875,7/9/2014,900000.0,4,2.5,2230,4372,2.0,0.0,0.0,5,8,1540,690,1935,0,98103,47.6698,-122.334,2020,4372,7,9,2014,UNK,210,0
4027700930,4/28/2015,330000.0,5,1.75,2100,7347,1.0,0.0,0.0,3,7,1070,1030,1981,0,98028,47.7751,-122.26799999999999,2170,9418,4,28,2015,UNK,-70,-2071
1535204165,12/4/2014,510000.0,3,1.75,2060,58341,1.0,0.0,4.0,3,8,1100,960,1982,0,98070,47.4193,-122.439,1230,14904,12,4,2014,UNK,830,43437
3303860590,6/27/2014,465000.0,4,2.5,3060,6000,2.0,0.0,0.0,3,9,3060,0,2012,0,98038,47.3689,-122.05799999999999,3040,6000,6,27,2014,N,20,0
1925069066,6/23/2014,1700000.0,3,2.75,2810,18731,2.0,1.0,4.0,4,10,2810,0,1974,0,98052,47.6361,-122.09299999999999,3120,14810,6,23,2014,UNK,-310,3921
6137610540,8/27/2014,490000.0,3,2.25,2550,8588,1.0,0.0,4.0,3,9,2550,0,1989,0,98011,47.7711,-122.195,3050,8588,8,27,2014,UNK,-500,0
2525049263,7/9/2014,2680000.0,5,3.0,4290,20445,2.0,0.0,0.0,4,11,4290,0,1985,0,98039,47.6217,-122.23899999999999,3620,22325,7,9,2014,UNK,670,-1880
126059310,11/30/2014,1000000.0,3,2.25,3040,52302,1.0,0.0,0.0,3,9,3040,0,2005,0,98072,47.7635,-122.11200000000001,2070,38600,11,30,2014,N,970,13702
4254000540,7/8/2014,469950.0,4,2.75,2530,14178,2.0,0.0,0.0,3,8,2530,0,1997,0,98019,47.736999999999995,-121.955,2530,14055,7,8,2014,UNK,0,123
5101405067,5/9/2014,536000.0,3,1.75,1300,5413,1.5,0.0,0.0,3,7,1300,0,1925,0,98115,47.6988,-122.32,1590,6380,5,9,2014,UNK,-290,-967
5468000180,3/5/2015,244950.0,4,2.5,1790,19177,1.0,0.0,0.0,4,7,1790,0,1966,0,98030,47.3617,-122.17200000000001,1760,11726,3,5,2015,UNK,30,7451
1930301220,4/17/2015,575000.0,3,1.0,1530,2400,1.0,0.0,0.0,4,7,890,640,1928,0,98103,47.6543,-122.354,1240,2400,4,17,2015,UNK,290,0
9282801450,3/25/2015,361000.0,5,2.75,2380,7500,1.0,0.0,0.0,3,7,1300,1080,1984,0,98178,47.5009,-122.235,2400,6000,3,25,2015,UNK,-20,1500
4037000925,3/27/2015,650000.0,5,2.25,2400,13450,1.0,0.0,0.0,5,7,1200,1200,1957,0,98008,47.6007,-122.117,1950,10361,3,27,2015,UNK,450,3089
3336000230,3/23/2015,230005.0,2,1.0,1030,6000,1.0,0.0,0.0,2,7,830,200,1951,0,98118,47.5291,-122.26799999999999,1770,5000,3,23,2015,UNK,-740,1000
3621059043,5/27/2014,293000.0,4,2.5,3250,235063,1.0,0.0,2.0,3,9,3250,0,1973,0,98092,47.2582,-122.113,1600,44287,5,27,2014,UNK,1650,190776
126049231,5/16/2014,445000.0,3,3.0,1970,24318,1.0,0.0,0.0,3,8,1970,0,2010,0,98028,47.7651,-122.24600000000001,2150,14695,5,16,2014,N,-180,9623
3331000220,8/14/2014,280000.0,4,1.5,1940,6386,1.0,0.0,0.0,3,7,1140,800,1954,0,98118,47.5533,-122.285,1340,6165,8,14,2014,UNK,600,221
3904900230,7/16/2014,520000.0,3,2.25,1850,10855,1.0,0.0,0.0,3,8,1370,480,1985,0,98029,47.5696,-122.02,1850,8209,7,16,2014,UNK,0,2646
525069133,8/5/2014,780000.0,4,3.25,3900,40962,2.0,0.0,0.0,3,10,3900,0,1991,0,98053,47.683,-122.06299999999999,1730,11775,8,5,2014,UNK,2170,29187
2721049061,7/9/2014,625000.0,3,1.75,3160,76230,1.0,0.0,0.0,4,8,2160,1000,1978,0,98001,47.273999999999994,-122.287,1990,45789,7,9,2014,UNK,1170,30441
5381000411,4/10/2015,239950.0,3,1.75,1440,7200,1.0,0.0,0.0,3,7,1440,0,1986,0,98188,47.4473,-122.28399999999999,1640,9167,4,10,2015,UNK,-200,-1967
603000150,6/16/2014,335000.0,3,1.5,2040,6000,1.0,0.0,0.0,3,7,1340,700,1957,0,98118,47.5218,-122.286,1190,6000,6,16,2014,UNK,850,0
3904960690,4/17/2015,612000.0,3,2.5,2120,7401,2.0,0.0,0.0,3,8,2120,0,1989,0,98029,47.5781,-122.01799999999999,2010,7972,4,17,2015,UNK,110,-571
7686202730,8/4/2014,200000.0,2,1.0,830,8000,1.0,0.0,0.0,3,6,830,0,1954,0,98198,47.4215,-122.318,1300,8000,8,4,2014,UNK,-470,0
9264910300,7/10/2014,345000.0,3,1.75,3140,8571,1.0,0.0,0.0,4,8,1670,1470,1985,0,98023,47.3074,-122.337,2590,7949,7,10,2014,UNK,550,622
1437910090,1/28/2015,520000.0,4,2.5,2410,6440,1.0,0.0,0.0,3,8,1550,860,1974,0,98034,47.7153,-122.191,2330,6938,1,28,2015,UNK,80,-498
2652500740,6/18/2014,855000.0,4,2.25,2190,4080,2.0,0.0,0.0,3,8,1800,390,1918,0,98119,47.6425,-122.35799999999999,2100,4080,6,18,2014,UNK,90,0
9274200735,5/7/2015,567500.0,4,1.75,2190,5060,1.0,0.0,0.0,3,7,1190,1000,1950,0,98116,47.5846,-122.387,1510,4600,5,7,2015,UNK,680,460
1745000090,11/10/2014,208000.0,3,1.5,1210,7247,1.0,0.0,0.0,4,7,1210,0,1967,0,98003,47.328,-122.321,1370,7869,11,10,2014,UNK,-160,-622
5101405338,8/21/2014,452000.0,3,1.75,1880,16239,1.0,0.0,0.0,3,7,880,1000,1922,0,98115,47.7004,-122.304,1260,7528,8,21,2014,UNK,620,8711
9348500220,7/28/2014,555000.0,3,3.0,2410,12183,2.0,0.0,0.0,3,9,2410,0,1988,0,98011,47.747,-122.177,2540,9979,7,28,2014,UNK,-130,2204
1066600090,9/5/2014,519000.0,5,2.75,2620,8861,1.0,0.0,0.0,5,8,1350,1270,1979,0,98056,47.5226,-122.18299999999999,1940,10800,9,5,2014,UNK,680,-1939
3331500455,12/3/2014,474950.0,3,2.25,1850,2575,2.0,0.0,0.0,3,9,1850,0,2013,0,98118,47.5525,-122.273,1080,4120,12,3,2014,N,770,-1545
1427300120,1/21/2015,419000.0,3,2.25,1760,16418,1.0,0.0,0.0,3,7,1190,570,1990,0,98053,47.6525,-121.985,2260,20747,1,21,2015,UNK,-500,-4329
1861400068,9/11/2014,390000.0,2,1.0,860,1800,1.0,0.0,0.0,3,7,860,0,1909,0,98119,47.6334,-122.37100000000001,2160,3120,9,11,2014,UNK,-1300,-1320
4040500100,10/20/2014,539000.0,7,2.25,2620,6890,2.0,0.0,0.0,4,7,2620,0,1961,0,98007,47.6123,-122.134,2070,7910,10,20,2014,UNK,550,-1020
6117501250,8/1/2014,569000.0,4,1.75,2400,21196,1.0,0.0,0.0,5,8,1590,810,1956,0,98166,47.4282,-122.34700000000001,2200,19134,8,1,2014,UNK,200,2062
9523103990,12/8/2014,611000.0,3,1.0,1850,5000,1.5,0.0,0.0,3,7,1850,0,1922,0,98103,47.6727,-122.351,1850,5000,12,8,2014,UNK,0,0
3221069054,10/28/2014,760000.0,3,2.5,4040,147856,2.0,0.0,0.0,3,9,4040,0,2004,0,98092,47.2711,-122.06700000000001,3000,125452,10,28,2014,N,1040,22404
8838900032,5/18/2014,732000.0,3,2.0,1940,55756,1.0,0.0,0.0,5,9,1940,0,1954,0,98007,47.5913,-122.149,2330,10018,5,18,2014,UNK,-390,45738
1455100355,7/8/2014,1680000.0,3,2.5,3490,8343,2.0,1.0,4.0,4,9,2150,1340,1939,0,98125,47.7265,-122.281,2990,13104,7,8,2014,UNK,500,-4761
1853080120,9/3/2014,919950.0,5,2.75,3170,7062,2.0,0.0,0.0,3,9,3170,0,2014,0,98074,47.5937,-122.061,3210,6891,9,3,2014,N,-40,171
2806800120,6/10/2014,400000.0,4,2.5,2530,7563,1.0,0.0,0.0,3,7,1440,1090,1978,0,98011,47.7762,-122.21,1960,7811,6,10,2014,UNK,570,-248
3216000090,7/29/2014,785000.0,4,2.5,3230,21781,2.0,0.0,0.0,3,9,3230,0,1993,0,98053,47.6318,-122.01,3230,21780,7,29,2014,UNK,0,1
1525059165,6/29/2014,835000.0,3,2.25,2120,54014,2.0,0.0,0.0,4,9,2120,0,1964,0,98005,47.6482,-122.15899999999999,3280,50690,6,29,2014,UNK,-1160,3324
8901000835,2/11/2015,640500.0,2,1.75,1640,6750,1.0,0.0,0.0,4,8,1340,300,1939,0,98125,47.7068,-122.30799999999999,1760,7490,2,11,2015,UNK,-120,-740
8001400300,3/16/2015,310000.0,4,2.5,2130,9013,2.0,0.0,0.0,3,8,2130,0,1988,0,98001,47.3208,-122.273,2350,8982,3,16,2015,UNK,-220,31
1138000450,10/16/2014,355000.0,4,1.0,1440,7215,1.5,0.0,0.0,3,7,1440,0,1969,0,98034,47.7133,-122.212,1150,7215,10,16,2014,UNK,290,0
2485000100,5/29/2014,685000.0,3,1.75,1940,7313,1.0,0.0,1.0,4,8,1440,500,1960,0,98136,47.5239,-122.387,2160,7200,5,29,2014,UNK,-220,113
7689600215,10/17/2014,202500.0,3,1.0,1120,8576,1.0,0.0,0.0,3,6,1120,0,1943,0,98178,47.4896,-122.24799999999999,1050,8812,10,17,2014,UNK,70,-236
7852010940,5/5/2015,540000.0,3,2.5,2400,5817,2.0,0.0,0.0,3,8,2400,0,1998,0,98065,47.5371,-121.87,2420,5817,5,5,2015,UNK,-20,0
739980360,11/17/2014,295000.0,4,2.5,1810,4871,2.0,0.0,0.0,3,8,1810,0,1999,0,98031,47.4088,-122.19200000000001,1850,5003,11,17,2014,UNK,-40,-132
1102001055,4/24/2015,518000.0,3,1.0,1270,6612,1.5,0.0,3.0,3,7,1270,0,1927,0,98118,47.5433,-122.264,2100,7680,4,24,2015,UNK,-830,-1068
2781250970,5/1/2015,250000.0,2,1.75,1350,4023,1.0,0.0,0.0,3,7,1350,0,2005,0,98038,47.3493,-122.023,1370,3570,5,1,2015,N,-20,453
3624079067,5/8/2014,330000.0,2,2.0,1550,435600,1.5,0.0,0.0,2,7,1550,0,1972,0,98065,47.5145,-121.853,1600,217800,5,8,2014,UNK,-50,217800
4443800785,11/21/2014,481000.0,2,1.0,1620,3880,1.0,0.0,0.0,4,7,920,700,1924,0,98117,47.6855,-122.391,1330,3880,11,21,2014,UNK,290,0
3303900090,10/23/2014,898000.0,3,2.25,2650,12845,1.0,0.0,3.0,3,9,1770,880,1977,0,98034,47.7209,-122.256,2650,12902,10,23,2014,UNK,0,-57
686530530,8/4/2014,570000.0,5,1.75,2510,9750,1.5,0.0,0.0,3,8,2510,0,1969,0,98052,47.6635,-122.149,1900,9750,8,4,2014,UNK,610,0
4254000220,3/7/2015,475000.0,4,2.5,2040,16200,2.0,0.0,0.0,3,8,2040,0,1997,0,98019,47.7366,-121.958,2530,15389,3,7,2015,UNK,-490,811
7575600610,2/9/2015,265000.0,3,2.5,1660,5250,2.0,0.0,0.0,4,8,1660,0,1988,0,98003,47.3541,-122.3,1630,5505,2,9,2015,UNK,30,-255
7631800110,9/18/2014,380000.0,3,2.5,1980,17342,2.0,1.0,4.0,3,10,1580,400,1984,0,98166,47.4551,-122.37299999999999,2060,17313,9,18,2014,UNK,-80,29
7732410120,8/19/2014,790000.0,4,2.5,2690,8036,2.0,0.0,0.0,4,9,2690,0,1987,0,98007,47.6596,-122.14399999999999,2420,8087,8,19,2014,UNK,270,-51
2493200040,3/12/2015,620000.0,2,2.25,2910,6110,2.0,0.0,2.0,4,9,2910,0,1985,0,98136,47.5279,-122.387,2090,5763,3,12,2015,UNK,820,347
2568300040,8/19/2014,709050.0,4,3.5,2720,9000,2.0,0.0,0.0,3,8,2670,50,1997,0,98125,47.7034,-122.29700000000001,1960,7772,8,19,2014,UNK,760,1228
1781500385,8/6/2014,296500.0,3,1.0,1280,5100,1.0,0.0,0.0,3,7,1280,0,1948,0,98126,47.5259,-122.38,1380,7140,8,6,2014,UNK,-100,-2040
626710220,8/13/2014,475000.0,3,2.5,2160,35912,2.0,0.0,0.0,3,8,2160,0,1982,0,98077,47.7273,-122.083,2230,35244,8,13,2014,UNK,-70,668
9414500230,10/22/2014,440000.0,3,2.25,1760,10835,1.0,0.0,0.0,4,8,1290,470,1976,0,98027,47.522,-122.04799999999999,2050,10488,10,22,2014,UNK,-290,347
6638900405,12/8/2014,405000.0,2,1.0,800,6016,1.0,0.0,0.0,3,6,800,0,1942,0,98117,47.6913,-122.369,1470,3734,12,8,2014,UNK,-670,2282
7327902612,5/13/2015,269500.0,2,1.0,930,4000,1.0,0.0,0.0,3,6,730,200,1943,0,98108,47.5321,-122.323,1100,5000,5,13,2015,UNK,-170,-1000
7923600330,11/19/2014,520000.0,5,1.75,2040,5280,1.0,0.0,0.0,4,7,1020,1020,1961,0,98007,47.5941,-122.14399999999999,1720,7344,11,19,2014,UNK,320,-2064
2011400782,8/4/2014,229500.0,1,1.0,1180,22000,1.0,0.0,2.0,3,6,1180,0,1948,0,98198,47.4007,-122.323,1890,11761,8,4,2014,UNK,-710,10239
821049149,10/9/2014,335000.0,4,1.75,2000,10890,1.0,0.0,0.0,4,7,1390,610,1961,0,98003,47.3203,-122.321,1520,9250,10,9,2014,UNK,480,1640
4054700300,10/21/2014,680000.0,4,2.75,3310,50951,2.0,0.0,0.0,3,9,3310,0,1998,0,98077,47.7249,-122.027,3230,39340,10,21,2014,UNK,80,11611
3931900580,3/13/2015,1390000.0,4,3.5,3130,3900,2.0,0.0,0.0,3,9,2550,580,2008,0,98115,47.6849,-122.32700000000001,1830,3900,3,13,2015,N,1300,0
2485000165,12/15/2014,740000.0,4,2.5,2300,9900,1.0,0.0,2.0,3,8,1600,700,1961,0,98136,47.5256,-122.385,2510,7500,12,15,2014,UNK,-210,2400
1117000150,3/17/2015,270000.0,3,2.25,2140,9990,1.0,0.0,0.0,4,8,2140,0,1962,0,98003,47.3484,-122.29799999999999,2060,9990,3,17,2015,UNK,80,0
4321200600,5/4/2015,510000.0,4,2.0,2210,5572,1.5,0.0,3.0,3,7,1760,450,1911,0,98126,47.5727,-122.376,1760,4713,5,4,2015,UNK,450,859
123039364,5/21/2014,300000.0,2,1.0,970,13700,1.0,0.0,0.0,3,6,970,0,1949,0,98106,47.515,-122.36200000000001,1570,10880,5,21,2014,UNK,-600,2820
2175100205,3/23/2015,1300000.0,5,2.25,2690,10800,1.0,0.0,3.0,4,8,2020,670,1956,0,98040,47.5821,-122.24700000000001,3380,9134,3,23,2015,UNK,-690,1666
8813400165,8/19/2014,675000.0,4,2.0,1890,5188,1.5,0.0,0.0,4,7,1670,220,1940,0,98105,47.6633,-122.287,1800,4848,8,19,2014,UNK,90,340
2597531020,11/4/2014,925850.0,6,3.25,3140,14923,2.0,0.0,0.0,3,10,3140,0,1991,0,98006,47.5411,-122.133,2980,10758,11,4,2014,UNK,160,4165
723069013,7/18/2014,255500.0,2,1.0,1440,43560,1.0,0.0,0.0,4,7,1150,290,1965,0,98027,47.4916,-122.08200000000001,1870,56628,7,18,2014,UNK,-430,-13068
1137800230,5/14/2014,450000.0,3,2.5,2910,17172,2.0,0.0,0.0,3,10,2910,0,1989,0,98003,47.2789,-122.331,2910,20048,5,14,2014,UNK,0,-2876
3221069057,11/5/2014,280000.0,3,1.0,1310,22652,1.0,0.0,0.0,3,7,1310,0,1968,0,98092,47.2574,-122.072,1600,103672,11,5,2014,UNK,-290,-81020
3832500230,1/5/2015,245000.0,4,2.25,2140,8800,2.0,0.0,0.0,4,7,2140,0,1963,0,98032,47.3655,-122.291,2060,9790,1,5,2015,UNK,80,-990
1138010220,3/17/2015,344950.0,3,1.0,1090,6712,1.0,0.0,0.0,4,7,1090,0,1972,0,98034,47.7155,-122.211,1440,7350,3,17,2015,UNK,-350,-638
3205500230,8/11/2014,381000.0,3,1.75,1330,7216,1.0,0.0,0.0,3,7,1330,0,1969,0,98034,47.7199,-122.18,1500,8000,8,11,2014,UNK,-170,-784
4389201241,12/30/2014,1950000.0,4,4.0,4690,6900,2.0,0.0,0.0,3,11,3480,1210,2001,0,98004,47.6165,-122.21600000000001,2800,11240,12,30,2014,UNK,1890,-4340
9808700025,2/11/2015,1500000.0,3,1.5,1910,21374,1.0,0.0,0.0,1,8,1910,0,1955,0,98004,47.6453,-122.214,2850,16167,2,11,2015,UNK,-940,5207
4399210110,6/19/2014,232603.0,3,1.75,1750,11461,2.0,0.0,0.0,4,7,1750,0,1976,0,98002,47.3173,-122.21,2140,11276,6,19,2014,UNK,-390,185
7972602490,12/12/2014,220000.0,5,2.5,1760,10200,1.5,0.0,0.0,3,6,1760,0,1925,0,98106,47.5271,-122.351,1370,7620,12,12,2014,UNK,390,2580
2128000180,8/11/2014,600000.0,4,1.75,1810,7700,1.0,0.0,0.0,5,8,1390,420,1977,0,98033,47.6976,-122.169,2080,7700,8,11,2014,UNK,-270,0
4345000090,11/5/2014,239000.0,3,2.5,1360,5754,2.0,0.0,0.0,3,7,1360,0,1994,0,98030,47.3645,-122.18299999999999,1360,7050,11,5,2014,UNK,0,-1296
6413100242,8/26/2014,400000.0,3,1.75,1730,9211,1.0,0.0,0.0,3,8,1730,0,1961,0,98125,47.7149,-122.322,1440,9211,8,26,2014,UNK,290,0
4218400455,7/8/2014,2180000.0,6,2.75,4710,11000,2.0,0.0,3.0,3,10,3690,1020,1931,0,98105,47.6622,-122.272,2950,5300,7,8,2014,UNK,1760,5700
1568100220,9/8/2014,350000.0,3,1.0,1010,8551,1.0,0.0,0.0,5,7,1010,0,1953,0,98155,47.7351,-122.295,1310,8504,9,8,2014,UNK,-300,47
1626069220,9/5/2014,562000.0,3,2.5,2400,97138,2.0,0.0,0.0,5,8,2400,0,1983,0,98077,47.7361,-122.046,2230,54450,9,5,2014,UNK,170,42688
3342103149,9/10/2014,380000.0,3,1.5,1540,8400,1.0,0.0,0.0,5,7,1540,0,1968,0,98056,47.5237,-122.199,1690,7689,9,10,2014,UNK,-150,711
8127700410,10/15/2014,511200.0,4,1.75,1480,7875,1.0,0.0,0.0,3,7,740,740,1927,0,98199,47.643,-122.397,1680,5851,10,15,2014,UNK,-200,2024
3629970090,10/14/2014,680000.0,4,2.5,2520,5000,2.0,0.0,0.0,3,9,2520,0,2004,0,98029,47.5524,-121.992,2910,5001,10,14,2014,N,-390,-1
8910500237,7/26/2014,350000.0,3,3.25,1210,941,2.0,0.0,0.0,3,8,1000,210,2002,0,98133,47.7114,-122.35600000000001,1650,1493,7,26,2014,UNK,-440,-552
621069218,2/19/2015,410000.0,5,2.5,2670,184140,1.0,0.0,0.0,3,8,1410,1260,1980,0,98042,47.3429,-122.09700000000001,1860,35719,2,19,2015,UNK,810,148421
3394100230,5/22/2014,1050000.0,4,2.5,3030,12590,1.5,0.0,0.0,4,10,3030,0,1988,0,98004,47.5806,-122.193,2980,11635,5,22,2014,UNK,50,955
8682211030,10/28/2014,391265.0,3,2.0,1440,3900,1.0,0.0,0.0,3,8,1440,0,2002,0,98053,47.7022,-122.021,1350,3900,10,28,2014,UNK,90,0
5427100150,6/26/2014,1410000.0,4,2.25,3250,16684,2.0,0.0,0.0,3,9,3250,0,1979,0,98039,47.6334,-122.229,2890,16927,6,26,2014,UNK,360,-243
7579200600,4/28/2015,575000.0,3,2.0,1750,5750,1.0,0.0,2.0,5,7,870,880,1956,0,98116,47.5579,-122.384,1750,5750,4,28,2015,UNK,0,0
7302000610,5/8/2015,316000.0,4,1.5,2120,46173,2.0,0.0,0.0,3,7,2120,0,1974,0,98053,47.6503,-121.96799999999999,2000,46173,5,8,2015,UNK,120,0
3004800175,4/16/2015,165000.0,3,1.0,1050,5156,1.5,0.0,0.0,3,7,1050,0,1919,0,98106,47.5169,-122.35799999999999,1050,5502,4,16,2015,UNK,0,-346
2397101055,8/12/2014,850000.0,3,2.25,1950,3600,1.5,0.0,0.0,5,8,1430,520,1911,0,98119,47.637,-122.363,1950,3600,8,12,2014,UNK,0,0
2354300845,8/4/2014,210000.0,3,1.0,1020,6000,1.0,0.0,0.0,3,5,1020,0,1900,0,98027,47.5281,-122.031,2070,7200,8,4,2014,UNK,-1050,-1200
984220330,8/24/2014,325000.0,4,2.5,1820,9161,1.0,0.0,0.0,4,7,1220,600,1975,0,98058,47.4333,-122.16799999999999,1860,7650,8,24,2014,UNK,-40,1511
7273100026,4/7/2015,682000.0,4,2.5,2390,53941,2.0,0.0,0.0,3,8,2390,0,1989,0,98053,47.7066,-122.08,2610,104108,4,7,2015,UNK,-220,-50167
6386200100,7/18/2014,430000.0,3,2.5,1400,7508,2.0,0.0,0.0,4,7,1400,0,1987,0,98034,47.7233,-122.167,1710,7700,7,18,2014,UNK,-310,-192
9324800025,11/25/2014,325500.0,3,1.5,1540,8110,1.0,0.0,0.0,4,7,1190,350,1959,0,98125,47.7329,-122.291,1290,8110,11,25,2014,UNK,250,0
4058800930,7/20/2014,385000.0,3,1.75,2370,6360,1.0,0.0,3.0,3,7,1280,1090,1954,0,98178,47.5039,-122.24,1990,6360,7,20,2014,UNK,380,0
1972201161,3/23/2015,435000.0,1,1.0,670,1800,1.0,0.0,0.0,5,6,670,0,1905,0,98103,47.653999999999996,-122.35,1330,3360,3,23,2015,UNK,-660,-1560
2202500025,7/21/2014,550000.0,4,1.0,2420,15520,2.0,0.0,0.0,4,7,2420,0,1945,0,98006,47.5744,-122.137,1630,9965,7,21,2014,UNK,790,5555
4077800258,10/9/2014,400000.0,3,1.0,1000,7800,1.0,0.0,0.0,4,6,860,0,1930,0,98125,47.7098,-122.28299999999999,1700,7800,10,9,2014,UNK,-700,0
2558700220,7/21/2014,503000.0,4,2.75,2100,7350,1.0,0.0,0.0,5,7,1240,860,1978,0,98034,47.7194,-122.17200000000001,2490,7350,7,21,2014,UNK,-390,0
290200230,8/19/2014,676000.0,4,2.5,2800,5368,2.0,0.0,0.0,3,8,2800,0,2003,0,98074,47.6076,-122.053,2790,5368,8,19,2014,UNK,10,0
1951100100,11/13/2014,180000.0,3,1.0,940,11055,1.5,0.0,0.0,4,7,940,0,1959,0,98032,47.3732,-122.295,1420,9100,11,13,2014,UNK,-480,1955
9499200220,6/11/2014,234000.0,3,2.0,1640,5280,1.5,0.0,0.0,5,6,1640,0,1910,0,98002,47.3089,-122.213,1160,7875,6,11,2014,UNK,480,-2595
999000215,5/12/2014,734200.0,4,2.5,2760,5000,1.5,0.0,0.0,5,7,1680,1080,1928,0,98107,47.6726,-122.37100000000001,1850,5000,5,12,2014,UNK,910,0
822069118,7/29/2014,920000.0,3,3.25,3660,66211,2.0,0.0,0.0,3,10,3660,0,2003,0,98038,47.4087,-122.06200000000001,3660,107153,7,29,2014,UNK,0,-40942
2425049066,6/16/2014,1920000.0,4,2.5,3070,34412,1.0,0.0,3.0,4,9,2070,1000,1950,0,98039,47.64,-122.24,3780,27940,6,16,2014,UNK,-710,6472
7950700110,12/9/2014,224000.0,3,1.75,1100,10125,1.0,0.0,0.0,4,7,1100,0,1969,0,98092,47.3232,-122.103,1520,10125,12,9,2014,UNK,-420,0
9253900408,4/8/2015,1400000.0,3,2.75,3130,19530,1.0,1.0,4.0,3,8,1690,1440,1947,1984,98008,47.5895,-122.111,2980,18782,4,8,2015,Y,150,748
3313600077,9/19/2014,185000.0,3,1.0,1320,7155,1.0,0.0,0.0,4,6,1320,0,1961,0,98002,47.2857,-122.22,1070,8100,9,19,2014,UNK,250,-945
452001540,8/18/2014,554600.0,3,1.75,1470,5000,1.5,0.0,0.0,5,7,1470,0,1900,0,98107,47.6755,-122.369,1530,5000,8,18,2014,UNK,-60,0
3832710210,8/25/2014,268000.0,3,1.75,1480,8009,1.0,0.0,0.0,3,7,980,500,1980,0,98032,47.3657,-122.28,1790,7678,8,25,2014,UNK,-310,331
8563000300,9/15/2014,675000.0,4,2.25,2260,8715,1.0,0.0,0.0,4,8,1530,730,1976,0,98008,47.6237,-122.10600000000001,2220,8650,9,15,2014,UNK,40,65
1313000650,7/11/2014,620000.0,4,2.25,2210,10039,1.0,0.0,0.0,4,8,1710,500,1967,0,98052,47.63399999999999,-122.101,2070,10965,7,11,2014,UNK,140,-926
3424069066,5/21/2014,396450.0,3,1.75,1540,12446,1.0,0.0,0.0,5,8,1540,0,1967,0,98027,47.5172,-122.027,1330,11508,5,21,2014,UNK,210,938
2206500300,8/20/2014,565000.0,5,1.75,1910,9720,1.0,0.0,0.0,4,7,1390,520,1955,0,98006,47.5772,-122.15899999999999,1750,9720,8,20,2014,UNK,160,0
3083001095,8/24/2014,410000.0,3,1.75,1760,3520,1.0,0.0,0.0,3,7,1160,600,1966,0,98144,47.5773,-122.303,1840,5000,8,24,2014,UNK,-80,-1480
809002290,5/19/2014,1190000.0,4,3.0,2240,6000,1.5,0.0,0.0,4,8,1270,970,1914,0,98109,47.6369,-122.35,2240,4250,5,19,2014,UNK,0,1750
6669070220,8/21/2014,716125.0,3,2.25,2110,7279,1.0,0.0,0.0,4,9,2110,0,1984,0,98033,47.6669,-122.17,2130,7279,8,21,2014,UNK,-20,0
2325069054,5/21/2014,225000.0,2,1.0,1396,111949,1.0,0.0,0.0,3,7,1396,0,1940,1997,98053,47.6374,-122.007,2020,111949,5,21,2014,Y,-624,0
8820901792,7/11/2014,640000.0,4,2.75,3040,7274,2.0,0.0,3.0,3,9,2320,720,1986,0,98125,47.7184,-122.28,2830,10080,7,11,2014,UNK,210,-2806
3488300110,9/10/2014,374000.0,2,1.0,1140,5650,1.0,0.0,1.0,3,6,980,160,1920,0,98116,47.5634,-122.391,1220,5700,9,10,2014,UNK,-80,-50
3971700330,4/15/2015,415000.0,4,2.0,1780,12161,1.0,0.0,0.0,5,7,1160,620,1950,0,98155,47.7746,-122.323,1780,8170,4,15,2015,UNK,0,3991
5561400220,8/19/2014,592500.0,4,2.5,3370,35150,1.0,0.0,0.0,5,8,1770,1600,1993,0,98027,47.46100000000001,-122.00200000000001,2920,41241,8,19,2014,UNK,450,-6091
2979800762,9/4/2014,365000.0,3,2.5,1484,1761,3.0,0.0,0.0,3,7,1484,0,2003,0,98115,47.6844,-122.31700000000001,1484,4320,9,4,2014,UNK,0,-2559
6600220300,9/14/2014,600000.0,4,2.5,2230,12753,1.0,0.0,0.0,4,7,1180,1050,1981,0,98074,47.6297,-122.03299999999999,1860,12753,9,14,2014,UNK,370,0
2817910220,12/16/2014,465000.0,4,2.5,2820,39413,2.0,0.0,0.0,4,9,2820,0,1989,0,98092,47.3064,-122.1,2910,39413,12,16,2014,UNK,-90,0
7696620100,4/22/2015,254999.0,3,1.0,1580,7560,1.0,0.0,0.0,4,7,1000,580,1976,0,98001,47.3318,-122.277,1580,7560,4,22,2015,UNK,0,0
7760400900,9/16/2014,279000.0,4,2.5,2040,8076,2.0,0.0,0.0,3,7,2040,0,1994,0,98042,47.3691,-122.074,2040,8408,9,16,2014,UNK,0,-332
3353404265,12/31/2014,460000.0,3,2.5,2720,40813,2.0,0.0,0.0,3,8,2720,0,2001,0,98001,47.2619,-122.271,2250,40511,12,31,2014,UNK,470,302
9828702666,7/28/2014,507000.0,4,2.25,1490,956,2.0,0.0,0.0,3,7,1020,470,2005,0,98122,47.6184,-122.301,1510,1350,7,28,2014,N,-20,-394
1823059223,5/20/2014,291000.0,3,1.75,1560,9788,1.0,0.0,0.0,3,7,1560,0,1964,0,98178,47.4876,-122.226,1840,11180,5,20,2014,UNK,-280,-1392
2197600388,12/2/2014,350000.0,2,1.5,830,1077,2.0,0.0,0.0,3,7,830,0,2006,0,98122,47.6058,-122.319,830,1366,12,2,2014,N,0,-289
4239400300,11/29/2014,90000.0,3,1.0,980,2490,2.0,0.0,0.0,4,6,980,0,1969,0,98092,47.317,-122.182,980,3154,11,29,2014,UNK,0,-664
1328300820,8/6/2014,329000.0,3,1.75,1980,7000,1.0,0.0,0.0,4,8,1360,620,1977,0,98058,47.4442,-122.12899999999999,1880,7200,8,6,2014,UNK,100,-200
7805450870,8/14/2014,909000.0,4,2.5,3680,11648,2.0,0.0,0.0,3,10,3680,0,1986,0,98006,47.5604,-122.10700000000001,2830,11251,8,14,2014,UNK,850,397
419000035,10/15/2014,187000.0,2,1.0,860,5400,1.0,0.0,0.0,4,5,860,0,1953,0,98056,47.492,-122.171,960,5400,10,15,2014,UNK,-100,0
3131201105,7/9/2014,580000.0,3,1.75,1850,5100,1.0,0.0,0.0,3,7,1020,830,1909,0,98105,47.6605,-122.32600000000001,1850,5100,7,9,2014,UNK,0,0
112900110,9/3/2014,345000.0,3,2.5,1620,5992,2.0,0.0,0.0,3,7,1620,0,2001,0,98019,47.736000000000004,-121.965,1620,4644,9,3,2014,UNK,0,1348
5249802240,5/15/2014,497000.0,4,2.5,2240,7200,2.0,0.0,0.0,3,8,2240,0,1995,0,98118,47.5636,-122.275,1860,6600,5,15,2014,UNK,380,600
7950302345,8/15/2014,345000.0,3,1.0,1010,3060,1.5,0.0,0.0,3,6,1010,0,1904,0,98118,47.5657,-122.285,1330,4590,8,15,2014,UNK,-320,-1530
2473371570,11/19/2014,313500.0,3,1.75,1610,7350,1.0,0.0,0.0,3,8,1610,0,1974,0,98058,47.4503,-122.131,2120,7350,11,19,2014,UNK,-510,0
3982700088,4/2/2015,910000.0,3,2.5,2720,7250,2.0,0.0,0.0,3,9,2720,0,1990,0,98033,47.6894,-122.195,2870,7250,4,2,2015,UNK,-150,0
3448000755,6/4/2014,399950.0,3,1.5,2080,5244,1.0,0.0,0.0,3,7,1190,890,1959,0,98125,47.7144,-122.29299999999999,1850,6982,6,4,2014,UNK,230,-1738
1446400615,5/27/2014,268000.0,4,2.0,1930,6600,1.0,0.0,0.0,4,7,1030,900,1967,0,98168,47.482,-122.33200000000001,1220,6600,5,27,2014,UNK,710,0
2484700145,12/29/2014,559000.0,4,1.75,2250,8458,1.0,0.0,0.0,3,8,1450,800,1954,0,98136,47.5235,-122.383,1950,7198,12,29,2014,UNK,300,1260
1753500100,7/9/2014,309000.0,3,2.25,1980,8755,1.0,0.0,0.0,4,7,1300,680,1963,0,98198,47.3922,-122.321,2030,8671,7,9,2014,UNK,-50,84
7853300770,6/9/2014,410000.0,3,2.5,1960,4400,2.0,0.0,0.0,3,7,1960,0,2006,0,98065,47.5384,-121.889,2060,4400,6,9,2014,N,-100,0
7236100015,5/20/2014,259000.0,3,1.0,1320,8625,1.0,0.0,0.0,4,7,1320,0,1957,0,98056,47.4902,-122.179,1370,8295,5,20,2014,UNK,-50,330
1959701695,11/24/2014,950000.0,5,2.0,2940,5500,2.0,0.0,0.0,4,9,2340,600,1909,0,98102,47.6466,-122.321,2940,5500,11,24,2014,UNK,0,0
4024101421,12/2/2014,320000.0,4,1.0,1460,7200,1.5,0.0,0.0,4,7,1460,0,1955,0,98155,47.7602,-122.306,1690,7357,12,2,2014,UNK,-230,-157
327000165,4/13/2015,1150000.0,4,2.5,2330,30122,1.0,0.0,1.0,3,8,1490,840,1951,0,98115,47.6843,-122.26700000000001,2430,6726,4,13,2015,UNK,-100,23396
7893800534,11/24/2014,394250.0,3,2.0,2620,10107,1.0,0.0,3.0,3,7,2620,0,1982,0,98198,47.4096,-122.329,1730,7812,11,24,2014,UNK,890,2295
6430500191,11/6/2014,315000.0,1,1.0,700,3876,1.0,0.0,0.0,3,6,700,0,1910,0,98103,47.6886,-122.352,1150,3952,11,6,2014,UNK,-450,-76
2354300835,12/24/2014,480000.0,2,2.0,1140,12000,1.0,0.0,0.0,3,6,1140,0,1943,0,98027,47.5277,-122.031,1880,6125,12,24,2014,UNK,-740,5875
9510300220,8/4/2014,556000.0,3,2.5,2750,35440,2.0,0.0,0.0,3,9,2750,0,1994,0,98045,47.4745,-121.723,2710,35440,8,4,2014,UNK,40,0
7852130410,10/27/2014,450000.0,3,2.5,2480,5647,2.0,0.0,0.0,3,7,2480,0,2002,0,98065,47.5355,-121.88,2510,5018,10,27,2014,UNK,-30,629
5101406522,10/1/2014,420000.0,3,1.5,1130,5413,1.0,0.0,0.0,3,7,940,190,1946,0,98125,47.7021,-122.32,1400,7168,10,1,2014,UNK,-270,-1755
2768200090,3/17/2015,890000.0,6,3.75,2770,5000,1.0,0.0,0.0,3,8,1870,900,1969,0,98107,47.669,-122.365,1570,2108,3,17,2015,UNK,1200,2892
1761300650,10/6/2014,295000.0,4,2.0,1710,8814,1.0,0.0,0.0,5,7,1030,0,1975,0,98031,47.395,-122.17399999999999,1710,7272,10,6,2014,UNK,0,1542
1081330210,9/11/2014,410000.0,4,2.25,2150,27345,2.0,0.0,0.0,5,8,2150,0,1976,0,98059,47.468999999999994,-122.12100000000001,2200,11923,9,11,2014,UNK,-50,15422
4137070090,6/11/2014,308900.0,3,2.5,2250,7294,2.0,0.0,0.0,3,8,2250,0,1994,0,98092,47.2636,-122.212,2140,7363,6,11,2014,UNK,110,-69
327000100,10/22/2014,1160000.0,4,2.5,2960,26742,1.0,0.0,3.0,3,8,1480,1480,1949,1996,98115,47.6846,-122.26799999999999,2500,9460,10,22,2014,Y,460,17282
8682281510,1/28/2015,665000.0,2,2.5,2300,6984,1.0,0.0,0.0,3,8,2300,0,2006,0,98053,47.7087,-122.015,1820,4950,1,28,2015,N,480,2034
3297700100,9/3/2014,577000.0,3,1.75,1740,5500,1.0,0.0,0.0,5,7,970,770,1953,0,98116,47.577,-122.395,1740,7250,9,3,2014,UNK,0,-1750
7518506717,9/17/2014,959000.0,3,2.5,2830,3750,3.0,0.0,0.0,3,10,2830,0,2014,0,98117,47.6799,-122.385,1780,5000,9,17,2014,N,1050,-1250
65000210,6/26/2014,471000.0,2,1.75,1240,6417,1.0,0.0,0.0,5,7,1240,0,1924,0,98126,47.5439,-122.37899999999999,1800,6417,6,26,2014,UNK,-560,0
3905040590,4/21/2015,560000.0,3,2.5,2180,7169,2.0,0.0,0.0,3,8,2180,0,1990,0,98029,47.5714,-122.00200000000001,2150,5914,4,21,2015,UNK,30,1255
5451210150,5/14/2014,955000.0,5,2.25,2510,9887,2.0,0.0,0.0,3,8,2510,0,1972,0,98040,47.5339,-122.223,2510,10006,5,14,2014,UNK,0,-119
1778360150,6/20/2014,1240000.0,7,5.5,6630,13782,2.0,0.0,0.0,3,10,4930,1700,2004,0,98006,47.5399,-122.118,4470,8639,6,20,2014,N,2160,5143
6649900301,12/31/2014,579000.0,3,2.5,2300,18540,1.0,0.0,0.0,3,8,1800,500,1961,0,98177,47.7767,-122.369,2460,18540,12,31,2014,UNK,-160,0
9264901490,4/28/2015,335000.0,4,2.25,3220,7889,2.0,0.0,0.0,3,8,3220,0,1978,0,98023,47.3112,-122.339,2120,7651,4,28,2015,UNK,1100,238
7853220910,9/15/2014,485000.0,3,2.5,2270,7887,2.0,0.0,2.0,3,8,2270,0,2004,0,98065,47.5326,-121.855,2550,7133,9,15,2014,N,-280,754
9346700150,7/2/2014,552000.0,3,2.5,1840,9900,1.0,0.0,0.0,3,9,1840,0,1978,0,98007,47.6131,-122.15100000000001,2730,9900,7,2,2014,UNK,-890,0
2327000110,7/14/2014,950000.0,4,3.25,3820,15293,2.0,0.0,0.0,3,10,3820,0,2003,0,98074,47.6097,-122.01700000000001,2790,7142,7,14,2014,UNK,1030,8151
7137900490,3/16/2015,203700.0,3,2.0,1660,7958,1.0,0.0,0.0,3,7,1130,530,1983,0,98092,47.3187,-122.171,1550,7647,3,16,2015,UNK,110,311
9264960850,7/9/2014,412000.0,4,3.5,3360,9767,2.0,0.0,0.0,3,9,2450,910,1990,0,98023,47.3047,-122.34700000000001,2580,8757,7,9,2014,UNK,780,1010
1545808960,1/6/2015,237500.0,3,2.0,1350,8960,1.0,0.0,0.0,4,7,1350,0,1986,0,98038,47.3614,-122.045,1470,8288,1,6,2015,UNK,-120,672
486000085,8/15/2014,866800.0,4,3.5,2970,5000,2.0,0.0,2.0,3,9,2200,770,2001,0,98117,47.6772,-122.399,1470,4560,8,15,2014,UNK,1500,440
7977200945,3/10/2015,425000.0,3,1.0,1000,5100,1.0,0.0,0.0,3,7,860,140,1946,0,98115,47.6857,-122.29299999999999,1000,5100,3,10,2015,UNK,0,0
3056700150,6/25/2014,200000.0,3,2.0,1190,6833,1.0,0.0,0.0,3,7,1190,0,1995,0,98092,47.3191,-122.18,1540,8000,6,25,2014,UNK,-350,-1167
7896300150,9/29/2014,280000.0,3,1.75,1670,6034,1.0,0.0,0.0,3,7,990,680,1957,0,98118,47.5209,-122.286,1230,6034,9,29,2014,UNK,440,0
7399100210,11/26/2014,140000.0,3,1.5,1200,2002,2.0,0.0,0.0,3,8,1200,0,1966,0,98055,47.4659,-122.189,1270,1848,11,26,2014,UNK,-70,154
2473370110,11/14/2014,370000.0,5,2.5,2250,10400,1.0,0.0,0.0,3,8,1280,970,1973,0,98058,47.4501,-122.139,2140,9592,11,14,2014,UNK,110,808
2770605420,9/16/2014,550000.0,2,0.75,1040,4000,1.0,0.0,0.0,3,7,930,110,1909,0,98119,47.6489,-122.37200000000001,1700,4800,9,16,2014,UNK,-660,-800
7856400300,7/2/2014,1410000.0,2,2.5,3180,9400,2.0,0.0,4.0,5,10,2610,570,1985,0,98006,47.5617,-122.15799999999999,3760,9450,7,2,2014,UNK,-580,-50
7856400300,3/22/2015,1510000.0,2,2.5,3180,9400,2.0,0.0,4.0,5,10,2610,570,1985,0,98006,47.5617,-122.15799999999999,3760,9450,3,22,2015,UNK,-580,-50
7923700330,5/28/2014,510000.0,4,1.5,2040,8800,1.0,0.0,0.0,4,7,1020,1020,1961,0,98007,47.5965,-122.139,1490,8800,5,28,2014,UNK,550,0
5632500110,7/16/2014,351000.0,3,1.0,1160,10518,1.0,0.0,0.0,3,7,1160,0,1960,0,98028,47.7343,-122.22,1670,9380,7,16,2014,UNK,-510,1138
723049219,3/25/2015,210000.0,3,1.0,880,10800,1.0,0.0,0.0,3,6,880,0,1942,0,98146,47.4949,-122.338,1100,8820,3,25,2015,UNK,-220,1980
2320069111,5/7/2015,449999.0,4,1.75,2290,36900,1.5,0.0,2.0,5,7,1690,600,1938,0,98022,47.2034,-122.00299999999999,2170,12434,5,7,2015,UNK,120,24466
7972604345,5/19/2014,137000.0,3,1.0,950,7620,1.0,0.0,0.0,3,6,950,0,1954,0,98106,47.5178,-122.346,1260,7620,5,19,2014,UNK,-310,0
3222069156,12/17/2014,270000.0,3,1.0,1010,14510,1.0,0.0,0.0,5,7,1010,0,1974,0,98042,47.3437,-122.07799999999999,2020,44866,12,17,2014,UNK,-1010,-30356
1722069097,12/29/2014,540000.0,3,2.5,3100,100188,1.0,0.0,0.0,4,7,1820,0,1981,0,98038,47.3928,-122.066,2430,104979,12,29,2014,UNK,670,-4791
4022905473,12/5/2014,565000.0,5,3.0,2560,12480,1.0,0.0,0.0,3,8,1590,970,2012,0,98155,47.7657,-122.28399999999999,2500,17299,12,5,2014,N,60,-4819
5318101695,4/9/2015,940000.0,4,1.5,2430,3600,2.5,0.0,0.0,3,8,2430,0,1980,0,98112,47.6351,-122.285,2020,4800,4,9,2015,UNK,410,-1200
5216200090,6/16/2014,385000.0,2,1.0,830,26329,1.0,1.0,3.0,4,6,830,0,1928,0,98070,47.4012,-122.425,2030,27338,6,16,2014,UNK,-1200,-1009
9526500090,8/22/2014,400000.0,3,3.0,2090,7634,1.0,0.0,0.0,3,8,1450,640,2001,0,98019,47.7408,-121.97399999999999,2090,9600,8,22,2014,UNK,0,-1966
423059039,3/21/2015,365000.0,3,2.0,2030,8649,1.0,0.0,0.0,3,7,2030,0,1998,0,98056,47.5082,-122.166,1760,7200,3,21,2015,UNK,270,1449
6909700437,5/22/2014,353250.0,2,1.0,1060,1600,2.0,0.0,0.0,3,7,1060,0,1979,0,98144,47.5888,-122.294,1360,3360,5,22,2014,UNK,-300,-1760
1205000215,4/29/2015,455000.0,2,1.5,1090,6750,1.0,0.0,0.0,3,7,950,140,1942,0,98117,47.6836,-122.397,1640,6750,4,29,2015,UNK,-550,0
3223039229,5/27/2014,475000.0,4,3.5,3400,234352,2.0,0.0,0.0,3,8,2500,900,1991,0,98070,47.4335,-122.449,1300,39639,5,27,2014,UNK,2100,194713
4077800474,11/24/2014,571500.0,4,1.75,1920,7455,1.0,0.0,0.0,4,7,960,960,1939,1964,98125,47.7106,-122.286,1920,7455,11,24,2014,Y,0,0
1604600227,3/28/2015,441000.0,2,1.0,1150,3000,1.0,0.0,0.0,3,6,780,370,1915,0,98118,47.5624,-122.291,1150,5000,3,28,2015,UNK,0,-2000
9542200220,2/13/2015,810000.0,6,2.75,3970,9500,1.0,0.0,0.0,4,10,2180,0,1970,0,98005,47.5956,-122.178,2490,9775,2,13,2015,UNK,1480,-275
6600220490,4/9/2015,550000.0,3,2.25,1880,11556,2.0,0.0,0.0,3,8,1880,0,1987,0,98074,47.6283,-122.03200000000001,1880,12000,4,9,2015,UNK,0,-444
2138700141,7/2/2014,736000.0,2,1.0,1500,4000,1.0,0.0,0.0,3,8,1100,400,1933,0,98109,47.6409,-122.353,1980,4000,7,2,2014,UNK,-480,0
4046600820,2/24/2015,375000.0,3,1.75,2190,17550,1.0,0.0,0.0,3,7,2190,0,1989,0,98014,47.6984,-121.912,1700,17550,2,24,2015,UNK,490,0
9430100360,2/5/2015,717500.0,3,2.5,2530,9932,2.0,0.0,0.0,3,8,2530,0,1995,0,98052,47.6853,-122.16,2140,7950,2,5,2015,UNK,390,1982
2447500015,11/21/2014,581000.0,2,1.75,1930,11200,1.0,0.0,2.0,3,8,1430,500,1951,0,98177,47.7576,-122.37,2840,12408,11,21,2014,UNK,-910,-1208
1524039043,7/25/2014,629000.0,3,2.0,1510,4560,2.0,0.0,0.0,4,7,1510,0,1909,1995,98116,47.5689,-122.40799999999999,1990,5000,7,25,2014,Y,-480,-440
2303900100,9/11/2014,3800000.0,3,4.25,5510,35000,2.0,0.0,4.0,3,13,4910,600,1997,0,98177,47.7296,-122.37,3430,45302,9,11,2014,UNK,2080,-10302
8651400230,12/8/2014,225000.0,3,2.0,1100,5200,1.0,0.0,0.0,3,6,1100,0,1969,2014,98042,47.3606,-122.083,1050,5330,12,8,2014,Y,50,-130
7437100210,6/18/2014,315000.0,3,2.5,1730,6368,2.0,0.0,0.0,3,7,1730,0,1993,0,98038,47.3505,-122.03200000000001,1780,6597,6,18,2014,UNK,-50,-229
3630020150,3/10/2015,425000.0,3,2.5,1480,1386,3.0,0.0,0.0,3,8,1480,0,2005,0,98029,47.5468,-121.99799999999999,1470,1593,3,10,2015,N,10,-207
1773600691,6/25/2014,346500.0,3,1.0,1150,11802,1.0,0.0,0.0,4,7,1150,0,1932,1958,98106,47.5624,-122.361,1880,6082,6,25,2014,Y,-730,5720
5448300150,1/5/2015,550000.0,3,2.25,1950,26500,1.0,0.0,0.0,4,8,1570,380,1965,0,98006,47.5784,-122.179,2160,12751,1,5,2015,UNK,-210,13749
2260000210,2/9/2015,565000.0,3,1.75,2380,10450,1.0,0.0,0.0,3,8,1400,980,1977,0,98052,47.6409,-122.111,2150,9600,2,9,2015,UNK,230,850
6815100085,12/24/2014,1000000.0,4,2.0,3100,8000,1.5,0.0,0.0,5,7,2040,1060,1939,0,98103,47.6852,-122.329,1650,4000,12,24,2014,UNK,1450,4000
5141000720,8/5/2014,400000.0,2,2.0,2010,3797,1.5,0.0,0.0,3,7,1450,560,1922,2004,98108,47.5596,-122.315,1660,4650,8,5,2014,Y,350,-853
9276200455,11/21/2014,724950.0,4,2.0,2270,5760,2.0,0.0,0.0,4,8,2270,0,1909,0,98116,47.5809,-122.39,1420,5760,11,21,2014,UNK,850,0
5459500165,7/8/2014,623000.0,3,1.75,2050,16313,1.0,0.0,0.0,2,8,2050,0,1973,0,98040,47.5743,-122.212,3180,10264,7,8,2014,UNK,-1130,6049
9828701295,6/24/2014,295000.0,2,1.0,650,5400,1.0,0.0,0.0,3,6,650,0,1950,0,98122,47.6185,-122.295,1310,4906,6,24,2014,UNK,-660,494
164000261,5/21/2014,700000.0,4,3.25,2780,7875,2.0,0.0,0.0,3,9,2780,0,2006,0,98133,47.7294,-122.352,1000,7500,5,21,2014,N,1780,375
2767704682,4/8/2015,482000.0,2,1.5,1300,1229,2.0,0.0,0.0,3,8,1160,140,2000,0,98107,47.6727,-122.375,1430,1255,4,8,2015,UNK,-130,-26
6791050450,8/21/2014,770000.0,3,2.5,2730,11380,2.0,0.0,0.0,3,10,2730,0,1995,0,98075,47.58,-122.057,2800,10070,8,21,2014,UNK,-70,1310
1221039066,10/17/2014,310000.0,4,2.5,3140,22100,1.0,0.0,0.0,4,8,1820,1320,1960,0,98023,47.318999999999996,-122.36200000000001,2700,25500,10,17,2014,UNK,440,-3400
686300450,7/8/2014,720000.0,4,2.25,2410,8400,2.0,0.0,0.0,5,8,2410,0,1965,0,98008,47.62600000000001,-122.119,1910,8056,7,8,2014,UNK,500,344
3822200087,3/19/2015,355000.0,3,1.0,1180,5965,1.5,0.0,0.0,4,6,1180,0,1928,0,98125,47.7281,-122.29899999999999,1270,7710,3,19,2015,UNK,-90,-1745
6669250100,7/29/2014,512000.0,4,2.5,2600,4506,2.0,0.0,0.0,3,9,2600,0,2005,0,98056,47.5146,-122.18799999999999,2470,6041,7,29,2014,N,130,-1535
1453602310,12/16/2014,303000.0,2,1.5,1400,1650,3.0,0.0,0.0,3,7,1400,0,1999,0,98125,47.7222,-122.29,1430,1650,12,16,2014,UNK,-30,0
984200690,6/18/2014,299000.0,5,2.5,2220,9360,1.0,0.0,0.0,4,7,1110,1110,1968,0,98058,47.4341,-122.169,1780,7704,6,18,2014,UNK,440,1656
5468770180,6/23/2014,285000.0,3,2.5,1660,6263,2.0,0.0,0.0,3,8,1660,0,2003,0,98042,47.3507,-122.141,2190,6192,6,23,2014,UNK,-530,71
5459500100,9/24/2014,680000.0,3,1.75,2330,9652,1.0,0.0,0.0,4,8,1590,740,1968,0,98040,47.5714,-122.211,2420,9631,9,24,2014,UNK,-90,21
2968801605,9/2/2014,285000.0,4,1.75,1440,6720,1.0,0.0,0.0,5,6,720,720,1954,0,98166,47.4571,-122.345,1820,6784,9,2,2014,UNK,-380,-64
2141310580,11/25/2014,707000.0,4,2.25,2920,17023,1.0,0.0,0.0,4,9,1690,1230,1977,0,98006,47.5585,-122.134,2710,10681,11,25,2014,UNK,210,6342
2325039067,5/7/2014,690000.0,3,2.0,1760,6428,1.0,0.0,0.0,4,7,980,780,1942,0,98199,47.6388,-122.397,1760,6004,5,7,2014,UNK,0,424
2426059103,4/22/2015,872000.0,4,2.25,2860,40284,2.0,0.0,0.0,3,10,2860,0,1983,0,98072,47.7308,-122.115,2670,92782,4,22,2015,UNK,190,-52498
3541600450,11/4/2014,290000.0,4,1.75,2090,12750,1.0,0.0,0.0,3,8,1360,730,1967,0,98166,47.4792,-122.35700000000001,2040,12300,11,4,2014,UNK,50,450
5631501161,4/17/2015,425000.0,4,1.75,1910,16785,1.0,0.0,0.0,4,7,1110,0,1981,0,98028,47.7474,-122.235,1590,9900,4,17,2015,UNK,320,6885
3224510300,1/26/2015,925000.0,3,2.75,3280,10558,1.0,0.0,2.0,4,9,2040,1240,1979,0,98006,47.5606,-122.133,3150,9998,1,26,2015,UNK,130,560
4027700466,12/19/2014,340500.0,3,1.0,1770,12458,1.0,0.0,0.0,3,7,1770,0,1957,0,98155,47.7715,-122.27,2000,8225,12,19,2014,UNK,-230,4233
1702901500,11/21/2014,365000.0,2,1.0,920,6600,1.0,0.0,0.0,4,6,920,0,1910,0,98118,47.5572,-122.28200000000001,1370,5500,11,21,2014,UNK,-450,1100
8146300205,7/10/2014,725000.0,3,1.75,1690,8489,1.0,0.0,0.0,4,7,1690,0,1959,0,98004,47.6079,-122.19200000000001,1850,8536,7,10,2014,UNK,-160,-47
3526039019,7/2/2014,811000.0,3,3.0,2470,7410,2.0,0.0,0.0,5,8,1860,610,1977,0,98117,47.6937,-122.39200000000001,2390,7800,7,2,2014,UNK,80,-390
5230300210,12/10/2014,299000.0,3,1.0,1040,9514,1.0,0.0,0.0,4,7,1040,0,1969,0,98059,47.4936,-122.102,1040,9514,12,10,2014,UNK,0,0
7907600100,4/21/2015,287500.0,4,2.0,1220,9147,1.0,0.0,0.0,5,7,1220,0,1953,0,98146,47.5011,-122.336,1220,8576,4,21,2015,UNK,0,571
9322800210,5/20/2014,879950.0,4,2.25,3500,13875,1.0,0.0,4.0,4,9,1830,1670,1938,0,98146,47.5083,-122.38799999999999,2960,15000,5,20,2014,UNK,540,-1125
3352400661,11/10/2014,135900.0,2,1.0,760,3800,1.0,0.0,0.0,3,6,760,0,1950,0,98178,47.5019,-122.26899999999999,1220,7410,11,10,2014,UNK,-460,-3610
3625710100,5/12/2014,1230000.0,4,2.25,3070,16028,1.0,0.0,3.0,3,9,1870,1200,1976,0,98040,47.5271,-122.228,3070,19822,5,12,2014,UNK,0,-3794
3626039207,10/17/2014,522500.0,4,1.75,2100,6480,1.0,0.0,0.0,5,7,1300,800,1947,0,98177,47.7049,-122.359,1840,7500,10,17,2014,UNK,260,-1020
7568700215,3/12/2015,399500.0,4,1.5,1660,6617,1.0,0.0,0.0,5,7,1660,0,1947,0,98155,47.739,-122.323,950,7440,3,12,2015,UNK,710,-823
1604600540,5/4/2015,450000.0,3,1.0,1430,5960,1.5,0.0,0.0,4,7,1430,0,1917,0,98118,47.562,-122.289,1140,3960,5,4,2015,UNK,290,2000
1421039067,10/27/2014,218000.0,4,1.0,1620,17500,1.0,0.0,0.0,3,7,1620,0,1962,0,98023,47.3021,-122.38799999999999,2400,17394,10,27,2014,UNK,-780,106
7137970210,3/27/2015,289999.0,3,2.0,1490,9285,1.0,0.0,0.0,3,8,1490,0,1995,0,98092,47.3248,-122.169,2040,6681,3,27,2015,UNK,-550,2604
2767603255,2/24/2015,540000.0,2,1.0,1170,4750,1.0,0.0,0.0,3,6,1170,0,1903,0,98107,47.6729,-122.37799999999999,1170,2023,2,24,2015,UNK,0,2727
3575303700,7/25/2014,324950.0,3,1.0,1240,7500,1.0,0.0,0.0,4,7,1240,0,1976,0,98074,47.6199,-122.06200000000001,1240,9750,7,25,2014,UNK,0,-2250
1702901340,6/13/2014,718500.0,3,2.0,2910,6600,2.0,0.0,0.0,4,7,1920,990,1900,0,98118,47.5576,-122.281,1370,5500,6,13,2014,UNK,1540,1100
2320069014,7/9/2014,495000.0,3,2.0,2660,192099,1.0,0.0,0.0,4,9,2660,0,1964,0,98022,47.2098,-122.016,2570,43561,7,9,2014,UNK,90,148538
3141600600,5/21/2014,260000.0,6,2.0,2220,8797,1.0,0.0,0.0,3,7,2220,0,1977,0,98002,47.2977,-122.227,1170,5123,5,21,2014,UNK,1050,3674
2201501015,5/2/2014,430000.0,4,1.5,1920,10000,1.0,0.0,0.0,4,7,1070,850,1954,0,98006,47.5725,-122.133,1450,10836,5,2,2014,UNK,470,-836
3782760040,6/3/2014,402500.0,3,3.25,2780,4002,2.0,0.0,0.0,3,8,2780,0,2009,0,98019,47.7348,-121.96600000000001,1890,4090,6,3,2014,N,890,-88
6613001241,8/11/2014,1420000.0,4,3.0,3110,4408,2.5,0.0,3.0,4,10,2510,600,1931,0,98105,47.6583,-122.27,3250,5669,8,11,2014,UNK,-140,-1261
3276980120,10/28/2014,275000.0,3,2.25,1820,9766,1.0,0.0,0.0,4,7,1450,370,1987,0,98031,47.397,-122.20299999999999,1860,8236,10,28,2014,UNK,-40,1530
1321400650,6/3/2014,250000.0,3,2.25,1765,7652,2.0,0.0,0.0,3,7,1765,0,1996,0,98003,47.3072,-122.32799999999999,1765,7719,6,3,2014,UNK,0,-67
643300180,5/23/2014,665000.0,3,2.75,1800,9550,1.0,0.0,0.0,4,7,1320,480,1966,0,98006,47.5679,-122.178,1890,9902,5,23,2014,UNK,-90,-352
322059210,2/3/2015,425000.0,3,2.5,2650,144183,1.0,0.0,0.0,3,8,2650,0,1967,0,98042,47.4212,-122.14399999999999,1940,41210,2,3,2015,UNK,710,102973
9551201560,7/22/2014,760000.0,2,1.0,1410,3600,1.5,0.0,0.0,4,7,1310,100,1925,0,98103,47.6695,-122.338,1740,4200,7,22,2014,UNK,-330,-600
7202330330,8/14/2014,447000.0,3,2.5,1650,3076,2.0,0.0,0.0,3,7,1650,0,2003,0,98053,47.681999999999995,-122.035,1560,3064,8,14,2014,UNK,90,12
5153900150,7/8/2014,205000.0,3,1.0,1180,8240,1.0,0.0,0.0,4,7,1180,0,1967,0,98003,47.3325,-122.321,1180,7840,7,8,2014,UNK,0,400
1788700230,5/6/2014,191000.0,3,1.5,800,8850,1.0,0.0,0.0,4,6,800,0,1959,0,98023,47.3266,-122.348,820,8775,5,6,2014,UNK,-20,75
49000051,3/16/2015,350000.0,2,1.75,1430,7921,1.0,0.0,0.0,3,7,1430,0,1983,0,98146,47.5088,-122.37100000000001,1290,8040,3,16,2015,UNK,140,-119
3343301393,3/30/2015,789888.0,5,3.5,3300,7860,2.0,0.0,0.0,3,9,2410,890,2001,0,98006,47.5463,-122.19200000000001,2540,9920,3,30,2015,UNK,760,-2060
2832100215,3/23/2015,443000.0,2,1.0,1220,10170,1.0,0.0,0.0,3,7,980,240,1948,0,98125,47.7297,-122.32700000000001,1990,9064,3,23,2015,UNK,-770,1106
1980200015,9/29/2014,695000.0,4,3.5,3530,7202,2.0,0.0,0.0,3,9,2660,870,2000,0,98177,47.7339,-122.36,2810,8100,9,29,2014,UNK,720,-898
1825049013,2/13/2015,560000.0,4,2.0,1380,4048,1.5,0.0,0.0,4,7,1380,0,1906,0,98103,47.6583,-122.344,1440,3956,2,13,2015,UNK,-60,92
7550800015,7/14/2014,550000.0,3,1.75,1410,5000,1.0,0.0,0.0,4,7,810,600,1923,0,98107,47.6727,-122.395,1760,5000,7,14,2014,UNK,-350,0
8682230760,7/24/2014,850000.0,2,2.5,3360,6750,2.0,0.0,0.0,3,9,3360,0,2004,0,98053,47.7112,-122.03299999999999,2510,6750,7,24,2014,N,850,0
8645511500,4/20/2015,352750.0,4,2.75,2270,24237,1.0,0.0,0.0,4,7,1360,910,1977,0,98058,47.4672,-122.175,2050,8016,4,20,2015,UNK,220,16221
8567450220,8/18/2014,550000.0,4,2.5,2890,9045,2.0,0.0,0.0,3,8,2890,0,2001,0,98019,47.7385,-121.965,2840,10114,8,18,2014,UNK,50,-1069
1556200205,11/18/2014,774900.0,5,1.0,1750,3861,1.5,0.0,0.0,3,7,1750,0,1903,0,98122,47.6075,-122.295,1700,4255,11,18,2014,UNK,50,-394
9476200580,7/10/2014,250000.0,3,1.0,1010,8711,1.0,0.0,0.0,5,6,1010,0,1944,0,98056,47.4914,-122.186,1250,8053,7,10,2014,UNK,-240,658
8965410150,8/25/2014,962800.0,4,2.5,3780,23623,2.0,0.0,0.0,3,9,3780,0,1997,0,98006,47.559,-122.118,3370,10210,8,25,2014,UNK,410,13413
5031300011,11/4/2014,299500.0,3,1.75,1880,11700,1.0,0.0,0.0,4,7,1880,0,1968,0,98092,47.3213,-122.18700000000001,2230,35200,11,4,2014,UNK,-350,-23500
5101408735,11/3/2014,250000.0,2,1.0,800,5220,1.0,0.0,0.0,3,6,800,0,1943,0,98125,47.7037,-122.32,1910,5376,11,3,2014,UNK,-1110,-156
2623069010,1/16/2015,745000.0,5,4.0,4720,493534,2.0,0.0,0.0,5,9,3960,760,1975,0,98027,47.4536,-122.009,2160,219542,1,16,2015,UNK,2560,273992
2624089040,2/17/2015,279475.0,2,1.0,1060,10600,1.5,0.0,0.0,3,6,1060,0,1968,0,98065,47.5375,-121.742,1560,21344,2,17,2015,UNK,-500,-10744
3345700165,12/2/2014,450000.0,3,2.25,2530,27227,2.0,0.0,0.0,3,8,2530,0,1987,0,98056,47.527,-122.193,2160,30192,12,2,2014,UNK,370,-2965
379000051,8/26/2014,307700.0,5,2.25,1980,13132,1.0,0.0,0.0,4,7,1260,720,1962,0,98198,47.3984,-122.301,1880,11325,8,26,2014,UNK,100,1807
871000155,12/11/2014,665000.0,3,1.0,1650,5102,1.0,0.0,0.0,4,8,1300,350,1953,0,98199,47.6524,-122.404,1440,5102,12,11,2014,UNK,210,0
7852020580,7/24/2014,375000.0,3,2.75,1890,3930,2.0,0.0,0.0,3,8,1890,0,1999,0,98065,47.5337,-121.867,2100,4259,7,24,2014,UNK,-210,-329
7298050110,3/3/2015,420000.0,4,2.5,3360,11637,2.0,0.0,0.0,3,11,3360,0,1990,0,98023,47.3018,-122.34200000000001,3530,11205,3,3,2015,UNK,-170,432
2114700615,7/8/2014,148000.0,2,1.0,630,4200,1.0,0.0,0.0,3,6,630,0,1930,0,98106,47.5329,-122.348,970,4200,7,8,2014,UNK,-340,0
809001965,7/29/2014,707000.0,3,1.5,1980,4000,2.0,0.0,0.0,3,8,1980,0,1919,0,98109,47.6364,-122.351,1980,3600,7,29,2014,UNK,0,400
9557200090,11/12/2014,399000.0,3,1.0,990,4250,1.0,0.0,0.0,4,7,840,150,1924,0,98136,47.5392,-122.39,990,4500,11,12,2014,UNK,0,-250
5126210360,10/22/2014,570000.0,4,2.5,3420,115434,2.0,0.0,0.0,3,9,3420,0,1989,0,98038,47.3932,-121.988,3250,111513,10,22,2014,UNK,170,3921
3528000210,3/23/2015,853000.0,4,2.25,3440,35025,2.0,0.0,0.0,3,10,3440,0,1988,0,98053,47.6674,-122.055,3210,35005,3,23,2015,UNK,230,20
424059052,12/22/2014,400000.0,3,1.0,1300,14138,1.0,0.0,0.0,4,7,1300,0,1943,0,98005,47.593,-122.165,2440,12196,12,22,2014,UNK,-1140,1942
594000115,5/12/2014,615000.0,2,1.75,2040,28593,1.5,1.0,3.0,4,7,2040,0,1919,1990,98070,47.3979,-122.465,2040,35124,5,12,2014,Y,0,-6531
2207100740,1/6/2015,463000.0,3,1.0,1250,7700,1.0,0.0,0.0,4,7,1250,0,1955,0,98007,47.5974,-122.149,1520,7700,1,6,2015,UNK,-270,0
7784000100,6/3/2014,600000.0,4,2.5,1960,14242,1.0,0.0,1.0,4,8,1290,670,1958,0,98146,47.4947,-122.369,2490,10907,6,3,2014,UNK,-530,3335
3732800495,10/28/2014,429000.0,5,2.5,2720,8120,1.0,0.0,0.0,3,7,1360,1360,1970,0,98108,47.556999999999995,-122.30799999999999,2020,8120,10,28,2014,UNK,700,0
2025059131,9/4/2014,980000.0,4,4.25,3250,11780,2.0,0.0,0.0,3,8,2360,890,1944,2001,98004,47.6322,-122.20299999999999,1800,9000,9,4,2014,Y,1450,2780
6699000740,4/21/2015,359500.0,6,3.75,3190,4700,2.0,0.0,0.0,3,8,3190,0,2003,0,98042,47.3724,-122.105,2680,5640,4,21,2015,UNK,510,-940
8651610580,11/7/2014,715000.0,4,2.5,2570,7980,2.0,0.0,0.0,3,9,2570,0,1998,0,98074,47.6378,-122.065,2760,6866,11,7,2014,UNK,-190,1114
5412300100,3/25/2015,240000.0,3,1.75,1420,6984,1.0,0.0,0.0,4,7,980,440,1980,0,98030,47.3748,-122.18,1430,7875,3,25,2015,UNK,-10,-891
8096600100,12/15/2014,455000.0,4,2.0,2120,9442,1.0,0.0,0.0,5,7,1060,1060,1968,0,98011,47.7675,-122.226,1290,9600,12,15,2014,UNK,830,-158
722079015,10/17/2014,610000.0,3,2.5,2080,167270,1.0,0.0,0.0,3,7,2080,0,2000,0,98038,47.4032,-121.963,2080,55321,10,17,2014,UNK,0,111949
339350150,3/11/2015,675000.0,3,2.75,2740,5735,2.0,0.0,0.0,3,9,2740,0,2004,0,98052,47.6862,-122.09299999999999,2210,5026,3,11,2015,N,530,709
2560805440,1/29/2015,283500.0,3,1.75,1250,5375,1.0,0.0,0.0,3,7,1250,0,1985,0,98198,47.3787,-122.323,1320,6258,1,29,2015,UNK,-70,-883
7131300047,8/26/2014,235000.0,2,1.0,2150,4500,1.5,0.0,0.0,3,7,1260,890,1917,0,98118,47.5158,-122.26700000000001,1590,5010,8,26,2014,UNK,560,-510
3459600180,6/26/2014,827000.0,4,2.5,3230,12100,1.0,0.0,0.0,3,9,1870,1360,1977,0,98006,47.562,-122.146,2670,10200,6,26,2014,UNK,560,1900
7663700663,9/10/2014,353000.0,2,1.0,860,8511,1.0,0.0,0.0,3,7,860,0,1949,0,98125,47.7312,-122.3,1554,8499,9,10,2014,UNK,-694,12
5415350770,9/23/2014,747500.0,4,2.5,2810,11902,2.0,0.0,0.0,4,9,2810,0,1993,0,98059,47.5303,-122.14299999999999,2990,10754,9,23,2014,UNK,-180,1148
3083000940,4/12/2015,341000.0,2,1.0,1040,4000,1.0,0.0,0.0,3,6,1040,0,1914,0,98144,47.5753,-122.303,1740,4000,4,12,2015,UNK,-700,0
1670400090,11/24/2014,182000.0,3,1.0,1160,18055,1.0,0.0,0.0,2,5,1160,0,1950,0,98168,47.4772,-122.26899999999999,1340,10324,11,24,2014,UNK,-180,7731
2781250610,12/2/2014,250000.0,3,2.0,1470,2781,2.0,0.0,0.0,3,6,1470,0,2003,0,98038,47.349,-122.024,1360,3008,12,2,2014,UNK,110,-227
3764500090,5/21/2014,655000.0,4,3.5,2350,13402,2.0,0.0,3.0,3,8,1670,680,1994,0,98033,47.6947,-122.19,2250,9474,5,21,2014,UNK,100,3928
7401000040,5/7/2014,405000.0,3,2.25,1660,8307,1.0,0.0,0.0,4,8,1660,0,1961,0,98133,47.7575,-122.352,2510,7800,5,7,2014,UNK,-850,507
4323700230,8/18/2014,390000.0,4,1.75,2020,9750,1.0,0.0,0.0,3,7,1100,920,1975,0,98074,47.6192,-122.055,1670,9600,8,18,2014,UNK,350,150
3500100047,10/8/2014,275400.0,2,1.0,890,8180,1.0,0.0,0.0,3,7,890,0,1947,0,98155,47.736999999999995,-122.3,1130,8180,10,8,2014,UNK,-240,0
3885807362,6/4/2014,791000.0,3,2.25,2430,5500,2.0,0.0,0.0,3,8,1810,620,1989,0,98033,47.6812,-122.196,2040,5500,6,4,2014,UNK,390,0
7199340650,5/8/2014,424500.0,3,1.75,1460,7700,1.0,0.0,0.0,3,7,1460,0,1979,0,98052,47.6981,-122.12700000000001,1720,7280,5,8,2014,UNK,-260,420
5014000120,6/17/2014,430000.0,3,1.0,980,7200,1.0,0.0,0.0,4,7,980,0,1950,0,98116,47.5718,-122.395,1180,6572,6,17,2014,UNK,-200,628
3758900037,5/5/2015,865000.0,4,2.5,2580,10631,2.0,0.0,2.0,4,9,2580,0,1992,0,98033,47.6993,-122.206,4220,10631,5,5,2015,UNK,-1640,0
2724201202,3/4/2015,163000.0,2,2.0,1250,7543,1.0,0.0,0.0,3,7,1250,0,1962,0,98198,47.4051,-122.296,1250,7506,3,4,2015,UNK,0,37
7855600730,9/8/2014,920000.0,4,2.75,3140,9085,1.0,0.0,2.0,5,8,1570,1570,1961,0,98006,47.5675,-122.16,2430,9350,9,8,2014,UNK,710,-265
7151700360,12/11/2014,1030000.0,5,3.25,2680,3011,2.0,0.0,0.0,3,9,1870,810,1910,0,98122,47.6115,-122.287,3440,5165,12,11,2014,UNK,-760,-2154
3811300090,7/24/2014,325000.0,3,1.75,1810,8048,1.0,0.0,0.0,4,7,1290,520,1983,0,98055,47.4484,-122.194,1550,9081,7,24,2014,UNK,260,-1033
538000450,6/3/2014,315000.0,5,2.5,2090,4698,2.0,0.0,0.0,3,7,2090,0,1998,0,98038,47.3538,-122.025,2070,4698,6,3,2014,UNK,20,0
6303400475,9/11/2014,227000.0,4,1.0,1120,8763,1.0,0.0,0.0,3,6,1120,0,1971,0,98146,47.508,-122.35799999999999,1120,8636,9,11,2014,UNK,0,127
3388110230,7/29/2014,179000.0,4,1.75,1790,7175,1.5,0.0,0.0,3,6,1410,380,1900,0,98168,47.4963,-122.318,1790,8417,7,29,2014,UNK,0,-1242
9834201215,10/9/2014,276000.0,2,1.0,870,2676,1.0,0.0,0.0,3,7,820,50,2004,0,98144,47.5702,-122.287,1500,1719,10,9,2014,N,-630,957
844000375,3/3/2015,335000.0,4,1.5,3160,19745,1.5,0.0,0.0,4,6,1840,1320,1968,0,98010,47.3103,-122.006,1540,8611,3,3,2015,UNK,1620,11134
3816700150,11/14/2014,430000.0,3,2.0,2350,12480,1.0,0.0,0.0,3,7,1600,750,1981,0,98028,47.7661,-122.262,2160,12000,11,14,2014,UNK,190,480
7237301210,11/18/2014,266490.0,3,2.5,1810,4113,2.0,0.0,0.0,3,7,1810,0,2004,0,98042,47.3715,-122.126,1880,4465,11,18,2014,N,-70,-352
130000175,8/6/2014,655000.0,4,2.75,3160,8197,1.0,0.0,0.0,3,8,1580,1580,1962,0,98115,47.7004,-122.287,2050,8197,8,6,2014,UNK,1110,0
9468200175,11/14/2014,635500.0,3,2.0,1660,3600,1.0,0.0,0.0,3,7,1000,660,1939,2006,98103,47.6789,-122.351,1700,4356,11,14,2014,Y,-40,-756
8643200061,6/26/2014,235000.0,5,2.5,2500,9583,1.0,0.0,0.0,3,7,1300,1200,1979,0,98198,47.3946,-122.31200000000001,2120,19352,6,26,2014,UNK,380,-9769
7805460760,4/27/2015,885000.0,3,2.5,2880,11443,2.0,0.0,0.0,4,9,2880,0,1986,0,98006,47.5633,-122.111,2840,12530,4,27,2015,UNK,40,-1087
6713700155,8/18/2014,352500.0,3,1.0,1470,8400,1.0,0.0,0.0,4,7,1470,0,1953,0,98133,47.7628,-122.354,1470,8400,8,18,2014,UNK,0,0
3236500220,7/9/2014,450000.0,3,2.5,1460,7573,2.0,0.0,0.0,3,8,1460,0,1983,0,98007,47.6012,-122.141,1910,7668,7,9,2014,UNK,-450,-95
3625049042,10/11/2014,3640000.0,5,6.0,5490,19897,2.0,0.0,0.0,3,12,5490,0,2005,0,98039,47.6165,-122.236,2910,17600,10,11,2014,N,2580,2297
7935000450,9/19/2014,1050000.0,3,2.25,2480,15022,1.0,0.0,4.0,3,9,1330,1150,1967,2003,98136,47.5497,-122.396,2500,8178,9,19,2014,Y,-20,6844
1324300018,11/21/2014,476000.0,2,2.25,1140,1332,3.0,0.0,0.0,3,8,1140,0,1999,0,98103,47.6543,-122.35600000000001,1140,1267,11,21,2014,UNK,0,65
4123820450,5/7/2014,375000.0,3,2.5,1830,13042,2.0,0.0,0.0,3,8,1830,0,1990,0,98038,47.3738,-122.042,1940,6996,5,7,2014,UNK,-110,6046
9325200120,9/9/2014,600600.0,4,3.5,3110,6829,2.0,0.0,0.0,3,8,3110,0,2014,0,98148,47.4349,-122.32799999999999,2910,7425,9,9,2014,N,200,-596
3918400097,11/17/2014,567000.0,4,1.75,2630,11213,1.0,0.0,2.0,4,8,1430,1200,1948,0,98177,47.7158,-122.366,2240,15186,11,17,2014,UNK,390,-3973
8126300410,7/25/2014,650000.0,4,1.75,2390,12000,1.0,0.0,0.0,3,8,1470,920,1979,0,98052,47.7061,-122.163,2110,12000,7,25,2014,UNK,280,0
7227800040,6/4/2014,190000.0,5,2.0,1750,10284,1.0,0.0,0.0,4,5,1750,0,1943,0,98056,47.5094,-122.182,1560,9010,6,4,2014,UNK,190,1274
1020069042,10/1/2014,858000.0,4,3.5,4370,422967,1.0,0.0,2.0,4,10,2580,1790,1978,0,98022,47.2332,-122.029,3260,422967,10,1,2014,UNK,1110,0
3213200245,1/15/2015,435500.0,1,1.75,1020,4512,1.0,0.0,0.0,3,7,770,250,1937,0,98115,47.6724,-122.266,1230,5029,1,15,2015,UNK,-210,-517
455000760,3/11/2015,685000.0,3,2.0,2500,6733,1.0,0.0,0.0,3,8,1770,730,1979,0,98107,47.6691,-122.36,1770,6343,3,11,2015,UNK,730,390
104510230,11/19/2014,252000.0,3,2.0,1540,7210,2.0,0.0,0.0,4,7,1540,0,1984,0,98023,47.3128,-122.351,1500,7210,11,19,2014,UNK,40,0
4140090110,9/12/2014,512500.0,4,2.25,2200,6900,2.0,0.0,0.0,4,8,2200,0,1975,0,98028,47.7682,-122.26100000000001,2400,6900,9,12,2014,UNK,-200,0
6072500490,8/1/2014,423800.0,3,2.5,1940,7415,2.0,0.0,0.0,3,8,1940,0,1965,0,98006,47.542,-122.176,1940,8425,8,1,2014,UNK,0,-1010
6705120100,5/4/2015,460000.0,3,2.25,1453,2225,2.0,0.0,0.0,4,8,1453,0,1986,0,98006,47.5429,-122.18799999999999,1860,2526,5,4,2015,UNK,-407,-301
3764390100,7/22/2014,434000.0,3,2.75,1830,3200,2.0,0.0,0.0,3,8,1830,0,1991,0,98034,47.7155,-122.21799999999999,2030,3331,7,22,2014,UNK,-200,-131
2988800011,4/14/2015,244000.0,3,1.0,2000,15900,1.0,0.0,0.0,3,6,1000,1000,1948,0,98178,47.4816,-122.23299999999999,1760,10500,4,14,2015,UNK,240,5400
1073100065,2/17/2015,348125.0,3,1.0,1400,8451,1.5,0.0,0.0,3,7,1400,0,1953,0,98133,47.7719,-122.337,1590,8433,2,17,2015,UNK,-190,18
1136100062,5/9/2014,585000.0,4,3.25,2400,29252,2.0,0.0,0.0,4,8,2400,0,1982,0,98072,47.743,-122.131,2280,45000,5,9,2014,UNK,120,-15748
3356402020,5/8/2014,230000.0,3,1.0,1390,16000,1.0,0.0,0.0,4,6,1390,0,1960,0,98001,47.2898,-122.251,1420,10000,5,8,2014,UNK,-30,6000
8039900180,8/5/2014,450000.0,3,2.0,1680,11250,1.0,0.0,0.0,4,8,1680,0,1967,0,98045,47.4861,-121.786,1760,12160,8,5,2014,UNK,-80,-910
4174600391,3/23/2015,393000.0,5,2.0,1820,5054,1.0,0.0,0.0,4,7,910,910,1970,0,98108,47.5547,-122.29899999999999,1180,5628,3,23,2015,UNK,640,-574
6865200981,12/21/2014,517000.0,2,1.0,1140,3750,1.0,0.0,0.0,4,7,1140,0,1925,0,98103,47.6619,-122.34299999999999,1660,4000,12,21,2014,UNK,-520,-250
1236900090,9/15/2014,400000.0,3,1.0,1060,12690,1.0,0.0,0.0,3,7,1060,0,1969,0,98033,47.6736,-122.167,1920,10200,9,15,2014,UNK,-860,2490
925069152,3/4/2015,890000.0,2,1.75,3050,50965,2.0,0.0,0.0,3,10,3050,0,1991,0,98053,47.6744,-122.05,3050,40107,3,4,2015,UNK,0,10858
9456200405,3/10/2015,205950.0,3,1.0,970,11963,1.0,0.0,0.0,4,6,970,0,1970,0,98198,47.3776,-122.315,1210,11963,3,10,2015,UNK,-240,0
2420069220,12/3/2014,209000.0,3,1.0,1320,3954,1.5,0.0,0.0,3,6,1320,0,1912,2014,98022,47.202,-121.994,1270,5184,12,3,2014,Y,50,-1230
6381501965,6/12/2014,430000.0,4,1.75,1890,6000,1.0,0.0,0.0,4,6,1110,780,1947,0,98125,47.7274,-122.305,1560,6356,6,12,2014,UNK,330,-356
9191201325,3/1/2015,534000.0,4,1.75,2040,2750,1.5,0.0,0.0,4,6,1260,780,1926,0,98105,47.6698,-122.3,1940,3750,3,1,2015,UNK,100,-1000
9547202245,6/27/2014,735000.0,4,3.0,2370,3672,1.5,0.0,0.0,5,7,1650,720,1916,0,98115,47.678000000000004,-122.311,2140,4182,6,27,2014,UNK,230,-510
1924069115,2/24/2015,873000.0,3,2.25,2720,54450,2.0,0.0,0.0,3,11,2720,0,1997,0,98027,47.5473,-122.09200000000001,3170,60548,2,24,2015,UNK,-450,-6098
8121200970,11/18/2014,475000.0,4,2.25,1970,7532,1.0,0.0,0.0,3,8,1390,580,1983,0,98052,47.7219,-122.109,1970,8248,11,18,2014,UNK,0,-716
323049176,5/30/2014,325000.0,3,1.75,2180,10230,1.0,0.0,0.0,4,7,1090,1090,1961,0,98118,47.5158,-122.281,2130,7200,5,30,2014,UNK,50,3030
826079047,8/14/2014,500000.0,3,2.25,2990,216057,2.0,0.0,0.0,3,9,2990,0,1994,0,98019,47.754,-121.94200000000001,2840,215622,8,14,2014,UNK,150,435
8078550610,1/20/2015,279000.0,4,2.75,2180,8475,1.0,0.0,0.0,4,7,1330,850,1987,0,98031,47.4045,-122.17399999999999,1500,7140,1,20,2015,UNK,680,1335
3904930530,4/14/2015,350000.0,3,2.0,1440,5469,1.0,0.0,0.0,3,8,1440,0,1988,0,98029,47.5753,-122.01700000000001,1980,6198,4,14,2015,UNK,-540,-729
7504020970,4/21/2015,660000.0,4,2.25,3180,13653,2.0,0.0,0.0,3,9,3180,0,1978,0,98074,47.6316,-122.05,2910,12350,4,21,2015,UNK,270,1303
8642600090,2/18/2015,324950.0,2,1.5,1643,14616,1.0,0.0,1.0,4,7,1643,0,1954,0,98198,47.3973,-122.31200000000001,2270,9940,2,18,2015,UNK,-627,4676
2239000011,1/27/2015,500000.0,4,2.0,1530,7816,1.0,0.0,0.0,3,7,1530,0,1955,0,98133,47.7309,-122.33200000000001,1480,7816,1,27,2015,UNK,50,0
9382200121,7/18/2014,187300.0,2,1.0,1310,7697,1.0,0.0,0.0,3,6,850,460,1950,0,98146,47.4982,-122.348,1270,6410,7,18,2014,UNK,40,1287
7942601475,5/20/2014,345600.0,5,3.5,2800,5120,2.5,0.0,0.0,3,9,2800,0,1903,2005,98122,47.6059,-122.31,1780,5120,5,20,2014,Y,1020,0
7375300100,11/24/2014,400000.0,3,1.5,1510,7642,1.0,0.0,0.0,3,7,1510,0,1959,0,98008,47.5978,-122.116,2180,8357,11,24,2014,UNK,-670,-715
7974200457,1/22/2015,935000.0,5,3.0,2700,5001,2.0,0.0,0.0,3,10,2700,0,2009,0,98115,47.6811,-122.288,1610,5191,1,22,2015,N,1090,-190
923059206,7/15/2014,374000.0,4,1.75,2220,15600,1.0,0.0,0.0,5,7,1140,1080,1963,0,98056,47.492,-122.166,1670,4800,7,15,2014,UNK,550,10800
782700150,6/9/2014,328000.0,3,1.75,1440,45302,2.0,0.0,0.0,3,7,1440,0,1977,0,98019,47.7078,-121.915,2080,49658,6,9,2014,UNK,-640,-4356
2144800146,8/26/2014,257500.0,3,2.0,1300,9334,1.0,0.0,0.0,5,7,1300,0,1981,0,98178,47.4865,-122.238,2210,9636,8,26,2014,UNK,-910,-302
1337800220,9/8/2014,1000000.0,4,2.5,2230,3600,2.0,0.0,0.0,5,8,1630,600,1906,0,98112,47.6304,-122.309,2410,4800,9,8,2014,UNK,-180,-1200
3530410081,6/26/2014,216500.0,2,1.75,1390,4482,1.0,0.0,0.0,4,8,1390,0,1980,0,98198,47.3785,-122.32,1390,4680,6,26,2014,UNK,0,-198
1525059198,5/21/2014,1190000.0,3,2.25,2760,40946,2.0,0.0,0.0,5,10,2760,0,1978,0,98005,47.6501,-122.164,3030,42253,5,21,2014,UNK,-270,-1307
8665000040,7/30/2014,360000.0,4,2.5,3200,7282,2.0,0.0,0.0,3,9,3200,0,2007,0,98188,47.4318,-122.286,3030,7290,7,30,2014,N,170,-8
5016001619,1/22/2015,699999.0,3,0.75,1240,4000,1.0,0.0,0.0,4,7,1240,0,1968,0,98112,47.6239,-122.29700000000001,1460,4000,1,22,2015,UNK,-220,0
826069184,10/2/2014,535000.0,3,2.5,1960,47044,2.0,0.0,0.0,4,8,1960,0,1978,0,98077,47.7573,-122.07,2020,29004,10,2,2014,UNK,-60,18040
123039147,3/19/2015,464950.0,3,2.0,2190,19800,1.0,0.0,0.0,3,7,2190,0,1994,0,98146,47.5106,-122.365,1640,9719,3,19,2015,UNK,550,10081
8089510150,12/2/2014,925000.0,4,2.5,3540,18168,2.0,0.0,0.0,3,10,3540,0,1996,0,98006,47.5441,-122.131,4130,11180,12,2,2014,UNK,-590,6988
8818400450,5/8/2014,930000.0,3,3.25,2640,4080,2.0,0.0,0.0,3,9,1840,800,1912,2000,98105,47.6636,-122.32600000000001,1990,4080,5,8,2014,Y,650,0
6324000115,9/22/2014,727500.0,3,2.0,2660,5000,1.5,0.0,3.0,3,8,1940,720,1910,0,98116,47.5829,-122.382,2270,5000,9,22,2014,UNK,390,0
1133000694,3/12/2015,325000.0,4,1.75,1670,9500,1.0,0.0,0.0,3,7,1670,0,1976,0,98125,47.7254,-122.31,1620,9500,3,12,2015,UNK,50,0
4441300325,9/5/2014,695000.0,3,3.25,3080,12100,2.0,0.0,0.0,3,8,2080,1000,1984,0,98117,47.695,-122.399,2100,6581,9,5,2014,UNK,980,5519
3288301010,6/25/2014,585000.0,4,2.75,2890,6825,1.0,0.0,0.0,3,8,1560,1330,1973,0,98034,47.733999999999995,-122.182,1900,10120,6,25,2014,UNK,990,-3295
8125200481,9/26/2014,319000.0,3,2.25,1800,9597,1.0,0.0,2.0,3,7,1200,600,1963,0,98188,47.4516,-122.26700000000001,1700,13502,9,26,2014,UNK,100,-3905
8857600540,1/6/2015,265000.0,6,2.5,2000,7650,1.5,0.0,0.0,4,7,1790,210,1960,0,98032,47.3841,-122.288,1710,7650,1,6,2015,UNK,290,0
1901600090,6/26/2014,359000.0,5,1.75,1940,6654,1.5,0.0,0.0,4,7,1940,0,1953,0,98166,47.4663,-122.359,2300,9500,6,26,2014,UNK,-360,-2846
1901600090,4/26/2015,390000.0,5,1.75,1940,6654,1.5,0.0,0.0,4,7,1940,0,1953,0,98166,47.4663,-122.359,2300,9500,4,26,2015,UNK,-360,-2846
9144300120,1/28/2015,374500.0,3,1.0,960,9531,1.0,0.0,0.0,5,7,960,0,1969,0,98072,47.7619,-122.162,1670,9250,1,28,2015,UNK,-710,281
3401700031,8/22/2014,661000.0,2,1.5,1750,46173,2.0,0.0,0.0,4,8,1750,0,1964,0,98072,47.7397,-122.126,2220,42224,8,22,2014,UNK,-470,3949
5332200375,12/3/2014,900000.0,3,2.5,2320,5000,2.0,0.0,0.0,3,8,1620,700,1907,1993,98112,47.6278,-122.292,2160,5000,12,3,2014,Y,160,0
8582400015,4/13/2015,600000.0,5,2.5,2380,8204,1.0,0.0,0.0,3,8,1540,840,1957,0,98115,47.7,-122.287,2270,8204,4,13,2015,UNK,110,0
4131900042,5/16/2014,2000000.0,5,4.25,6490,10862,2.0,0.0,3.0,4,11,3940,2550,1991,0,98040,47.5728,-122.205,3290,14080,5,16,2014,UNK,3200,-3218
3964400120,5/8/2015,512500.0,4,1.75,1620,4240,1.5,0.0,0.0,5,7,1620,0,1916,0,98144,47.5746,-122.311,1450,4240,5,8,2015,UNK,170,0
2212600040,6/4/2014,229500.0,3,1.75,1770,33224,1.0,0.0,0.0,4,8,1770,0,1968,0,98092,47.3377,-122.194,1690,22069,6,4,2014,UNK,80,11155
8562750300,7/31/2014,589000.0,3,2.5,2320,5663,2.0,0.0,0.0,3,8,2320,0,2003,0,98027,47.538999999999994,-122.07,2500,4500,7,31,2014,UNK,-180,1163
2705600067,3/23/2015,539950.0,3,2.5,1330,2183,3.0,0.0,0.0,3,8,1330,0,2014,0,98117,47.6987,-122.365,1310,5000,3,23,2015,N,20,-2817
3023049143,10/20/2014,640000.0,4,2.5,3420,21344,2.0,0.0,0.0,3,9,3420,0,2002,0,98166,47.45,-122.334,2110,21344,10,20,2014,UNK,1310,0
8944300110,1/8/2015,218250.0,3,1.0,1270,7344,1.0,0.0,0.0,3,7,970,300,1967,0,98023,47.305,-122.37100000000001,1290,7300,1,8,2015,UNK,-20,44
7277100395,2/25/2015,675000.0,4,3.5,2550,3600,2.0,0.0,2.0,3,8,1880,670,1997,0,98177,47.7709,-122.39,2090,6000,2,25,2015,UNK,460,-2400
9407001830,7/17/2014,338000.0,5,2.0,1860,9000,2.0,0.0,0.0,3,7,1860,0,1980,0,98045,47.4484,-121.772,1390,9752,7,17,2014,UNK,470,-752
4406000620,3/31/2015,231750.0,3,1.0,1020,7615,1.0,0.0,0.0,3,7,1020,0,1981,0,98058,47.4292,-122.152,1470,9515,3,31,2015,UNK,-450,-1900
2414600366,11/14/2014,199900.0,1,1.0,720,7140,1.0,0.0,0.0,3,6,720,0,1930,0,98146,47.5119,-122.339,1140,7577,11,14,2014,UNK,-420,-437
98000870,10/1/2014,1060000.0,4,3.5,4460,16271,2.0,0.0,2.0,3,11,4460,0,2001,0,98075,47.5862,-121.97,4540,17122,10,1,2014,UNK,-80,-851
9211500230,10/2/2014,263000.0,4,2.75,1830,7315,1.0,0.0,0.0,5,7,1250,580,1979,0,98023,47.2989,-122.38,1730,7208,10,2,2014,UNK,100,107
3600600065,8/20/2014,279950.0,3,1.5,1520,7200,1.0,0.0,0.0,4,7,1160,360,1990,0,98198,47.3855,-122.302,1460,7200,8,20,2014,UNK,60,0
7177300090,5/20/2014,395000.0,3,1.5,1080,2940,1.5,0.0,0.0,4,7,1080,0,1920,0,98115,47.6832,-122.304,1400,4930,5,20,2014,UNK,-320,-1990
6664900410,6/26/2014,252500.0,3,2.0,1900,8002,1.0,0.0,0.0,3,7,1900,0,1991,0,98023,47.2909,-122.352,1900,6086,6,26,2014,UNK,0,1916
1853000530,3/12/2015,1150000.0,4,3.75,5300,37034,2.0,0.0,0.0,3,11,5300,0,1989,0,98077,47.7283,-122.07600000000001,3730,37034,3,12,2015,UNK,1570,0
3751604653,8/26/2014,205000.0,3,1.0,1370,10708,1.0,0.0,0.0,3,7,1370,0,1969,0,98001,47.2769,-122.264,1770,14482,8,26,2014,UNK,-400,-3774
8563001130,8/28/2014,654000.0,5,2.5,2960,8968,1.0,0.0,0.0,4,8,1640,1320,1965,0,98008,47.6233,-122.102,1890,9077,8,28,2014,UNK,1070,-109
1324079029,3/17/2015,200000.0,3,1.0,960,213008,1.0,0.0,0.0,2,6,960,0,1933,0,98024,47.5621,-121.86200000000001,1520,57499,3,17,2015,UNK,-560,155509
1236300214,7/22/2014,700000.0,3,2.5,2190,7982,2.0,0.0,0.0,3,8,2190,0,2004,0,98033,47.6869,-122.18700000000001,2090,8888,7,22,2014,N,100,-906
2525049086,10/3/2014,2720000.0,4,3.25,3990,18115,2.0,0.0,0.0,4,11,3990,0,1989,0,98039,47.6177,-122.229,3450,16087,10,3,2014,UNK,540,2028
8822900115,12/9/2014,306000.0,2,1.75,1200,2622,1.0,0.0,0.0,5,7,800,400,1956,0,98125,47.7175,-122.292,1310,1926,12,9,2014,UNK,-110,696
3832080610,4/6/2015,270000.0,3,2.5,1780,5015,2.0,0.0,0.0,3,7,1780,0,2010,0,98042,47.3352,-122.052,2010,5250,4,6,2015,N,-230,-235
1657300450,10/29/2014,340000.0,3,2.25,2630,9916,2.0,0.0,0.0,4,9,2630,0,1988,0,98092,47.3314,-122.20200000000001,2470,10810,10,29,2014,UNK,160,-894
1151100035,6/11/2014,450000.0,4,2.5,2300,19250,1.0,0.0,0.0,4,7,2300,0,1955,0,98045,47.4793,-121.77600000000001,1460,19250,6,11,2014,UNK,840,0
3876311490,7/24/2014,580000.0,4,2.75,3210,6825,1.0,0.0,0.0,5,7,1810,1400,1975,0,98034,47.7338,-122.169,1840,8000,7,24,2014,UNK,1370,-1175
9297300590,11/3/2014,435000.0,4,1.75,2290,4400,1.0,0.0,3.0,3,7,1290,1000,1959,0,98126,47.5698,-122.375,1820,4000,11,3,2014,UNK,470,400
3260350100,8/18/2014,690000.0,4,2.5,2780,4688,2.0,0.0,0.0,3,9,2780,0,2003,0,98059,47.5225,-122.156,3000,6029,8,18,2014,UNK,-220,-1341
3886902615,6/17/2014,720000.0,4,2.5,2650,11520,2.0,0.0,0.0,3,8,2110,0,1988,0,98033,47.683,-122.18700000000001,2000,7680,6,17,2014,UNK,650,3840
2193300620,2/17/2015,403000.0,3,2.25,1840,13020,1.0,0.0,0.0,3,8,1390,450,1980,0,98052,47.6923,-122.095,2210,13020,2,17,2015,UNK,-370,0
7016100120,6/12/2014,440000.0,3,2.75,1560,7392,1.0,0.0,0.0,5,7,1030,530,1972,0,98011,47.7382,-122.182,1870,7520,6,12,2014,UNK,-310,-128
8857600220,10/23/2014,178500.0,3,1.0,1200,8470,1.0,0.0,0.0,5,7,1200,0,1961,0,98032,47.3864,-122.287,1200,7952,10,23,2014,UNK,0,518
1645000580,10/2/2014,270000.0,4,2.5,1900,8282,1.0,0.0,0.0,3,7,1900,0,1968,1997,98022,47.2089,-122.00299999999999,1420,8350,10,2,2014,Y,480,-68
4337600205,11/12/2014,129888.0,2,1.0,710,9900,1.0,0.0,0.0,3,6,710,0,1943,0,98166,47.479,-122.339,1070,9900,11,12,2014,UNK,-360,0
1545805730,2/18/2015,260000.0,3,1.75,1360,15210,1.0,0.0,0.0,3,7,1360,0,1987,0,98038,47.3657,-122.04700000000001,1610,7800,2,18,2015,UNK,-250,7410
8650100120,8/29/2014,339950.0,5,2.5,2990,7292,2.0,0.0,0.0,4,8,2990,0,1990,0,98042,47.3604,-122.09100000000001,2150,8190,8,29,2014,UNK,840,-898
4047200820,8/22/2014,250000.0,3,1.0,1640,26127,2.0,0.0,0.0,3,6,1640,0,1975,0,98019,47.7656,-121.905,1620,25788,8,22,2014,UNK,20,339
1822059156,1/14/2015,680000.0,3,3.5,3650,103672,1.0,0.0,0.0,3,10,2050,1600,2011,0,98031,47.4002,-122.21700000000001,2550,16140,1,14,2015,N,1100,87532
8812401450,12/29/2014,660000.0,10,3.0,2920,3745,2.0,0.0,0.0,4,7,1860,1060,1913,0,98105,47.6635,-122.32,1810,3745,12,29,2014,UNK,1110,0
1854750090,7/16/2014,1230000.0,3,3.5,3680,11491,2.0,0.0,2.0,3,11,3680,0,1999,0,98007,47.5647,-122.12799999999999,3710,10030,7,16,2014,UNK,-30,1461
6071200455,5/23/2014,550000.0,3,2.0,1830,9152,1.0,0.0,0.0,5,8,1830,0,1959,0,98006,47.5531,-122.181,1770,9220,5,23,2014,UNK,60,-68
6790200110,1/2/2015,675000.0,5,2.75,2570,12906,2.0,0.0,0.0,3,8,2570,0,1987,0,98075,47.5814,-122.05,2580,12927,1,2,2015,UNK,-10,-21
6710100131,4/10/2015,981000.0,3,3.25,2730,9588,2.0,0.0,1.0,3,10,1900,830,1984,0,98052,47.6339,-122.09,2730,12736,4,10,2015,UNK,0,-3148
8856004415,3/25/2015,168000.0,3,1.0,1150,8000,1.5,0.0,0.0,4,6,1150,0,1913,1957,98001,47.2749,-122.25200000000001,1170,9600,3,25,2015,Y,-20,-1600
3276940100,5/22/2014,1000000.0,4,3.0,4260,18687,2.0,0.0,0.0,3,11,4260,0,1996,0,98075,47.5874,-121.98200000000001,3490,16772,5,22,2014,UNK,770,1915
9407100300,4/1/2015,320000.0,3,1.0,1260,9600,1.0,0.0,0.0,3,7,1260,0,1970,1995,98045,47.4444,-121.762,1530,9790,4,1,2015,Y,-270,-190
1224049095,2/4/2015,959000.0,6,3.25,4440,17424,1.0,0.0,1.0,4,9,2220,2220,1959,0,98040,47.5791,-122.23,2660,10768,2,4,2015,UNK,1780,6656
7899800586,4/9/2015,372000.0,4,1.0,2300,7680,1.0,0.0,0.0,3,7,1270,1030,1959,0,98106,47.523999999999994,-122.359,1840,5120,4,9,2015,UNK,460,2560
2607730110,7/7/2014,391500.0,3,2.5,1920,9625,2.0,0.0,0.0,3,8,1920,0,1993,0,98045,47.4876,-121.8,1920,10343,7,7,2014,UNK,0,-718
1781500180,3/27/2015,390000.0,2,1.0,1080,4725,1.5,0.0,0.0,3,7,1080,0,1944,0,98126,47.5275,-122.381,1520,4961,3,27,2015,UNK,-440,-236
2341800195,11/6/2014,302000.0,2,1.0,890,5000,1.0,0.0,0.0,4,6,890,0,1947,0,98118,47.5526,-122.287,1160,5000,11,6,2014,UNK,-270,0
52000067,11/3/2014,495000.0,3,3.5,1650,1577,2.0,0.0,0.0,3,7,1100,550,2012,0,98109,47.6302,-122.344,1580,1280,11,3,2014,N,70,297
1972202023,9/4/2014,504500.0,3,2.5,1820,1545,3.0,0.0,2.0,3,8,1640,180,1998,0,98103,47.6523,-122.346,1440,1290,9,4,2014,UNK,380,255
2919700540,3/18/2015,555000.0,4,1.75,2320,4800,1.5,0.0,0.0,3,7,2170,150,1918,0,98117,47.6893,-122.365,1390,4800,3,18,2015,UNK,930,0
6613000375,3/17/2015,1550000.0,4,3.5,3260,5000,2.0,0.0,0.0,5,9,2630,630,1937,0,98105,47.6598,-122.273,2600,5000,3,17,2015,UNK,660,0
2391600735,9/9/2014,550000.0,3,1.5,1730,5750,1.0,0.0,0.0,3,7,1250,480,1947,0,98116,47.5645,-122.397,1370,5750,9,9,2014,UNK,360,0
1337300145,7/21/2014,1800000.0,4,2.5,3320,8325,2.5,0.0,0.0,5,10,3320,0,1905,0,98112,47.6263,-122.314,3680,6050,7,21,2014,UNK,-360,2275
9164100035,4/29/2015,655000.0,1,1.0,1660,5422,1.0,0.0,0.0,4,7,830,830,1908,0,98117,47.6821,-122.38799999999999,1100,5356,4,29,2015,UNK,560,66
821069025,2/13/2015,685000.0,3,2.5,3290,90796,2.0,0.0,0.0,4,10,3290,0,1992,0,98042,47.3154,-122.079,2700,55023,2,13,2015,UNK,590,35773
1566100555,5/1/2015,721000.0,4,2.0,2280,8339,1.0,0.0,0.0,4,7,1220,1060,1954,0,98115,47.6986,-122.29700000000001,1970,8340,5,1,2015,UNK,310,-1
2397100705,7/14/2014,1520000.0,4,4.25,3650,5328,1.5,0.0,0.0,3,9,2330,1320,1907,2014,98119,47.63800000000001,-122.36200000000001,1710,3600,7,14,2014,Y,1940,1728
822069066,2/23/2015,365000.0,4,2.5,1620,219542,2.0,0.0,0.0,3,7,1620,0,1980,0,98038,47.4014,-122.069,2240,217800,2,23,2015,UNK,-620,1742
3834000820,6/13/2014,458000.0,3,2.0,2020,8555,1.0,0.0,0.0,4,7,1220,800,1957,0,98125,47.7278,-122.287,1600,8148,6,13,2014,UNK,420,407
1432700880,4/9/2015,280000.0,2,1.0,1150,12861,1.0,0.0,0.0,3,6,1150,0,1959,0,98058,47.4493,-122.171,1170,7574,4,9,2015,UNK,-20,5287
3658700395,4/9/2015,628000.0,4,1.75,1940,3060,1.0,0.0,0.0,4,7,1000,940,1911,0,98115,47.6786,-122.31700000000001,1320,3060,4,9,2015,UNK,620,0
1564000410,2/18/2015,781500.0,4,2.5,3440,6332,2.0,0.0,0.0,3,10,3440,0,2001,0,98059,47.5347,-122.155,3310,6528,2,18,2015,UNK,130,-196
984100450,6/24/2014,295000.0,3,1.75,2000,7560,1.0,0.0,0.0,4,7,1300,700,1968,0,98058,47.4346,-122.171,1900,8301,6,24,2014,UNK,100,-741
4449800063,4/3/2015,435000.0,2,1.0,750,2786,1.0,0.0,0.0,5,7,750,0,1947,0,98117,47.6892,-122.39299999999999,1700,4653,4,3,2015,UNK,-950,-1867
7694600201,3/22/2015,300000.0,3,1.75,1420,7200,1.0,0.0,0.0,3,7,1000,420,1979,0,98146,47.5069,-122.367,1550,8640,3,22,2015,UNK,-130,-1440
844001145,3/26/2015,208500.0,2,1.0,880,4814,1.0,0.0,0.0,4,5,880,0,1906,0,98010,47.3107,-121.999,1010,6160,3,26,2015,UNK,-130,-1346
8682281960,6/3/2014,930000.0,2,2.5,2680,11214,1.0,0.0,0.0,3,9,2680,0,2006,0,98053,47.7078,-122.01899999999999,2305,6908,6,3,2014,N,375,4306
1604600790,2/11/2015,316000.0,2,2.0,860,3000,1.0,0.0,0.0,3,6,860,0,1906,0,98118,47.5633,-122.288,1290,3500,2,11,2015,UNK,-430,-500
1796380330,6/23/2014,249900.0,3,2.0,1310,6738,1.0,0.0,0.0,4,7,1310,0,1990,0,98042,47.3694,-122.083,1290,8067,6,23,2014,UNK,20,-1329
3416600490,7/31/2014,675000.0,3,2.25,1780,4252,2.0,0.0,0.0,4,8,1540,240,1989,0,98144,47.6004,-122.292,2220,4000,7,31,2014,UNK,-440,252
3904901520,10/30/2014,447000.0,3,2.25,1440,4667,2.0,0.0,0.0,3,7,1440,0,1985,0,98029,47.5662,-122.01700000000001,1610,4756,10,30,2014,UNK,-170,-89
1556200155,4/17/2015,675000.0,3,2.0,1510,3817,1.5,0.0,0.0,3,8,1510,0,1905,1994,98122,47.6088,-122.294,1510,3817,4,17,2015,Y,0,0
567000401,4/21/2015,546000.0,4,2.5,2100,1397,3.0,0.0,0.0,3,8,1580,520,2008,0,98144,47.5928,-122.295,1490,1201,4,21,2015,N,610,196
6450300673,12/31/2014,310000.0,3,2.0,1310,1361,3.0,0.0,0.0,3,7,1310,0,2003,0,98133,47.7337,-122.34299999999999,1370,1608,12,31,2014,UNK,-60,-247
4440400155,1/6/2015,190000.0,3,1.0,1280,5100,1.0,0.0,0.0,3,7,880,400,1961,0,98178,47.5035,-122.259,1360,6120,1,6,2015,UNK,-80,-1020
2450000165,6/18/2014,650000.0,3,1.5,1320,8114,1.0,0.0,0.0,3,8,1320,0,1951,0,98004,47.5827,-122.195,2110,8114,6,18,2014,UNK,-790,0
9828701605,10/2/2014,585000.0,3,2.5,1740,2350,2.0,0.0,0.0,3,8,1130,610,1995,0,98112,47.6207,-122.29700000000001,1740,3201,10,2,2014,UNK,0,-851
856000985,11/6/2014,1430000.0,4,2.5,2910,7364,2.0,0.0,0.0,3,10,2910,0,2003,0,98033,47.6906,-122.213,2480,8400,11,6,2014,UNK,430,-1036
7504100360,1/12/2015,565000.0,4,2.5,2500,12090,1.0,0.0,0.0,3,9,2500,0,1983,0,98074,47.6346,-122.045,3380,12760,1,12,2015,UNK,-880,-670
7883606725,11/11/2014,174900.0,3,1.0,1100,6000,1.5,0.0,0.0,2,6,1100,0,1926,0,98108,47.5279,-122.318,960,5880,11,11,2014,UNK,140,120
2926049564,9/24/2014,360000.0,3,2.25,1381,1180,3.0,0.0,0.0,3,8,1381,0,2007,0,98125,47.71100000000001,-122.32,1381,1180,9,24,2014,N,0,0
7418700040,4/29/2015,234000.0,3,1.0,960,9624,1.0,0.0,0.0,3,7,960,0,1953,0,98155,47.7758,-122.301,1540,9624,4,29,2015,UNK,-580,0
3756900027,11/25/2014,575000.0,8,3.0,3840,15990,1.0,0.0,0.0,3,7,2530,1310,1961,0,98034,47.7111,-122.211,1380,8172,11,25,2014,UNK,2460,7818
7237300610,3/3/2015,315000.0,3,2.5,2200,5954,2.0,0.0,0.0,3,7,2200,0,2004,0,98042,47.3709,-122.125,2200,5046,3,3,2015,N,0,908
1312900180,3/25/2015,225000.0,3,1.0,1250,7820,1.0,0.0,0.0,3,7,1250,0,1967,0,98001,47.3397,-122.291,1300,7920,3,25,2015,UNK,-50,-100
3824100211,6/26/2014,370000.0,3,1.5,2380,14500,1.0,0.0,0.0,4,7,1850,530,1961,0,98028,47.7714,-122.256,1830,13600,6,26,2014,UNK,550,900
455000395,5/23/2014,606000.0,3,1.0,1500,3920,1.0,0.0,0.0,3,7,1000,500,1947,0,98107,47.6718,-122.359,1640,4017,5,23,2014,UNK,-140,-97
2472950120,6/3/2014,272500.0,3,2.0,1410,7622,1.0,0.0,0.0,4,7,1410,0,1983,0,98058,47.4273,-122.147,1830,8330,6,3,2014,UNK,-420,-708
7977201709,3/23/2015,475000.0,3,1.75,1680,3420,1.0,0.0,0.0,3,7,960,720,1992,0,98115,47.6855,-122.291,1680,4080,3,23,2015,UNK,0,-660
5095400040,6/5/2014,270000.0,3,1.0,1500,13500,1.0,0.0,0.0,4,7,1500,0,1968,0,98059,47.4666,-122.072,1350,13680,6,5,2014,UNK,150,-180
2324039152,8/18/2014,624000.0,4,1.75,2710,9216,1.0,0.0,0.0,3,8,1440,1270,1961,0,98126,47.5523,-122.37899999999999,1960,6350,8,18,2014,UNK,750,2866
1442300035,7/2/2014,355000.0,3,1.75,1730,7416,1.5,0.0,0.0,3,7,1730,0,1954,0,98133,47.76,-122.34899999999999,1390,6490,7,2,2014,UNK,340,926
6145601725,11/4/2014,345000.0,3,1.0,960,3844,1.0,0.0,0.0,3,7,960,0,1972,0,98133,47.7027,-122.346,1020,3844,11,4,2014,UNK,-60,0
7137950210,11/20/2014,342000.0,4,2.5,2380,7792,2.0,0.0,0.0,3,8,2380,0,1993,0,98092,47.3273,-122.17299999999999,2260,7378,11,20,2014,UNK,120,414
2720069019,11/3/2014,316000.0,3,1.75,1120,98445,1.5,0.0,2.0,4,7,1120,0,1917,0,98022,47.1853,-122.01700000000001,1620,34200,11,3,2014,UNK,-500,64245
1560920040,7/31/2014,539950.0,4,2.5,2960,37430,2.0,0.0,0.0,3,9,2960,0,1990,0,98038,47.3988,-122.023,2800,36384,7,31,2014,UNK,160,1046
7812801785,2/18/2015,221347.0,3,2.0,1580,6655,1.0,0.0,0.0,3,6,790,790,1944,0,98178,47.4927,-122.24799999999999,1090,6655,2,18,2015,UNK,490,0
8860500300,7/18/2014,330000.0,3,2.5,1870,4657,2.0,0.0,0.0,3,8,1870,0,2000,0,98055,47.4615,-122.214,2290,4795,7,18,2014,UNK,-420,-138
6142100090,7/18/2014,279000.0,4,2.5,1810,13000,1.0,0.0,0.0,4,8,1470,340,1977,0,98022,47.2202,-121.993,1850,13000,7,18,2014,UNK,-40,0
4083302225,10/14/2014,850000.0,4,3.0,2550,3784,1.5,0.0,0.0,4,8,1750,800,1900,0,98103,47.6559,-122.338,2100,4560,10,14,2014,UNK,450,-776
2591700037,2/12/2015,746000.0,3,1.75,1910,12321,1.0,0.0,0.0,4,7,1100,810,1952,0,98004,47.5995,-122.198,1910,11761,2,12,2015,UNK,0,560
5458300580,10/1/2014,478000.0,2,2.0,1200,1867,1.0,0.0,0.0,3,7,600,600,1924,1998,98109,47.626999999999995,-122.345,1790,2221,10,1,2014,Y,-590,-354
3362400650,1/16/2015,820000.0,4,2.75,2420,4635,1.5,0.0,0.0,5,7,2420,0,1905,0,98103,47.681999999999995,-122.34700000000001,1590,3150,1,16,2015,UNK,830,1485
5553300375,8/20/2014,2160000.0,3,3.5,3080,6495,2.0,0.0,3.0,3,11,2530,550,1996,2006,98199,47.6321,-122.39299999999999,4120,8620,8,20,2014,Y,-1040,-2125
2024059111,10/23/2014,820000.0,3,3.0,3850,38830,2.0,0.0,1.0,3,10,3850,0,2000,0,98006,47.5535,-122.191,2970,14050,10,23,2014,UNK,880,24780
6649900090,4/18/2015,887000.0,3,2.0,3000,22040,2.0,0.0,2.0,4,8,2470,530,1942,0,98177,47.7745,-122.368,2600,7947,4,18,2015,UNK,400,14093
3356403400,7/24/2014,159000.0,3,1.0,1360,20000,1.0,0.0,0.0,4,7,1360,0,1953,0,98001,47.2861,-122.25299999999999,1530,9997,7,24,2014,UNK,-170,10003
2771604190,6/17/2014,824000.0,7,4.25,3670,4000,2.0,0.0,1.0,3,8,2800,870,1964,0,98199,47.6375,-122.38799999999999,2010,4000,6,17,2014,UNK,1660,0
6638900265,9/25/2014,812000.0,4,2.5,2270,5000,2.0,0.0,0.0,3,9,2270,0,2014,0,98117,47.6916,-122.37,1210,5000,9,25,2014,N,1060,0
8731960540,12/15/2014,242000.0,4,2.5,1750,11400,2.0,0.0,0.0,4,7,1750,0,1975,0,98023,47.3149,-122.38600000000001,1890,9024,12,15,2014,UNK,-140,2376
7853301400,5/20/2014,625000.0,4,2.5,3550,8048,2.0,0.0,0.0,3,9,3550,0,2007,0,98065,47.5422,-121.88799999999999,3920,7871,5,20,2014,N,-370,177
123039176,12/12/2014,399888.0,4,1.0,2370,30200,1.5,0.0,0.0,4,7,1570,800,1948,0,98146,47.5108,-122.366,1640,9719,12,12,2014,UNK,730,20481
4178500150,9/22/2014,289000.0,3,2.25,1670,6600,2.0,0.0,0.0,4,7,1670,0,1990,0,98042,47.3604,-122.089,1670,6801,9,22,2014,UNK,0,-201
7702600930,8/4/2014,400000.0,3,2.0,1860,12944,1.0,0.0,0.0,3,9,1860,0,2002,0,98058,47.4298,-122.102,2500,29279,8,4,2014,UNK,-640,-16335
3892500150,5/21/2014,1550000.0,3,2.5,4460,26027,2.0,0.0,0.0,3,12,4460,0,1992,0,98033,47.6573,-122.17299999999999,3770,26027,5,21,2014,UNK,690,0
6021500970,5/28/2014,345000.0,2,1.0,1080,4000,1.0,0.0,0.0,3,7,1080,0,1940,0,98117,47.6902,-122.387,1530,4240,5,28,2014,UNK,-450,-240
6021500970,4/7/2015,874950.0,2,1.0,1080,4000,1.0,0.0,0.0,3,7,1080,0,1940,0,98117,47.6902,-122.387,1530,4240,4,7,2015,UNK,-450,-240
9136100056,5/28/2014,875000.0,3,2.75,2280,4280,1.0,0.0,0.0,5,7,1280,1000,1917,0,98103,47.6685,-122.335,1650,4280,5,28,2014,UNK,630,0
205000120,3/10/2015,628990.0,4,2.5,2540,32647,2.0,0.0,0.0,3,9,2540,0,1996,0,98053,47.6324,-121.988,2740,32647,3,10,2015,UNK,-200,0
3019300090,7/23/2014,535000.0,2,3.5,2560,5000,1.0,0.0,0.0,4,6,1280,1280,1944,0,98107,47.6681,-122.368,1390,4000,7,23,2014,UNK,1170,1000
5492200090,10/7/2014,770126.0,4,2.75,2390,9300,1.0,0.0,0.0,3,8,1430,960,1979,0,98004,47.6035,-122.206,1910,9348,10,7,2014,UNK,480,-48
1777600900,7/10/2014,710000.0,4,2.5,2870,8995,1.0,0.0,0.0,5,8,1870,1000,1968,0,98006,47.5678,-122.12799999999999,2670,9672,7,10,2014,UNK,200,-677
9297301050,6/18/2014,465000.0,3,1.75,1510,4800,1.0,0.0,2.0,3,7,860,650,1925,0,98126,47.5667,-122.37200000000001,1510,4800,6,18,2014,UNK,0,0
5745600040,8/14/2014,359000.0,3,1.75,2200,11520,1.0,0.0,0.0,4,7,2200,0,1952,0,98133,47.7659,-122.34100000000001,1690,8038,8,14,2014,UNK,510,3482
2114700090,3/1/2015,151000.0,2,0.75,720,5040,1.0,0.0,0.0,3,4,720,0,1949,0,98106,47.5323,-122.34700000000001,1290,4120,3,1,2015,UNK,-570,920
2597530650,8/15/2014,820000.0,3,2.5,2970,9600,2.0,0.0,0.0,3,9,2970,0,1994,0,98006,47.5422,-122.132,2970,9707,8,15,2014,UNK,0,-107
1099600620,3/26/2015,160000.0,3,1.5,960,6497,1.0,0.0,0.0,4,7,960,0,1970,0,98023,47.3018,-122.37799999999999,1160,7080,3,26,2015,UNK,-200,-583
3693901720,7/1/2014,535000.0,4,1.75,1420,5000,1.5,0.0,0.0,4,7,1420,0,1945,0,98117,47.6771,-122.397,1490,5000,7,1,2014,UNK,-70,0
7417100123,4/23/2015,365000.0,3,2.25,1800,9010,1.0,0.0,0.0,3,7,1300,500,1975,0,98155,47.7722,-122.31200000000001,1950,10240,4,23,2015,UNK,-150,-1230
8691410730,2/20/2015,708000.0,4,2.5,3090,5600,2.0,0.0,0.0,3,9,3090,0,2005,0,98075,47.597,-121.979,3080,5788,2,20,2015,N,10,-188
3832300090,7/9/2014,215000.0,3,1.0,1200,7280,1.0,0.0,0.0,4,7,1200,0,1967,0,98032,47.3724,-122.277,1200,8400,7,9,2014,UNK,0,-1120
2525049113,7/25/2014,1950000.0,4,3.5,4065,18713,2.0,0.0,0.0,4,10,4065,0,1987,0,98039,47.6209,-122.23700000000001,3070,18713,7,25,2014,UNK,995,0
1523059103,9/26/2014,390000.0,4,2.5,2570,22215,2.0,0.0,0.0,5,7,2570,0,1958,0,98059,47.4833,-122.15700000000001,2460,6533,9,26,2014,UNK,110,15682
3187600100,5/13/2014,570000.0,3,2.0,1530,5401,1.0,0.0,0.0,4,7,1530,0,1937,0,98115,47.68600000000001,-122.304,1640,5467,5,13,2014,UNK,-110,-66
1628700107,6/25/2014,383000.0,3,1.75,1500,13430,1.0,0.0,0.0,3,7,1500,0,1977,0,98072,47.7527,-122.08200000000001,1500,13430,6,25,2014,UNK,0,0
1152700120,4/9/2015,370000.0,4,3.0,2490,5706,2.0,0.0,0.0,3,9,2490,0,2005,0,98042,47.3509,-122.165,2650,5880,4,9,2015,N,-160,-174
808300180,2/11/2015,454000.0,4,2.5,3040,12522,2.0,0.0,0.0,3,7,3040,0,2000,0,98019,47.7247,-121.959,2490,9742,2,11,2015,UNK,550,2780
3585300194,3/24/2015,1400000.0,5,3.25,4140,32700,1.0,0.0,4.0,3,10,2190,1950,1973,0,98177,47.7633,-122.369,3220,22077,3,24,2015,UNK,920,10623
3342700610,7/28/2014,371000.0,4,1.75,1690,10854,1.0,0.0,0.0,3,7,1690,0,1977,0,98056,47.5241,-122.199,2390,7000,7,28,2014,UNK,-700,3854
7376300085,5/5/2015,530000.0,3,1.75,1430,10350,1.0,0.0,0.0,3,7,1430,0,1959,0,98008,47.6353,-122.12299999999999,1890,10350,5,5,2015,UNK,-460,0
6204000040,6/10/2014,608000.0,4,2.75,2490,9714,1.0,0.0,0.0,4,8,1400,1090,1983,0,98011,47.7496,-122.20100000000001,2060,15300,6,10,2014,UNK,430,-5586
3992700475,11/11/2014,450000.0,3,1.75,1350,7200,1.0,0.0,0.0,5,7,1350,0,1954,0,98125,47.713,-122.28399999999999,1100,7200,11,11,2014,UNK,250,0
9510920120,7/30/2014,780000.0,4,2.5,3140,14421,2.0,0.0,0.0,3,10,3140,0,1994,0,98075,47.5943,-122.01799999999999,3140,17417,7,30,2014,UNK,0,-2996
9485920120,8/29/2014,290000.0,4,2.5,2340,52272,2.0,0.0,0.0,2,8,2340,0,1978,0,98042,47.3468,-122.09100000000001,2480,40500,8,29,2014,UNK,-140,11772
1685200110,9/16/2014,225000.0,3,1.75,1610,14182,1.0,0.0,0.0,4,7,1100,510,1978,0,98092,47.3174,-122.18,1510,8400,9,16,2014,UNK,100,5782
7574910650,9/11/2014,805000.0,4,2.5,3320,38032,2.0,0.0,0.0,4,10,3320,0,1991,0,98077,47.7478,-122.036,3270,37804,9,11,2014,UNK,50,228
4178600040,4/7/2015,660000.0,3,2.5,2390,15669,2.0,0.0,0.0,3,9,2390,0,1991,0,98011,47.7446,-122.193,2640,12500,4,7,2015,UNK,-250,3169
3793700210,6/13/2014,299000.0,3,1.75,1180,13927,1.0,0.0,0.0,5,7,1180,0,1962,0,98059,47.4818,-122.094,1400,13173,6,13,2014,UNK,-220,754
1972200325,9/19/2014,530000.0,2,2.25,1260,1312,3.0,0.0,0.0,3,8,1260,0,2007,0,98103,47.6538,-122.35600000000001,1300,1312,9,19,2014,N,-40,0
7010701383,10/17/2014,680000.0,3,2.5,1800,4400,1.0,0.0,0.0,5,7,1350,450,1970,0,98199,47.6599,-122.396,1920,4400,10,17,2014,UNK,-120,0
3353401340,2/16/2015,199900.0,4,1.75,1790,12000,1.0,0.0,0.0,5,6,1790,0,1944,0,98001,47.2664,-122.256,1550,9840,2,16,2015,UNK,240,2160
3352401037,1/8/2015,224000.0,3,1.75,1760,6300,1.0,0.0,0.0,3,7,1060,700,1963,0,98178,47.5003,-122.26,1340,7300,1,8,2015,UNK,420,-1000
8802400906,8/29/2014,244000.0,3,1.75,1540,8885,1.0,0.0,0.0,4,7,1440,100,1980,0,98031,47.4031,-122.20100000000001,1540,12734,8,29,2014,UNK,0,-3849
4443800940,4/8/2015,485000.0,4,1.75,1260,3880,1.0,0.0,0.0,5,7,860,400,1918,0,98117,47.687,-122.391,1000,3880,4,8,2015,UNK,260,0
2215450100,1/12/2015,330000.0,4,2.5,2240,7589,2.0,0.0,0.0,3,8,2240,0,1994,0,98030,47.3824,-122.20700000000001,2250,7300,1,12,2015,UNK,-10,289
8900000100,12/31/2014,509000.0,4,2.0,1630,1724,1.5,0.0,0.0,3,6,1030,600,1915,1970,98119,47.6472,-122.36200000000001,1780,3810,12,31,2014,Y,-150,-2086
8079010220,11/17/2014,440000.0,4,2.5,2350,7203,2.0,0.0,0.0,3,8,2350,0,1989,0,98059,47.5123,-122.15100000000001,2260,7274,11,17,2014,UNK,90,-71
8078050120,12/10/2014,244000.0,3,2.0,1350,8587,1.0,0.0,0.0,3,7,1350,0,1998,0,98022,47.2073,-122.012,1350,8587,12,10,2014,UNK,0,0
1773101215,7/17/2014,399700.0,4,1.75,1320,4800,1.0,0.0,0.0,4,7,870,450,1930,0,98106,47.5534,-122.365,940,4800,7,17,2014,UNK,380,0
2768100205,6/25/2014,519000.0,4,2.5,1950,2617,1.5,0.0,0.0,4,7,1250,700,1910,0,98107,47.6696,-122.37200000000001,1520,1438,6,25,2014,UNK,430,1179
5537200043,5/8/2014,211000.0,4,1.0,2100,9200,1.0,0.0,0.0,3,7,1050,1050,1959,0,98168,47.476000000000006,-122.292,1540,10033,5,8,2014,UNK,560,-833
868000905,7/8/2014,950000.0,3,2.5,3480,7800,1.0,0.0,0.0,4,7,1750,1730,1941,1998,98177,47.7047,-122.37799999999999,3010,9918,7,8,2014,Y,470,-2118
8635760490,9/2/2014,410000.0,3,2.5,1830,2839,2.0,0.0,0.0,3,8,1830,0,1999,0,98074,47.6022,-122.021,1830,3011,9,2,2014,UNK,0,-172
3052700245,3/25/2015,750000.0,4,2.0,2640,5000,2.0,0.0,0.0,3,7,2040,600,1949,0,98117,47.678000000000004,-122.375,1330,5000,3,25,2015,UNK,1310,0
9320901250,9/10/2014,133400.0,3,1.0,900,2550,1.0,0.0,0.0,4,6,900,0,1978,0,98023,47.3036,-122.363,1120,2550,9,10,2014,UNK,-220,0
2420069042,4/24/2015,240000.0,3,2.0,1553,6550,1.0,0.0,0.0,3,7,1553,0,1900,0,98022,47.2056,-121.994,1010,10546,4,24,2015,UNK,543,-3996
6870300090,6/4/2014,539000.0,3,2.5,1710,2300,2.0,0.0,0.0,3,8,1570,140,2005,0,98052,47.6743,-122.14200000000001,2120,2856,6,4,2014,N,-410,-556
1223089066,8/14/2014,688000.0,4,3.0,3400,292723,2.0,0.0,0.0,3,10,3400,0,1998,0,98045,47.4883,-121.725,1760,69696,8,14,2014,UNK,1640,223027
7974200937,5/13/2014,465000.0,3,1.5,1270,5112,1.0,0.0,0.0,3,7,1270,0,1950,0,98115,47.676,-122.288,1580,5080,5,13,2014,UNK,-310,32
2998300146,6/17/2014,936000.0,3,1.75,2960,12420,1.0,0.0,2.0,4,8,1480,1480,1952,0,98116,47.5739,-122.406,2700,9106,6,17,2014,UNK,260,3314
7202290650,12/30/2014,620000.0,4,2.5,3040,9606,2.0,0.0,0.0,3,7,3040,0,2003,0,98053,47.6884,-122.044,1690,3849,12,30,2014,UNK,1350,5757
1326039061,10/20/2014,429950.0,3,1.75,1430,9750,1.0,0.0,0.0,5,7,1430,0,1962,0,98133,47.7441,-122.35700000000001,1630,9282,10,20,2014,UNK,-200,468
4142450330,7/7/2014,296475.0,3,2.5,1520,4170,2.0,0.0,0.0,3,7,1520,0,2004,0,98038,47.3842,-122.04,1560,4237,7,7,2014,N,-40,-67
6139100076,4/27/2015,330000.0,4,2.0,1820,9450,1.0,0.0,0.0,3,7,1100,720,1962,0,98155,47.7607,-122.329,1540,9450,4,27,2015,UNK,280,0
8126300360,7/30/2014,445000.0,3,2.25,1800,11200,1.0,0.0,0.0,3,8,1270,530,1979,0,98052,47.7072,-122.164,1940,11250,7,30,2014,UNK,-140,-50
1231000645,8/1/2014,846000.0,4,3.25,2720,4000,2.0,0.0,1.0,3,10,2070,650,2014,0,98118,47.5554,-122.26700000000001,1450,4000,8,1,2014,N,1270,0
8149600265,5/14/2015,725000.0,4,1.75,1980,5850,1.0,0.0,1.0,4,8,1380,600,1960,0,98116,47.5607,-122.391,1810,5850,5,14,2015,UNK,170,0
9264950410,5/4/2015,369000.0,4,2.5,2550,7349,2.0,0.0,0.0,3,9,2550,0,1989,0,98023,47.3059,-122.34899999999999,2400,8508,5,4,2015,UNK,150,-1159
9541800065,6/9/2014,625000.0,3,1.75,2210,16200,1.0,0.0,0.0,3,8,1390,820,1958,0,98005,47.5924,-122.175,2050,16200,6,9,2014,UNK,160,0
7202330790,6/18/2014,535000.0,3,2.0,2120,4080,2.0,0.0,0.0,3,7,2120,0,2003,0,98053,47.681999999999995,-122.037,2280,4080,6,18,2014,UNK,-160,0
7335400065,12/18/2014,229950.0,4,1.5,1570,6717,1.0,0.0,0.0,5,6,1570,0,1911,0,98002,47.306999999999995,-122.21700000000001,1140,6716,12,18,2014,UNK,430,1
1313500090,4/23/2015,229999.0,3,1.75,1310,6960,1.0,0.0,0.0,4,7,1310,0,1974,0,98092,47.2761,-122.15299999999999,1580,7200,4,23,2015,UNK,-270,-240
1797500600,8/25/2014,850000.0,5,3.5,3150,4120,2.0,0.0,0.0,3,8,2460,690,1911,2007,98115,47.6754,-122.315,2080,4160,8,25,2014,Y,1070,-40
5561301220,6/10/2014,589900.0,4,4.5,3870,35889,2.0,0.0,0.0,3,10,2530,1340,2001,0,98027,47.4677,-122.01,3020,35366,6,10,2014,UNK,850,523
5700002165,10/30/2014,513000.0,2,1.0,1840,4322,1.0,0.0,0.0,4,7,1160,680,1914,0,98144,47.5764,-122.289,1750,4322,10,30,2014,UNK,90,0
9202650040,9/26/2014,401000.0,3,1.0,1120,8321,1.0,0.0,0.0,4,6,1120,0,1941,0,98027,47.5631,-122.09100000000001,1980,8671,9,26,2014,UNK,-860,-350
7211401975,9/5/2014,260000.0,3,2.5,1440,2500,2.0,0.0,0.0,3,7,1440,0,2006,0,98146,47.511,-122.359,1440,5000,9,5,2014,N,0,-2500
126039394,5/8/2015,525000.0,4,2.75,2300,26650,1.0,0.0,0.0,4,8,2300,0,1950,0,98177,47.7771,-122.36200000000001,2000,9879,5,8,2015,UNK,300,16771
3204800150,3/20/2015,470000.0,3,3.5,2070,11658,1.0,0.0,0.0,4,8,1370,700,1977,0,98056,47.537,-122.178,1930,8744,3,20,2015,UNK,140,2914
7686204750,1/21/2015,205000.0,4,1.5,1420,8063,1.0,0.0,0.0,3,7,940,480,1962,0,98198,47.4174,-122.316,1330,7515,1,21,2015,UNK,90,548
7524950900,2/10/2015,620000.0,3,2.25,2010,7495,1.0,0.0,0.0,4,8,1570,440,1979,0,98027,47.5613,-122.083,2050,8402,2,10,2015,UNK,-40,-907
7211400850,8/11/2014,229000.0,3,1.5,1200,5000,1.0,0.0,0.0,3,6,1200,0,1979,0,98146,47.5122,-122.35700000000001,1440,2500,8,11,2014,UNK,-240,2500
8024202520,5/9/2014,445000.0,2,2.0,1150,6634,1.0,0.0,0.0,3,7,860,290,1940,0,98115,47.7001,-122.309,1680,6892,5,9,2014,UNK,-530,-258
7340600068,5/14/2014,215000.0,2,1.0,1240,7200,1.0,0.0,0.0,3,7,1240,0,1967,0,98168,47.4971,-122.28200000000001,1130,9200,5,14,2014,UNK,110,-2000
8682260850,7/29/2014,504975.0,2,2.5,1900,4871,2.0,0.0,0.0,3,8,1900,0,2005,0,98053,47.7132,-122.03399999999999,1640,4780,7,29,2014,N,260,91
6804600720,8/1/2014,495000.0,4,2.25,2350,10072,2.0,0.0,0.0,3,8,2350,0,1980,0,98011,47.7628,-122.16799999999999,2210,9687,8,1,2014,UNK,140,385
1865820300,3/11/2015,205000.0,3,1.0,1120,8342,1.0,0.0,0.0,4,7,1120,0,1976,0,98042,47.3732,-122.116,1190,6660,3,11,2015,UNK,-70,1682
3163600076,7/30/2014,152275.0,1,1.0,1020,6871,1.0,0.0,0.0,3,6,1020,0,1937,0,98146,47.5051,-122.338,1260,6933,7,30,2014,UNK,-240,-62
5418500650,3/25/2015,586000.0,4,2.25,1930,8338,1.0,0.0,0.0,3,8,1930,0,1968,0,98125,47.7026,-122.285,2280,7616,3,25,2015,UNK,-350,722
8682220230,10/17/2014,779950.0,2,2.5,2680,7625,1.0,0.0,0.0,3,9,2680,0,2002,0,98053,47.7094,-122.024,2310,7395,10,17,2014,UNK,370,230
3578401210,12/18/2014,557000.0,4,1.75,2660,11315,2.0,0.0,0.0,4,8,2660,0,1983,0,98074,47.6204,-122.044,1980,11315,12,18,2014,UNK,680,0
9122001225,10/29/2014,610000.0,4,2.25,2200,7200,1.0,0.0,2.0,4,8,1220,980,1958,0,98144,47.5818,-122.296,1940,6000,10,29,2014,UNK,260,1200
5667100025,7/8/2014,405000.0,3,1.5,1010,7683,1.5,0.0,0.0,5,7,1010,0,1953,0,98125,47.72,-122.318,1550,7271,7,8,2014,UNK,-540,412
5089700750,5/9/2014,320000.0,4,2.25,2310,7490,2.0,0.0,0.0,3,8,2310,0,1980,0,98055,47.4379,-122.19200000000001,2310,8480,5,9,2014,UNK,0,-990
3331500650,9/19/2014,356000.0,3,1.0,920,3863,1.0,0.0,0.0,3,6,920,0,1970,0,98118,47.5524,-122.27,1080,5150,9,19,2014,UNK,-160,-1287
9528102865,2/26/2015,794500.0,5,3.0,3030,4120,1.5,0.0,0.0,4,7,1930,1100,1913,0,98115,47.6771,-122.319,1280,3090,2,26,2015,UNK,1750,1030
6928000590,5/8/2014,349000.0,3,1.75,1590,9620,1.0,0.0,0.0,3,7,1590,0,1988,0,98059,47.4815,-122.152,2980,9398,5,8,2014,UNK,-1390,222
1423069162,6/4/2014,549000.0,4,2.25,2740,88426,2.0,0.0,0.0,3,7,2740,0,1991,0,98027,47.4734,-122.006,2740,62726,6,4,2014,UNK,0,25700
7877400245,7/18/2014,193000.0,3,1.0,960,10761,1.0,0.0,0.0,4,6,960,0,1962,0,98002,47.2819,-122.22399999999999,960,10761,7,18,2014,UNK,0,0
7430500301,10/16/2014,700000.0,3,1.5,2240,7227,2.0,0.0,1.0,3,9,1440,800,1977,0,98008,47.6208,-122.09299999999999,3150,16150,10,16,2014,UNK,-910,-8923
7852010900,3/24/2015,523000.0,3,2.5,2400,6182,2.0,0.0,0.0,3,8,2400,0,1998,0,98065,47.5363,-121.87,2420,5829,3,24,2015,UNK,-20,353
4022900652,11/18/2014,565000.0,5,3.25,2860,20790,1.0,0.0,0.0,4,7,1800,1060,1965,0,98155,47.7757,-122.295,1920,9612,11,18,2014,UNK,940,11178
7852030790,5/5/2015,500000.0,4,2.5,2960,5027,2.0,0.0,0.0,3,7,2960,0,2000,0,98065,47.5328,-121.881,2760,5500,5,5,2015,UNK,200,-473
3528900330,7/7/2014,1450000.0,4,3.25,3770,4103,2.0,0.0,0.0,5,9,2710,1060,1925,0,98109,47.64100000000001,-122.34899999999999,2560,4160,7,7,2014,UNK,1210,-57
2623069106,2/19/2015,710000.0,6,3.5,3830,68825,2.0,0.0,0.0,3,9,3830,0,1995,0,98027,47.4574,-122.00299999999999,2410,68825,2,19,2015,UNK,1420,0
88000173,10/15/2014,333000.0,4,2.0,2750,9001,1.0,0.0,0.0,3,8,2750,0,2008,0,98055,47.457,-122.189,1340,11050,10,15,2014,N,1410,-2049
3179102305,7/17/2014,580000.0,3,1.75,2100,6874,1.0,0.0,0.0,3,7,1300,800,1943,0,98115,47.6724,-122.279,2220,5912,7,17,2014,UNK,-120,962
5379803386,8/1/2014,289950.0,4,1.75,1500,8400,1.0,0.0,0.0,3,7,1200,300,1956,0,98188,47.4531,-122.273,1780,9913,8,1,2014,UNK,-280,-1513
8127700845,2/19/2015,375000.0,2,1.0,710,4618,1.0,0.0,1.0,3,5,710,0,1925,0,98199,47.64,-122.39399999999999,1810,4988,2,19,2015,UNK,-1100,-370
8562901010,9/26/2014,505000.0,2,3.0,2770,10800,1.5,0.0,0.0,5,8,1910,860,1984,0,98074,47.6082,-122.057,2140,10800,9,26,2014,UNK,630,0
4058200915,7/21/2014,324950.0,3,1.75,2050,6720,1.0,0.0,2.0,3,7,1050,1000,1939,0,98178,47.5058,-122.235,2380,7260,7,21,2014,UNK,-330,-540
8861700110,7/14/2014,490000.0,4,2.25,1960,10275,2.0,0.0,0.0,3,7,1960,0,1965,0,98052,47.6887,-122.124,1560,10275,7,14,2014,UNK,400,0
6822100155,5/12/2014,630000.0,4,2.0,1770,6000,2.0,0.0,0.0,5,7,1770,0,1911,0,98199,47.6493,-122.40100000000001,1340,6000,5,12,2014,UNK,430,0
3345700215,6/20/2014,595000.0,3,2.75,3290,22649,2.0,0.0,0.0,4,8,3290,0,1993,0,98056,47.5241,-122.193,2750,6119,6,20,2014,UNK,540,16530
582000644,5/1/2015,872500.0,4,2.0,1990,6000,1.0,0.0,0.0,3,9,1260,730,1956,2015,98199,47.6515,-122.397,1770,6000,5,1,2015,Y,220,0
6126601380,2/22/2015,490000.0,2,1.0,1760,5250,1.0,0.0,2.0,4,7,1000,0,1951,0,98126,47.5577,-122.37899999999999,1760,5400,2,22,2015,UNK,0,-150
3303850330,12/16/2014,1900000.0,4,3.25,5080,27755,2.0,0.0,0.0,3,11,5080,0,2001,0,98006,47.5423,-122.111,4730,22326,12,16,2014,UNK,350,5429
3343902281,5/5/2015,310000.0,2,1.0,1020,8102,1.0,0.0,0.0,3,7,1020,0,1956,0,98056,47.5135,-122.193,1770,7291,5,5,2015,UNK,-750,811
2023059052,5/4/2015,450000.0,3,1.0,1350,92721,1.0,0.0,0.0,2,6,1200,150,1946,0,98055,47.4657,-122.198,1860,8096,5,4,2015,UNK,-510,84625
7504001430,10/23/2014,539000.0,3,1.5,1740,12000,2.0,0.0,0.0,3,9,1740,0,1974,0,98074,47.6276,-122.053,2580,12224,10,23,2014,UNK,-840,-224
9290850330,7/7/2014,888550.0,3,2.5,3540,38322,2.0,0.0,0.0,3,10,3540,0,1989,0,98053,47.6892,-122.04799999999999,3540,35926,7,7,2014,UNK,0,2396
7955080300,7/14/2014,269950.0,3,2.5,1520,8720,1.0,0.0,0.0,3,7,1080,440,1981,0,98058,47.4267,-122.15700000000001,1720,7551,7,14,2014,UNK,-200,1169
3755100220,8/19/2014,300000.0,3,1.75,1310,9761,1.0,0.0,0.0,3,7,1310,0,1967,0,98034,47.721000000000004,-122.228,1490,9600,8,19,2014,UNK,-180,161
3425059076,9/22/2014,780000.0,2,3.25,3000,24004,1.0,0.0,0.0,3,10,2410,590,1952,0,98005,47.611000000000004,-122.15700000000001,4270,24506,9,22,2014,UNK,-1270,-502
8728550150,7/15/2014,545000.0,3,2.5,2660,20369,2.0,0.0,0.0,3,8,2660,0,1992,0,98027,47.5234,-122.055,2720,12927,7,15,2014,UNK,-60,7442
2108500110,4/15/2015,278000.0,3,2.25,2120,9804,2.0,0.0,0.0,3,7,2120,0,1994,0,98042,47.3596,-122.16,2120,7200,4,15,2015,UNK,0,2604
7941130110,12/1/2014,342000.0,3,2.25,1200,2845,2.0,0.0,0.0,3,7,1200,0,1986,0,98034,47.7151,-122.20299999999999,1220,2140,12,1,2014,UNK,-20,705
1545807180,5/6/2015,190000.0,4,1.75,1900,9861,1.0,0.0,0.0,4,7,1900,0,1967,0,98038,47.3615,-122.057,1720,7967,5,6,2015,UNK,180,1894
1972200382,11/21/2014,387000.0,2,1.5,1010,948,3.0,0.0,0.0,3,8,1010,0,1999,0,98103,47.6529,-122.355,1330,1318,11,21,2014,UNK,-320,-370
2473420100,3/4/2015,279950.0,3,2.25,1850,7480,2.0,0.0,0.0,3,7,1850,0,1978,0,98058,47.452,-122.15899999999999,1870,7480,3,4,2015,UNK,-20,0
722059020,3/18/2015,550000.0,6,4.5,4520,40164,2.0,0.0,0.0,3,9,3580,940,1953,2008,98031,47.407,-122.21600000000001,2870,13068,3,18,2015,Y,1650,27096
1626079154,5/20/2014,439000.0,3,2.0,2010,251341,2.0,0.0,0.0,3,8,1510,500,2003,0,98019,47.7416,-121.91,1780,108900,5,20,2014,UNK,230,142441
1152000040,10/10/2014,774888.0,3,2.25,2420,23507,1.0,0.0,0.0,4,8,2420,0,1969,0,98027,47.5107,-122.027,2540,22257,10,10,2014,UNK,-120,1250
5152960330,6/10/2014,480000.0,5,2.5,2732,9500,1.0,0.0,2.0,4,8,1870,862,1975,0,98003,47.3436,-122.323,2720,10000,6,10,2014,UNK,12,-500
6431000206,5/8/2014,835000.0,4,2.0,1910,6960,1.5,0.0,0.0,5,8,1910,0,1941,0,98103,47.6893,-122.348,1360,3300,5,8,2014,UNK,550,3660
2397101185,3/3/2015,1500000.0,5,3.5,3520,5400,2.0,0.0,0.0,3,9,2400,1120,2008,0,98119,47.6364,-122.363,1360,3600,3,3,2015,N,2160,1800
2922700865,3/26/2015,771000.0,4,2.0,2220,3760,1.5,0.0,0.0,4,7,1370,850,1929,0,98117,47.6876,-122.368,1620,3760,3,26,2015,UNK,600,0
3271800870,8/7/2014,1230000.0,4,2.25,2020,5800,1.0,0.0,3.0,4,9,1760,260,1941,0,98199,47.6471,-122.412,3100,5800,8,7,2014,UNK,-1080,0
1562200090,10/17/2014,600000.0,4,2.5,2090,7290,1.0,0.0,0.0,5,8,1420,670,1966,0,98007,47.623999999999995,-122.14200000000001,2110,8436,10,17,2014,UNK,-20,-1146
1431700210,7/2/2014,305000.0,3,1.0,1580,7424,1.0,0.0,0.0,3,7,1010,570,1962,0,98058,47.4607,-122.171,1710,7772,7,2,2014,UNK,-130,-348
2566300100,3/27/2015,1390000.0,5,1.75,2650,11340,1.0,0.0,0.0,3,8,2650,0,1955,0,98004,47.62600000000001,-122.213,2780,13204,3,27,2015,UNK,-130,-1864
5379806155,9/10/2014,216500.0,3,1.0,1020,11652,1.0,0.0,0.0,4,6,1020,0,1971,0,98188,47.4459,-122.27799999999999,1690,11652,9,10,2014,UNK,-670,0
952006857,1/22/2015,370000.0,3,2.5,1070,1219,2.0,0.0,0.0,3,7,720,350,2004,0,98116,47.5618,-122.384,1070,1254,1,22,2015,N,0,-35
3792400110,6/30/2014,492650.0,4,1.75,2120,9786,1.0,0.0,0.0,3,8,1640,480,1967,0,98177,47.7753,-122.365,2310,8787,6,30,2014,UNK,-190,999
3755100540,7/25/2014,431200.0,5,1.75,1360,10609,1.0,0.0,0.0,3,7,1060,300,1966,0,98034,47.7203,-122.229,1490,9935,7,25,2014,UNK,-130,674
2122059014,4/9/2015,277500.0,4,2.0,1700,12048,2.0,0.0,0.0,3,7,1700,0,1990,0,98030,47.3748,-122.186,1960,7650,4,9,2015,UNK,-260,4398
110000040,3/17/2015,278000.0,5,1.5,1820,8712,1.0,0.0,0.0,5,7,1090,730,1960,0,98032,47.3712,-122.289,1820,8712,3,17,2015,UNK,0,0
3876800580,9/2/2014,351000.0,4,1.0,1430,8400,1.0,0.0,0.0,3,6,730,700,1969,0,98072,47.7417,-122.17200000000001,1310,8240,9,2,2014,UNK,120,160
3127200021,6/16/2014,850000.0,4,3.5,4140,7089,2.0,0.0,0.0,3,10,3160,980,2003,0,98034,47.7059,-122.2,2640,8896,6,16,2014,UNK,1500,-1807
2397101460,8/11/2014,885000.0,2,2.0,1313,3600,1.0,0.0,0.0,3,8,1313,0,1904,2012,98119,47.6369,-122.365,1080,3600,8,11,2014,Y,233,0
1720069146,7/15/2014,399950.0,3,2.0,1590,87120,1.0,0.0,3.0,3,8,1590,0,1998,0,98022,47.2241,-122.072,2780,183161,7,15,2014,UNK,-1190,-96041
7878400043,8/5/2014,185000.0,3,1.75,1080,9262,1.0,0.0,0.0,3,7,1080,0,1968,0,98178,47.4883,-122.24799999999999,1090,9262,8,5,2014,UNK,-10,0
9282801030,9/25/2014,440000.0,5,3.0,2730,6000,1.0,0.0,0.0,3,8,1470,1260,1979,0,98178,47.4994,-122.234,2590,6000,9,25,2014,UNK,140,0
6072800265,8/13/2014,2400000.0,4,3.25,3800,19798,2.0,0.0,0.0,3,10,3800,0,1969,2009,98006,47.5684,-122.19,3940,18975,8,13,2014,Y,-140,823
5267000180,8/21/2014,299000.0,3,2.25,2540,9961,1.0,0.0,0.0,4,8,1320,1220,1969,0,98031,47.41,-122.208,1870,10251,8,21,2014,UNK,670,-290
2722049077,8/28/2014,299500.0,3,1.75,1810,34500,1.0,0.0,0.0,3,8,1230,580,1980,0,98032,47.3707,-122.275,2090,9735,8,28,2014,UNK,-280,24765
1115100278,3/17/2015,420000.0,3,1.5,1540,7506,1.0,0.0,0.0,5,7,1540,0,1961,0,98155,47.7565,-122.325,2180,7653,3,17,2015,UNK,-640,-147
8075400530,6/27/2014,234000.0,4,1.0,1390,18000,1.0,0.0,0.0,3,7,1390,0,1955,2013,98032,47.3885,-122.28399999999999,1390,18000,6,27,2014,Y,0,0
1997200245,7/14/2014,540000.0,2,1.75,1460,4800,1.0,0.0,0.0,5,7,850,610,1950,0,98103,47.6928,-122.339,2050,5592,7,14,2014,UNK,-590,-792
926069009,6/9/2014,649950.0,4,2.5,2350,63162,2.0,0.0,0.0,4,8,2350,0,1994,0,98077,47.7545,-122.04700000000001,2370,63162,6,9,2014,UNK,-20,0
6381500110,1/8/2015,330000.0,3,1.0,1160,7912,1.0,0.0,0.0,4,7,1160,0,1956,0,98125,47.7336,-122.306,1190,7482,1,8,2015,UNK,-30,430
7203100850,4/27/2015,840000.0,4,3.25,3500,5960,2.0,0.0,0.0,3,9,3500,0,2010,0,98053,47.6944,-122.022,3390,6856,4,27,2015,N,110,-896
3529300330,11/7/2014,370000.0,3,2.5,1980,6922,2.0,0.0,0.0,5,8,1980,0,1991,0,98031,47.396,-122.184,2090,7697,11,7,2014,UNK,-110,-775
3204800330,6/25/2014,410000.0,3,1.5,1250,7700,1.0,0.0,0.0,5,7,1250,0,1968,0,98056,47.5383,-122.178,1430,7700,6,25,2014,UNK,-180,0
6411600411,12/9/2014,257000.0,2,1.0,770,7200,1.0,0.0,0.0,3,7,770,0,1951,0,98125,47.7143,-122.325,1320,7139,12,9,2014,UNK,-550,61
8685500145,12/30/2014,350000.0,3,1.0,1920,6710,1.0,0.0,0.0,3,7,1320,600,1959,0,98118,47.5346,-122.286,1810,5600,12,30,2014,UNK,110,1110
7277100610,8/25/2014,380000.0,2,1.0,1120,7560,1.0,0.0,1.0,3,6,1120,0,1947,0,98177,47.77,-122.39,1120,7200,8,25,2014,UNK,0,360
1775800750,3/10/2015,344000.0,3,1.0,1150,12402,1.0,0.0,0.0,4,6,1150,0,1969,0,98072,47.7422,-122.09899999999999,1400,13600,3,10,2015,UNK,-250,-1198
2856101105,5/27/2014,488000.0,3,2.5,1590,2550,3.0,0.0,0.0,3,7,1590,0,1985,0,98117,47.6772,-122.39299999999999,1260,5100,5,27,2014,UNK,330,-2550
4443800705,10/8/2014,465000.0,3,1.0,910,3880,1.0,0.0,0.0,3,7,780,130,1942,0,98117,47.6862,-122.39200000000001,1220,3880,10,8,2014,UNK,-310,0
3878900464,5/4/2015,229500.0,2,1.75,1870,6625,1.0,0.0,0.0,3,7,960,910,1948,0,98178,47.5071,-122.249,1680,6000,5,4,2015,UNK,190,625
8151600900,11/12/2014,445000.0,5,3.0,2420,11250,2.0,0.0,0.0,3,8,2420,0,2013,0,98146,47.5082,-122.36200000000001,1510,9950,11,12,2014,N,910,1300
1612500155,3/17/2015,246000.0,4,1.5,2120,7110,1.5,0.0,0.0,3,6,2120,0,1919,0,98030,47.3846,-122.227,1540,7110,3,17,2015,UNK,580,0
4140500180,6/4/2014,545000.0,5,2.5,2730,17240,1.0,0.0,0.0,5,7,1660,1070,1958,0,98028,47.7646,-122.26700000000001,2250,13200,6,4,2014,UNK,480,4040
3342103174,8/13/2014,518000.0,4,2.5,2560,5672,2.0,0.0,1.0,3,8,2560,0,2005,0,98056,47.5222,-122.20100000000001,2190,6788,8,13,2014,N,370,-1116
2078500210,10/31/2014,565000.0,4,2.5,2620,10016,2.0,0.0,0.0,3,8,2620,0,1996,0,98056,47.5295,-122.179,2620,10016,10,31,2014,UNK,0,0
3955900910,4/10/2015,445000.0,4,2.5,2760,8558,2.0,0.0,0.0,3,7,2760,0,2001,0,98056,47.4802,-122.189,2760,7703,4,10,2015,UNK,0,855
3472800068,7/17/2014,968000.0,5,2.5,2900,9799,1.0,0.0,0.0,3,8,1450,1450,1959,0,98004,47.6255,-122.208,2810,9687,7,17,2014,UNK,90,112
8928100205,3/31/2015,725000.0,3,2.0,1820,6324,1.0,0.0,0.0,5,7,910,910,1945,0,98115,47.6823,-122.27,1850,6440,3,31,2015,UNK,-30,-116
2473400110,8/26/2014,315500.0,3,1.75,1870,8400,1.0,0.0,0.0,3,7,990,880,1977,0,98058,47.45399999999999,-122.164,1750,8400,8,26,2014,UNK,120,0
2558720120,5/5/2014,487585.0,4,1.75,2010,9211,1.0,0.0,0.0,3,7,1470,540,1977,0,98034,47.7206,-122.171,1840,8500,5,5,2014,UNK,170,711
2023049361,3/23/2015,246500.0,2,1.0,940,6000,1.0,0.0,0.0,2,7,940,0,1954,0,98148,47.4631,-122.329,1890,8547,3,23,2015,UNK,-950,-2547
6821101285,8/14/2014,819000.0,3,1.75,1850,6000,1.5,0.0,0.0,3,8,1650,200,1913,1999,98199,47.6528,-122.40100000000001,1540,6000,8,14,2014,Y,310,0
2780910100,12/18/2014,349900.0,5,2.5,2530,4229,2.0,0.0,0.0,3,7,2530,0,2004,0,98038,47.3531,-122.021,2070,4879,12,18,2014,N,460,-650
9357000230,8/22/2014,267000.0,3,1.0,940,4700,1.0,0.0,0.0,4,6,940,0,1942,0,98146,47.5117,-122.37799999999999,1020,5700,8,22,2014,UNK,-80,-1000
3649100015,5/13/2015,480000.0,3,2.25,1820,15000,1.0,0.0,0.0,3,7,1480,340,1978,0,98028,47.7401,-122.249,1930,13600,5,13,2015,UNK,-110,1400
1189000180,9/10/2014,525000.0,2,1.0,1510,3360,1.0,0.0,0.0,3,7,880,630,1924,0,98122,47.6135,-122.29700000000001,1330,3360,9,10,2014,UNK,180,0
3905120610,6/25/2014,578000.0,4,2.5,2070,5415,2.0,0.0,0.0,3,8,2070,0,1996,0,98029,47.5706,-122.006,2120,5331,6,25,2014,UNK,-50,84
993002177,5/6/2015,345000.0,3,2.5,1380,1547,3.0,0.0,0.0,3,8,1380,0,2000,0,98103,47.6908,-122.34100000000001,1380,1465,5,6,2015,UNK,0,82
6384500535,3/26/2015,499000.0,3,1.0,1270,6250,1.0,0.0,0.0,3,7,910,360,1955,0,98116,47.5694,-122.397,2000,6250,3,26,2015,UNK,-730,0
7751800115,8/26/2014,425000.0,3,1.5,1390,9680,1.0,0.0,0.0,4,7,1390,0,1956,0,98008,47.63399999999999,-122.125,1460,10050,8,26,2014,UNK,-70,-370
4137020820,10/27/2014,268000.0,4,3.0,1840,7510,2.0,0.0,0.0,5,8,1840,0,1988,2013,98092,47.2595,-122.21799999999999,1650,7957,10,27,2014,Y,190,-447
9407000230,12/4/2014,240000.0,3,1.0,1600,12566,1.0,0.0,0.0,4,7,1600,0,1971,0,98045,47.4431,-121.765,1600,10650,12,4,2014,UNK,0,1916
3306200230,3/3/2015,147000.0,3,1.5,1480,9606,1.0,0.0,0.0,4,7,1100,380,1964,0,98023,47.2978,-122.363,1600,9619,3,3,2015,UNK,-120,-13
3888100176,3/6/2015,500000.0,4,2.0,2120,7806,1.0,0.0,0.0,4,6,1770,350,1949,0,98033,47.6859,-122.166,1560,9920,3,6,2015,UNK,560,-2114
7011201325,10/28/2014,1010000.0,4,2.75,2940,5400,1.5,0.0,2.0,5,8,1940,1000,1910,0,98119,47.6366,-122.369,1970,2008,10,28,2014,UNK,970,3392
1424130220,3/9/2015,991500.0,4,3.0,3820,26895,2.0,0.0,2.0,3,11,3820,0,1995,0,98072,47.7253,-122.09200000000001,3820,24751,3,9,2015,UNK,0,2144
9165100375,11/18/2014,510000.0,5,2.0,2740,3838,1.0,0.0,0.0,4,7,1370,1370,1959,0,98117,47.6819,-122.39299999999999,1660,4040,11,18,2014,UNK,1080,-202
1651500040,8/1/2014,1980000.0,4,4.0,4360,12081,2.0,0.0,0.0,3,10,4360,0,2007,0,98004,47.6377,-122.219,2180,10800,8,1,2014,N,2180,1281
8929000090,7/2/2014,484998.0,4,2.5,1540,1870,2.0,0.0,0.0,3,8,1540,0,2014,0,98029,47.5524,-121.999,1540,1619,7,2,2014,N,0,251
3303850360,6/25/2014,1280000.0,4,3.5,4660,17398,2.0,0.0,2.0,3,11,4660,0,2003,0,98006,47.5422,-122.11200000000001,5080,24913,6,25,2014,UNK,-420,-7515
2011000120,5/29/2014,210000.0,3,1.75,1590,7617,2.0,0.0,0.0,3,7,1590,0,1986,0,98198,47.3819,-122.31200000000001,1490,7450,5,29,2014,UNK,100,167
6751100205,8/4/2014,450000.0,2,1.0,1180,10720,1.0,0.0,0.0,4,7,1180,0,1955,0,98007,47.5893,-122.135,1420,10750,8,4,2014,UNK,-240,-30
5078400035,4/2/2015,875000.0,4,1.75,2360,8286,1.0,0.0,0.0,3,7,1320,1040,1952,0,98004,47.6226,-122.205,1680,7630,4,2,2015,UNK,680,656
6073300530,4/28/2015,529950.0,4,2.75,1860,7500,1.0,0.0,0.0,5,8,1220,640,1967,0,98056,47.5398,-122.17299999999999,2020,8137,4,28,2015,UNK,-160,-637
9818700645,7/23/2014,415000.0,3,1.75,1470,4000,1.0,0.0,0.0,3,7,1070,400,1979,0,98122,47.6067,-122.29799999999999,1280,3500,7,23,2014,UNK,190,500
6181700625,2/20/2015,590000.0,4,2.0,2990,12970,1.5,0.0,2.0,4,7,1960,1030,1948,0,98028,47.7605,-122.258,2500,10680,2,20,2015,UNK,490,2290
8718500610,5/26/2014,379950.0,3,1.5,1690,9144,1.0,0.0,0.0,4,7,1140,550,1956,0,98028,47.739,-122.25299999999999,1840,10600,5,26,2014,UNK,-150,-1456
7950302150,4/10/2015,385000.0,1,1.0,660,3570,1.0,0.0,0.0,3,6,660,0,1906,0,98118,47.5659,-122.28399999999999,1520,4080,4,10,2015,UNK,-860,-510
923000115,10/29/2014,588000.0,3,1.75,2310,7620,2.0,0.0,0.0,3,8,2310,0,1942,1988,98177,47.7266,-122.363,2200,7672,10,29,2014,Y,110,-52
1722800835,8/11/2014,252500.0,2,1.0,770,2191,1.0,0.0,0.0,3,6,770,0,1937,0,98108,47.5512,-122.323,940,5000,8,11,2014,UNK,-170,-2809
7436300180,5/19/2014,530000.0,3,3.5,2320,3174,2.0,0.0,0.0,3,9,2060,260,1997,0,98033,47.6897,-122.175,2320,3187,5,19,2014,UNK,0,-13
1630700276,1/5/2015,385000.0,2,1.5,1370,159865,1.0,0.0,0.0,3,7,1370,0,1960,0,98072,47.7592,-122.09200000000001,1370,16217,1,5,2015,UNK,0,143648
2558670110,8/29/2014,419000.0,3,2.25,1700,7650,1.0,0.0,0.0,4,7,1340,360,1975,0,98034,47.7214,-122.166,1980,7200,8,29,2014,UNK,-280,450
402000110,10/17/2014,175000.0,2,1.0,960,5508,1.0,0.0,0.0,3,6,770,190,1951,0,98118,47.5307,-122.277,1280,5304,10,17,2014,UNK,-320,204
442000175,3/31/2015,515000.0,2,1.0,1150,5664,1.0,0.0,0.0,3,7,870,280,1948,0,98115,47.6894,-122.28399999999999,1380,5664,3,31,2015,UNK,-230,0
8825900410,2/18/2015,945000.0,4,2.5,2910,4680,1.5,0.0,0.0,5,9,1850,1060,1937,0,98115,47.6745,-122.31,1960,4120,2,18,2015,UNK,950,560
984210120,6/20/2014,359900.0,5,2.25,2290,7420,1.0,0.0,0.0,3,7,1290,1000,1973,0,98058,47.4375,-122.166,1660,7526,6,20,2014,UNK,630,-106
8044050040,8/7/2014,419950.0,4,2.5,2260,5164,2.0,0.0,0.0,3,8,2260,0,1996,0,98056,47.50899999999999,-122.166,2260,5866,8,7,2014,UNK,0,-702
2771604370,9/26/2014,460000.0,3,1.75,1300,4000,1.0,0.0,0.0,3,7,900,400,1953,0,98199,47.6368,-122.38799999999999,1750,4000,9,26,2014,UNK,-450,0
5028602020,3/5/2015,255000.0,3,2.25,1850,7151,2.0,0.0,0.0,3,7,1850,0,1989,0,98023,47.2843,-122.352,1710,6827,3,5,2015,UNK,140,324
643300040,11/4/2014,481000.0,4,1.75,1920,9500,1.0,0.0,0.0,4,7,1470,450,1966,0,98006,47.5683,-122.177,1820,10091,11,4,2014,UNK,100,-591
643300040,3/13/2015,719521.0,4,1.75,1920,9500,1.0,0.0,0.0,4,7,1470,450,1966,0,98006,47.5683,-122.177,1820,10091,3,13,2015,UNK,100,-591
224059025,6/20/2014,1080000.0,3,3.0,4910,43560,2.0,0.0,0.0,4,10,4000,910,1989,0,98007,47.5911,-122.131,3540,12288,6,20,2014,UNK,1370,31272
3379200100,5/23/2014,334000.0,4,2.5,2210,6080,1.0,0.0,2.0,4,8,1410,800,1965,0,98178,47.4915,-122.228,2210,6175,5,23,2014,UNK,0,-95
6338000493,9/12/2014,675000.0,4,2.75,2280,3200,1.5,0.0,0.0,5,8,1520,760,1931,0,98105,47.6709,-122.28200000000001,1970,4687,9,12,2014,UNK,310,-1487
293000068,6/13/2014,556000.0,3,1.75,1640,7437,1.0,0.0,0.0,3,7,1090,550,1948,0,98126,47.5324,-122.38,1640,7436,6,13,2014,UNK,0,1
6169901095,8/15/2014,900000.0,4,2.0,1980,7200,2.0,0.0,3.0,3,8,1700,280,1910,0,98119,47.6318,-122.369,2490,4200,8,15,2014,UNK,-510,3000
4443800375,10/2/2014,400000.0,3,1.0,900,4084,1.5,0.0,0.0,3,7,900,0,1910,0,98117,47.684,-122.39299999999999,1280,4080,10,2,2014,UNK,-380,4
9376301800,3/24/2015,724950.0,4,1.75,1960,4340,1.0,0.0,0.0,5,8,980,980,1912,0,98117,47.6847,-122.37,1630,4360,3,24,2015,UNK,330,-20
6799300150,9/3/2014,321000.0,4,2.25,1800,4500,2.0,0.0,0.0,4,8,1800,0,2004,0,98031,47.394,-122.18299999999999,2010,5050,9,3,2014,N,-210,-550
3271800910,7/1/2014,1360000.0,4,3.5,4270,5800,2.0,0.0,3.0,5,10,3170,1100,1937,0,98199,47.6474,-122.411,3100,5800,7,1,2014,UNK,1170,0
42000245,6/13/2014,171000.0,4,2.0,1520,19672,1.0,0.0,0.0,3,6,1020,500,1920,0,98188,47.4683,-122.281,1810,7840,6,13,2014,UNK,-290,11832
1625069101,7/7/2014,1360000.0,4,3.0,5430,108900,2.0,0.0,0.0,4,10,5430,0,1987,0,98053,47.6582,-122.038,3170,107076,7,7,2014,UNK,2260,1824
4046700110,2/24/2015,323000.0,3,1.75,1950,15037,1.0,0.0,0.0,3,7,1950,0,1989,0,98014,47.6892,-121.913,1760,15181,2,24,2015,UNK,190,-144
2423600100,5/2/2014,491500.0,4,1.75,2190,125452,1.0,0.0,2.0,3,9,2190,0,1968,0,98092,47.2703,-122.069,3000,125017,5,2,2014,UNK,-810,435
621069154,7/21/2014,226000.0,4,1.5,1200,10890,1.0,0.0,0.0,5,7,1200,0,1972,0,98042,47.3423,-122.088,1250,10139,7,21,2014,UNK,-50,751
2436200025,10/9/2014,580000.0,6,1.75,2180,4000,1.5,0.0,0.0,4,7,1380,800,1926,0,98105,47.6643,-122.29,1720,4000,10,9,2014,UNK,460,0
9808610410,8/22/2014,640000.0,4,2.5,2320,11259,2.0,0.0,0.0,3,9,2320,0,1982,0,98004,47.6443,-122.194,2820,11770,8,22,2014,UNK,-500,-511
1370803640,8/20/2014,619790.0,3,1.75,1040,5097,1.0,0.0,0.0,4,7,800,240,1944,0,98199,47.6385,-122.40100000000001,1630,5097,8,20,2014,UNK,-590,0
3779300210,6/30/2014,383962.0,4,2.5,2700,6998,2.0,0.0,0.0,3,8,2700,0,2001,0,98188,47.4694,-122.26299999999999,2350,10550,6,30,2014,UNK,350,-3552
424049059,8/15/2014,373000.0,3,2.0,1400,2445,1.0,0.0,0.0,3,7,840,560,2002,0,98144,47.5926,-122.29899999999999,1400,3200,8,15,2014,UNK,0,-755
5422560850,12/10/2014,541338.0,3,2.5,2060,8123,2.0,0.0,0.0,3,8,1010,1050,1977,0,98052,47.6642,-122.13,1760,6170,12,10,2014,UNK,300,1953
558100065,10/3/2014,254922.0,2,1.0,780,8160,1.0,0.0,0.0,4,6,780,0,1953,0,98133,47.7356,-122.34,1310,8160,10,3,2014,UNK,-530,0
4442800040,6/24/2014,575000.0,3,2.25,2400,5000,1.5,0.0,0.0,4,7,1440,960,1926,0,98117,47.6897,-122.39299999999999,1630,5000,6,24,2014,UNK,770,0
4038600300,9/2/2014,650000.0,4,3.0,2900,15535,1.0,0.0,2.0,4,7,1870,1030,1961,0,98008,47.611999999999995,-122.119,2330,10217,9,2,2014,UNK,570,5318
5070000120,8/13/2014,269950.0,3,1.5,1740,9547,1.0,0.0,0.0,4,7,1740,0,1962,0,98055,47.4475,-122.213,1780,9936,8,13,2014,UNK,-40,-389
795002450,4/30/2015,270950.0,2,1.0,780,6250,1.0,0.0,0.0,3,6,780,0,1942,0,98168,47.5099,-122.33,1280,7100,4,30,2015,UNK,-500,-850
3579000180,12/29/2014,495000.0,3,2.75,2430,14861,1.0,0.0,0.0,3,9,1530,900,1988,0,98028,47.7461,-122.24700000000001,2230,10300,12,29,2014,UNK,200,4561
6821102170,5/7/2014,794154.0,4,2.0,2210,8556,1.0,0.0,1.0,4,8,1210,1000,1954,0,98199,47.6498,-122.396,2190,7975,5,7,2014,UNK,20,581
5151900110,12/19/2014,340768.0,3,1.5,1510,11200,1.0,0.0,0.0,4,8,1510,0,1960,0,98003,47.3347,-122.325,2110,12070,12,19,2014,UNK,-600,-870
5101407790,8/1/2014,375000.0,2,1.0,900,5413,1.0,0.0,0.0,3,7,900,0,1947,0,98125,47.7047,-122.307,1280,6380,8,1,2014,UNK,-380,-967
2538400040,5/24/2014,820000.0,4,2.5,3670,7000,2.0,0.0,0.0,3,10,3670,0,2005,0,98075,47.5854,-122.08,3680,7437,5,24,2014,N,-10,-437
1025049266,9/30/2014,555000.0,2,2.25,1160,954,2.0,0.0,0.0,3,8,960,200,2014,0,98105,47.6647,-122.28399999999999,1160,1327,9,30,2014,N,0,-373
4340610040,6/12/2014,312500.0,2,1.5,1070,1200,2.0,0.0,0.0,3,7,1070,0,1999,0,98103,47.696999999999996,-122.34700000000001,1070,1200,6,12,2014,UNK,0,0
3204300610,12/2/2014,450000.0,2,1.0,950,4560,1.5,0.0,0.0,3,7,950,0,1925,0,98112,47.6288,-122.3,2040,4560,12,2,2014,UNK,-1090,0
6793300220,1/5/2015,739000.0,3,2.75,2950,6667,2.0,0.0,0.0,3,9,2950,0,2003,0,98029,47.5577,-122.02600000000001,3340,6667,1,5,2015,UNK,-390,0
1568100087,4/13/2015,320000.0,3,2.0,1420,1716,2.0,0.0,0.0,3,7,1050,370,2003,0,98155,47.7364,-122.295,1420,8150,4,13,2015,UNK,0,-6434
4338800600,6/9/2014,235000.0,3,1.0,1590,13000,1.5,0.0,0.0,3,6,1590,0,1944,0,98166,47.4789,-122.346,1460,8400,6,9,2014,UNK,130,4600
7211400535,3/23/2015,275500.0,4,1.0,1290,5000,1.5,0.0,0.0,3,7,1290,0,1957,0,98146,47.5128,-122.35799999999999,1440,2500,3,23,2015,UNK,-150,2500
8682261140,6/18/2014,564000.0,2,2.0,1690,4500,1.0,0.0,0.0,3,8,1690,0,2004,0,98053,47.7133,-122.031,1640,4500,6,18,2014,N,50,0
4435000145,5/1/2015,263000.0,4,1.75,1340,8700,1.5,0.0,0.0,3,6,1340,0,1958,0,98188,47.4514,-122.287,1240,8700,5,1,2015,UNK,100,0
421059018,11/4/2014,257000.0,3,1.75,1397,18000,1.0,0.0,0.0,3,7,1397,0,1965,2014,98092,47.3388,-122.166,1950,31294,11,4,2014,Y,-553,-13294
1321059013,3/19/2015,725000.0,4,2.5,3750,218506,2.0,0.0,0.0,3,10,3750,0,1991,0,98092,47.3045,-122.103,2540,39413,3,19,2015,UNK,1210,179093
2143700406,12/11/2014,300000.0,3,2.25,2000,7560,1.0,0.0,0.0,3,7,1400,600,1979,0,98055,47.4798,-122.228,2040,6949,12,11,2014,UNK,-40,611
8961950410,7/7/2014,328000.0,3,2.0,2250,7904,1.5,0.0,0.0,3,8,2250,0,1998,0,98001,47.3165,-122.25200000000001,2460,8622,7,7,2014,UNK,-210,-718
1788800770,7/28/2014,187500.0,3,1.0,840,8400,1.0,0.0,0.0,3,6,840,0,1959,0,98023,47.3281,-122.344,1030,8640,7,28,2014,UNK,-190,-240
7518507685,2/23/2015,400000.0,3,1.0,1100,5100,2.0,0.0,0.0,4,7,1100,0,1900,0,98117,47.678999999999995,-122.38600000000001,1540,5100,2,23,2015,UNK,-440,0
2490200220,3/2/2015,515000.0,3,1.5,1660,5100,1.0,0.0,0.0,4,7,1210,450,1954,0,98136,47.5345,-122.383,1440,5100,3,2,2015,UNK,220,0
284000025,4/20/2015,1410000.0,2,2.0,2180,18525,1.0,1.0,4.0,5,9,1580,0,1952,0,98146,47.5036,-122.387,2480,21503,4,20,2015,UNK,-300,-2978
522059189,4/17/2015,235000.0,3,1.0,1460,8400,1.0,0.0,0.0,3,7,1460,0,1958,0,98055,47.4243,-122.198,1460,9600,4,17,2015,UNK,0,-1200
7203150330,7/17/2014,669000.0,4,2.5,2470,4945,2.0,0.0,0.0,3,8,2470,0,2012,0,98053,47.6898,-122.015,2510,4988,7,17,2014,N,-40,-43
3124089060,4/24/2015,282000.0,3,1.0,1250,13503,1.5,0.0,0.0,4,6,1250,0,1931,0,98065,47.526,-121.829,1450,13503,4,24,2015,UNK,-200,0
7518504130,6/26/2014,663000.0,3,2.0,1480,3876,1.0,0.0,0.0,5,7,860,620,1928,0,98117,47.6808,-122.382,1660,3774,6,26,2014,UNK,-180,102
7893802670,4/24/2015,279900.0,3,3.25,2240,5000,2.0,0.0,0.0,3,9,1540,700,1989,0,98198,47.4114,-122.334,1800,7500,4,24,2015,UNK,440,-2500
2548100180,5/7/2014,335000.0,3,2.0,1570,7200,1.0,0.0,0.0,4,7,1570,0,1952,0,98155,47.7501,-122.314,1410,7434,5,7,2014,UNK,160,-234
4024100915,12/31/2014,689000.0,4,2.75,3250,10000,2.0,0.0,0.0,3,9,3250,0,2014,0,98155,47.7557,-122.309,1620,10089,12,31,2014,N,1630,-89
1026069106,4/21/2015,413100.0,3,2.25,1790,231303,1.0,0.0,0.0,3,7,1250,540,1980,0,98077,47.7558,-122.027,2090,93654,4,21,2015,UNK,-300,137649
7852020720,3/27/2015,506950.0,3,2.5,2080,4931,2.0,0.0,0.0,3,8,2080,0,2000,0,98065,47.5342,-121.868,1890,4229,3,27,2015,UNK,190,702
9828702265,5/6/2014,500000.0,3,2.5,1480,1171,3.0,0.0,0.0,3,8,1480,0,2006,0,98112,47.62,-122.3,1480,1231,5,6,2014,N,0,-60
5104511250,6/13/2014,540000.0,5,3.0,3610,9775,2.0,0.0,0.0,3,8,3610,0,2003,0,98038,47.3545,-122.01100000000001,2800,8582,6,13,2014,UNK,810,1193
9828201885,8/22/2014,812000.0,3,2.5,2040,4559,2.0,0.0,0.0,3,9,2040,0,1998,0,98122,47.6156,-122.295,1500,4500,8,22,2014,UNK,540,59
7525950110,8/28/2014,1200000.0,4,3.25,3850,19842,2.0,0.0,3.0,3,11,3180,670,1989,0,98074,47.6239,-122.065,4320,19500,8,28,2014,UNK,-470,342
3211260120,12/15/2014,370000.0,3,2.25,3230,35306,2.0,0.0,0.0,3,9,3230,0,1987,0,98092,47.3065,-122.113,2760,35285,12,15,2014,UNK,470,21
7250000065,8/25/2014,338000.0,3,2.0,2440,23512,1.0,0.0,0.0,3,6,1640,800,1933,0,98148,47.4594,-122.32600000000001,1630,19613,8,25,2014,UNK,810,3899
1446400564,5/7/2014,185000.0,4,1.0,1490,6600,1.0,0.0,0.0,3,7,1490,0,1969,0,98168,47.4835,-122.33200000000001,1280,6600,5,7,2014,UNK,210,0
224059021,12/19/2014,450000.0,3,1.0,1150,35415,1.0,0.0,0.0,4,7,1010,0,1950,0,98008,47.5974,-122.12899999999999,2460,11781,12,19,2014,UNK,-1310,23634
6392000625,7/12/2014,451000.0,2,1.0,900,6000,1.0,0.0,0.0,3,7,900,0,1944,2004,98115,47.6855,-122.289,1460,4800,7,12,2014,Y,-560,1200
6817850110,4/21/2015,785000.0,4,2.5,3210,24527,1.5,0.0,0.0,3,11,3210,0,1984,0,98074,47.6399,-122.052,3280,24527,4,21,2015,UNK,-70,0
3902100175,7/28/2014,850000.0,5,3.0,3900,5250,1.5,0.0,1.0,5,8,2620,1280,1931,0,98116,47.5577,-122.389,1950,5700,7,28,2014,UNK,1950,-450
7205400180,12/23/2014,235000.0,3,1.0,1240,18000,1.0,0.0,0.0,2,7,1240,0,1943,0,98198,47.3514,-122.315,1240,18000,12,23,2014,UNK,0,0
7351200295,1/14/2015,1150000.0,3,1.75,1760,6788,2.0,1.0,4.0,3,7,1760,0,1940,0,98125,47.7336,-122.28399999999999,1630,7588,1,14,2015,UNK,130,-800
291310260,5/16/2014,377500.0,3,2.25,1410,1377,2.0,0.0,0.0,3,7,1290,120,2005,0,98027,47.5342,-122.06700000000001,1445,1370,5,16,2014,N,-35,7
3026059204,5/30/2014,825500.0,3,2.5,2780,11964,2.0,0.0,0.0,3,9,2780,0,2009,0,98034,47.7127,-122.21600000000001,1760,9640,5,30,2014,N,1020,2324
2856102105,6/10/2014,1060000.0,5,3.25,3230,3825,2.0,0.0,0.0,3,9,2480,750,2014,0,98117,47.6785,-122.39200000000001,1480,5100,6,10,2014,N,1750,-1275
3343301343,11/20/2014,880000.0,5,3.5,4600,8764,2.0,0.0,0.0,3,10,3180,1420,2007,0,98006,47.5491,-122.19,3210,9431,11,20,2014,N,1390,-667
8682302030,5/21/2014,413800.0,3,2.0,1440,4421,1.0,0.0,0.0,3,8,1440,0,2007,0,98053,47.7188,-122.024,1440,4157,5,21,2014,N,0,264
1048000160,6/27/2014,504200.0,2,1.5,1200,1687,3.0,0.0,0.0,3,8,1200,0,2008,0,98103,47.6491,-122.334,1240,1296,6,27,2014,N,-40,391
5714200140,4/22/2015,421500.0,4,3.0,2793,5703,2.0,0.0,0.0,3,9,2793,0,2009,0,98030,47.3682,-122.178,2793,5704,4,22,2015,N,0,-1
1152200030,3/5/2015,855169.0,4,2.5,2970,5050,2.0,0.0,0.0,3,8,2970,0,2014,0,98052,47.7043,-122.12200000000001,2810,4998,3,5,2015,N,160,52
3157600075,2/7/2015,380000.0,3,2.0,1440,3218,1.0,0.0,0.0,3,7,850,590,2008,0,98106,47.5655,-122.36,1170,5000,2,7,2015,N,270,-1782
1972200554,8/4/2014,580000.0,3,2.25,1480,1026,3.0,0.0,0.0,3,8,1480,0,2014,0,98103,47.6536,-122.354,1570,1283,8,4,2014,N,-90,-257
9429400060,4/9/2015,377000.0,3,2.5,1870,5333,2.0,0.0,0.0,3,8,1870,0,2012,0,98019,47.7447,-121.984,2100,3730,4,9,2015,N,-230,1603
301401610,9/30/2014,329900.0,4,2.75,2475,4000,2.0,0.0,0.0,3,7,2475,0,2014,0,98002,47.3452,-122.209,2475,4000,9,30,2014,N,0,0
1025039326,8/28/2014,921800.0,4,2.5,2950,7024,2.0,0.0,0.0,3,10,2950,0,2012,0,98199,47.6651,-122.40299999999999,2950,6339,8,28,2014,N,0,685
9385200041,3/4/2015,529500.0,3,2.25,1410,905,3.0,0.0,0.0,3,9,1410,0,2014,0,98116,47.5818,-122.402,1510,1352,3,4,2015,N,-100,-447
7237450550,6/3/2014,363990.0,4,2.5,2240,3712,2.0,0.0,0.0,3,8,2240,0,2014,0,98038,47.3551,-122.061,2530,4315,6,3,2014,N,-290,-603
2862500060,1/15/2015,834950.0,5,2.75,3230,6500,2.0,0.0,0.0,3,9,3230,0,2014,0,98074,47.6237,-122.023,3180,7624,1,15,2015,N,50,-1124
4046500270,8/19/2014,399000.0,3,2.0,2100,31550,1.0,0.0,0.0,3,8,2100,0,2010,0,98014,47.6907,-121.917,1860,18452,8,19,2014,N,240,13098
2161400060,11/14/2014,338900.0,3,2.25,1936,9495,1.0,0.0,0.0,3,8,1936,0,2013,0,98030,47.3714,-122.197,1410,12770,11,14,2014,N,526,-3275
2781230070,3/11/2015,419950.0,3,2.5,3120,6000,2.0,0.0,0.0,3,9,3120,0,2007,0,98038,47.3473,-122.03,2670,6000,3,11,2015,N,450,0
4019500160,4/13/2015,493000.0,4,2.5,2070,4270,2.0,0.0,0.0,3,8,2070,0,2010,0,98028,47.773,-122.265,2070,4610,4,13,2015,N,0,-340
6980500030,12/11/2014,650000.0,4,2.5,3700,4500,2.0,0.0,0.0,3,9,3700,0,2007,0,98028,47.7473,-122.23,3050,5047,12,11,2014,N,650,-547
1442880260,9/9/2014,456000.0,3,2.5,2130,5205,2.0,0.0,0.0,3,8,2130,0,2013,0,98045,47.4832,-121.774,2250,5462,9,9,2014,N,-120,-257
9268851860,9/18/2014,425000.0,3,2.25,1620,997,2.5,0.0,0.0,3,8,1540,80,2010,0,98027,47.54,-122.02600000000001,1620,1068,9,18,2014,N,0,-71
832700320,2/9/2015,348000.0,3,2.5,1490,2478,3.0,0.0,0.0,3,8,1490,0,2009,0,98133,47.7236,-122.353,1270,1156,2,9,2015,N,220,1322
2937300550,10/29/2014,1040000.0,5,4.0,4180,7232,2.0,0.0,0.0,3,9,4180,0,2014,0,98052,47.7049,-122.125,3570,6054,10,29,2014,N,610,1178
2114700368,11/18/2014,299000.0,2,2.5,1400,1262,2.0,0.0,0.0,3,8,1160,240,2008,0,98106,47.5342,-122.34899999999999,1060,1524,11,18,2014,N,340,-262
2213000030,5/12/2014,1260000.0,4,3.75,3490,9170,2.0,0.0,0.0,3,9,3490,0,2012,0,98004,47.5991,-122.2,1810,8470,5,12,2014,N,1680,700
2626119062,11/12/2014,155000.0,3,1.0,1300,6098,1.0,0.0,0.0,3,7,1300,0,2013,0,98014,47.7074,-121.36399999999999,1300,6849,11,12,2014,N,0,-751
7338220160,2/25/2015,319500.0,4,2.5,2730,4962,2.0,0.0,0.0,3,8,2730,0,2006,0,98002,47.3363,-122.21600000000001,2150,3802,2,25,2015,N,580,1160
2781280310,12/22/2014,274000.0,3,2.5,1830,2517,2.0,0.0,0.0,3,8,1830,0,2005,0,98055,47.4496,-122.189,1610,2762,12,22,2014,N,220,-245
3448740070,6/16/2014,429000.0,5,2.5,2340,4500,2.0,0.0,0.0,3,7,2340,0,2009,0,98059,47.4911,-122.154,2190,4500,6,16,2014,N,150,0
2895800710,12/2/2014,267800.0,3,1.75,1410,1899,2.0,0.0,0.0,3,8,1410,0,2014,0,98106,47.5171,-122.34700000000001,1410,1811,12,2,2014,N,0,88
723049434,4/8/2015,369950.0,3,2.5,1930,8254,2.0,0.0,0.0,3,7,1930,0,2014,0,98146,47.4973,-122.346,1540,8849,4,8,2015,N,390,-595
2922059212,1/9/2015,480000.0,6,5.0,3028,18055,2.0,0.0,0.0,3,7,3028,0,2005,0,98030,47.3651,-122.197,1400,34575,1,9,2015,N,1628,-16520
1441000350,9/15/2014,440000.0,4,3.5,3180,4869,2.0,0.0,0.0,3,8,2390,790,2007,0,98055,47.4482,-122.206,2850,4500,9,15,2014,N,330,369
8562790310,3/24/2015,839704.0,4,3.25,2950,4161,2.0,0.0,0.0,3,10,2210,740,2014,0,98027,47.5297,-122.073,2790,3693,3,24,2015,N,160,468
2767604425,1/29/2015,535000.0,3,3.25,1430,1276,3.0,0.0,0.0,3,8,1430,0,2007,0,98107,47.6712,-122.38,1430,1243,1,29,2015,N,0,33
306000565,8/25/2014,290000.0,2,1.5,1020,1275,3.0,0.0,0.0,3,8,1020,0,2008,0,98103,47.7003,-122.346,980,1415,8,25,2014,N,40,-140
6130500060,7/21/2014,370000.0,3,2.5,1650,1793,3.0,0.0,0.0,3,8,1650,0,2007,0,98133,47.7107,-122.33200000000001,1650,1863,7,21,2014,N,0,-70
3362400125,3/3/2015,405000.0,3,2.0,1060,651,3.0,0.0,0.0,3,7,1060,0,2007,0,98103,47.6828,-122.345,1440,1501,3,3,2015,N,-380,-850
1442880510,5/30/2014,499431.0,4,2.75,2620,6019,2.0,0.0,0.0,3,8,2620,0,2013,0,98045,47.483999999999995,-121.771,2790,6716,5,30,2014,N,-170,-697
9188200505,7/10/2014,275000.0,4,2.5,1830,3868,2.0,0.0,0.0,3,7,1830,0,2007,0,98118,47.5186,-122.27600000000001,2330,3868,7,10,2014,N,-500,0
1865400075,5/22/2014,320000.0,3,2.25,998,844,2.0,0.0,0.0,3,7,798,200,2007,0,98117,47.6983,-122.367,998,1110,5,22,2014,N,0,-266
7853320550,8/5/2014,425000.0,4,2.5,2070,4427,2.0,0.0,0.0,3,7,2070,0,2007,0,98065,47.5208,-121.869,2070,4556,8,5,2014,N,0,-129
9831200172,2/27/2015,1450000.0,4,3.5,2860,2199,3.0,0.0,0.0,3,10,2860,0,2013,0,98102,47.6262,-122.323,1990,1378,2,27,2015,N,870,821
8141300030,2/10/2015,340000.0,3,2.0,1920,5688,1.0,0.0,3.0,3,9,1920,0,2007,0,98022,47.1952,-121.976,2384,4802,2,10,2015,N,-464,886
7899800863,10/1/2014,299900.0,3,2.5,1210,2046,2.0,0.0,0.0,3,9,920,290,2008,0,98106,47.5212,-122.35700000000001,1070,651,10,1,2014,N,140,1395
745530240,12/26/2014,865950.0,5,3.5,4890,12039,2.0,0.0,0.0,3,9,3590,1300,2014,0,98011,47.7338,-122.208,4590,10079,12,26,2014,N,300,1960
4055700784,8/15/2014,720000.0,4,2.5,3420,17038,2.0,0.0,0.0,3,9,3420,0,2007,0,98034,47.718,-122.241,2520,14190,8,15,2014,N,900,2848
1180000830,10/2/2014,460000.0,4,3.5,2870,3225,2.0,0.0,3.0,3,9,2070,800,2006,0,98178,47.5009,-122.225,1770,6450,10,2,2014,N,1100,-3225
291310270,11/19/2014,375000.0,3,2.5,1600,2042,2.0,0.0,0.0,3,8,1600,0,2005,0,98027,47.5341,-122.06700000000001,1445,1370,11,19,2014,N,155,672
1934800162,5/11/2015,386180.0,2,1.5,960,1829,2.0,0.0,0.0,3,7,960,0,2005,0,98122,47.6032,-122.30799999999999,1470,1829,5,11,2015,N,-510,0
2309710070,1/14/2015,280000.0,3,2.75,1740,5639,1.0,0.0,3.0,3,7,1740,0,2010,0,98022,47.1942,-121.977,2380,5331,1,14,2015,N,-640,308
6181500340,8/8/2014,359000.0,4,2.5,2575,4725,2.0,0.0,0.0,3,8,2575,0,2011,0,98001,47.3058,-122.277,2575,5323,8,8,2014,N,0,-598
7853220390,5/2/2014,785000.0,5,3.25,3660,11995,2.0,0.0,2.0,3,10,3660,0,2006,0,98065,47.5337,-121.86,3320,11241,5,2,2014,N,340,754
9834201375,2/6/2015,425000.0,3,2.25,1420,1230,2.0,0.0,0.0,3,8,940,480,2009,0,98144,47.5703,-122.288,1400,1230,2,6,2015,N,20,0
5214510060,5/4/2015,575000.0,5,2.5,3070,7200,2.0,0.0,0.0,3,8,3070,0,2005,0,98059,47.4939,-122.137,2590,7200,5,4,2015,N,480,0
3221079050,3/3/2015,465000.0,3,2.5,1920,144619,1.0,0.0,0.0,3,8,1920,0,2014,0,98022,47.2683,-121.946,2010,48787,3,3,2015,N,-90,95832
1266200140,5/6/2015,1850000.0,4,3.25,4160,10335,2.0,0.0,0.0,3,10,4160,0,2014,0,98004,47.6235,-122.19200000000001,1840,10333,5,6,2015,N,2320,2
2523039346,2/18/2015,720000.0,4,3.25,3276,10801,2.0,0.0,0.0,3,9,3276,0,2008,0,98166,47.4585,-122.361,2010,11656,2,18,2015,N,1266,-855
1624049293,5/6/2014,390000.0,5,3.75,2890,5000,1.0,0.0,0.0,3,7,1310,1580,2006,0,98108,47.5701,-122.296,1930,5117,5,6,2014,N,960,-117
1973700030,4/29/2015,2210000.0,3,2.5,3430,10177,2.0,0.0,0.0,3,10,3430,0,2014,0,98034,47.7159,-122.251,3110,12339,4,29,2015,N,320,-2162
1070000390,7/2/2014,1050000.0,4,3.5,3390,3979,2.0,0.0,0.0,3,9,2610,780,2014,0,98199,47.6482,-122.40799999999999,3350,4165,7,2,2014,N,40,-186
2524059269,6/10/2014,915000.0,6,3.75,2930,14980,2.0,0.0,3.0,3,9,2930,0,2013,0,98006,47.5441,-122.117,3210,10787,6,10,2014,N,-280,4193
1972200326,4/22/2015,562000.0,2,2.25,1300,1314,3.0,0.0,0.0,3,8,1300,0,2008,0,98103,47.6536,-122.35600000000001,1300,1312,4,22,2015,N,0,2
3796000400,11/20/2014,349000.0,2,1.75,1250,1208,2.0,0.0,0.0,3,7,1040,210,2007,0,98144,47.6004,-122.29899999999999,1250,1656,11,20,2014,N,0,-448
321030070,8/14/2014,375000.0,4,2.5,2310,7800,2.0,0.0,0.0,3,8,2310,0,2011,0,98042,47.3737,-122.164,2310,7140,8,14,2014,N,0,660
476000118,12/12/2014,479950.0,2,2.25,1360,1336,3.0,0.0,0.0,3,8,1360,0,2008,0,98107,47.6714,-122.39200000000001,1280,1295,12,12,2014,N,80,41
2909310060,1/9/2015,319000.0,4,2.5,2020,5100,2.0,0.0,0.0,3,7,2020,0,2010,0,98023,47.2822,-122.35700000000001,2300,5685,1,9,2015,N,-280,-585
832700240,10/3/2014,325000.0,3,1.5,1270,1067,3.0,0.0,0.0,3,8,1270,0,2009,0,98133,47.7236,-122.353,1090,1118,10,3,2014,N,180,-51
1442880570,8/21/2014,505657.0,4,2.75,2790,8092,2.0,0.0,0.0,3,8,2790,0,2013,0,98045,47.4834,-121.773,2790,6154,8,21,2014,N,0,1938
9542840060,3/5/2015,340000.0,4,2.5,2320,4142,2.0,0.0,0.0,3,7,2320,0,2010,0,98038,47.3662,-122.01899999999999,2150,4140,3,5,2015,N,170,2
629650370,1/23/2015,250000.0,3,2.5,1750,6351,2.0,0.0,0.0,3,7,1750,0,2012,0,98001,47.2589,-122.256,1398,6092,1,23,2015,N,352,259
7967000060,9/26/2014,349500.0,4,2.5,2030,4596,2.0,0.0,0.0,3,8,2030,0,2014,0,98001,47.3515,-122.275,2040,4705,9,26,2014,N,-10,-109
3904100041,4/24/2015,290750.0,3,2.5,1270,865,2.0,0.0,0.0,3,7,1080,190,2008,0,98118,47.5351,-122.279,1630,7752,4,24,2015,N,-360,-6887
9268850860,5/5/2015,715000.0,5,3.25,2710,2356,2.0,0.0,0.0,3,8,2230,480,2013,0,98027,47.5394,-122.02799999999999,2160,2108,5,5,2015,N,550,248
1454100127,8/11/2014,689950.0,4,2.75,2520,8433,2.0,0.0,0.0,3,8,2520,0,2014,0,98125,47.7214,-122.289,1890,7772,8,11,2014,N,630,661
2856101290,9/24/2014,425000.0,2,2.5,1340,1263,3.0,0.0,0.0,3,8,1340,0,2008,0,98117,47.6788,-122.38799999999999,1510,1260,9,24,2014,N,-170,3
2767601872,1/19/2015,657000.0,2,3.0,1570,1281,3.0,0.0,0.0,3,8,1570,0,2014,0,98107,47.6741,-122.384,1570,2500,1,19,2015,N,0,-1219
255370570,11/20/2014,359950.0,4,3.5,2690,5564,2.0,0.0,0.0,3,7,2690,0,2007,0,98038,47.3537,-122.01799999999999,2210,4046,11,20,2014,N,480,1518
301401370,7/31/2014,319900.0,4,2.75,2475,4276,2.0,0.0,0.0,3,7,2475,0,2014,0,98002,47.345,-122.21,2475,4000,7,31,2014,N,0,276
1604601804,4/16/2015,532000.0,3,3.75,2260,2050,2.0,0.0,0.0,3,9,1170,1090,2010,0,98118,47.566,-122.29,2130,3082,4,16,2015,N,130,-1032
6749700004,3/30/2015,291000.0,2,1.0,840,863,3.0,0.0,0.0,3,8,840,0,2008,0,98103,47.6974,-122.34899999999999,1110,1190,3,30,2015,N,-270,-327
1806900499,7/21/2014,675000.0,3,3.25,1720,1330,2.0,0.0,0.0,3,8,1030,690,2004,0,98112,47.62,-122.309,1720,1520,7,21,2014,N,0,-190
7625703435,1/21/2015,885000.0,3,2.25,2940,6500,3.0,0.0,0.0,3,9,2940,0,2014,0,98136,47.5482,-122.38799999999999,1680,6500,1,21,2015,N,1260,0
7324900016,10/21/2014,1450000.0,5,3.5,4170,9090,2.0,0.0,0.0,3,10,4170,0,2008,0,98004,47.5918,-122.196,1930,13635,10,21,2014,N,2240,-4545
3575303430,10/16/2014,780000.0,6,4.25,4310,10000,2.0,0.0,0.0,3,8,2950,1360,2008,0,98074,47.6214,-122.06200000000001,2100,10000,10,16,2014,N,2210,0
9492500140,7/12/2014,839950.0,4,2.75,3010,7200,2.0,0.0,0.0,3,9,3010,0,2014,0,98033,47.6948,-122.179,3010,7203,7,12,2014,N,0,-3
9268851670,4/24/2015,645000.0,3,2.5,2170,1984,2.5,0.0,0.0,3,8,2170,0,2008,0,98027,47.5401,-122.027,2150,1984,4,24,2015,N,20,0
301400830,12/23/2014,263000.0,3,2.5,1584,3200,2.0,0.0,0.0,3,7,1584,0,2011,0,98002,47.3451,-122.215,1584,2800,12,23,2014,N,0,400
4310702918,10/30/2014,345000.0,2,2.25,1110,1290,3.0,0.0,0.0,3,8,1110,0,2006,0,98103,47.6968,-122.34,1360,1251,10,30,2014,N,-250,39
4305600240,11/25/2014,505000.0,4,2.5,2420,5006,2.0,0.0,0.0,3,8,2420,0,2013,0,98059,47.4795,-122.126,2750,5471,11,25,2014,N,-330,-465
7169500200,9/3/2014,522500.0,2,2.25,1430,1210,2.0,0.0,0.0,3,8,1340,90,2005,0,98115,47.6765,-122.301,1430,1016,9,3,2014,N,0,194
3943600070,8/11/2014,400000.0,3,2.5,2393,4788,2.0,0.0,0.0,3,8,2393,0,2012,0,98055,47.4517,-122.204,2439,5477,8,11,2014,N,-46,-689
1048000060,6/19/2014,543000.0,3,2.25,1240,949,3.0,0.0,0.0,3,8,1240,0,2008,0,98103,47.6488,-122.334,1310,1140,6,19,2014,N,-70,-191
3449500045,10/13/2014,495000.0,4,2.5,2980,12075,1.0,0.0,0.0,3,8,1910,1070,2007,0,98056,47.5074,-122.17200000000001,2240,12075,10,13,2014,N,740,0
1438000200,9/11/2014,549995.0,4,3.5,2970,6587,2.0,0.0,0.0,3,8,2260,710,2014,0,98059,47.4776,-122.12200000000001,2970,5690,9,11,2014,N,0,897
5424100030,2/11/2015,327555.0,3,2.5,2329,5720,2.0,0.0,0.0,3,8,2329,0,2010,0,98030,47.361999999999995,-122.2,2197,5720,2,11,2015,N,132,0
7853270710,4/9/2015,690000.0,5,3.25,3340,9075,2.0,0.0,0.0,3,8,2600,740,2005,0,98065,47.5446,-121.88,2770,6646,4,9,2015,N,570,2429
9161100075,3/18/2015,673000.0,4,2.25,2580,2875,2.0,0.0,0.0,3,9,2580,0,2015,0,98116,47.5674,-122.39200000000001,1290,5750,3,18,2015,N,1290,-2875
1085622860,7/21/2014,384435.0,3,2.5,2029,3906,2.0,0.0,0.0,3,9,2029,0,2014,0,98003,47.341,-122.18,2029,3920,7,21,2014,N,0,-14
9578090240,8/15/2014,780000.0,4,2.75,3430,6500,2.0,0.0,0.0,3,9,3050,380,2006,0,98052,47.7079,-122.10600000000001,3070,6802,8,15,2014,N,360,-302
4083306045,10/29/2014,1380000.0,5,3.75,3330,5042,2.0,0.0,2.0,3,9,2470,860,2014,0,98103,47.6497,-122.339,1780,3990,10,29,2014,N,1550,1052
6666830320,3/24/2015,950968.0,5,3.5,3220,5081,2.0,0.0,0.0,3,8,3220,0,2013,0,98052,47.7048,-122.111,2970,5753,3,24,2015,N,250,-672
8562780160,3/29/2015,334950.0,2,2.25,1240,750,2.0,0.0,0.0,3,7,1150,90,2008,0,98027,47.5322,-122.073,1240,750,3,29,2015,N,0,0
2767704603,6/9/2014,489000.0,3,3.5,1500,1249,2.0,0.0,0.0,3,8,1240,260,2004,0,98107,47.6727,-122.37299999999999,1440,1850,6,9,2014,N,60,-601
5631500292,4/20/2015,600000.0,3,3.0,3530,8345,2.0,0.0,0.0,3,10,3530,0,2006,0,98028,47.7338,-122.234,1940,9600,4,20,2015,N,1590,-1255
2424039036,8/22/2014,282000.0,3,2.25,1260,915,2.0,0.0,0.0,3,8,1020,240,2007,0,98106,47.555,-122.363,1260,1056,8,22,2014,N,0,-141
2867300030,8/1/2014,442000.0,4,4.0,4168,8485,2.0,0.0,0.0,3,10,3222,946,2007,0,98023,47.3029,-122.387,4362,8100,8,1,2014,N,-194,385
6661200260,5/12/2015,220000.0,2,1.5,1030,2850,2.0,0.0,0.0,3,7,1030,0,1995,0,98038,47.3845,-122.039,1030,3000,5,12,2015,UNK,0,-150
7238000240,2/18/2015,489000.0,3,2.5,3080,5598,2.0,0.0,0.0,3,8,3080,0,2006,0,98055,47.4372,-122.206,3080,5303,2,18,2015,N,0,295
4051150070,12/23/2014,250000.0,3,1.5,1072,4339,2.0,0.0,0.0,3,7,1072,0,2009,0,98042,47.386,-122.162,1443,4341,12,23,2014,N,-371,-2
1442880320,7/24/2014,484259.0,4,2.75,2790,5000,2.0,0.0,0.0,3,8,2790,0,2014,0,98045,47.4831,-121.773,2620,5527,7,24,2014,N,170,-527
3616600003,3/2/2015,1680000.0,3,2.5,4090,16972,2.0,0.0,2.0,3,11,3590,500,2007,0,98177,47.7258,-122.37,3740,16972,3,2,2015,N,350,0
3862710030,4/24/2015,450000.0,3,2.5,1800,4357,2.0,0.0,0.0,3,8,1800,0,2013,0,98065,47.5337,-121.84100000000001,1800,3663,4,24,2015,N,0,694
9828201361,11/14/2014,299000.0,2,1.5,830,1276,2.0,0.0,0.0,3,7,830,0,2005,0,98122,47.6175,-122.29700000000001,1540,1484,11,14,2014,N,-710,-208
4019500030,10/29/2014,450000.0,3,2.5,2280,4557,2.0,0.0,0.0,3,8,2280,0,2010,0,98028,47.7733,-122.266,2070,4610,10,29,2014,N,210,-53
3630240140,1/23/2015,585000.0,4,3.0,2110,1286,2.0,0.0,0.0,3,9,1710,400,2007,0,98029,47.5444,-122.014,2000,1286,1,23,2015,N,110,0
5695000270,11/3/2014,660000.0,3,2.25,1570,1680,3.0,0.0,0.0,3,8,1570,0,2014,0,98103,47.6585,-122.348,1290,1870,11,3,2014,N,280,-190
2349300069,5/12/2014,301500.0,2,1.5,830,1333,2.0,0.0,0.0,3,7,830,0,2005,0,98136,47.5506,-122.381,1120,4822,5,12,2014,N,-290,-3489
6790830060,9/15/2014,949950.0,4,3.75,4120,8258,2.0,0.0,0.0,3,10,4120,0,2012,0,98075,47.5872,-122.055,3730,8332,9,15,2014,N,390,-74
3630200640,10/30/2014,759990.0,4,2.5,2540,5760,2.0,0.0,0.0,3,9,2540,0,2009,0,98029,47.5405,-121.993,2580,3600,10,30,2014,N,-40,2160
7967000160,3/16/2015,355000.0,4,2.75,2050,4000,2.0,0.0,0.0,3,8,2050,0,2014,0,98001,47.3522,-122.275,2050,4000,3,16,2015,N,0,0
9492500160,7/23/2014,889950.0,4,2.75,3080,7242,2.0,0.0,0.0,3,9,3080,0,2014,0,98033,47.6948,-122.178,3010,7205,7,23,2014,N,70,37
9268851740,7/1/2014,629800.0,3,2.5,2390,1984,2.0,0.0,0.0,3,8,2220,170,2008,0,98027,47.5405,-122.027,2150,1984,7,1,2014,N,240,0
3342100421,4/24/2015,745000.0,4,2.5,3170,5100,2.0,0.0,0.0,3,9,3170,0,2012,0,98056,47.5187,-122.208,1580,5100,4,24,2015,N,1590,0
6362900138,11/3/2014,379900.0,2,1.5,1240,1331,2.0,0.0,0.0,3,7,1050,190,2007,0,98144,47.5959,-122.29799999999999,1250,1431,11,3,2014,N,-10,-100
9358001422,11/14/2014,335000.0,3,2.5,1090,1139,2.0,0.0,0.0,3,8,960,130,2009,0,98126,47.5664,-122.369,1400,1348,11,14,2014,N,-310,-209
7853280350,5/12/2014,809000.0,5,4.5,4630,6324,2.0,0.0,0.0,3,9,3210,1420,2006,0,98065,47.5382,-121.86,4420,6790,5,12,2014,N,210,-466
7853361420,8/26/2014,569950.0,4,2.5,3230,5899,2.0,0.0,0.0,3,8,3230,0,2012,0,98065,47.515,-121.869,2720,5899,8,26,2014,N,510,0
7852120030,8/8/2014,723000.0,4,3.5,3510,9263,2.0,0.0,0.0,3,10,3510,0,2001,0,98065,47.5413,-121.87700000000001,3690,10417,8,8,2014,UNK,-180,-1154
731500320,11/10/2014,282000.0,4,2.5,1785,2552,2.0,0.0,0.0,3,8,1785,0,2009,0,98030,47.3582,-122.2,1691,2700,11,10,2014,N,94,-148
6056100102,10/30/2014,569900.0,5,3.25,2360,3873,2.0,0.0,0.0,3,8,1990,370,2006,0,98108,47.5635,-122.29899999999999,1720,3071,10,30,2014,N,640,802
1823049179,1/21/2015,385000.0,4,2.0,2340,9716,1.0,0.0,0.0,3,7,2340,0,2009,0,98146,47.4842,-122.34700000000001,1180,13500,1,21,2015,N,1160,-3784
9268850030,7/7/2014,420000.0,3,2.25,1620,1075,3.0,0.0,0.0,3,8,1540,80,2009,0,98027,47.5405,-122.02600000000001,1620,1237,7,7,2014,N,0,-162
9831200159,8/6/2014,2250000.0,3,3.25,3890,3452,2.0,0.0,0.0,3,12,2890,1000,2006,0,98102,47.62600000000001,-122.323,2860,2199,8,6,2014,N,1030,1253
8924100370,9/15/2014,1210000.0,4,3.5,3590,5335,2.0,0.0,2.0,3,9,3140,450,2006,0,98115,47.6762,-122.26700000000001,2100,6250,9,15,2014,N,1490,-915
8669150700,12/8/2014,292000.0,4,3.0,1984,4460,2.0,0.0,0.0,3,7,1984,0,2012,0,98002,47.3532,-122.211,2095,3402,12,8,2014,N,-111,1058
889000024,3/16/2015,645000.0,3,2.25,1640,1023,3.0,0.0,0.0,3,8,1640,0,2014,0,98105,47.6636,-122.319,1720,1960,3,16,2015,N,-80,-937
9268850350,3/19/2015,304500.0,4,2.0,1350,942,3.0,0.0,0.0,3,7,1350,0,2008,0,98027,47.5394,-122.02600000000001,1390,942,3,19,2015,N,-40,0
2619950310,5/7/2015,489500.0,4,3.5,2730,5707,2.0,0.0,0.0,3,8,2000,730,2011,0,98019,47.7327,-121.965,2430,5899,5,7,2015,N,300,-192
7430200060,4/24/2015,1580000.0,4,4.0,5610,11063,3.0,0.0,0.0,3,11,4750,860,2006,0,98074,47.65,-122.065,4560,11063,4,24,2015,N,1050,0
5100400251,1/6/2015,390000.0,2,1.0,962,1992,2.0,0.0,0.0,3,7,962,0,2012,0,98115,47.6911,-122.31299999999999,1130,1992,1,6,2015,N,-168,0
2597490030,10/2/2014,815000.0,4,3.5,3040,4006,2.0,0.0,0.0,3,8,2350,690,2013,0,98029,47.5439,-122.01100000000001,2050,4000,10,2,2014,N,990,6
3655500030,4/3/2015,719000.0,3,3.5,2540,10578,2.0,0.0,1.0,3,9,2010,530,2014,0,98006,47.547,-122.19200000000001,3240,9831,4,3,2015,N,-700,747
3751600784,4/3/2015,331210.0,4,2.5,2240,4800,2.0,0.0,0.0,3,8,2240,0,2014,0,98001,47.2911,-122.266,2240,5040,4,3,2015,N,0,-240
6781200013,5/7/2014,245000.0,3,1.5,1260,1270,2.0,0.0,0.0,3,7,1040,220,2005,0,98133,47.7111,-122.331,1260,1472,5,7,2014,N,0,-202
2619950060,9/9/2014,465000.0,5,4.0,3210,7200,2.0,0.0,0.0,3,8,2410,800,2011,0,98019,47.7329,-121.96600000000001,2750,7200,9,9,2014,N,460,0
9523100731,9/30/2014,580000.0,3,2.5,1620,1171,3.0,0.0,4.0,3,8,1470,150,2008,0,98103,47.6681,-122.355,1620,1505,9,30,2014,N,0,-334
9272201318,4/14/2015,540000.0,3,2.0,1580,1972,2.5,0.0,2.0,3,8,1180,400,2007,0,98116,47.5903,-122.38600000000001,1500,1908,4,14,2015,N,80,64
5676000004,11/18/2014,399000.0,3,2.5,1430,1250,3.0,0.0,0.0,3,7,1430,0,2007,0,98103,47.6904,-122.34200000000001,1360,1269,11,18,2014,N,70,-19
8091670070,8/4/2014,328000.0,4,2.5,1850,5388,2.0,0.0,0.0,3,8,1850,0,2009,0,98038,47.3494,-122.041,2140,5086,8,4,2014,N,-290,302
7853380570,5/11/2015,701000.0,4,2.5,3340,5314,2.0,0.0,0.0,3,10,3340,0,2010,0,98065,47.5167,-121.885,3220,5500,5,11,2015,N,120,-186
8091670200,10/22/2014,408000.0,3,2.75,2670,4800,2.0,0.0,0.0,3,8,2670,0,2014,0,98038,47.3483,-122.042,2340,5000,10,22,2014,N,330,-200
8084900160,2/12/2015,2640000.0,5,4.25,4660,16200,2.0,0.0,2.0,3,11,4660,0,2005,0,98004,47.6326,-122.21600000000001,3340,16200,2,12,2015,N,1320,0
1498300875,8/14/2014,445000.0,3,2.5,1550,930,2.0,0.0,0.0,3,8,1060,490,2006,0,98144,47.5857,-122.314,1550,1301,8,14,2014,N,0,-371
7853270200,10/21/2014,672500.0,4,2.5,3470,6651,2.0,0.0,0.0,3,9,3470,0,2005,0,98065,47.5426,-121.87899999999999,2730,6179,10,21,2014,N,740,472
9211010320,7/9/2014,538000.0,3,2.5,3010,7014,2.0,0.0,0.0,3,8,3010,0,2009,0,98059,47.4949,-122.149,3030,6180,7,9,2014,N,-20,834
2867300160,9/4/2014,450000.0,5,3.5,3931,9497,2.0,0.0,0.0,3,10,2650,1281,2014,0,98023,47.3008,-122.38600000000001,3510,9497,9,4,2014,N,421,0
3278605570,6/19/2014,362500.0,3,2.5,1800,2700,2.0,0.0,0.0,3,8,1800,0,2011,0,98126,47.5458,-122.369,1380,1200,6,19,2014,N,420,1500
4310702858,10/15/2014,414950.0,3,2.5,1570,1551,3.0,0.0,0.0,3,8,1570,0,2008,0,98103,47.6961,-122.34100000000001,1570,1705,10,15,2014,N,0,-154
2838000030,1/27/2015,679950.0,3,2.5,2230,3939,2.0,0.0,0.0,3,8,2230,0,2014,0,98133,47.73,-122.335,2230,4200,1,27,2015,N,0,-261
1673000240,11/12/2014,290000.0,4,2.5,2423,7292,2.0,0.0,0.0,3,8,2423,0,2005,0,98023,47.3227,-122.37,2495,7489,11,12,2014,N,-72,-197
7899800791,10/23/2014,230000.0,3,2.0,1160,1174,2.0,0.0,0.0,3,7,790,370,2007,0,98106,47.5225,-122.35700000000001,1160,994,10,23,2014,N,0,180
8682320160,2/20/2015,439950.0,2,2.0,1440,4666,1.0,0.0,0.0,3,8,1440,0,2010,0,98053,47.708999999999996,-122.01899999999999,1510,4595,2,20,2015,N,-70,71
8155870200,5/22/2014,349900.0,4,2.5,2052,3723,2.0,0.0,0.0,3,8,2052,0,2014,0,98003,47.2824,-122.295,2052,5250,5,22,2014,N,0,-1527
2858600083,12/22/2014,550000.0,5,2.5,2780,9272,2.0,0.0,0.0,3,8,2780,0,2014,0,98126,47.5168,-122.37799999999999,1150,8460,12,22,2014,N,1630,812
2391601195,4/30/2015,1050000.0,4,4.25,3720,5750,2.0,0.0,2.0,3,9,2960,760,2006,0,98116,47.5632,-122.399,2550,5750,4,30,2015,N,1170,0
976000903,3/19/2015,655000.0,2,2.25,1460,1851,2.0,0.0,0.0,3,9,1180,280,2014,0,98119,47.6461,-122.36200000000001,1800,4269,3,19,2015,N,-340,-2418
7904700128,11/10/2014,385000.0,3,3.5,1370,1540,2.0,0.0,0.0,3,8,1100,270,2006,0,98116,47.5638,-122.38799999999999,1370,915,11,10,2014,N,0,625
5609000311,4/10/2015,729999.0,6,4.5,3600,6110,2.0,0.0,0.0,3,9,2510,0,2012,0,98118,47.5687,-122.291,1360,5800,4,10,2015,N,2240,310
1972201963,6/16/2014,523950.0,3,2.25,1420,1282,3.0,0.0,0.0,3,8,1420,0,2006,0,98103,47.6533,-122.346,1530,1280,6,16,2014,N,-110,2
9272201704,5/12/2014,369000.0,2,2.5,980,895,2.0,0.0,0.0,3,8,670,310,2009,0,98116,47.5874,-122.38600000000001,980,899,5,12,2014,N,0,-4
8648900060,5/5/2014,509900.0,3,2.5,1790,2700,2.0,0.0,0.0,3,8,1790,0,2010,0,98027,47.56399999999999,-122.09299999999999,1890,3078,5,5,2014,N,-100,-378
3832050890,7/15/2014,282000.0,3,2.5,2010,5399,2.0,0.0,0.0,3,7,2010,0,2006,0,98042,47.3338,-122.052,2280,5141,7,15,2014,N,-270,258
255450340,8/27/2014,387865.0,3,2.5,2370,4200,2.0,0.0,0.0,3,8,2370,0,2014,0,98038,47.3696,-122.01799999999999,2370,4200,8,27,2014,N,0,0
2172000890,11/20/2014,385000.0,4,2.5,2560,6238,2.0,0.0,0.0,3,8,2560,0,2007,0,98178,47.4899,-122.255,2560,6240,11,20,2014,N,0,-2
6127010320,6/9/2014,536000.0,3,2.5,1900,6224,2.0,0.0,0.0,3,7,1900,0,2005,0,98075,47.5941,-122.00399999999999,2260,5450,6,9,2014,N,-360,774
2810100023,6/25/2014,395000.0,2,2.25,1350,1493,2.0,0.0,0.0,3,8,1050,300,2007,0,98136,47.5421,-122.38799999999999,1250,1202,6,25,2014,N,100,291
8011100125,11/17/2014,545000.0,4,2.75,2650,6717,2.0,0.0,0.0,3,10,2650,0,2014,0,98056,47.4947,-122.171,2740,7923,11,17,2014,N,-90,-1206
7852090390,4/13/2015,715000.0,4,2.5,3020,7035,2.0,0.0,4.0,3,9,3020,0,2001,0,98065,47.5344,-121.874,3020,6771,4,13,2015,UNK,0,264
3630080070,7/10/2014,348000.0,3,2.5,1500,2255,2.0,0.0,0.0,3,7,1500,0,2005,0,98029,47.5538,-121.99700000000001,1440,2040,7,10,2014,N,60,215
9126100765,8/1/2014,455000.0,3,1.75,1320,1014,3.0,0.0,0.0,3,9,1320,0,2015,0,98122,47.6047,-122.305,1380,1495,8,1,2014,N,-60,-481
7853380510,6/3/2014,575000.0,4,2.75,3120,7644,2.0,0.0,0.0,3,10,3120,0,2010,0,98065,47.5156,-121.884,2980,6050,6,3,2014,N,140,1594
993000136,10/7/2014,449950.0,3,2.25,1540,1270,3.0,0.0,0.0,3,7,1540,0,2014,0,98103,47.6935,-122.34100000000001,1230,1454,10,7,2014,N,310,-184
3278604510,6/25/2014,364000.0,3,2.5,1800,2790,2.0,0.0,0.0,3,8,1800,0,2011,0,98126,47.5455,-122.37100000000001,1580,2036,6,25,2014,N,220,754
2937300060,12/1/2014,932990.0,4,2.5,3640,6389,2.0,0.0,0.0,3,9,3640,0,2014,0,98052,47.7049,-122.12299999999999,3570,6303,12,1,2014,N,70,86
9510860060,6/27/2014,710000.0,3,2.5,2440,4153,2.0,0.0,0.0,3,9,2440,0,2003,0,98052,47.665,-122.087,2030,4143,6,27,2014,UNK,410,10
293070310,2/13/2015,949990.0,4,4.0,3970,7314,2.0,0.0,0.0,3,9,3970,0,2014,0,98074,47.6173,-122.056,3560,5258,2,13,2015,N,410,2056
255450400,7/31/2014,326989.0,3,2.5,2060,4200,2.0,0.0,0.0,3,8,2060,0,2014,0,98038,47.3706,-122.01700000000001,2370,4200,7,31,2014,N,-310,0
3845100140,7/8/2014,335606.0,3,2.5,2538,4600,2.0,0.0,0.0,3,8,2538,0,2013,0,98092,47.2584,-122.196,2570,4800,7,8,2014,N,-32,-200
3758900075,5/7/2014,1530000.0,5,4.5,4270,8076,2.0,0.0,0.0,3,11,3400,870,2007,0,98033,47.699,-122.206,4100,10631,5,7,2014,N,170,-2555
3395071610,11/26/2014,299950.0,3,2.5,1320,3150,2.0,0.0,0.0,3,7,1320,0,2005,0,98118,47.5328,-122.28200000000001,1390,1725,11,26,2014,N,-70,1425
9477580030,10/14/2014,962000.0,4,2.75,3340,5700,2.0,0.0,0.0,3,11,3340,0,2013,0,98059,47.5059,-122.146,3340,6940,10,14,2014,N,0,-1240
8138870060,8/13/2014,395825.0,2,2.5,1590,1679,2.0,0.0,0.0,3,8,1590,0,2012,0,98029,47.5449,-122.01100000000001,1590,1680,8,13,2014,N,0,-1
7237450030,10/14/2014,419354.0,5,2.75,2710,4500,2.0,0.0,0.0,3,8,2710,0,2014,0,98038,47.3547,-122.06200000000001,2710,4626,10,14,2014,N,0,-126
3767300041,8/26/2014,920000.0,4,2.75,3140,7258,2.0,0.0,1.0,3,10,3140,0,2006,0,98034,47.7064,-122.23200000000001,2990,13600,8,26,2014,N,150,-6342
291310370,8/29/2014,366000.0,3,2.25,1445,1028,2.0,0.0,0.0,3,7,1300,145,2005,0,98027,47.5339,-122.06700000000001,1445,1377,8,29,2014,N,0,-349
7853361230,5/16/2014,480000.0,4,2.5,2430,5000,2.0,0.0,0.0,3,7,2430,0,2009,0,98065,47.515,-121.87299999999999,2430,5441,5,16,2014,N,0,-441
7904700126,11/20/2014,388000.0,3,3.25,1370,915,2.0,0.0,0.0,3,8,1100,270,2006,0,98116,47.5639,-122.38799999999999,1370,1146,11,20,2014,N,0,-231
8085400376,4/21/2015,2320000.0,4,3.5,5050,9520,2.0,0.0,0.0,3,11,3610,1440,2007,0,98004,47.6364,-122.209,2430,9248,4,21,2015,N,2620,272
9828702851,1/21/2015,730000.0,3,2.5,1860,1290,2.0,0.0,0.0,3,9,1240,620,2010,0,98122,47.6179,-122.301,1710,1525,1,21,2015,N,150,-235
8562710550,5/21/2014,950000.0,5,3.75,5330,6000,2.0,0.0,2.0,3,10,3570,1760,2006,0,98027,47.5401,-122.073,4420,5797,5,21,2014,N,910,203
3278613210,7/28/2014,358990.0,3,3.25,1710,2171,2.0,0.0,0.0,3,7,1400,310,2014,0,98106,47.5434,-122.368,1380,1300,7,28,2014,N,330,871
7694200340,10/16/2014,398651.0,4,2.5,2650,4120,2.0,0.0,0.0,3,8,2650,0,2014,0,98146,47.5019,-122.34,2030,3768,10,16,2014,N,620,352
1839500055,11/14/2014,530000.0,4,2.5,2590,7891,2.0,0.0,0.0,3,9,2590,0,2006,0,98056,47.5055,-122.194,1400,7891,11,14,2014,N,1190,0
3448900320,7/23/2014,610360.0,4,2.5,2610,5562,2.0,0.0,0.0,3,9,2610,0,2013,0,98056,47.5137,-122.169,2720,7400,7,23,2014,N,-110,-1838
9267200226,5/2/2014,436110.0,3,2.5,1770,1235,3.0,0.0,0.0,3,8,1600,170,2007,0,98103,47.6965,-122.34200000000001,1680,1203,5,2,2014,N,90,32
2895730070,6/20/2014,925000.0,4,2.75,3730,8014,2.0,0.0,0.0,3,10,3730,0,2012,0,98074,47.6036,-122.059,3670,8279,6,20,2014,N,60,-265
2970800105,3/13/2015,449950.0,4,2.5,2420,5244,2.0,0.0,0.0,3,9,2420,0,2007,0,98166,47.4729,-122.35,1400,5250,3,13,2015,N,1020,-6
325059277,5/27/2014,760000.0,4,2.5,3330,7399,2.0,0.0,0.0,3,9,3330,0,2009,0,98052,47.678999999999995,-122.15299999999999,2640,8601,5,27,2014,N,690,-1202
6817750140,7/8/2014,293000.0,3,2.25,1910,3481,2.0,0.0,0.0,3,8,1910,0,2009,0,98055,47.4293,-122.18799999999999,1714,3177,7,8,2014,N,196,304
8682320640,2/12/2015,695000.0,2,2.5,2170,7665,1.0,0.0,2.0,3,8,2170,0,2013,0,98053,47.7112,-122.01899999999999,2300,7100,2,12,2015,N,-130,565
8669180390,6/4/2014,285000.0,3,2.5,2437,5136,2.0,0.0,0.0,3,7,2437,0,2011,0,98002,47.3517,-122.21,2437,4614,6,4,2014,N,0,522
4233600260,12/30/2014,1260000.0,5,4.0,4180,12042,2.0,0.0,0.0,3,10,4180,0,2014,0,98075,47.5959,-122.014,1800,6052,12,30,2014,N,2380,5990
3278611600,7/14/2014,379900.0,3,2.5,1800,2791,2.0,0.0,0.0,3,8,1800,0,2011,0,98126,47.5442,-122.37100000000001,1580,2617,7,14,2014,N,220,174
7787920160,4/27/2015,472000.0,5,2.5,2570,7412,2.0,0.0,0.0,3,8,2570,0,2006,0,98019,47.7265,-121.95700000000001,2890,8056,4,27,2015,N,-320,-644
2517101200,7/7/2014,300000.0,4,2.5,2090,5195,2.0,0.0,0.0,3,7,2090,0,2007,0,98031,47.3986,-122.166,2090,5236,7,7,2014,N,0,-41
6181420200,11/20/2014,272000.0,4,2.5,2789,3960,2.0,0.0,0.0,3,7,2789,0,2007,0,98001,47.3059,-122.28,2547,3960,11,20,2014,N,242,0
3845100550,11/20/2014,418395.0,4,2.5,2906,5893,2.0,0.0,0.0,3,9,2906,0,2014,0,98092,47.2599,-122.19200000000001,2680,4950,11,20,2014,N,226,943
7853321180,12/22/2014,465000.0,5,2.5,2550,6405,2.0,0.0,0.0,3,7,2550,0,2008,0,98065,47.5191,-121.869,2190,5900,12,22,2014,N,360,505
7502800030,7/16/2014,659950.0,4,2.75,3550,9400,2.0,0.0,0.0,3,9,3550,0,2014,0,98059,47.4827,-122.131,3550,9421,7,16,2014,N,0,-21
3869900139,1/7/2015,484950.0,3,2.25,1590,926,3.0,0.0,0.0,3,8,1590,0,2014,0,98136,47.5402,-122.387,1640,1321,1,7,2015,N,-50,-395
1332700200,4/26/2015,359000.0,3,2.25,1950,1968,2.0,0.0,0.0,4,7,1160,790,1979,0,98056,47.5179,-122.195,1950,1968,4,26,2015,UNK,0,0
9211010260,6/17/2014,519000.0,4,2.5,3250,4500,2.0,0.0,0.0,3,8,3250,0,2009,0,98059,47.4944,-122.149,3030,4518,6,17,2014,N,220,-18
4100500070,5/27/2014,1710000.0,5,4.5,4590,14685,2.0,0.0,0.0,3,10,4590,0,2009,0,98033,47.663999999999994,-122.2,3030,9486,5,27,2014,N,1560,5199
7708210070,6/17/2014,535000.0,4,2.75,3070,7201,2.0,0.0,0.0,3,9,3070,0,2006,0,98059,47.4897,-122.147,2880,8364,6,17,2014,N,190,-1163
7853270520,4/9/2015,622950.0,4,3.25,3030,7644,2.0,0.0,0.0,3,8,2830,200,2006,0,98065,47.5457,-121.881,3400,6908,4,9,2015,N,-370,736
5126300060,8/11/2014,515000.0,3,2.5,2610,5845,2.0,0.0,0.0,3,8,2610,0,2005,0,98059,47.4821,-122.14200000000001,2810,5000,8,11,2014,N,-200,845
2517000260,5/22/2014,330000.0,4,3.5,3150,6202,2.0,0.0,0.0,3,7,3150,0,2005,0,98042,47.3993,-122.162,2950,5940,5,22,2014,N,200,262
832700270,2/13/2015,318000.0,3,1.5,1240,983,3.0,0.0,0.0,3,8,1240,0,2009,0,98133,47.7235,-122.353,1240,1026,2,13,2015,N,0,-43
3022800260,10/7/2014,439000.0,3,2.5,1680,2801,2.0,0.0,0.0,3,7,1680,0,2011,0,98011,47.745,-122.181,1920,2723,10,7,2014,N,-240,78
254000241,3/24/2015,540000.0,3,2.5,2220,5279,2.0,0.0,0.0,3,8,2220,0,2006,0,98146,47.5132,-122.387,1610,5297,3,24,2015,N,610,-18
7237501370,7/17/2014,1080000.0,4,3.25,4800,12727,2.0,0.0,0.0,3,10,4800,0,2011,0,98059,47.5311,-122.134,4750,13602,7,17,2014,N,50,-875
662440030,3/26/2015,435000.0,4,2.5,3100,4699,2.0,0.0,0.0,3,9,3100,0,2010,0,98038,47.3785,-122.023,2450,5130,3,26,2015,N,650,-431
2524069078,1/22/2015,2700000.0,4,4.0,7850,89651,2.0,0.0,0.0,3,12,7850,0,2006,0,98027,47.5406,-121.98200000000001,6210,95832,1,22,2015,N,1640,-6181
8895800200,10/17/2014,1100000.0,4,2.75,3590,5625,2.0,0.0,0.0,3,10,3590,0,2012,0,98052,47.6959,-122.133,3590,5625,10,17,2014,N,0,0
9268850160,2/6/2015,293467.0,4,2.0,1590,942,3.0,0.0,0.0,3,7,1590,0,2008,0,98027,47.54,-122.02600000000001,1390,942,2,6,2015,N,200,0
7299600700,5/12/2015,328000.0,3,2.5,2242,4800,2.0,0.0,0.0,3,8,2242,0,2013,0,98092,47.2581,-122.2,2009,4800,5,12,2015,N,233,0
291310340,7/8/2014,550000.0,3,3.5,2490,3582,2.0,0.0,0.0,3,8,1720,770,2005,0,98027,47.5338,-122.06700000000001,1445,1590,7,8,2014,N,1045,1992
2768100510,4/2/2015,649000.0,3,2.0,1530,1442,3.0,0.0,0.0,3,9,1530,0,2015,0,98107,47.6692,-122.37200000000001,1620,1456,4,2,2015,N,-90,-14
1776230060,7/8/2014,435000.0,4,2.5,2150,3143,2.0,0.0,0.0,3,7,2150,0,2010,0,98059,47.5048,-122.154,2640,3200,7,8,2014,N,-490,-57
1772600510,6/20/2014,625000.0,3,2.5,2440,4800,2.0,0.0,0.0,3,10,2440,0,2014,0,98106,47.5595,-122.365,1180,5480,6,20,2014,N,1260,-680
8024200677,4/29/2015,415000.0,3,1.5,1270,1483,3.0,0.0,0.0,3,8,1270,0,2007,0,98115,47.6987,-122.31700000000001,1270,1413,4,29,2015,N,0,70
982850060,6/3/2014,400000.0,3,2.25,1450,4706,2.0,0.0,0.0,3,7,1450,0,2009,0,98028,47.761,-122.23200000000001,1490,4667,6,3,2014,N,-40,39
7518506715,5/6/2014,979000.0,3,2.5,2690,4047,3.0,0.0,0.0,3,10,2690,0,2014,0,98117,47.6797,-122.385,2040,5000,5,6,2014,N,650,-953
7202280390,2/20/2015,625250.0,4,2.5,2755,4831,2.0,0.0,0.0,3,7,2755,0,2003,0,98053,47.685,-122.039,2510,4831,2,20,2015,UNK,245,0
710600160,9/9/2014,665000.0,4,3.5,2650,3474,2.0,0.0,0.0,3,8,2230,420,2011,0,98027,47.5377,-122.046,2330,3474,9,9,2014,N,320,0
952005525,6/27/2014,589500.0,3,3.25,2310,3075,2.0,0.0,0.0,3,8,1730,580,2005,0,98116,47.5644,-122.383,2310,3075,6,27,2014,N,0,0
2487700274,3/9/2015,437000.0,2,3.0,1460,1452,2.0,0.0,0.0,3,8,1140,320,2007,0,98136,47.5224,-122.39,1460,1452,3,9,2015,N,0,0
3449000060,10/1/2014,320000.0,3,1.0,1400,9000,1.0,0.0,0.0,5,7,1400,0,1959,0,98059,47.5022,-122.145,1440,8400,10,1,2014,UNK,-40,600
7830800473,1/14/2015,333500.0,3,2.5,2196,7475,2.0,0.0,0.0,3,8,2196,0,2006,0,98030,47.3803,-122.204,1860,6755,1,14,2015,N,336,720
6056100370,11/24/2014,430000.0,3,2.25,2020,2750,2.0,0.0,0.0,3,8,1680,340,2008,0,98108,47.5633,-122.29700000000001,1720,1546,11,24,2014,N,300,1204
2126059295,8/5/2014,995500.0,5,4.5,4280,8465,2.0,0.0,0.0,3,10,4280,0,2014,0,98034,47.7325,-122.165,2990,11067,8,5,2014,N,1290,-2602
1442880340,6/3/2014,427874.0,3,3.0,2340,5002,2.0,0.0,0.0,3,8,2340,0,2013,0,98045,47.4831,-121.773,2790,5375,6,3,2014,N,-450,-373
7694200070,5/21/2014,334990.0,4,2.5,2220,4228,2.0,0.0,0.0,3,8,2220,0,2014,0,98146,47.5014,-122.34100000000001,2220,4157,5,21,2014,N,0,71
8562710640,2/11/2015,909500.0,4,4.0,4420,5940,2.0,0.0,0.0,3,10,3410,1010,2006,0,98027,47.5397,-122.072,4510,5797,2,11,2015,N,-90,143
3832050860,3/19/2015,210000.0,3,2.0,1580,4961,2.0,0.0,0.0,3,7,1580,0,2006,0,98042,47.3338,-122.053,2280,5000,3,19,2015,N,-700,-39
2526059225,1/23/2015,952990.0,4,2.75,3550,6558,2.0,0.0,0.0,3,9,3550,0,2013,0,98052,47.7076,-122.115,3140,5617,1,23,2015,N,410,941
1972200139,2/18/2015,622500.0,2,1.75,1510,851,3.0,0.0,0.0,3,8,1420,90,2013,0,98107,47.6536,-122.35799999999999,1300,1338,2,18,2015,N,210,-487
2768100186,6/18/2014,515000.0,3,3.5,1360,1419,2.0,0.0,0.0,3,8,1040,320,2007,0,98107,47.6697,-122.37100000000001,1560,1977,6,18,2014,N,-200,-558
6791400070,1/26/2015,350000.0,3,2.5,2040,13590,2.0,0.0,0.0,3,8,2040,0,2009,0,98042,47.3122,-122.04,1850,12485,1,26,2015,N,190,1105
424049284,10/16/2014,310000.0,1,1.5,1120,912,3.0,0.0,0.0,3,7,1120,0,2011,0,98144,47.5924,-122.29899999999999,1380,3200,10,16,2014,N,-260,-2288
7853280550,5/28/2014,700000.0,4,3.5,4490,5099,2.0,0.0,0.0,3,9,3390,1100,2006,0,98065,47.5394,-121.861,4290,5537,5,28,2014,N,200,-438
7768800270,7/15/2014,907687.0,4,2.5,3560,6786,2.0,0.0,0.0,3,9,2930,630,2014,0,98075,47.5756,-122.071,3560,5886,7,15,2014,N,0,900
8682320350,7/9/2014,741500.0,2,2.5,2150,5760,1.0,0.0,0.0,3,8,2150,0,2010,0,98053,47.7094,-122.01799999999999,1640,4680,7,9,2014,N,510,1080
1776460140,7/24/2014,395000.0,3,2.5,2130,5088,2.0,0.0,0.0,3,8,1840,290,2011,0,98019,47.7329,-121.976,2130,5762,7,24,2014,N,0,-674
5045700400,2/23/2015,559950.0,5,2.75,2990,6370,2.0,0.0,0.0,3,8,2990,0,2014,0,98059,47.4853,-122.154,2730,5740,2,23,2015,N,260,630
3356402702,7/25/2014,215000.0,4,2.5,1847,8000,2.0,0.0,0.0,3,7,1847,0,2008,0,98001,47.2872,-122.257,1847,8000,7,25,2014,N,0,0
2140950160,2/22/2015,390000.0,4,2.5,2610,7227,2.0,0.0,0.0,3,9,2610,0,2011,0,98010,47.31399999999999,-122.023,2630,7421,2,22,2015,N,-20,-194
2621069017,3/3/2015,425000.0,3,2.25,1670,107157,1.0,0.0,0.0,3,7,1670,0,2007,0,98022,47.2743,-122.009,3310,108900,3,3,2015,N,-1640,-1743
1422069070,5/7/2015,472000.0,3,2.5,1860,415126,2.0,0.0,0.0,3,7,1860,0,2006,0,98038,47.3974,-122.005,2070,54014,5,7,2015,N,-210,361112
2579500181,4/7/2015,1330000.0,4,3.5,3440,9776,2.0,0.0,0.0,3,10,3440,0,2006,0,98040,47.5374,-122.21600000000001,2400,11000,4,7,2015,N,1040,-1224
7852120140,6/10/2014,695000.0,4,3.5,3510,9364,2.0,0.0,0.0,3,10,3510,0,2001,0,98065,47.54,-121.876,3510,9161,6,10,2014,UNK,0,203
9274200324,1/20/2015,545000.0,3,2.5,1740,1279,3.0,0.0,0.0,3,8,1740,0,2008,0,98116,47.589,-122.387,1740,1280,1,20,2015,N,0,-1
422000075,7/11/2014,389950.0,4,2.5,2240,5500,2.0,0.0,0.0,3,8,2240,0,2013,0,98056,47.496,-122.169,700,5500,7,11,2014,N,1540,0
263000253,3/30/2015,380000.0,3,2.25,1550,1485,3.0,0.0,0.0,3,8,1550,0,2011,0,98103,47.6989,-122.346,1550,1480,3,30,2015,N,0,5
9268850140,11/17/2014,288790.0,4,2.0,1390,745,3.0,0.0,0.0,3,7,1390,0,2008,0,98027,47.5401,-122.02600000000001,1390,942,11,17,2014,N,0,-197
9306500200,4/1/2015,432500.0,3,3.0,2500,6000,2.0,0.0,0.0,3,8,2500,0,2012,0,98058,47.4408,-122.161,2130,6000,4,1,2015,N,370,0
8562770350,12/6/2014,615000.0,3,3.5,2710,3326,2.0,0.0,0.0,3,8,1650,1060,2005,0,98027,47.5371,-122.073,2280,2738,12,6,2014,N,430,588
2026049326,7/7/2014,500000.0,3,2.5,1720,3012,2.0,0.0,0.0,3,9,1720,0,2011,0,98133,47.7312,-122.334,1720,7658,7,7,2014,N,0,-4646
9126101090,5/31/2014,615000.0,3,2.25,1760,1146,3.0,0.0,0.0,3,9,1760,0,2014,0,98122,47.6073,-122.304,1346,3472,5,31,2014,N,414,-2326
2888000030,9/26/2014,500000.0,4,2.25,2270,8196,1.0,0.0,0.0,5,7,1150,1120,1963,0,98034,47.7214,-122.227,1920,10122,9,26,2014,UNK,350,-1926
8032700075,10/15/2014,622000.0,3,3.5,1690,1765,2.0,0.0,0.0,3,8,1370,320,2006,0,98103,47.6536,-122.34,1690,1694,10,15,2014,N,0,71
7853440140,4/9/2015,802945.0,5,3.5,4000,9234,2.0,0.0,0.0,3,9,4000,0,2015,0,98024,47.5265,-121.887,3690,6600,4,9,2015,N,310,2634
1245003330,7/31/2014,1260000.0,4,2.5,2880,9003,2.0,0.0,0.0,3,10,2880,0,2008,0,98033,47.6844,-122.199,2640,8126,7,31,2014,N,240,877
1176001124,2/24/2015,598950.0,3,2.5,1480,1531,3.0,0.0,0.0,3,8,1480,0,2014,0,98107,47.669,-122.402,1530,1321,2,24,2015,N,-50,210
7853360990,1/2/2015,430000.0,3,2.5,1950,4949,2.0,0.0,0.0,3,7,1950,0,2009,0,98065,47.5155,-121.87,2200,5740,1,2,2015,N,-250,-791
7853320030,11/24/2014,515000.0,4,2.75,2700,5150,2.0,0.0,0.0,3,9,2700,0,2009,0,98065,47.5209,-121.874,2700,5747,11,24,2014,N,0,-597
7576200012,7/17/2014,1260000.0,2,3.0,2210,3917,2.0,0.0,0.0,3,10,1500,710,2008,0,98122,47.6166,-122.291,1720,3933,7,17,2014,N,490,-16
7207900030,6/9/2014,400000.0,4,3.5,2370,3692,2.5,0.0,0.0,3,8,2370,0,2013,0,98056,47.5044,-122.17,2520,5425,6,9,2014,N,-150,-1733
952006827,4/22/2015,390000.0,3,2.5,1310,1254,2.0,0.0,0.0,3,7,850,460,2007,0,98116,47.5622,-122.384,1310,1372,4,22,2015,N,0,-118
7853321090,10/1/2014,450000.0,3,2.5,2410,4293,2.0,0.0,0.0,3,7,2410,0,2007,0,98065,47.5196,-121.869,2190,5900,10,1,2014,N,220,-1607
1042700060,5/16/2014,804995.0,5,1.5,3360,5402,2.0,0.0,0.0,3,9,3360,0,2014,0,98074,47.6067,-122.053,3360,5415,5,16,2014,N,0,-13
2597490140,3/26/2015,825000.0,4,3.25,3040,4155,2.0,0.0,0.0,3,8,2350,690,2013,0,98029,47.5429,-122.012,2680,4000,3,26,2015,N,360,155
7852130800,5/13/2014,435000.0,4,2.25,2140,6355,2.0,0.0,0.0,3,7,2140,0,2002,0,98065,47.5367,-121.88,2480,5746,5,13,2014,UNK,-340,609
7625702967,6/9/2014,398000.0,3,2.5,1720,1715,2.0,0.0,0.0,3,7,1240,480,2004,0,98136,47.5481,-122.384,1610,1626,6,9,2014,N,110,89
3845100640,6/5/2014,411605.0,4,2.5,2658,3960,2.0,0.0,0.0,3,9,2658,0,2014,0,98092,47.2603,-122.194,2578,4200,6,5,2014,N,80,-240
1773100922,12/8/2014,315000.0,3,3.25,1480,983,2.0,0.0,0.0,3,8,1180,300,2013,0,98106,47.5555,-122.363,1330,1062,12,8,2014,N,150,-79
2770602493,11/20/2014,455000.0,2,2.0,1350,1209,3.0,0.0,0.0,3,8,1350,0,2013,0,98199,47.648999999999994,-122.383,1310,982,11,20,2014,N,40,227
475000187,5/1/2015,452950.0,3,2.5,1150,1194,2.0,0.0,0.0,3,8,1020,130,2006,0,98107,47.6684,-122.365,1450,1714,5,1,2015,N,-300,-520
6056100383,5/20/2014,380000.0,3,1.75,1690,1468,2.0,0.0,0.0,3,8,1380,310,2008,0,98108,47.563,-122.29700000000001,1690,1936,5,20,2014,N,0,-468
6056111370,11/24/2014,340000.0,2,1.75,1270,1916,2.0,0.0,0.0,3,8,1270,0,2012,0,98108,47.5648,-122.294,1140,1916,11,24,2014,N,130,0
9578500510,11/3/2014,409950.0,3,2.5,2655,5080,2.0,0.0,0.0,3,8,2655,0,2013,0,98023,47.2972,-122.348,2879,5232,11,3,2014,N,-224,-152
9828701488,5/4/2015,360000.0,2,1.0,880,1165,2.0,0.0,0.0,3,8,880,0,2005,0,98122,47.6192,-122.29700000000001,1640,3825,5,4,2015,N,-760,-2660
6600000217,4/3/2015,1600000.0,4,4.25,4645,7757,2.0,0.0,0.0,3,10,3855,790,2006,0,98112,47.6248,-122.29,2150,6970,4,3,2015,N,2495,787
8024200685,5/20/2014,440000.0,3,1.5,1270,1443,3.0,0.0,0.0,3,8,1270,0,2007,0,98115,47.699,-122.31700000000001,1270,1413,5,20,2014,N,0,30
2923039264,9/10/2014,730000.0,2,1.75,1728,95950,1.0,0.0,3.0,3,9,1728,0,2012,0,98070,47.4579,-122.443,1720,35735,9,10,2014,N,8,60215
8073900070,5/22/2014,408000.0,3,2.25,1950,7221,1.0,0.0,0.0,4,8,1950,0,2006,0,98188,47.431000000000004,-122.285,2310,8125,5,22,2014,N,-360,-904
2419700030,8/25/2014,820000.0,4,2.5,3170,3862,3.0,0.0,0.0,3,8,3170,0,2008,0,98034,47.6705,-122.145,2840,4181,8,25,2014,N,330,-319
9396700024,7/31/2014,360000.0,2,2.5,1233,1244,2.0,0.0,0.0,3,7,963,270,2007,0,98136,47.5533,-122.381,1230,1300,7,31,2014,N,3,-56
3845100160,6/20/2014,339990.0,3,2.5,2570,4600,2.0,0.0,0.0,3,8,2570,0,2014,0,98092,47.2582,-122.196,2570,5000,6,20,2014,N,0,-400
9126100814,10/8/2014,515000.0,3,2.0,1560,1020,3.0,0.0,0.0,3,8,1560,0,2014,0,98122,47.605,-122.304,1560,1728,10,8,2014,N,0,-708
1982201595,1/21/2015,541000.0,3,1.75,1630,1166,2.0,0.0,0.0,3,8,1020,610,2013,0,98107,47.6646,-122.367,1420,1670,1,21,2015,N,210,-504
8151600973,4/6/2015,375000.0,4,2.5,2510,7245,2.0,0.0,0.0,3,9,2510,0,2007,0,98146,47.5096,-122.363,1830,8900,4,6,2015,N,680,-1655
2722059322,10/20/2014,320000.0,4,2.5,2223,5780,2.0,0.0,0.0,3,8,2223,0,2010,0,98042,47.3586,-122.15700000000001,1690,7766,10,20,2014,N,533,-1986
8562780090,2/27/2015,325000.0,2,2.25,1230,1058,2.0,0.0,0.0,3,7,1160,70,2008,0,98027,47.5325,-122.073,1240,817,2,27,2015,N,-10,241
3346300356,3/18/2015,740000.0,5,2.75,3050,7520,2.0,0.0,0.0,3,8,3050,0,2014,0,98056,47.5245,-122.184,2180,10800,3,18,2015,N,870,-3280
7237450600,10/30/2014,450000.0,5,2.75,2710,6220,2.0,0.0,0.0,3,8,2710,0,2014,0,98038,47.3555,-122.061,2530,4759,10,30,2014,N,180,1461
8944550100,7/23/2014,455000.0,4,2.5,2090,4400,2.0,0.0,0.0,3,8,2090,0,2011,0,98118,47.5403,-122.286,2090,3430,7,23,2014,N,0,970
3438502437,2/3/2015,292500.0,3,2.5,1440,1068,2.0,0.0,0.0,3,8,1160,280,2006,0,98106,47.5393,-122.361,1580,1483,2,3,2015,N,-140,-415
2423069039,8/6/2014,650000.0,3,2.5,2500,51836,1.0,0.0,0.0,3,9,1510,0,2013,0,98027,47.4694,-121.98899999999999,2270,54450,8,6,2014,N,230,-2614
8011100047,3/6/2015,530000.0,4,2.75,2740,7872,2.0,0.0,0.0,3,10,2740,0,2015,0,98056,47.4954,-122.17200000000001,1220,6300,3,6,2015,N,1520,1572
1042700300,8/4/2014,829995.0,5,3.25,3360,6120,2.0,0.0,0.0,3,9,3360,0,2014,0,98074,47.607,-122.053,3230,5398,8,4,2014,N,130,722
1776460110,12/23/2014,395000.0,4,2.75,2280,5013,2.0,0.0,0.0,3,8,2280,0,2009,0,98019,47.7333,-121.976,2130,5121,12,23,2014,N,150,-108
293070090,7/11/2014,859990.0,4,2.75,3520,5500,2.0,0.0,0.0,3,9,3520,0,2014,0,98074,47.6181,-122.056,3340,5500,7,11,2014,N,180,0
7548301044,7/10/2014,342500.0,2,1.5,1320,826,2.0,0.0,0.0,3,8,1100,220,2008,0,98144,47.5879,-122.304,1340,1213,7,10,2014,N,-20,-387
7203160090,12/5/2014,743000.0,4,2.75,3410,5838,2.0,0.0,0.0,3,9,3410,0,2012,0,98053,47.6931,-122.022,3420,7048,12,5,2014,N,-10,-1210
8096800110,12/15/2014,345000.0,3,2.25,2730,9388,1.0,0.0,0.0,3,7,1390,1340,1975,0,98030,47.3785,-122.185,2255,5701,12,15,2014,UNK,475,3687
3278600900,12/31/2014,443000.0,3,2.5,1780,2778,2.0,0.0,0.0,3,8,1530,250,2007,0,98126,47.5487,-122.37200000000001,1380,1998,12,31,2014,N,400,780
4051150100,9/29/2014,260000.0,3,2.5,1427,4337,2.0,0.0,0.0,3,7,1427,0,2009,0,98042,47.3857,-122.162,1443,4347,9,29,2014,N,-16,-10
925059311,7/22/2014,810000.0,4,2.5,2910,6555,2.0,0.0,0.0,3,9,2910,0,2005,0,98033,47.6659,-122.17200000000001,2910,10419,7,22,2014,N,0,-3864
4305600100,12/22/2014,570000.0,4,2.75,3250,5600,2.0,0.0,0.0,3,8,3250,0,2011,0,98059,47.4806,-122.125,2730,5667,12,22,2014,N,520,-67
2311400195,3/3/2015,1560000.0,5,3.5,3630,8100,2.0,0.0,0.0,3,10,3630,0,2008,0,98004,47.5951,-122.2,1730,8246,3,3,2015,N,1900,-146
1732800194,11/13/2014,840000.0,2,2.5,1680,975,3.0,0.0,0.0,3,9,1680,0,2009,0,98119,47.6321,-122.361,1680,977,11,13,2014,N,0,-2
5015001452,4/14/2015,950000.0,3,2.5,2280,2296,3.0,0.0,0.0,3,9,1890,390,2013,0,98112,47.6256,-122.29899999999999,1390,4000,4,14,2015,N,890,-1704
7853430690,1/27/2015,572800.0,3,2.5,3310,4682,2.0,0.0,0.0,3,9,2380,930,2015,0,98065,47.5201,-121.885,2660,5166,1,27,2015,N,650,-484
3821700038,10/1/2014,305000.0,3,3.0,1290,1112,3.0,0.0,0.0,3,7,1290,0,2008,0,98125,47.7282,-122.296,1230,9000,10,1,2014,N,60,-7888
5078400215,7/30/2014,1700000.0,5,4.75,3940,7067,2.0,0.0,0.0,3,10,3230,710,2008,0,98004,47.6232,-122.205,1910,7735,7,30,2014,N,2030,-668
1773100315,8/27/2014,445000.0,4,2.5,2170,6000,2.0,0.0,0.0,3,7,1630,540,2008,0,98106,47.5589,-122.365,1720,5668,8,27,2014,N,450,332
2224069165,9/2/2014,801000.0,4,3.5,3290,8059,2.0,0.0,0.0,3,9,3290,0,2012,0,98029,47.5573,-122.02,3290,10758,9,2,2014,N,0,-2699
9510861140,7/14/2014,711000.0,3,2.5,2550,5376,2.0,0.0,0.0,3,9,2550,0,2004,0,98052,47.6647,-122.083,2250,4050,7,14,2014,N,300,1326
3277801431,8/27/2014,268500.0,3,2.25,1140,977,2.0,0.0,0.0,3,7,850,290,2008,0,98126,47.5439,-122.375,1140,976,8,27,2014,N,0,1
1760650750,10/6/2014,320000.0,4,2.5,2300,3825,2.0,0.0,0.0,3,7,2300,0,2012,0,98042,47.3594,-122.08200000000001,2110,3825,10,6,2014,N,190,0
1607100038,9/21/2014,500000.0,4,3.25,2670,5001,1.0,0.0,0.0,3,9,1640,1030,2013,0,98108,47.5666,-122.29299999999999,1610,5001,9,21,2014,N,1060,0
1862400176,5/5/2014,631625.0,4,2.5,2440,6651,2.0,0.0,0.0,3,9,2440,0,2014,0,98117,47.6971,-122.37100000000001,1350,7653,5,5,2014,N,1090,-1002
5457801833,1/27/2015,850000.0,2,2.5,1611,2210,2.0,0.0,2.0,3,10,1611,0,2005,0,98109,47.6291,-122.34700000000001,2070,2182,1,27,2015,N,-459,28
8562770110,10/27/2014,600000.0,3,3.5,2710,3290,2.0,0.0,0.0,3,8,1650,1060,2006,0,98027,47.5367,-122.072,2440,3290,10,27,2014,N,270,0
2623039019,5/8/2014,988500.0,3,2.75,2015,16807,2.0,1.0,4.0,3,9,2015,0,2007,0,98166,47.45,-122.37700000000001,1780,12310,5,8,2014,N,235,4497
9578500690,3/27/2015,430236.0,4,3.25,3444,5166,2.0,0.0,0.0,3,8,2714,730,2014,0,98023,47.2966,-122.348,2848,5182,3,27,2015,N,596,-16
711000110,9/15/2014,1270000.0,3,2.5,3060,9576,2.0,0.0,0.0,3,10,3060,0,2005,0,98004,47.5928,-122.199,3060,9579,9,15,2014,N,0,-3
2597490750,4/28/2015,689500.0,4,2.5,2050,2772,2.0,0.0,0.0,3,8,2050,0,2013,0,98029,47.5431,-122.01100000000001,1800,2886,4,28,2015,N,250,-114
6056100165,12/1/2014,175003.0,3,1.5,1390,1882,2.0,0.0,0.0,3,7,1390,0,2014,0,98108,47.5667,-122.29700000000001,1490,2175,12,1,2014,N,-100,-293
2767603824,9/15/2014,459000.0,2,2.5,1240,1249,3.0,0.0,0.0,3,8,1240,0,2006,0,98107,47.6718,-122.38600000000001,1240,2500,9,15,2014,N,0,-1251
7237550110,4/24/2015,1180000.0,4,3.25,3750,74052,2.0,0.0,0.0,3,10,3750,0,2013,0,98053,47.658,-122.006,4920,74052,4,24,2015,N,-1170,0
2325300037,9/2/2014,358000.0,3,3.25,1410,1442,3.0,0.0,0.0,3,8,1360,50,2006,0,98125,47.7183,-122.31700000000001,1500,1200,9,2,2014,N,-90,242
1085623710,7/14/2014,447055.0,4,2.5,2448,4949,2.0,0.0,0.0,3,9,2448,0,2014,0,98030,47.3428,-122.179,2815,5446,7,14,2014,N,-367,-497
774100475,6/27/2014,415000.0,3,2.75,2600,64626,1.5,0.0,0.0,3,8,2600,0,2009,0,98014,47.7185,-121.405,1740,64626,6,27,2014,N,860,0
1489300215,10/13/2014,1210000.0,4,3.25,3330,9000,2.0,0.0,0.0,3,9,2870,460,2004,0,98033,47.6836,-122.208,2550,6349,10,13,2014,N,780,2651
9828702902,10/21/2014,495000.0,2,2.25,1160,1010,2.0,0.0,0.0,3,8,1000,160,2006,0,98112,47.6207,-122.301,1200,1170,10,21,2014,N,-40,-160
6371000100,11/20/2014,479000.0,2,2.25,1330,1380,2.0,0.0,0.0,3,8,1060,270,2005,0,98116,47.577,-122.41,1580,4802,11,20,2014,N,-250,-3422
2025069140,3/17/2015,1900000.0,3,2.5,2830,4334,3.0,1.0,4.0,3,10,2830,0,2006,0,98074,47.6318,-122.071,2830,38211,3,17,2015,N,0,-33877
2781280300,10/16/2014,249900.0,3,2.5,1610,3517,2.0,0.0,0.0,3,8,1610,0,2005,0,98055,47.4496,-122.189,1830,2889,10,16,2014,N,-220,628
9551201240,10/30/2014,1470000.0,4,2.5,2800,4000,2.0,0.0,0.0,3,9,2800,0,2011,0,98103,47.6695,-122.339,1770,4200,10,30,2014,N,1030,-200
2726059144,4/10/2015,1040000.0,5,3.75,4570,10194,2.0,0.0,0.0,3,11,4570,0,2006,0,98034,47.718,-122.161,2040,7560,4,10,2015,N,2530,2634
5363200100,10/20/2014,897000.0,4,2.5,2820,6120,2.0,0.0,0.0,3,9,2820,0,2014,0,98115,47.6911,-122.29299999999999,1510,6120,10,20,2014,N,1310,0
1725059330,3/27/2015,1100000.0,4,2.5,2570,9470,2.0,0.0,0.0,3,9,2570,0,2006,0,98033,47.6548,-122.19,2570,10663,3,27,2015,N,0,-1193
7234601140,11/13/2014,685000.0,3,2.25,1710,1193,2.0,0.0,0.0,3,9,1140,570,2014,0,98122,47.6173,-122.31,1510,1193,11,13,2014,N,200,0
3057000300,9/30/2014,295000.0,3,1.5,1220,3286,2.0,0.0,0.0,3,7,1220,0,1982,0,98033,47.7168,-122.189,1220,2640,9,30,2014,UNK,0,646
1972200553,8/4/2014,619000.0,3,2.25,1650,946,3.0,0.0,0.0,3,8,1650,0,2014,0,98103,47.6536,-122.354,1570,1283,8,4,2014,N,80,-337
6371000148,11/25/2014,439108.0,2,1.5,1130,1340,2.0,0.0,0.0,3,8,910,220,2008,0,98116,47.5761,-122.41,1310,1340,11,25,2014,N,-180,0
301400850,2/20/2015,260000.0,3,2.25,1489,2800,2.0,0.0,0.0,3,7,1489,0,2011,0,98002,47.3452,-122.215,1584,3200,2,20,2015,N,-95,-400
1123049232,6/6/2014,279000.0,5,2.5,2690,5557,2.0,0.0,0.0,3,7,2690,0,2012,0,98178,47.4914,-122.25299999999999,2090,10500,6,6,2014,N,600,-4943
3654200037,3/30/2015,380000.0,3,2.25,1530,1305,2.0,0.0,0.0,3,7,1116,414,2007,0,98177,47.7034,-122.35700000000001,1320,1427,3,30,2015,N,210,-122
7299601790,11/7/2014,287000.0,3,2.5,1600,6315,2.0,0.0,0.0,3,8,1600,0,2013,0,98092,47.2611,-122.198,1608,4300,11,7,2014,N,-8,2015
2771101921,12/11/2014,377000.0,2,1.5,1000,1251,2.0,0.0,0.0,3,7,930,70,2006,0,98199,47.6529,-122.384,1420,1187,12,11,2014,N,-420,64
3566800485,2/23/2015,649950.0,4,3.5,2440,3012,3.0,0.0,1.0,3,8,2440,0,2005,0,98117,47.6923,-122.39200000000001,1860,4650,2,23,2015,N,580,-1638
2767601311,10/24/2014,445000.0,3,2.5,1260,1102,3.0,0.0,0.0,3,8,1260,0,2007,0,98107,47.675,-122.387,1320,2500,10,24,2014,N,-60,-1398
9137101696,5/4/2015,605000.0,3,2.5,1660,1692,3.0,0.0,0.0,3,7,1610,50,2005,0,98115,47.6801,-122.322,1210,1230,5,4,2015,N,450,462
9528104345,9/23/2014,475000.0,3,2.25,1190,1137,2.0,0.0,0.0,3,7,960,230,1999,0,98115,47.677,-122.325,1190,1080,9,23,2014,UNK,0,57
3753000100,8/28/2014,399000.0,3,3.0,1520,1884,3.0,0.0,0.0,3,8,1520,0,2009,0,98125,47.7176,-122.28399999999999,1360,1939,8,28,2014,N,160,-55
6798100690,4/20/2015,718000.0,5,2.75,3250,8100,2.0,0.0,0.0,3,8,3250,0,2014,0,98125,47.7133,-122.311,1270,8100,4,20,2015,N,1980,0
148000475,5/28/2014,1400000.0,4,3.25,4700,9160,1.0,0.0,0.0,3,11,2520,2180,2005,0,98116,47.5744,-122.406,2240,8700,5,28,2014,N,2460,460
3277801417,5/16/2014,341000.0,3,2.5,1480,1663,2.0,0.0,0.0,3,9,1180,300,2012,0,98126,47.5443,-122.375,1380,1537,5,16,2014,N,100,126
8682320090,5/19/2014,818000.0,2,2.5,2380,9374,1.0,0.0,2.0,3,8,2380,0,2011,0,98053,47.7095,-122.01899999999999,1610,5000,5,19,2014,N,770,4374
9828701507,12/2/2014,759000.0,3,2.25,1640,1873,3.0,0.0,0.0,3,8,1640,0,2014,0,98112,47.6196,-122.29700000000001,1640,3920,12,2,2014,N,0,-2047
3362400432,6/11/2014,547500.0,3,3.5,1650,2262,3.0,0.0,0.0,3,8,1650,0,2010,0,98103,47.6823,-122.34700000000001,1620,3166,6,11,2014,N,30,-904
856000195,5/21/2014,2700000.0,5,4.75,5305,8401,2.0,0.0,2.0,3,11,3745,1560,2005,0,98033,47.6864,-122.215,2960,7200,5,21,2014,N,2345,1201
9396700028,7/22/2014,358000.0,2,2.5,1278,987,2.0,0.0,0.0,3,7,1002,276,2007,0,98136,47.5532,-122.381,1220,1287,7,22,2014,N,58,-300
8850000018,10/1/2014,412000.0,3,2.5,1200,813,3.0,0.0,0.0,3,9,1200,0,2010,0,98144,47.5894,-122.315,1750,4365,10,1,2014,N,-550,-3552
9524100207,1/30/2015,245000.0,2,1.5,690,1058,2.0,0.0,0.0,3,7,690,0,2005,0,98103,47.6951,-122.34299999999999,690,1058,1,30,2015,N,0,0
1085623350,10/7/2014,460940.0,4,2.5,3202,4964,2.0,0.0,0.0,3,9,3202,0,2014,0,98030,47.3412,-122.179,2425,4886,10,7,2014,N,777,78
7663700973,5/22/2014,321000.0,3,2.25,1347,1292,3.0,0.0,0.0,3,7,1347,0,2010,0,98125,47.7306,-122.291,1480,1865,5,22,2014,N,-133,-573
7853420100,6/23/2014,633634.0,4,3.5,2960,6000,2.0,0.0,0.0,3,9,2960,0,2014,0,98065,47.5183,-121.88600000000001,2960,6000,6,23,2014,N,0,0
1025039168,9/23/2014,290000.0,1,0.75,740,1284,1.0,0.0,0.0,4,6,740,0,1928,0,98107,47.6741,-122.406,1430,3988,9,23,2014,UNK,-690,-2704
476000110,4/1/2015,445000.0,2,2.25,1200,1137,3.0,0.0,0.0,3,7,1200,0,2007,0,98107,47.6715,-122.39200000000001,1280,1295,4,1,2015,N,-80,-158
2254100090,4/7/2015,887250.0,5,3.5,4320,7502,2.0,0.0,0.0,3,9,3500,820,2012,0,98056,47.5235,-122.16799999999999,3250,7538,4,7,2015,N,1070,-36
8682320600,9/11/2014,739000.0,3,2.5,2310,7348,1.0,0.0,3.0,3,8,2310,0,2010,0,98053,47.7116,-122.01899999999999,2310,7153,9,11,2014,N,0,195
9834201366,12/16/2014,429900.0,3,2.0,1490,1286,3.0,0.0,0.0,3,8,1490,0,2014,0,98144,47.57,-122.288,1420,1230,12,16,2014,N,70,56
7625702451,1/6/2015,459000.0,3,2.0,1480,800,2.0,0.0,0.0,3,8,1000,480,2014,0,98136,47.5492,-122.387,1480,886,1,6,2015,N,0,-86
301402120,6/25/2014,240000.0,3,2.25,1481,2820,2.0,0.0,0.0,3,7,1481,0,2012,0,98002,47.3457,-122.21700000000001,1481,3028,6,25,2014,N,0,-208
6382500076,9/10/2014,566950.0,3,3.0,1730,1902,3.0,0.0,0.0,3,8,1730,0,2014,0,98117,47.6944,-122.37700000000001,1830,1804,9,10,2014,N,-100,98
3758900259,5/7/2014,1040000.0,4,3.5,3900,8391,2.0,0.0,0.0,3,10,3900,0,2006,0,98033,47.6979,-122.205,3820,12268,5,7,2014,N,80,-3877
3126049446,3/10/2015,343000.0,3,3.5,1130,1449,3.0,0.0,0.0,3,7,1130,0,2005,0,98103,47.6968,-122.348,1130,1200,3,10,2015,N,0,249
3744000100,11/11/2014,572115.0,4,3.25,3230,4838,2.0,0.0,0.0,3,9,3230,0,2014,0,98038,47.3559,-122.023,2980,5094,11,11,2014,N,250,-256
9510860750,1/8/2015,918000.0,5,3.5,3920,5150,2.0,0.0,0.0,3,9,2820,1100,2004,0,98052,47.6638,-122.084,3170,5530,1,8,2015,N,750,-380
7228500037,5/5/2015,555000.0,2,1.5,1190,1361,2.0,0.0,0.0,3,8,1190,0,2007,0,98122,47.6161,-122.302,1280,3360,5,5,2015,N,-90,-1999
3814900750,7/16/2014,399440.0,4,2.5,2311,4396,2.0,0.0,0.0,3,9,2311,0,2014,0,98092,47.3276,-122.163,2458,4616,7,16,2014,N,-147,-220
1294300038,7/11/2014,450000.0,3,2.5,1810,914,3.0,0.0,0.0,3,8,1380,430,2008,0,98116,47.5732,-122.387,1810,914,7,11,2014,N,0,0
7853350090,6/4/2014,648000.0,4,2.5,3290,6203,2.0,0.0,0.0,3,9,3290,0,2008,0,98065,47.5441,-121.86,2990,6835,6,4,2014,N,300,-632
9211010900,6/18/2014,580000.0,4,2.5,3250,5000,2.0,0.0,0.0,3,8,3250,0,2008,0,98059,47.4988,-122.148,3230,5507,6,18,2014,N,20,-507
1085623250,3/31/2015,415000.0,4,2.5,2544,4071,2.0,0.0,0.0,3,9,2544,0,2013,0,98030,47.341,-122.179,2358,4179,3,31,2015,N,186,-108
2025049192,10/21/2014,527500.0,3,2.5,1380,1389,3.0,0.0,0.0,3,8,1380,0,2008,0,98102,47.6427,-122.32700000000001,1380,1249,10,21,2014,N,0,140
7625703354,7/30/2014,384000.0,3,2.25,1430,800,2.0,0.0,0.0,3,8,1140,290,2011,0,98136,47.5477,-122.38799999999999,1430,1387,7,30,2014,N,0,-587
2051200436,8/20/2014,692000.0,3,2.5,3490,28213,1.5,0.0,2.0,3,9,2242,1248,2009,0,98070,47.365,-122.456,2120,56628,8,20,2014,N,1370,-28415
3880900236,8/22/2014,455000.0,2,1.5,910,966,2.0,0.0,0.0,3,8,820,90,2006,0,98119,47.626999999999995,-122.361,2740,6400,8,22,2014,N,-1830,-5434
1646502355,4/3/2015,1280000.0,4,3.25,3080,4120,2.0,0.0,0.0,3,9,2380,700,2014,0,98117,47.6845,-122.359,1410,4120,4,3,2015,N,1670,0
2619950110,6/24/2014,415000.0,3,2.5,2280,6031,2.0,0.0,0.0,3,8,2280,0,2011,0,98019,47.7322,-121.96600000000001,2430,7200,6,24,2014,N,-150,-1169
1964700054,12/22/2014,975000.0,3,2.5,1660,1344,3.0,0.0,0.0,3,8,1660,0,2008,0,98102,47.644,-122.32700000000001,1750,2040,12,22,2014,N,-90,-696
1926059039,10/6/2014,799950.0,4,2.5,3320,7429,2.0,0.0,0.0,3,9,3320,0,2014,0,98034,47.7189,-122.225,1840,7429,10,6,2014,N,1480,0
3438500037,4/5/2015,545000.0,5,4.0,1680,7268,1.0,0.0,0.0,3,8,1370,310,2008,0,98106,47.5571,-122.35600000000001,2040,8259,4,5,2015,N,-360,-991
9578501110,10/3/2014,429900.0,4,3.5,2584,5005,2.0,0.0,0.0,3,8,2584,0,2014,0,98023,47.29600000000001,-122.35,2767,5201,10,3,2014,N,-183,-196
8856004786,7/29/2014,275000.0,3,2.5,2217,8019,2.0,0.0,0.0,3,7,2217,0,2009,0,98001,47.2776,-122.251,1470,8037,7,29,2014,N,747,-18
7708200600,7/18/2014,498000.0,3,2.5,2480,4136,2.0,0.0,0.0,3,8,2480,0,2009,0,98059,47.493,-122.147,2510,4314,7,18,2014,N,-30,-178
9492500090,5/27/2014,754950.0,3,2.5,2610,7256,2.0,0.0,0.0,3,9,2610,0,2014,0,98033,47.695,-122.18,2610,7206,5,27,2014,N,0,50
8691440100,6/6/2014,895000.0,4,3.0,3240,5562,2.0,0.0,0.0,3,10,3240,0,2013,0,98075,47.5919,-121.975,3380,5562,6,6,2014,N,-140,0
7222000090,5/6/2014,580000.0,4,3.25,3569,8327,2.0,0.0,0.0,3,10,3569,0,2013,0,98055,47.4595,-122.208,2550,5251,5,6,2014,N,1019,3076
3321049112,2/22/2015,379900.0,4,2.5,3181,5831,2.0,0.0,0.0,3,8,3181,0,2014,0,98003,47.2716,-122.29700000000001,2056,24393,2,22,2015,N,1125,-18562
2911000100,3/10/2015,245000.0,4,2.5,1921,4888,2.0,0.0,0.0,3,7,1921,0,2009,0,98001,47.2689,-122.24,1921,9140,3,10,2015,N,0,-4252
3862710090,8/26/2014,417000.0,3,2.5,1570,4926,2.0,0.0,0.0,3,8,1570,0,2014,0,98065,47.5342,-121.84200000000001,1800,3202,8,26,2014,N,-230,1724
8648900110,5/5/2014,555000.0,3,2.5,1940,3211,2.0,0.0,0.0,3,8,1940,0,2009,0,98027,47.5644,-122.09299999999999,1880,3078,5,5,2014,N,60,133
8648900110,8/26/2014,555000.0,3,2.5,1940,3211,2.0,0.0,0.0,3,8,1940,0,2009,0,98027,47.5644,-122.09299999999999,1880,3078,8,26,2014,N,60,133
6791400100,9/10/2014,353000.0,4,2.5,2210,13721,2.0,0.0,0.0,3,8,2210,0,2009,0,98042,47.3122,-122.039,1850,12951,9,10,2014,N,360,770
2768301477,4/25/2015,539000.0,3,2.25,1280,1187,2.0,0.0,0.0,3,8,1080,200,2008,0,98107,47.6651,-122.368,1280,1681,4,25,2015,N,0,-494
126039256,9/4/2014,434900.0,3,2.0,1520,5040,2.0,0.0,0.0,3,7,1520,0,1977,2006,98177,47.777,-122.36200000000001,1860,8710,9,4,2014,Y,-340,-3670
8562780110,12/2/2014,325000.0,2,2.25,1230,1078,2.0,0.0,0.0,3,7,1160,70,2008,0,98027,47.5324,-122.073,1240,817,12,2,2014,N,-10,261
8032700110,4/9/2015,650000.0,3,2.5,1480,2159,3.0,0.0,0.0,3,8,1480,0,2007,0,98103,47.6533,-122.34100000000001,1480,1554,4,9,2015,N,0,605
5635100090,2/25/2015,379950.0,4,2.5,2612,5850,2.0,0.0,0.0,3,8,2612,0,2014,0,98030,47.3751,-122.189,2419,8984,2,25,2015,N,193,-3134
2597490300,11/19/2014,700000.0,3,2.5,2350,4975,2.0,0.0,0.0,3,8,2350,0,2012,0,98029,47.5418,-122.01,2350,3951,11,19,2014,N,0,1024
9301300805,12/15/2014,675000.0,3,2.5,1300,1590,2.0,0.0,0.0,3,8,1100,200,2014,0,98109,47.6384,-122.34299999999999,1070,1223,12,15,2014,N,230,367
3449000300,6/9/2014,379000.0,4,1.5,2020,7560,1.0,0.0,0.0,4,7,2020,0,1960,0,98059,47.501999999999995,-122.146,1410,8080,6,9,2014,UNK,610,-520
8562770490,3/30/2015,571000.0,3,2.5,2140,2867,2.0,0.0,0.0,3,8,1960,180,2005,0,98027,47.5357,-122.073,2280,2836,3,30,2015,N,-140,31
3052700464,10/24/2014,475000.0,3,2.25,1380,1621,2.0,0.0,0.0,3,8,1140,240,2007,0,98117,47.678000000000004,-122.375,1460,1403,10,24,2014,N,-80,218
9276200569,5/9/2014,769900.0,4,3.5,2730,3047,2.0,0.0,0.0,3,8,2400,330,2006,0,98116,47.5797,-122.391,1980,4600,5,9,2014,N,750,-1553
7853280490,12/22/2014,633000.0,4,3.5,4220,5817,2.0,0.0,0.0,3,9,2910,1310,2006,0,98065,47.5392,-121.86200000000001,4290,6637,12,22,2014,N,-70,-820
2883200524,5/12/2014,635000.0,3,2.5,1570,1433,3.0,0.0,0.0,3,8,1570,0,2010,0,98103,47.6858,-122.336,1570,2652,5,12,2014,N,0,-1219
3630200300,7/25/2014,1240000.0,4,3.5,4670,6000,2.0,0.0,3.0,3,11,3820,850,2007,0,98027,47.5414,-121.994,4310,6000,7,25,2014,N,360,0
1383800015,1/8/2015,524000.0,3,2.25,1370,1007,3.0,0.0,0.0,3,8,1330,40,2009,0,98107,47.6682,-122.361,1570,1635,1,8,2015,N,-200,-628
1441000090,11/26/2014,485000.0,4,3.5,3273,5115,2.0,0.0,0.0,3,8,2671,602,2014,0,98055,47.4477,-122.204,2996,5100,11,26,2014,N,277,15
3760500407,5/21/2014,1030000.0,3,4.0,3880,13095,2.0,0.0,3.0,3,11,3700,180,2009,0,98034,47.6996,-122.23299999999999,3880,10830,5,21,2014,N,0,2265
9528101214,10/24/2014,650000.0,3,3.5,1494,1262,3.0,0.0,0.0,3,8,1494,0,2011,0,98115,47.6826,-122.324,1494,1264,10,24,2014,N,0,-2
2801910100,10/1/2014,754842.0,3,2.5,2930,5641,2.0,0.0,0.0,3,8,2930,0,2013,0,98052,47.71,-122.113,3300,5641,10,1,2014,N,-370,0
1085623640,9/24/2014,428900.0,4,2.5,2598,5553,2.0,0.0,0.0,3,9,2598,0,2014,0,98092,47.3412,-122.178,2502,4900,9,24,2014,N,96,653
7299601460,6/23/2014,329900.0,3,2.5,2242,4995,2.0,0.0,0.0,3,8,2242,0,2011,0,98092,47.2595,-122.20200000000001,1798,4942,6,23,2014,N,444,53
1070000110,12/18/2014,1040000.0,4,2.5,2830,5932,2.0,0.0,0.0,3,9,2830,0,2014,0,98199,47.6479,-122.40799999999999,2840,5593,12,18,2014,N,-10,339
7853360820,9/9/2014,544999.0,4,2.5,2710,6937,2.0,0.0,0.0,3,7,2710,0,2009,0,98065,47.5153,-121.87100000000001,2380,5866,9,9,2014,N,330,1071
7436700090,5/29/2014,449950.0,4,2.75,2320,4344,2.0,0.0,0.0,3,8,2320,0,2012,0,98059,47.4862,-122.163,2310,3770,5,29,2014,N,10,574
3034200399,1/13/2015,635000.0,4,2.5,2720,7991,2.0,0.0,0.0,3,9,2720,0,2006,0,98133,47.7168,-122.331,1590,8611,1,13,2015,N,1130,-620
889000015,11/3/2014,599000.0,3,1.75,1650,1180,3.0,0.0,0.0,3,8,1650,0,2014,0,98105,47.6638,-122.319,1650,1960,11,3,2014,N,0,-780
2767704252,11/3/2014,478000.0,3,3.25,1430,1348,2.0,0.0,0.0,3,8,1160,270,2008,0,98107,47.6743,-122.374,1160,1265,11,3,2014,N,270,83
2143700756,9/29/2014,388000.0,4,2.5,2090,5040,2.0,0.0,0.0,3,9,2090,0,2014,0,98055,47.4797,-122.23,1430,12000,9,29,2014,N,660,-6960
8946780110,8/4/2014,809950.0,4,3.5,3660,4903,2.0,0.0,0.0,3,9,2760,900,2014,0,98034,47.7184,-122.156,3630,4992,8,4,2014,N,30,-89
6790830090,4/15/2015,1060000.0,4,3.5,4220,8417,3.0,0.0,0.0,3,10,4220,0,2012,0,98075,47.5869,-122.054,3730,8435,4,15,2015,N,490,-18
2768100512,4/22/2015,659000.0,2,2.5,1450,1213,2.0,0.0,0.0,3,9,1110,340,2015,0,98107,47.6692,-122.37200000000001,1620,1456,4,22,2015,N,-170,-243
9477580110,6/26/2014,971971.0,4,3.75,3460,6738,2.0,0.0,0.0,3,11,3460,0,2013,0,98059,47.506,-122.145,3340,6120,6,26,2014,N,120,618
7625702437,1/15/2015,389000.0,3,2.5,1350,874,3.0,0.0,0.0,3,8,1270,80,2006,0,98136,47.5491,-122.387,1350,886,1,15,2015,N,0,-12
5416510490,7/8/2014,355000.0,4,2.75,3000,5470,2.0,0.0,0.0,3,8,3000,0,2005,0,98038,47.3613,-122.038,2420,4891,7,8,2014,N,580,579
1123059125,12/8/2014,551500.0,4,2.5,2950,10003,2.0,0.0,0.0,3,9,2950,0,2006,0,98059,47.489,-122.14,2790,9323,12,8,2014,N,160,680
7237450110,7/1/2014,417838.0,4,2.5,2530,5048,2.0,0.0,0.0,3,8,2530,0,2014,0,98038,47.3559,-122.06299999999999,2530,4359,7,1,2014,N,0,689
250000090,7/14/2014,1750000.0,4,4.5,4650,7660,2.0,0.0,0.0,3,11,3640,1010,2008,0,98004,47.6349,-122.198,1710,8400,7,14,2014,N,2940,-740
2025049206,6/11/2014,399950.0,2,1.0,710,1131,2.0,0.0,0.0,4,7,710,0,1943,0,98102,47.6413,-122.329,1370,1173,6,11,2014,UNK,-660,-42
5631500941,7/15/2014,740000.0,4,2.5,3050,8000,2.0,0.0,0.0,3,9,3050,0,2007,0,98028,47.7465,-122.23100000000001,1910,8000,7,15,2014,N,1140,0
8562780490,2/23/2015,335000.0,3,2.5,1150,683,2.0,0.0,0.0,3,7,1150,0,2013,0,98027,47.5323,-122.071,1150,755,2,23,2015,N,0,-72
3262300485,4/21/2015,2250000.0,5,5.25,3410,8118,2.0,0.0,0.0,3,11,3410,0,2006,0,98039,47.6295,-122.236,3410,16236,4,21,2015,N,0,-8118
5693500846,4/20/2015,667000.0,3,1.75,1370,1921,3.0,0.0,0.0,3,8,1370,0,2007,0,98103,47.6595,-122.351,1370,4000,4,20,2015,N,0,-2079
925059313,3/12/2015,920000.0,4,2.5,3540,7009,2.0,0.0,0.0,3,9,3540,0,2007,0,98033,47.6749,-122.176,2150,10290,3,12,2015,N,1390,-3281
2461900492,5/11/2014,368000.0,3,2.5,1370,1350,2.0,0.0,0.0,3,7,1010,360,2007,0,98136,47.5534,-122.382,1450,6000,5,11,2014,N,-80,-4650
6817750110,7/10/2014,307000.0,4,2.5,1714,3080,2.0,0.0,0.0,3,8,1714,0,2009,0,98055,47.428999999999995,-122.18799999999999,1714,3250,7,10,2014,N,0,-170
3574770100,1/16/2015,550000.0,4,2.75,3650,4534,2.0,0.0,0.0,3,7,2940,710,2014,0,98028,47.7397,-122.22399999999999,2400,7682,1,16,2015,N,1250,-3148
8564860110,1/13/2015,594491.0,4,2.5,2990,6037,2.0,0.0,0.0,3,9,2990,0,2013,0,98045,47.4766,-121.735,2990,5992,1,13,2015,N,0,45
1085622460,9/29/2014,460458.0,4,2.5,3284,6516,2.0,0.0,0.0,3,8,3284,0,2014,0,98092,47.3393,-122.181,2555,5008,9,29,2014,N,729,1508
1777600850,6/24/2014,859000.0,4,2.25,3550,13900,1.0,0.0,0.0,3,8,1830,1720,2010,0,98006,47.5681,-122.12700000000001,2770,12200,6,24,2014,N,780,1700
9284801500,12/11/2014,399950.0,3,3.0,1860,2875,2.0,0.0,0.0,3,8,1710,150,2009,0,98126,47.5511,-122.37299999999999,1350,4830,12,11,2014,N,510,-1955
7217400389,4/1/2015,547500.0,3,3.25,1720,1977,2.0,0.0,0.0,3,8,1360,360,2007,0,98122,47.6127,-122.29899999999999,1720,3420,4,1,2015,N,0,-1443
3832051140,6/23/2014,310000.0,3,2.5,2540,4775,2.0,0.0,0.0,3,7,2540,0,2006,0,98042,47.3341,-122.052,2270,5000,6,23,2014,N,270,-225
925059137,6/2/2014,939000.0,4,2.75,3270,12880,2.0,0.0,0.0,3,9,3270,0,2014,0,98033,47.6679,-122.17200000000001,2420,7505,6,2,2014,N,850,5375
6021503706,10/14/2014,329900.0,2,2.5,980,1021,3.0,0.0,0.0,3,8,980,0,2008,0,98117,47.6844,-122.387,980,1023,10,14,2014,N,0,-2
475000176,12/22/2014,436000.0,3,2.5,1150,1193,2.0,0.0,0.0,3,8,1020,130,2006,0,98107,47.6684,-122.365,1450,1640,12,22,2014,N,-300,-447
1220000367,7/16/2014,320000.0,3,2.5,1820,1855,2.0,0.0,0.0,3,8,1570,250,2008,0,98166,47.4643,-122.346,1470,6900,7,16,2014,N,350,-5045
3278605590,9/26/2014,375000.0,3,2.5,1580,3825,2.0,0.0,0.0,3,8,1580,0,2011,0,98126,47.5458,-122.369,1380,1500,9,26,2014,N,200,2325
7203140110,3/24/2015,392137.0,3,2.0,1460,3696,2.0,0.0,0.0,3,7,1460,0,2010,0,98053,47.6861,-122.01299999999999,1720,3631,3,24,2015,N,-260,65
3818400110,8/26/2014,520000.0,4,2.5,2900,4950,2.0,0.0,0.0,3,8,2900,0,2004,0,98028,47.7717,-122.236,2590,4950,8,26,2014,N,310,0
7702080110,10/16/2014,535000.0,5,2.75,2620,6389,2.0,0.0,0.0,3,9,2620,0,2007,0,98028,47.77,-122.236,2620,4504,10,16,2014,N,0,1885
952002250,3/24/2015,407000.0,2,2.5,1340,999,2.0,0.0,0.0,3,8,940,400,2008,0,98116,47.5655,-122.38600000000001,1470,1436,3,24,2015,N,-130,-437
9578500820,11/25/2014,424950.0,4,3.25,3266,5398,2.0,0.0,0.0,3,8,3266,0,2014,0,98023,47.2975,-122.35,3087,5152,11,25,2014,N,179,246
3448000542,8/11/2014,290000.0,2,1.5,1076,1060,3.0,0.0,0.0,3,7,1076,0,2006,0,98125,47.7167,-122.29799999999999,1076,1060,8,11,2014,N,0,0
9358000552,10/29/2014,399000.0,3,3.25,1680,1478,2.0,0.0,0.0,3,8,1360,320,2009,0,98126,47.5674,-122.369,1530,2753,10,29,2014,N,150,-1275
2770601696,7/3/2014,439990.0,3,2.5,1930,1348,2.0,0.0,0.0,3,8,1300,630,2005,0,98199,47.6513,-122.384,1630,6000,7,3,2014,N,300,-4652
9834201145,2/22/2015,635000.0,4,2.5,2880,3091,2.0,0.0,0.0,3,9,1940,940,2014,0,98144,47.5711,-122.286,1560,4080,2,22,2015,N,1320,-989
3575305452,7/17/2014,635000.0,4,2.25,2240,5000,2.0,0.0,0.0,3,8,2240,0,2013,0,98074,47.6212,-122.05799999999999,1760,7500,7,17,2014,N,480,-2500
6181500100,4/29/2015,351000.0,3,2.5,2594,4455,2.0,0.0,0.0,3,8,2594,0,2012,0,98001,47.3054,-122.27600000000001,2981,4950,4,29,2015,N,-387,-495
2767604074,8/22/2014,437500.0,2,1.5,1210,1232,3.0,0.0,0.0,3,8,1210,0,2007,0,98107,47.6712,-122.39,1330,1174,8,22,2014,N,-120,58
2872100345,5/30/2014,919204.0,4,3.5,3760,5000,2.0,0.0,0.0,3,9,2860,900,2014,0,98117,47.6826,-122.39399999999999,1340,5000,5,30,2014,N,2420,0
2937300440,9/8/2014,923990.0,4,2.5,3600,6055,2.0,0.0,0.0,3,9,3600,0,2014,0,98052,47.7053,-122.126,3590,6050,9,8,2014,N,10,5
2597490660,6/24/2014,639888.0,4,2.5,2050,2772,2.0,0.0,0.0,3,8,2050,0,2012,0,98029,47.5421,-122.01100000000001,2050,2934,6,24,2014,N,0,-162
3528900768,1/14/2015,675000.0,3,3.25,1510,2064,2.0,0.0,0.0,3,8,1220,290,2008,0,98109,47.6398,-122.345,1670,2594,1,14,2015,N,-160,-530
3885802135,6/10/2014,899900.0,4,2.5,2580,3909,2.0,0.0,0.0,3,8,2580,0,2013,0,98033,47.6852,-122.21,1820,5772,6,10,2014,N,760,-1863
3336500190,1/30/2015,252000.0,3,2.5,1670,4020,2.0,0.0,0.0,3,7,1670,0,2009,0,98118,47.53,-122.26799999999999,1670,4020,1,30,2015,N,0,0
2425059174,3/17/2015,925000.0,4,2.5,3190,10034,2.0,0.0,0.0,3,9,3190,0,2007,0,98052,47.6379,-122.111,2110,9300,3,17,2015,N,1080,734
1890000170,10/29/2014,552000.0,3,2.5,1280,1920,3.0,0.0,0.0,3,8,1280,0,2009,0,98105,47.6621,-122.324,1450,1900,10,29,2014,N,-170,20
5137800130,4/7/2015,388500.0,4,2.5,2718,6197,2.0,0.0,0.0,3,8,2718,0,2006,0,98092,47.3255,-122.164,2667,5000,4,7,2015,N,51,1197
2767603753,8/29/2014,548000.0,2,2.0,1370,1878,3.0,0.0,0.0,3,8,1370,0,2004,0,98107,47.6721,-122.387,1280,1878,8,29,2014,N,90,0
6181410950,9/22/2014,254950.0,3,2.5,1794,4769,2.0,0.0,0.0,3,7,1794,0,2005,0,98001,47.3052,-122.28299999999999,3557,4807,9,22,2014,N,-1763,-38
3226069049,12/8/2014,1240000.0,4,4.5,5120,41327,2.0,0.0,0.0,3,10,3290,1830,2008,0,98053,47.7009,-122.059,3360,82764,12,8,2014,N,1760,-41437
6056110430,9/30/2014,629000.0,3,2.5,2160,1912,2.0,0.0,0.0,3,9,1970,190,2014,0,98118,47.5642,-122.292,1810,2653,9,30,2014,N,350,-741
2916200091,3/3/2015,734000.0,4,2.5,2180,7204,2.0,0.0,0.0,3,8,2180,0,2014,0,98133,47.7221,-122.352,1500,7650,3,3,2015,N,680,-446
1773100980,6/18/2014,309000.0,3,2.25,1490,1294,2.0,0.0,0.0,3,7,1220,270,2010,0,98106,47.5569,-122.363,1490,1283,6,18,2014,N,0,11
1123059126,7/3/2014,554950.0,3,2.5,2950,10254,2.0,0.0,0.0,3,9,2950,0,2006,0,98059,47.4888,-122.14,2800,9323,7,3,2014,N,150,931
825079024,5/6/2015,785000.0,3,2.75,2990,207781,2.0,0.0,0.0,3,9,2990,0,2000,0,98014,47.662,-121.944,2590,218671,5,6,2015,UNK,400,-10890
8029770470,6/5/2014,550000.0,4,2.5,2700,5150,2.0,0.0,0.0,3,9,2700,0,2007,0,98059,47.5071,-122.148,3160,7620,6,5,2014,N,-460,-2470
1563102965,8/11/2014,1010000.0,4,3.5,3130,5000,3.0,0.0,0.0,3,10,3130,0,2014,0,98116,47.5656,-122.40299999999999,1950,5152,8,11,2014,N,1180,-152
5021900635,10/28/2014,1580000.0,3,2.0,3620,14250,2.0,0.0,0.0,3,8,3220,400,2007,0,98040,47.5767,-122.225,2370,14250,10,28,2014,N,1250,0
9264450460,6/3/2014,309000.0,5,2.75,2481,4045,2.0,0.0,0.0,3,8,2481,0,2014,0,98001,47.2602,-122.28399999999999,2363,4175,6,3,2014,N,118,-130
7694200430,6/25/2014,328423.0,3,2.5,1730,3600,2.0,0.0,0.0,3,8,1730,0,2014,0,98146,47.5019,-122.34,2030,3600,6,25,2014,N,-300,0
7548301041,6/23/2014,345000.0,3,1.5,1420,1192,2.0,0.0,0.0,3,8,1140,280,2008,0,98144,47.5881,-122.304,1340,1213,6,23,2014,N,80,-21
726059483,11/21/2014,660000.0,5,3.5,3160,5175,2.0,0.0,0.0,3,9,3160,0,2014,0,98011,47.755,-122.21600000000001,2100,9351,11,21,2014,N,1060,-4176
2771102144,5/2/2014,385000.0,3,3.25,1320,1327,2.0,0.0,0.0,3,8,1040,280,2008,0,98199,47.6506,-122.383,1440,1263,5,2,2014,N,-120,64
7011201476,3/18/2015,459000.0,2,2.25,1010,1107,2.0,0.0,0.0,3,8,710,300,2006,0,98119,47.6363,-122.37100000000001,1140,1531,3,18,2015,N,-130,-424
53500020,1/14/2015,248000.0,3,2.5,1870,4046,2.0,0.0,0.0,3,7,1870,0,2007,0,98042,47.342,-122.059,2130,4800,1,14,2015,N,-260,-754
8920100066,8/20/2014,1480000.0,4,3.5,5220,15411,2.0,0.0,3.0,3,11,3550,1670,2006,0,98075,47.592,-122.085,3110,14124,8,20,2014,N,2110,1287
8091670020,8/1/2014,379000.0,4,2.5,2260,5824,2.0,0.0,0.0,3,8,2260,0,2011,0,98038,47.3496,-122.042,2240,5561,8,1,2014,N,20,263
1176001310,3/4/2015,2950000.0,5,4.5,4340,5722,3.0,0.0,4.0,3,10,4340,0,2010,0,98107,47.6715,-122.406,1770,5250,3,4,2015,N,2570,472
3629960680,9/26/2014,395000.0,2,2.25,1620,1841,2.0,0.0,0.0,3,8,1540,80,2004,0,98029,47.5483,-122.00399999999999,1530,1831,9,26,2014,N,90,10
8562770250,5/7/2014,535000.0,3,2.5,2280,2289,2.0,0.0,0.0,3,8,1880,400,2006,0,98027,47.5375,-122.073,2280,2425,5,7,2014,N,0,-136
1102000514,10/22/2014,970000.0,5,3.5,3400,9804,2.0,0.0,0.0,3,9,2550,850,2008,0,98118,47.543,-122.266,2380,7440,10,22,2014,N,1020,2364
1773100275,2/1/2015,205000.0,2,1.5,830,1020,2.0,0.0,0.0,3,7,830,0,2006,0,98106,47.5604,-122.363,830,1379,2,1,2015,N,0,-359
321030010,10/15/2014,310000.0,4,2.5,2310,7384,2.0,0.0,0.0,3,8,2310,0,2010,0,98042,47.3737,-122.165,2310,7800,10,15,2014,N,0,-416
5393600509,7/2/2014,334500.0,2,1.5,830,1858,2.0,0.0,0.0,3,7,830,0,2005,0,98144,47.5828,-122.314,1480,3030,7,2,2014,N,-650,-1172
2895730280,8/28/2014,995000.0,5,3.25,4130,7197,2.0,0.0,0.0,3,10,4130,0,2012,0,98074,47.6022,-122.06,3730,7202,8,28,2014,N,400,-5
7967000130,4/1/2015,370228.0,4,3.0,2050,4000,2.0,0.0,0.0,3,8,2050,0,2014,0,98001,47.3525,-122.275,2050,4000,4,1,2015,N,0,0
7570060290,3/4/2015,383000.0,4,2.5,2050,4953,2.0,0.0,0.0,3,9,2050,0,2014,0,98038,47.3448,-122.024,2340,6175,3,4,2015,N,-290,-1222
291310170,8/4/2014,384500.0,3,2.5,1600,2610,2.0,0.0,0.0,3,8,1600,0,2005,0,98027,47.5344,-122.068,1445,1288,8,4,2014,N,155,1322
923000425,7/18/2014,865000.0,5,2.5,3190,8160,2.0,0.0,0.0,3,9,3190,0,2014,0,98177,47.7246,-122.363,1650,8160,7,18,2014,N,1540,0
3630200780,5/22/2014,1050000.0,4,3.75,3860,5474,2.5,0.0,0.0,3,10,3860,0,2007,0,98029,47.5396,-121.995,3040,5474,5,22,2014,N,820,0
9578060660,5/13/2014,502000.0,4,2.5,2040,5616,2.0,0.0,0.0,3,8,2040,0,2012,0,98028,47.7737,-122.238,2380,4737,5,13,2014,N,-340,879
250000010,9/24/2014,1750000.0,4,3.5,3845,8400,2.0,0.0,0.0,3,10,3845,0,2013,0,98004,47.6354,-122.198,1710,8400,9,24,2014,N,2135,0
1438000010,9/12/2014,569995.0,4,2.5,2650,6875,2.0,0.0,0.0,3,8,2650,0,2014,0,98059,47.479,-122.124,2650,5831,9,12,2014,N,0,1044
6626300095,5/19/2014,749950.0,4,2.5,3430,64441,2.0,0.0,0.0,3,8,3430,0,2013,0,98077,47.7694,-122.064,3580,64441,5,19,2014,N,-150,0
8562901100,12/30/2014,550000.0,3,2.5,2430,5400,2.0,0.0,0.0,3,8,2430,0,2007,0,98074,47.6062,-122.057,2640,11990,12,30,2014,N,-210,-6590
6979970080,5/13/2014,525000.0,3,3.5,2876,5086,2.0,0.0,0.0,3,8,2360,516,2007,0,98072,47.7511,-122.17299999999999,2390,4419,5,13,2014,N,486,667
7853320470,6/11/2014,516000.0,4,3.5,2550,8698,2.0,0.0,0.0,3,7,2550,0,2007,0,98065,47.5216,-121.869,2430,5519,6,11,2014,N,120,3179
1424069056,8/5/2014,1350000.0,4,3.75,4100,61419,2.0,0.0,0.0,3,9,4100,0,2014,0,98029,47.5626,-122.005,2010,32362,8,5,2014,N,2090,29057
3448740250,4/28/2015,440000.0,4,2.5,2730,4526,2.0,0.0,0.0,3,7,2730,0,2009,0,98059,47.49100000000001,-122.15299999999999,2190,4572,4,28,2015,N,540,-46
8129700728,4/14/2015,660000.0,3,2.5,1780,1729,2.0,0.0,0.0,3,8,1080,700,2008,0,98103,47.6594,-122.355,1780,1741,4,14,2015,N,0,-12
3832080440,12/9/2014,261950.0,3,2.5,1880,5000,2.0,0.0,0.0,3,7,1880,0,2010,0,98042,47.3359,-122.054,2260,5000,12,9,2014,N,-380,0
9512200050,8/27/2014,551000.0,5,3.75,3090,4943,2.0,0.0,0.0,3,10,3090,0,2010,0,98058,47.4594,-122.133,3191,5561,8,27,2014,N,-101,-618
4027700014,2/25/2015,665000.0,3,3.5,2460,14155,2.0,0.0,0.0,3,8,1900,560,2014,0,98155,47.7743,-122.279,2440,14080,2,25,2015,N,20,75
7853400250,6/4/2014,610000.0,4,3.5,2910,5260,2.0,0.0,0.0,3,9,2910,0,2012,0,98065,47.5168,-121.883,2910,5260,6,4,2014,N,0,0
7853400250,2/19/2015,645000.0,4,3.5,2910,5260,2.0,0.0,0.0,3,9,2910,0,2012,0,98065,47.5168,-121.883,2910,5260,2,19,2015,N,0,0
7853420480,6/18/2014,536751.0,3,1.75,1930,6360,1.0,0.0,0.0,3,9,1930,0,2013,0,98065,47.5181,-121.885,2770,6373,6,18,2014,N,-840,-13
8943600020,4/26/2015,260000.0,3,2.25,1413,3403,2.0,0.0,0.0,3,8,1413,0,2009,0,98031,47.4196,-122.193,1763,3719,4,26,2015,N,-350,-316
4221900305,1/21/2015,1310000.0,3,3.25,4030,6300,2.0,0.0,0.0,3,10,3630,400,2006,0,98105,47.6664,-122.27600000000001,1660,6300,1,21,2015,N,2370,0
1112630130,2/20/2015,429900.0,4,3.25,2880,5929,2.5,0.0,0.0,3,8,2880,0,2014,0,98023,47.2752,-122.34899999999999,2880,5846,2,20,2015,N,0,83
123039376,8/20/2014,535000.0,4,2.75,2360,15100,1.0,0.0,0.0,3,8,2360,0,2014,0,98146,47.5117,-122.365,1440,13346,8,20,2014,N,920,1754
2767603962,4/14/2015,462550.0,2,1.75,1070,1276,3.0,0.0,0.0,3,8,1070,0,2006,0,98107,47.6719,-122.39,1290,2057,4,14,2015,N,-220,-781
4083306552,3/10/2015,602000.0,3,3.25,1460,1367,3.0,0.0,0.0,3,8,1460,0,2008,0,98103,47.6485,-122.334,1310,1191,3,10,2015,N,150,176
745500010,12/8/2014,730000.0,4,2.75,3800,9606,2.0,0.0,0.0,3,9,3800,0,2008,0,98011,47.7368,-122.208,3400,9677,12,8,2014,N,400,-71
7899800851,4/23/2015,300500.0,2,1.5,1190,801,3.0,0.0,0.0,3,8,1190,0,2010,0,98106,47.5212,-122.35799999999999,1190,810,4,23,2015,N,0,-9
7853350170,5/16/2014,675000.0,5,2.5,3200,6455,2.0,0.0,0.0,3,9,3200,0,2009,0,98065,47.5446,-121.86200000000001,3290,7924,5,16,2014,N,-90,-1469
6056100380,5/20/2014,415000.0,3,2.25,1970,2377,2.0,0.0,0.0,3,8,1680,290,2008,0,98108,47.5631,-122.29700000000001,1690,1936,5,20,2014,N,280,441
626059127,11/17/2014,614000.0,3,2.5,2830,5831,2.0,0.0,0.0,3,9,2830,0,2010,0,98011,47.7744,-122.22399999999999,2830,6064,11,17,2014,N,0,-233
1459920190,12/4/2014,385000.0,4,2.5,2630,5701,2.0,0.0,0.0,3,7,2630,0,2010,0,98042,47.375,-122.16,2770,5939,12,4,2014,N,-140,-238
3574750020,6/25/2014,594000.0,4,2.75,2720,4613,2.0,0.0,0.0,3,9,2720,0,2005,0,98028,47.7352,-122.223,2830,4836,6,25,2014,N,-110,-223
2547200190,5/20/2014,860000.0,4,2.75,3160,8097,2.0,0.0,0.0,3,9,3160,0,2014,0,98033,47.6709,-122.166,2200,8097,5,20,2014,N,960,0
9206500250,9/9/2014,1100000.0,4,4.0,3770,8899,2.0,0.0,0.0,3,10,2940,830,2006,0,98074,47.6476,-122.079,3300,8308,9,9,2014,N,470,591
7202300480,10/24/2014,775000.0,4,2.75,3500,6226,2.0,0.0,0.0,3,9,3500,0,2004,0,98053,47.6846,-122.045,3480,7222,10,24,2014,N,20,-996
7237450190,8/6/2014,430760.0,5,2.75,2710,4685,2.0,0.0,0.0,3,8,2710,0,2014,0,98038,47.3555,-122.06200000000001,2710,4449,8,6,2014,N,0,236
8682320420,4/27/2015,755000.0,2,2.5,2170,6361,1.0,0.0,2.0,3,8,2170,0,2009,0,98053,47.7109,-122.01700000000001,2310,7419,4,27,2015,N,-140,-1058
6003500743,5/19/2014,640000.0,2,2.25,1540,958,3.0,0.0,0.0,3,9,1540,0,2007,0,98122,47.6179,-122.318,1410,958,5,19,2014,N,130,0
328000182,5/1/2015,613500.0,3,3.25,1876,1531,3.0,0.0,0.0,3,9,1876,0,2009,0,98115,47.6864,-122.265,1876,1533,5,1,2015,N,0,-2
821079102,10/17/2014,780000.0,4,3.5,3720,213073,1.0,0.0,2.0,3,10,3720,0,2007,0,98010,47.3216,-121.94,2190,59241,10,17,2014,N,1530,153832
1622049242,3/4/2015,550000.0,4,2.5,3148,9612,2.0,0.0,3.0,3,9,3148,0,2014,0,98198,47.3994,-122.311,3000,11475,3,4,2015,N,148,-1863
7203120050,10/8/2014,789500.0,4,3.25,3240,4852,2.0,0.0,0.0,3,9,3240,0,2010,0,98053,47.695,-122.022,3320,5318,10,8,2014,N,-80,-466
7853360250,7/10/2014,592000.0,5,3.5,3340,5000,2.0,0.0,0.0,3,8,2580,760,2012,0,98065,47.5168,-121.87100000000001,3420,5000,7,10,2014,N,-80,0
1327600190,4/10/2015,454950.0,4,2.5,2413,5701,2.0,0.0,0.0,3,8,2413,0,2014,0,98042,47.3731,-122.15899999999999,2380,5725,4,10,2015,N,33,-24
4187000250,4/13/2015,475000.0,4,2.5,2500,4500,2.0,0.0,0.0,3,7,2500,0,2010,0,98059,47.4928,-122.149,2230,4500,4,13,2015,N,270,0
2902201300,12/29/2014,659000.0,2,1.75,1180,904,2.0,0.0,0.0,3,10,780,400,2014,0,98102,47.6396,-122.329,1380,3610,12,29,2014,N,-200,-2706
1635500250,11/24/2014,570000.0,4,2.5,2890,5801,2.0,0.0,0.0,3,9,2890,0,2005,0,98028,47.7349,-122.238,2890,6286,11,24,2014,N,0,-485
6031400094,2/26/2015,347500.0,5,3.0,2230,6551,1.0,0.0,0.0,3,7,1330,900,2014,0,98168,47.486999999999995,-122.32,2230,9476,2,26,2015,N,0,-2925
6601200250,4/2/2015,205000.0,4,2.5,1767,4500,2.0,0.0,0.0,3,8,1767,0,2006,0,98001,47.2607,-122.25,1949,4636,4,2,2015,N,-182,-136
9358001403,9/3/2014,380000.0,3,3.25,1450,1468,2.0,0.0,0.0,3,8,1100,350,2009,0,98126,47.5664,-122.37,1450,1478,9,3,2014,N,0,-10
4216500020,10/3/2014,718000.0,5,2.75,2930,7663,2.0,0.0,0.0,3,9,2930,0,2013,0,98056,47.5308,-122.184,2750,10335,10,3,2014,N,180,-2672
1438000440,7/24/2014,515805.0,5,2.75,2710,4136,2.0,0.0,0.0,3,8,2710,0,2014,0,98059,47.4786,-122.12299999999999,2590,4136,7,24,2014,N,120,0
6061500130,7/14/2014,1030000.0,4,3.25,3600,18645,2.0,0.0,1.0,3,10,3000,600,2013,0,98059,47.5294,-122.154,3970,10957,7,14,2014,N,-370,7688
3862710050,11/13/2014,437718.0,3,2.5,1800,3265,2.0,0.0,0.0,3,8,1800,0,2014,0,98065,47.5338,-121.84100000000001,1800,3663,11,13,2014,N,0,-398
7604400114,8/14/2014,450000.0,4,2.5,2290,5515,2.0,0.0,0.0,3,8,2290,0,2006,0,98106,47.5518,-122.35700000000001,1380,5515,8,14,2014,N,910,0
9828702649,10/28/2014,515000.0,3,2.5,1510,1178,2.0,0.0,0.0,3,8,1060,450,2007,0,98122,47.6181,-122.301,1510,1210,10,28,2014,N,0,-32
2946003947,3/2/2015,204000.0,2,2.5,1090,13444,2.0,0.0,0.0,3,7,1090,0,2007,0,98198,47.4166,-122.319,1380,6000,3,2,2015,N,-290,7444
993000307,5/23/2014,360000.0,3,2.0,1270,1323,3.0,0.0,0.0,3,8,1270,0,2006,0,98103,47.6934,-122.34200000000001,1330,1323,5,23,2014,N,-60,0
3362400094,12/3/2014,550000.0,3,2.25,1540,1005,3.0,0.0,0.0,3,8,1540,0,2008,0,98103,47.6827,-122.346,1510,1501,12,3,2014,N,30,-496
7853380480,5/29/2014,650880.0,3,2.5,2930,6050,2.0,0.0,0.0,3,9,2930,0,2008,0,98065,47.5151,-121.883,2760,5765,5,29,2014,N,170,285
3893100462,2/25/2015,1790000.0,5,3.75,4360,8504,2.0,0.0,4.0,3,10,3530,830,2014,0,98033,47.6936,-122.19,2680,9000,2,25,2015,N,1680,-496
2326600130,2/25/2015,895900.0,4,3.5,3640,4983,2.0,0.0,3.0,3,9,2790,850,2014,0,98075,47.5619,-122.027,3270,14700,2,25,2015,N,370,-9717
3424069008,6/6/2014,585000.0,4,2.5,2430,4747,2.0,0.0,0.0,3,8,2430,0,2008,0,98027,47.5285,-122.031,1930,7200,6,6,2014,N,500,-2453
3277801586,5/8/2015,380000.0,3,2.25,1520,1464,2.0,0.0,0.0,3,8,1240,280,2010,0,98126,47.543,-122.375,1710,1464,5,8,2015,N,-190,0
5045700250,11/18/2014,565997.0,5,2.75,2730,5820,2.0,0.0,0.0,3,8,2730,0,2014,0,98059,47.4856,-122.154,2730,5700,11,18,2014,N,0,120
3278603000,5/4/2015,459000.0,3,3.0,2440,2076,2.0,0.0,0.0,3,8,1930,510,2006,0,98126,47.5476,-122.37,2440,2310,5,4,2015,N,0,-234
7548800050,4/21/2015,550000.0,3,3.75,1580,1303,2.0,0.0,0.0,3,8,1340,240,2010,0,98144,47.5875,-122.315,1560,1294,4,21,2015,N,20,9
1972201964,7/25/2014,500000.0,3,2.25,1420,983,3.0,0.0,0.0,3,8,1420,0,2006,0,98103,47.6533,-122.346,1530,1280,7,25,2014,N,-110,-297
3395070980,3/27/2015,461500.0,5,3.25,2820,3275,2.0,0.0,0.0,3,8,2230,590,2006,0,98118,47.5339,-122.28399999999999,2610,3275,3,27,2015,N,210,0
5710000005,5/22/2014,2150000.0,4,5.5,5060,10320,2.0,0.0,0.0,3,11,5060,0,2008,0,98004,47.6245,-122.21,3010,10080,5,22,2014,N,2050,240
9319800050,4/21/2015,790000.0,4,2.5,2650,5000,2.0,0.0,0.0,3,8,2650,0,2007,0,98116,47.5605,-122.396,1110,6250,4,21,2015,N,1540,-1250
3303700221,6/27/2014,735000.0,3,2.25,1490,1212,2.0,0.0,0.0,3,9,1040,450,2011,0,98112,47.6226,-122.31299999999999,1490,1337,6,27,2014,N,0,-125
3304300080,3/30/2015,588000.0,4,2.5,3060,7710,2.0,0.0,0.0,3,9,3060,0,2009,0,98059,47.4828,-122.13600000000001,3040,7840,3,30,2015,N,20,-130
642800130,5/13/2015,724500.0,3,3.25,3240,4185,2.0,0.0,0.0,3,8,2770,470,2011,0,98075,47.5794,-122.03,2660,4692,5,13,2015,N,580,-507
6192410480,7/9/2014,749000.0,3,2.75,2820,5348,2.0,0.0,0.0,3,9,2820,0,2008,0,98052,47.7073,-122.118,3140,5640,7,9,2014,N,-320,-292
6127000480,9/18/2014,720000.0,5,3.5,4140,7642,2.0,0.0,0.0,3,8,4140,0,2003,0,98075,47.591,-122.008,3330,6953,9,18,2014,UNK,810,689
6145601599,6/11/2014,250000.0,2,1.5,982,846,2.0,0.0,0.0,3,8,806,176,2006,0,98133,47.7034,-122.345,1010,3844,6,11,2014,N,-28,-2998
3630200460,3/27/2015,790000.0,3,2.75,2460,3600,2.0,0.0,0.0,3,9,2460,0,2007,0,98029,47.5409,-121.994,2570,3600,3,27,2015,N,-110,0
3845101100,1/21/2015,392440.0,4,2.5,2547,4800,2.0,0.0,0.0,3,9,2547,0,2014,0,98092,47.2592,-122.194,2598,4800,1,21,2015,N,-51,0
6792200066,7/25/2014,280000.0,4,2.25,1834,7460,2.0,0.0,0.0,3,8,1834,0,2012,0,98042,47.3568,-122.163,1979,9008,7,25,2014,N,-145,-1548
5317100294,11/13/2014,1330000.0,4,4.5,3130,5126,3.0,0.0,0.0,3,10,2450,680,2014,0,98112,47.6239,-122.29,2540,7784,11,13,2014,N,590,-2658
8150600250,12/17/2014,649000.0,4,2.5,2730,4847,2.0,0.0,0.0,3,9,2730,0,2008,0,98126,47.549,-122.374,1250,4840,12,17,2014,N,1480,7
9376301112,10/31/2014,457000.0,2,2.5,1380,1329,2.0,0.0,0.0,3,8,1050,330,2008,0,98117,47.6903,-122.37,1360,3750,10,31,2014,N,20,-2421
856000635,3/23/2015,2230000.0,4,4.25,4700,10800,2.0,0.0,1.0,3,11,3910,790,2002,0,98033,47.6882,-122.214,2370,7680,3,23,2015,UNK,2330,3120
9320350130,8/23/2014,453000.0,3,3.0,2330,4284,2.0,0.0,0.0,3,9,1920,410,2004,0,98108,47.5547,-122.30799999999999,2330,3709,8,23,2014,N,0,575
7694200380,9/22/2014,329780.0,3,2.5,1730,3600,2.0,0.0,0.0,3,8,1730,0,2014,0,98146,47.5014,-122.34,2030,3600,9,22,2014,N,-300,0
635000009,11/12/2014,1050000.0,2,2.5,2350,2390,3.0,0.0,2.0,3,10,2000,350,2007,0,98144,47.5999,-122.286,1950,2390,11,12,2014,N,400,0
7853440050,5/5/2015,771005.0,5,4.5,4000,6713,2.0,0.0,0.0,3,9,4000,0,2015,0,98024,47.5254,-121.88600000000001,3690,6600,5,5,2015,N,310,113
8563010130,7/25/2014,1300000.0,3,2.5,3350,7752,1.0,0.0,0.0,3,9,2180,1170,2009,0,98008,47.6263,-122.09899999999999,2570,7988,7,25,2014,N,780,-236
2767604592,6/19/2014,607500.0,3,3.25,1530,1612,3.0,0.0,0.0,3,8,1530,0,2006,0,98107,47.6706,-122.37799999999999,1530,1611,6,19,2014,N,0,1
1332700020,1/16/2015,278000.0,2,2.25,1610,1968,2.0,0.0,0.0,4,7,1610,0,1979,0,98056,47.5184,-122.196,1950,1968,1,16,2015,UNK,-340,0
1442870440,7/2/2014,475000.0,4,2.75,2620,6178,2.0,0.0,0.0,3,8,2620,0,2013,0,98045,47.4823,-121.771,2790,6538,7,2,2014,N,-170,-360
5347200179,8/14/2014,270000.0,3,2.0,1300,1920,2.0,0.0,0.0,3,8,850,450,2006,0,98126,47.5183,-122.376,1300,1344,8,14,2014,N,0,576
8924100372,4/23/2015,1300000.0,4,3.5,3590,5334,2.0,0.0,2.0,3,9,3140,450,2006,0,98115,47.6763,-122.26700000000001,2100,6250,4,23,2015,N,1490,-916
6666830170,8/11/2014,778983.0,4,2.5,2490,5647,2.0,0.0,0.0,3,8,2490,0,2014,0,98052,47.7043,-122.11399999999999,2970,5450,8,11,2014,N,-480,197
3336000052,10/22/2014,221000.0,3,2.5,1320,1780,2.0,0.0,0.0,3,7,880,440,2005,0,98118,47.528,-122.26899999999999,3040,6000,10,22,2014,N,-1720,-4220
2895800380,8/21/2014,338800.0,4,2.25,1800,2752,2.0,0.0,0.0,3,8,1800,0,2014,0,98106,47.5165,-122.346,1800,2752,8,21,2014,N,0,0
1042700250,8/4/2014,834995.0,5,1.5,3360,5225,2.0,0.0,0.0,3,9,3360,0,2014,0,98074,47.6072,-122.053,3230,5368,8,4,2014,N,130,-143
7787920250,5/1/2015,550000.0,4,2.5,3220,9328,2.0,0.0,0.0,3,8,3220,0,2006,0,98019,47.7273,-121.958,3020,9300,5,1,2015,N,200,28
3026059363,10/31/2014,575000.0,3,3.5,2514,1559,2.0,0.0,0.0,3,8,2024,490,2007,0,98034,47.7044,-122.209,2090,10454,10,31,2014,N,424,-8895
3590000050,9/23/2014,649000.0,4,2.75,3130,9711,2.0,0.0,0.0,3,9,3130,0,2014,0,98059,47.4823,-122.124,1570,10500,9,23,2014,N,1560,-789
7853361410,5/30/2014,545000.0,4,2.5,2720,4738,2.0,0.0,0.0,3,8,2720,0,2012,0,98065,47.515,-121.869,2590,5740,5,30,2014,N,130,-1002
1355300009,11/20/2014,625000.0,2,2.25,1390,916,2.0,0.0,0.0,3,8,1165,225,2007,0,98122,47.6168,-122.314,1415,1488,11,20,2014,N,-25,-572
8835800010,12/23/2014,1040000.0,4,4.5,4920,270236,2.0,0.0,3.0,3,10,3820,1100,2006,0,98045,47.4695,-121.775,4920,260924,12,23,2014,N,0,9312
9268851680,5/16/2014,611000.0,3,2.5,2134,1984,2.5,0.0,0.0,3,8,2134,0,2008,0,98027,47.5402,-122.027,2170,1984,5,16,2014,N,-36,0
8096800500,3/17/2015,300000.0,3,2.5,1741,5701,2.0,0.0,0.0,3,8,1741,0,2012,0,98030,47.379,-122.184,2002,5700,3,17,2015,N,-261,1
7202261060,12/29/2014,577000.0,3,2.5,2560,5238,2.0,0.0,0.0,3,8,2560,0,2001,0,98053,47.6887,-122.04,2560,5185,12,29,2014,UNK,0,53
7237450130,10/20/2014,349990.0,4,2.5,2220,3561,2.0,0.0,0.0,3,8,2220,0,2014,0,98038,47.3561,-122.06299999999999,2530,4449,10,20,2014,N,-310,-888
3630130010,7/14/2014,650000.0,3,2.5,1910,4363,2.0,0.0,0.0,3,9,1910,0,2006,0,98029,47.5482,-121.99600000000001,1890,3732,7,14,2014,N,20,631
567000381,3/28/2015,378000.0,2,1.5,980,853,2.0,0.0,0.0,3,7,820,160,2009,0,98144,47.5925,-122.295,1130,1270,3,28,2015,N,-150,-417
1760650290,2/5/2015,313200.0,3,2.5,1950,4197,2.0,0.0,0.0,3,7,1950,0,2013,0,98042,47.3613,-122.081,2300,4178,2,5,2015,N,-350,19
1024069215,9/12/2014,1210000.0,5,4.25,4150,12015,2.0,0.0,0.0,3,10,4150,0,2014,0,98075,47.5816,-122.021,3230,27520,9,12,2014,N,920,-15505
1105000373,5/6/2015,252500.0,2,1.5,1110,986,2.0,0.0,0.0,3,7,950,160,2009,0,98118,47.5427,-122.272,1110,3515,5,6,2015,N,0,-2529
1773100561,3/5/2015,308000.0,3,2.5,1250,1150,2.0,0.0,0.0,3,8,1080,170,2009,0,98106,47.5582,-122.363,1250,1150,3,5,2015,N,0,0
9510860840,5/15/2014,803100.0,4,2.5,3310,5404,2.0,0.0,0.0,3,9,3310,0,2004,0,98052,47.6635,-122.083,2600,4730,5,15,2014,N,710,674
4187000660,6/18/2014,415000.0,4,2.5,2020,5501,2.0,0.0,0.0,3,7,2020,0,2010,0,98059,47.4937,-122.15,2020,5494,6,18,2014,N,0,7
7203120020,8/14/2014,785000.0,4,3.5,3310,4850,2.0,0.0,0.0,3,9,3310,0,2010,0,98053,47.6954,-122.022,3320,5955,8,14,2014,N,-10,-1105
8559300020,5/28/2014,499950.0,4,2.5,2798,4473,2.0,0.0,0.0,3,9,2798,0,2012,0,98055,47.4295,-122.205,2358,4593,5,28,2014,N,440,-120
3356402705,3/17/2015,216000.0,4,2.5,1847,8000,2.0,0.0,0.0,3,7,1847,0,2008,0,98001,47.2874,-122.257,1767,8000,3,17,2015,N,80,0
662440020,2/26/2015,380000.0,4,2.5,2420,4981,2.0,0.0,0.0,3,9,2420,0,2009,0,98038,47.3785,-122.023,2420,5000,2,26,2015,N,0,-19
255370020,11/6/2014,345000.0,4,2.5,2020,3600,2.0,0.0,0.0,3,7,2020,0,2012,0,98038,47.3535,-122.01700000000001,2210,3800,11,6,2014,N,-190,-200
293810190,11/4/2014,456500.0,4,2.5,2400,6811,2.0,0.0,0.0,3,8,2400,0,2007,0,98059,47.4959,-122.15,2710,5314,11,4,2014,N,-310,1497
8091670190,11/4/2014,382495.0,3,2.5,1760,5390,1.0,0.0,0.0,3,8,1760,0,2014,0,98038,47.3482,-122.042,2310,5117,11,4,2014,N,-550,273
1760650280,3/6/2015,324950.0,4,2.5,2110,4178,2.0,0.0,0.0,3,7,2110,0,2013,0,98042,47.3612,-122.081,2300,4142,3,6,2015,N,-190,36
6306800010,8/11/2014,436472.0,4,2.5,2692,8392,2.0,0.0,0.0,3,9,2692,0,2014,0,98030,47.3519,-122.197,2574,14446,8,11,2014,N,118,-6054
982850010,5/30/2014,365250.0,3,2.25,1490,4522,2.0,0.0,0.0,3,7,1490,0,2009,0,98028,47.7611,-122.23299999999999,1580,4667,5,30,2014,N,-90,-145
6705600020,3/24/2015,919990.0,5,3.25,3960,6352,2.0,0.0,0.0,3,10,3960,0,2014,0,98075,47.5806,-122.055,2930,9875,3,24,2015,N,1030,-3523
9478550430,4/29/2015,316475.0,4,2.5,1740,4642,2.0,0.0,0.0,3,7,1740,0,2012,0,98042,47.3686,-122.117,1950,4642,4,29,2015,N,-210,0
5498100010,3/24/2015,425000.0,4,2.5,1940,4517,1.0,0.0,0.0,3,8,1190,750,2010,0,98028,47.776,-122.26,1910,10410,3,24,2015,N,30,-5893
7625702901,3/11/2015,302860.0,2,1.0,970,3279,2.0,0.0,0.0,3,7,790,180,2007,0,98136,47.5469,-122.383,1150,1351,3,11,2015,N,-180,1928
301401410,7/22/2014,298000.0,3,2.5,1852,4000,2.0,0.0,0.0,3,7,1852,0,2014,0,98002,47.3455,-122.21,2166,4000,7,22,2014,N,-314,0
251500080,8/26/2014,3200000.0,4,4.0,4810,18851,2.0,0.0,3.0,3,11,4810,0,2007,0,98004,47.6364,-122.214,3970,19929,8,26,2014,N,840,-1078
521049227,12/1/2014,950000.0,4,4.0,5635,9695,2.0,0.0,3.0,3,10,4360,1275,2011,0,98003,47.3389,-122.334,3726,9765,12,1,2014,N,1909,-70
100300500,11/21/2014,333000.0,3,2.5,1520,3041,2.0,0.0,0.0,3,7,1520,0,2009,0,98059,47.4874,-122.152,1820,3229,11,21,2014,N,-300,-188
8669160460,3/5/2015,289950.0,3,2.5,2099,4275,2.0,0.0,0.0,3,7,2099,0,2010,0,98002,47.3521,-122.211,2099,4275,3,5,2015,N,0,0
2810100007,5/6/2015,419950.0,3,2.25,1250,811,3.0,0.0,0.0,3,8,1250,0,2014,0,98136,47.5419,-122.38799999999999,1250,1232,5,6,2015,N,0,-421
6749700006,7/15/2014,306000.0,2,1.5,1090,1183,3.0,0.0,0.0,3,8,1090,0,2008,0,98103,47.6974,-122.34899999999999,1110,1384,7,15,2014,N,-20,-201
1085623730,11/29/2014,498445.0,4,2.5,3216,5902,2.0,0.0,0.0,3,9,3216,0,2014,0,98030,47.3425,-122.179,2815,4916,11,29,2014,N,401,986
6666830430,6/20/2014,775950.0,4,2.5,2970,4400,2.0,0.0,0.0,3,8,2970,0,2014,0,98052,47.705,-122.11399999999999,3010,4892,6,20,2014,N,-40,-492
7852110380,7/3/2014,605000.0,3,2.5,2610,6405,2.0,0.0,0.0,3,8,2610,0,2001,0,98065,47.5373,-121.874,2580,6285,7,3,2014,UNK,30,120
8080400177,9/9/2014,520000.0,2,1.75,1340,1368,2.0,0.0,0.0,3,7,1060,280,2006,0,98122,47.618,-122.311,2480,1707,9,9,2014,N,-1140,-339
293070010,10/28/2014,849990.0,4,2.75,3300,4987,2.0,0.0,0.0,3,9,3300,0,2014,0,98074,47.6175,-122.056,3520,5453,10,28,2014,N,-220,-466
9144100007,6/4/2014,767450.0,3,2.0,1630,7599,1.0,0.0,0.0,3,10,1630,0,2006,0,98117,47.6981,-122.376,2030,7599,6,4,2014,N,-400,0
7234601142,8/8/2014,665000.0,3,2.25,1590,929,2.0,0.0,0.0,3,9,1060,530,2014,0,98122,47.6172,-122.31,1510,1193,8,8,2014,N,80,-264
1972200426,9/18/2014,525000.0,2,2.75,1310,1268,3.5,0.0,0.0,3,8,1310,0,2007,0,98103,47.6534,-122.355,1350,1288,9,18,2014,N,-40,-20
7768800280,7/22/2014,870515.0,4,3.5,3600,5697,2.0,0.0,0.0,3,9,2940,660,2014,0,98075,47.5755,-122.071,3490,5911,7,22,2014,N,110,-214
9512200420,7/21/2014,390000.0,4,2.5,2154,4153,2.0,0.0,0.0,3,9,2154,0,2012,0,98058,47.4557,-122.13,2154,4091,7,21,2014,N,0,62
7132300525,4/11/2015,500000.0,3,1.75,1530,825,3.0,0.0,0.0,3,8,1530,0,2015,0,98144,47.5929,-122.30799999999999,1580,1915,4,11,2015,N,-50,-1090
7515000143,8/5/2014,399950.0,3,2.25,1360,1041,2.0,0.0,0.0,3,8,1094,266,2006,0,98117,47.6925,-122.375,1522,1382,8,5,2014,N,-162,-341
3395070440,2/9/2015,305000.0,3,2.5,1320,2480,2.0,0.0,0.0,3,7,1320,0,2005,0,98118,47.536,-122.28399999999999,1320,3240,2,9,2015,N,0,-760
629650380,1/23/2015,255000.0,4,2.5,1660,6724,2.0,0.0,0.0,3,7,1660,0,2009,0,98001,47.25899999999999,-122.256,1544,6054,1,23,2015,N,116,670
1115600130,9/30/2014,415000.0,4,2.5,2891,6499,2.0,0.0,0.0,3,9,2891,0,2014,0,98001,47.3359,-122.257,2550,8383,9,30,2014,N,341,-1884
8562790950,3/27/2015,716500.0,3,2.5,2340,2155,2.0,0.0,0.0,3,10,2120,220,2012,0,98027,47.53,-122.073,2640,2680,3,27,2015,N,-300,-525
3413700130,6/25/2014,425000.0,3,2.5,2320,2267,3.0,0.0,0.0,3,8,2320,0,2009,0,98177,47.7027,-122.359,1240,1883,6,25,2014,N,1080,384
9532000170,2/17/2015,540000.0,4,2.5,2190,3855,2.0,0.0,0.0,3,8,2190,0,2010,0,98011,47.7705,-122.169,2190,3600,2,17,2015,N,0,255
255450380,8/4/2014,324747.0,3,2.5,2060,4742,2.0,0.0,0.0,3,8,2060,0,2014,0,98038,47.3706,-122.01700000000001,2370,4725,8,4,2014,N,-310,17
7203140420,1/28/2015,385000.0,3,2.5,1740,4145,2.0,0.0,0.0,3,7,1740,0,2010,0,98053,47.6875,-122.015,1740,4045,1,28,2015,N,0,100
1760650670,8/12/2014,270000.0,3,2.25,1400,3825,2.0,0.0,0.0,3,7,1400,0,2012,0,98042,47.3596,-122.08200000000001,2110,3825,8,12,2014,N,-710,0
5556300098,6/12/2014,1240000.0,5,4.0,4410,14380,2.0,0.0,0.0,3,11,4410,0,2006,0,98052,47.6463,-122.12100000000001,2720,11454,6,12,2014,N,1690,2926
8129700743,4/16/2015,672000.0,3,2.5,1780,1647,2.0,0.0,0.0,3,8,1080,700,2008,0,98103,47.6597,-122.355,2000,1741,4,16,2015,N,-220,-94
3023000050,1/29/2015,310000.0,3,2.5,1760,10137,2.0,0.0,0.0,3,8,1760,0,2010,0,98038,47.355,-122.059,2000,6935,1,29,2015,N,-240,3202
518500480,8/11/2014,3000000.0,3,3.5,4410,10756,2.0,1.0,4.0,3,11,3430,980,2014,0,98056,47.5283,-122.205,3550,5634,8,11,2014,N,860,5122
1725059127,2/25/2015,2350000.0,6,4.25,5550,11547,2.0,0.0,2.0,3,11,4270,1280,2014,0,98033,47.6547,-122.20200000000001,3480,11547,2,25,2015,N,2070,0
9511120050,6/27/2014,427000.0,3,2.5,2432,9391,2.0,0.0,2.0,3,9,2432,0,2005,0,98001,47.3453,-122.26700000000001,2912,8932,6,27,2014,N,-480,459
8943600430,4/23/2015,389950.0,3,2.5,2283,3996,2.0,0.0,0.0,3,8,2283,0,2008,0,98031,47.4221,-122.19200000000001,1760,3992,4,23,2015,N,523,4
9429400170,6/25/2014,309620.0,3,2.5,1860,3730,2.0,0.0,0.0,3,8,1860,0,2012,0,98019,47.7442,-121.984,2110,4509,6,25,2014,N,-250,-779
3845101150,7/1/2014,399895.0,4,2.5,2701,4500,2.0,0.0,0.0,3,9,2701,0,2014,0,98092,47.2586,-122.194,2570,4800,7,1,2014,N,131,-300
1085623560,2/2/2015,442515.0,4,2.5,2930,4875,2.0,0.0,0.0,3,9,2930,0,2014,0,98030,47.3421,-122.179,2815,4900,2,2,2015,N,115,-25
263000255,12/2/2014,375000.0,3,2.25,1540,1561,3.0,0.0,0.0,3,8,1540,0,2010,0,98103,47.6991,-122.346,1540,1547,12,2,2014,N,0,14
7299600130,7/2/2014,309780.0,3,2.5,2242,4500,2.0,0.0,0.0,3,8,2242,0,2014,0,98092,47.2583,-122.198,2009,4500,7,2,2014,N,233,0
7853320280,3/12/2015,425000.0,3,2.5,1950,4345,2.0,0.0,0.0,3,7,1950,0,2007,0,98065,47.5202,-121.87299999999999,2260,4345,3,12,2015,N,-310,0
4253400098,5/1/2015,405000.0,2,3.0,1160,1073,2.0,0.0,0.0,3,7,880,280,2007,0,98144,47.5788,-122.315,1250,4812,5,1,2015,N,-90,-3739
3814900380,7/19/2014,356250.0,3,2.5,2060,5115,2.0,0.0,0.0,3,9,2060,0,2014,0,98092,47.3261,-122.163,2648,4500,7,19,2014,N,-588,615
6821101732,2/19/2015,550000.0,3,2.25,1230,875,3.0,0.0,0.0,3,8,1230,0,2013,0,98199,47.6521,-122.4,1760,5664,2,19,2015,N,-530,-4789
3644100086,5/5/2014,340000.0,2,1.5,1160,1438,2.0,0.0,0.0,3,7,1160,0,2001,0,98144,47.5917,-122.295,1220,1740,5,5,2014,UNK,-60,-302
7237450080,8/23/2014,362865.0,4,2.5,2245,4301,2.0,0.0,0.0,3,8,2245,0,2014,0,98038,47.3555,-122.06299999999999,2530,4478,8,23,2014,N,-285,-177
6389970010,3/23/2015,1360000.0,4,3.5,4120,12626,2.0,0.0,1.0,3,11,3970,150,2014,0,98034,47.7089,-122.245,4120,11913,3,23,2015,N,0,713
9578090050,5/5/2014,830000.0,4,2.5,3400,9692,2.0,0.0,0.0,3,9,3400,0,2007,0,98052,47.708,-122.109,3070,7375,5,5,2014,N,330,2317
1489300005,8/1/2014,1600000.0,5,3.75,4270,7500,2.0,0.0,0.0,3,10,3210,1060,2014,0,98033,47.6845,-122.20700000000001,2410,8350,8,1,2014,N,1860,-850
7768800290,3/4/2015,855000.0,4,3.5,2890,5911,2.0,0.0,0.0,3,9,2370,520,2014,0,98075,47.5754,-122.071,3490,6093,3,4,2015,N,-600,-182
1245003220,8/19/2014,1210000.0,5,3.5,3220,8000,2.0,0.0,0.0,3,9,2900,320,2008,0,98033,47.6834,-122.2,2100,9680,8,19,2014,N,1120,-1680
5608000010,8/11/2014,1390000.0,4,3.5,4010,15365,2.0,0.0,1.0,3,11,4010,0,2006,0,98027,47.5528,-122.09299999999999,3550,13429,8,11,2014,N,460,1936
5379805260,3/26/2015,400200.0,4,3.5,2260,30250,2.0,0.0,0.0,3,7,2260,0,2013,0,98188,47.4493,-122.281,1270,16350,3,26,2015,N,990,13900
3278600670,5/23/2014,235000.0,2,1.0,1140,1730,1.5,0.0,0.0,3,8,1010,130,2007,0,98126,47.5494,-122.37200000000001,1360,1730,5,23,2014,N,-220,0
2781240050,5/7/2015,349950.0,3,2.0,1640,4714,1.0,0.0,0.0,3,8,1640,0,2009,0,98038,47.3539,-122.021,1770,4802,5,7,2015,N,-130,-88
7502800050,7/9/2014,659950.0,4,2.75,3510,9400,2.0,0.0,0.0,3,9,3510,0,2014,0,98059,47.4827,-122.131,3550,9429,7,9,2014,N,-40,-29
9544700500,5/8/2014,785000.0,3,2.75,3010,1842,2.0,0.0,0.0,3,9,3010,0,2011,0,98075,47.5836,-121.994,2950,4200,5,8,2014,N,60,-2358
2771603314,4/16/2015,475000.0,2,2.25,1060,925,2.0,0.0,0.0,3,8,980,80,2006,0,98199,47.6386,-122.38799999999999,1020,4000,4,16,2015,N,40,-3075
4181200680,5/27/2014,263900.0,3,2.5,1658,2700,2.0,0.0,0.0,3,8,1658,0,2014,0,98198,47.3667,-122.307,1658,2700,5,27,2014,N,0,0
9347300010,5/1/2015,342000.0,3,2.5,1960,3540,2.0,0.0,0.0,3,8,1960,0,2012,0,98038,47.3568,-122.055,1840,3825,5,1,2015,N,120,-285
255450020,9/18/2014,367899.0,3,2.5,2420,4725,2.0,0.0,0.0,3,8,2420,0,2014,0,98038,47.371,-122.01799999999999,2370,4200,9,18,2014,N,50,525
7230200585,2/4/2015,657044.0,3,3.5,3420,23786,1.5,0.0,0.0,3,9,3420,0,2014,0,98059,47.4739,-122.11,1590,23774,2,4,2015,N,1830,12
9828702771,11/13/2014,359950.0,2,1.5,893,965,2.0,0.0,0.0,3,8,893,0,2007,0,98122,47.6187,-122.301,1340,1436,11,13,2014,N,-447,-471
9492500170,7/23/2014,879950.0,4,2.75,3020,7203,2.0,0.0,0.0,3,9,3020,0,2014,0,98033,47.6948,-122.178,3010,7215,7,23,2014,N,10,-12
9265880170,8/26/2014,550000.0,4,2.5,2470,5954,2.0,0.0,0.0,3,8,2470,0,2013,0,98028,47.7685,-122.236,2470,4800,8,26,2014,N,0,1154
7299600920,12/9/2014,279000.0,4,2.5,2009,4800,2.0,0.0,0.0,3,8,2009,0,2012,0,98092,47.2586,-122.2,1798,4800,12,9,2014,N,211,0
8690600050,7/18/2014,255000.0,3,2.5,1530,1116,2.5,0.0,0.0,3,7,1530,0,2005,0,98028,47.7385,-122.25,1530,7780,7,18,2014,N,0,-6664
1176001119,2/24/2015,609500.0,3,1.75,1590,1113,3.0,0.0,0.0,3,8,1590,0,2014,0,98107,47.6691,-122.402,1520,1357,2,24,2015,N,70,-244
3449850050,6/20/2014,420000.0,5,3.0,2630,3149,2.0,0.0,0.0,3,8,1670,960,2013,0,98056,47.5065,-122.171,2240,4825,6,20,2014,N,390,-1676
9211000170,10/8/2014,570000.0,4,2.5,3230,7187,2.0,0.0,0.0,3,9,3230,0,2008,0,98059,47.4995,-122.15,2950,6537,10,8,2014,N,280,650
6056111350,5/12/2015,439000.0,3,2.25,1430,2343,2.0,0.0,0.0,3,8,1430,0,2012,0,98108,47.5648,-122.294,1270,1916,5,12,2015,N,160,427
7299601630,11/8/2014,310000.0,3,2.5,2242,5744,2.0,0.0,0.0,3,8,2242,0,2012,0,98092,47.2597,-122.199,2009,5712,11,8,2014,N,233,32
7133300380,2/9/2015,635000.0,4,2.5,2500,4000,2.0,0.0,0.0,3,8,2500,0,2014,0,98144,47.5902,-122.311,1480,4300,2,9,2015,N,1020,-300
2770601775,11/28/2014,399950.0,3,2.5,1230,922,2.0,0.0,0.0,3,8,1080,150,2009,0,98199,47.6518,-122.384,1230,1237,11,28,2014,N,0,-315
3630200630,8/5/2014,805000.0,4,2.5,3020,3600,2.5,0.0,0.0,3,9,3020,0,2009,0,98029,47.5407,-121.993,2570,3600,8,5,2014,N,450,0
4385700250,4/7/2015,1800000.0,4,3.5,3480,4000,2.0,0.0,0.0,3,9,2460,1020,2015,0,98112,47.6356,-122.281,2620,4000,4,7,2015,N,860,0
6430500182,4/3/2015,1210000.0,4,3.0,3330,7650,1.0,0.0,0.0,3,9,1830,1500,2008,0,98103,47.6889,-122.352,1200,3876,4,3,2015,N,2130,3774
8029770190,10/15/2014,745000.0,4,2.5,3400,4840,2.0,0.0,0.0,3,10,3190,210,2006,0,98059,47.5066,-122.146,3400,5710,10,15,2014,N,0,-870
5393600507,6/24/2014,329445.0,2,1.5,830,1119,2.0,0.0,0.0,3,7,830,0,2005,0,98144,47.5828,-122.314,1480,3622,6,24,2014,N,-650,-2503
207700050,10/15/2014,588000.0,5,3.0,3110,4464,2.0,0.0,0.0,3,8,3110,0,2007,0,98011,47.7719,-122.16799999999999,2450,4221,10,15,2014,N,660,243
8138870470,7/7/2014,494815.0,3,2.5,1910,2091,2.0,0.0,0.0,3,8,1910,0,2014,0,98029,47.5445,-122.01299999999999,1630,1546,7,7,2014,N,280,545
7853370020,10/14/2014,591975.0,3,2.75,3230,5250,2.0,0.0,0.0,3,9,2680,550,2014,0,98065,47.5196,-121.87799999999999,2710,5250,10,14,2014,N,520,0
3304300380,1/8/2015,600000.0,5,2.75,3380,8179,2.0,0.0,0.0,3,9,3380,0,2011,0,98059,47.4827,-122.135,2840,8179,1,8,2015,N,540,0
3528960020,7/8/2014,673000.0,3,2.75,2830,3496,2.0,0.0,0.0,3,8,2830,0,2012,0,98029,47.5606,-122.01100000000001,2160,3501,7,8,2014,N,670,-5
1853080840,2/11/2015,889950.0,5,3.5,3700,7055,2.0,0.0,0.0,3,9,3700,0,2014,0,98074,47.5929,-122.057,3170,6527,2,11,2015,N,530,528
7852130460,3/25/2015,500000.0,4,3.0,2520,4104,2.0,0.0,0.0,3,7,2520,0,2002,0,98065,47.5352,-121.88,2510,5015,3,25,2015,UNK,10,-911
2768301357,10/1/2014,500000.0,3,2.25,1530,1396,2.0,0.0,0.0,3,8,1240,290,2007,0,98107,47.666000000000004,-122.367,1690,2500,10,1,2014,N,-160,-1104
8562710250,5/5/2014,890000.0,4,4.25,4420,5750,2.0,0.0,0.0,3,10,3410,1010,2006,0,98027,47.5404,-122.073,4420,5750,5,5,2014,N,0,0
6824100014,4/29/2015,437000.0,3,3.0,1460,1180,3.0,0.0,0.0,3,8,1460,0,2006,0,98117,47.6998,-122.367,1460,1224,4,29,2015,N,0,-44
7905200061,9/5/2014,419700.0,3,2.25,1450,1486,2.0,0.0,0.0,3,8,1160,290,2006,0,98116,47.5694,-122.387,1370,1437,9,5,2014,N,80,49
3524039228,7/23/2014,394000.0,3,2.0,1160,3441,1.0,0.0,0.0,4,6,580,580,1930,0,98136,47.5314,-122.39200000000001,1160,4000,7,23,2014,UNK,0,-559
2781240040,8/6/2014,342000.0,3,2.0,1640,4802,1.0,0.0,0.0,3,8,1640,0,2010,0,98038,47.3538,-122.021,1940,4802,8,6,2014,N,-300,0
1222029064,6/26/2014,420000.0,3,1.75,1444,249126,1.5,0.0,0.0,3,7,1444,0,2008,0,98070,47.4104,-122.486,1760,224770,6,26,2014,N,-316,24356
9523100730,5/23/2014,580000.0,3,2.5,1620,1173,3.0,0.0,4.0,3,8,1470,150,2008,0,98103,47.6681,-122.355,1620,1505,5,23,2014,N,0,-332
5649600464,3/27/2015,343000.0,2,1.5,1100,1228,2.0,0.0,0.0,3,7,900,200,2007,0,98118,47.5538,-122.28200000000001,1340,1380,3,27,2015,N,-240,-152
7548301050,4/2/2015,390000.0,2,1.5,1340,1402,2.0,0.0,0.0,3,8,1120,220,2008,0,98144,47.588,-122.304,1340,1213,4,2,2015,N,0,189
9542840450,8/11/2014,274000.0,3,1.5,1450,4694,2.0,0.0,0.0,3,7,1450,0,2011,0,98038,47.3654,-122.021,1870,4198,8,11,2014,N,-420,496
126039467,1/14/2015,700000.0,4,2.5,3040,7200,2.0,0.0,0.0,3,9,3040,0,2008,0,98177,47.7747,-122.366,2360,8245,1,14,2015,N,680,-1045
7936000463,4/16/2015,838000.0,4,2.5,2560,7210,2.0,0.0,0.0,3,9,2560,0,2006,0,98136,47.5535,-122.395,2160,10439,4,16,2015,N,400,-3229
3021059304,9/17/2014,300000.0,6,3.0,2744,9926,2.0,0.0,0.0,3,7,2744,0,2006,0,98002,47.2773,-122.21600000000001,2470,9926,9,17,2014,N,274,0
3362401758,9/3/2014,467000.0,3,2.25,1420,990,3.0,0.0,0.0,3,8,1420,0,2008,0,98103,47.6801,-122.348,1350,1415,9,3,2014,N,70,-425
886000090,3/2/2015,395000.0,2,1.0,700,7457,1.0,0.0,0.0,3,6,700,0,1943,0,98108,47.5348,-122.295,1500,7130,3,2,2015,UNK,-800,327
1196003740,9/24/2014,734000.0,5,4.25,4110,42755,2.0,0.0,0.0,3,10,2970,1140,2000,0,98023,47.3375,-122.337,2730,12750,9,24,2014,UNK,1380,30005
5045700090,1/6/2015,480000.0,5,2.75,2670,4780,2.0,0.0,0.0,3,8,2670,0,2013,0,98059,47.4866,-122.155,2560,5380,1,6,2015,N,110,-600
1604601801,2/17/2015,539000.0,3,2.75,2130,1400,2.0,0.0,0.0,3,9,1080,1050,2010,0,98118,47.5661,-122.29,1520,3132,2,17,2015,N,610,-1732
5057100090,5/5/2015,459950.0,5,2.75,3078,6371,2.0,0.0,0.0,3,9,3078,0,2014,0,98042,47.3587,-122.163,1979,19030,5,5,2015,N,1099,-12659
3869900146,10/30/2014,306500.0,2,1.0,840,892,2.0,0.0,0.0,3,7,840,0,2006,0,98136,47.5396,-122.387,1030,1007,10,30,2014,N,-190,-115
3862710180,3/26/2015,408474.0,3,2.5,1800,2731,2.0,0.0,0.0,3,8,1800,0,2014,0,98065,47.5342,-121.84100000000001,1800,3265,3,26,2015,N,0,-534
1023059246,5/14/2014,437000.0,3,2.75,2580,5200,2.0,0.0,0.0,3,8,2580,0,2008,0,98059,47.496,-122.15100000000001,2700,5602,5,14,2014,N,-120,-402
6056100150,6/23/2014,160797.0,3,1.5,1270,2356,2.0,0.0,0.0,3,7,1270,0,2012,0,98108,47.5671,-122.29799999999999,1490,2175,6,23,2014,N,-220,181
3342700464,1/7/2015,729000.0,4,3.5,3065,5440,3.0,0.0,0.0,3,9,3065,0,2014,0,98056,47.523999999999994,-122.2,2210,8400,1,7,2015,N,855,-2960
3026059362,10/31/2014,499000.0,3,2.5,1861,1587,2.0,0.0,0.0,3,8,1578,283,2007,0,98034,47.7043,-122.209,2090,10454,10,31,2014,N,-229,-8867
1327600150,10/16/2014,359950.0,4,2.75,2260,5705,2.0,0.0,0.0,3,8,2260,0,2014,0,98042,47.3726,-122.15899999999999,2260,5727,10,16,2014,N,0,-22
2895730540,12/10/2014,929000.0,5,3.25,4150,7100,2.0,0.0,0.0,3,10,4150,0,2013,0,98074,47.6026,-122.06,3560,7214,12,10,2014,N,590,-114
2768200209,10/6/2014,529950.0,2,2.5,1500,1174,2.0,0.0,0.0,3,8,1140,360,2014,0,98107,47.6689,-122.363,1550,1519,10,6,2014,N,-50,-345
9268851380,4/3/2015,461000.0,3,2.25,1620,998,2.5,0.0,0.0,3,8,1540,80,2012,0,98027,47.5394,-122.027,1620,1068,4,3,2015,N,0,-70
7625703007,10/14/2014,271115.0,2,1.5,830,1325,2.0,0.0,0.0,3,7,830,0,2005,0,98136,47.5472,-122.384,1310,1485,10,14,2014,N,-480,-160
7202280580,1/6/2015,653000.0,4,2.5,3120,5137,2.0,0.0,0.0,3,7,3120,0,2003,0,98053,47.6842,-122.04,2755,5137,1,6,2015,UNK,365,0
1972202187,10/24/2014,565000.0,3,2.5,1870,1058,3.0,0.0,0.0,3,8,1380,490,2007,0,98103,47.6512,-122.345,1440,1136,10,24,2014,N,430,-78
2767600985,12/4/2014,529950.0,3,2.25,1240,1250,3.0,0.0,0.0,3,8,1240,0,2014,0,98107,47.6748,-122.37700000000001,1470,1250,12,4,2014,N,-230,0
5631501202,3/26/2015,585000.0,4,2.5,2820,5612,2.0,0.0,0.0,3,9,2820,0,2007,0,98028,47.7477,-122.236,1620,14881,3,26,2015,N,1200,-9269
1972200556,7/3/2014,609000.0,3,1.75,1630,1526,3.0,0.0,0.0,3,8,1630,0,2014,0,98103,47.6536,-122.354,1570,1274,7,3,2014,N,60,252
301400930,6/18/2014,267000.0,3,2.25,1584,2800,2.0,0.0,0.0,3,7,1584,0,2012,0,98002,47.3454,-122.214,1584,2800,6,18,2014,N,0,0
9265880040,5/9/2014,557000.0,4,2.5,2840,4500,2.0,0.0,0.0,3,8,2840,0,2012,0,98028,47.7678,-122.23700000000001,2840,4939,5,9,2014,N,0,-439
7853280610,11/17/2014,709950.0,4,3.25,3910,6293,2.0,0.0,0.0,3,9,3130,780,2006,0,98065,47.5389,-121.86,4410,6015,11,17,2014,N,-500,278
1972200847,7/18/2014,625000.0,3,2.5,1730,1301,3.0,0.0,0.0,3,9,1730,0,2011,0,98103,47.653,-122.352,1330,1240,7,18,2014,N,400,61
8562790940,12/23/2014,599000.0,3,2.75,1840,2060,2.0,0.0,0.0,3,10,1700,140,2013,0,98027,47.53,-122.073,2590,2680,12,23,2014,N,-750,-620
1623089165,5/6/2015,920000.0,4,3.75,4030,503989,2.0,0.0,0.0,3,10,4030,0,2008,0,98045,47.4807,-121.795,2110,71874,5,6,2015,N,1920,432115
6788200596,10/16/2014,1290000.0,4,3.5,3440,3800,3.0,0.0,0.0,3,9,3440,0,2014,0,98112,47.6408,-122.307,1760,3800,10,16,2014,N,1680,0
1760650610,3/30/2015,324500.0,4,2.5,2110,3825,2.0,0.0,0.0,3,7,2110,0,2012,0,98042,47.3602,-122.08200000000001,2110,3825,3,30,2015,N,0,0
7853360850,1/16/2015,471500.0,3,2.5,2430,5866,2.0,0.0,0.0,3,7,2430,0,2009,0,98065,47.5158,-121.87100000000001,2380,5866,1,16,2015,N,50,0
2526069092,8/8/2014,1020000.0,4,3.75,4690,207141,2.0,0.0,0.0,3,10,4030,660,2007,0,98019,47.7072,-121.98299999999999,2890,200527,8,8,2014,N,1800,6614
2424059061,11/11/2014,998000.0,4,3.5,3500,43560,2.0,0.0,0.0,3,9,2850,650,2014,0,98006,47.5481,-122.103,3640,40545,11,11,2014,N,-140,3015
7661600206,1/29/2015,262000.0,4,2.5,2070,8685,2.0,0.0,0.0,3,7,2070,0,2006,0,98188,47.4697,-122.26700000000001,2170,9715,1,29,2015,N,-100,-1030
8149600065,4/1/2015,844000.0,4,3.5,3350,6350,2.0,0.0,2.0,3,8,2610,740,2009,0,98116,47.5602,-122.39,1820,6350,4,1,2015,N,1530,0
6666830120,6/24/2014,745641.0,4,2.5,2440,4850,2.0,0.0,0.0,3,8,2440,0,2013,0,98052,47.7043,-122.11399999999999,2970,5450,6,24,2014,N,-530,-600
3034200087,12/12/2014,659950.0,5,3.0,3010,7357,2.0,0.0,0.0,3,9,3010,0,2008,0,98133,47.7226,-122.33,2370,8050,12,12,2014,N,640,-693
255450410,8/4/2014,339989.0,3,2.5,2060,4200,2.0,0.0,0.0,3,8,2060,0,2014,0,98038,47.3706,-122.01799999999999,2370,4200,8,4,2014,N,-310,0
3438501327,5/4/2015,352500.0,2,2.5,1570,2399,2.0,0.0,0.0,3,7,1180,390,2009,0,98106,47.5488,-122.36399999999999,1590,2306,5,4,2015,N,-20,93
9828702389,5/13/2014,525000.0,3,2.5,1580,1161,2.0,0.0,0.0,3,8,1010,570,2008,0,98112,47.6206,-122.29899999999999,1680,1177,5,13,2014,N,-100,-16
8691440330,9/29/2014,1140000.0,5,3.5,4280,6530,2.0,0.0,3.0,3,10,4280,0,2014,0,98075,47.5941,-121.973,3960,6863,9,29,2014,N,320,-333
1085623740,8/12/2014,491000.0,5,3.5,2815,4900,2.0,0.0,0.0,3,9,2815,0,2011,0,98030,47.3424,-122.179,2798,4900,8,12,2014,N,17,0
1424069110,7/18/2014,675000.0,4,2.5,2620,6114,2.0,0.0,0.0,3,9,2620,0,2011,0,98029,47.5603,-122.01299999999999,2620,5808,7,18,2014,N,0,306
993001914,1/6/2015,344000.0,3,2.25,1250,1033,3.0,0.0,0.0,3,8,1250,0,2007,0,98103,47.6907,-122.34299999999999,1250,1150,1,6,2015,N,0,-117
9211010220,11/4/2014,530000.0,4,2.5,3250,4500,2.0,0.0,0.0,3,8,3250,0,2008,0,98059,47.4944,-122.15,3030,4598,11,4,2014,N,220,-98
2143701015,12/10/2014,290500.0,4,3.25,2510,7686,2.0,0.0,0.0,3,9,2510,0,2003,0,98055,47.4785,-122.228,2510,6732,12,10,2014,UNK,0,954
6056111430,1/13/2015,335000.0,2,1.75,1270,1685,2.0,0.0,0.0,3,8,1270,0,2012,0,98108,47.5646,-122.295,1270,1843,1,13,2015,N,0,-158
1925059254,5/7/2015,3000000.0,5,4.0,6670,16481,2.0,0.0,0.0,3,12,4960,1710,2007,0,98004,47.6409,-122.221,4800,16607,5,7,2015,N,1870,-126
3278606200,9/19/2014,379000.0,3,2.5,1580,3075,2.0,0.0,0.0,3,8,1580,0,2013,0,98126,47.545,-122.368,1710,2934,9,19,2014,N,-130,141
3126049501,7/17/2014,385000.0,3,1.5,1360,2030,3.0,0.0,0.0,3,8,1360,0,2008,0,98103,47.6961,-122.34899999999999,1360,1167,7,17,2014,N,0,863
4305600360,2/25/2015,500012.0,4,2.5,2400,9612,1.0,0.0,0.0,3,8,1230,1170,1962,2009,98059,47.4799,-122.12700000000001,2430,5539,2,25,2015,Y,-30,4073
6632300212,5/5/2014,366750.0,3,3.0,1571,2017,3.0,0.0,0.0,3,8,1571,0,2008,0,98125,47.7338,-122.309,1520,1497,5,5,2014,N,51,520
1189000492,6/6/2014,405000.0,2,2.0,1405,1073,2.0,0.0,0.0,3,8,1140,265,2007,0,98122,47.611999999999995,-122.295,1405,3000,6,6,2014,N,0,-1927
3319500628,2/12/2015,356999.0,3,1.5,1010,1546,2.0,0.0,0.0,3,8,1010,0,1971,2014,98144,47.5998,-122.311,1010,1517,2,12,2015,Y,0,29
2436700625,4/17/2015,590000.0,2,2.5,1450,1281,2.0,0.0,0.0,3,8,1220,230,2006,0,98105,47.665,-122.285,1440,1281,4,17,2015,N,10,0
3679400474,11/4/2014,294000.0,3,1.75,1420,1361,2.0,0.0,0.0,3,7,960,460,2014,0,98108,47.5684,-122.314,1340,1343,11,4,2014,N,80,18
7203190110,4/26/2015,731500.0,4,2.5,2650,4644,2.0,0.0,0.0,3,8,2650,0,2013,0,98053,47.6945,-122.01799999999999,2640,5099,4,26,2015,N,10,-455
1853080850,6/6/2014,837219.0,5,2.75,3030,7679,2.0,0.0,0.0,3,9,3030,0,2014,0,98074,47.593,-122.057,3080,6341,6,6,2014,N,-50,1338
1125079111,4/15/2015,1600000.0,4,5.5,6530,871200,2.0,0.0,2.0,3,11,6530,0,2008,0,98014,47.663999999999994,-121.87799999999999,1280,858132,4,15,2015,N,5250,13068
518500610,6/16/2014,798800.0,3,2.75,2670,3738,1.0,0.0,0.0,3,10,1720,950,2013,0,98056,47.5299,-122.20299999999999,2610,3734,6,16,2014,N,60,4
293670040,10/8/2014,482500.0,2,2.5,1170,809,2.0,0.0,0.0,3,9,1170,0,2007,0,98103,47.6875,-122.339,1170,1121,10,8,2014,N,0,-312
3303970100,3/6/2015,820000.0,4,2.5,3260,26772,2.0,0.0,0.0,3,9,3260,0,2007,0,98027,47.5115,-122.031,3260,14491,3,6,2015,N,0,12281
3834000594,7/11/2014,319000.0,3,1.5,1480,1722,3.0,0.0,0.0,3,7,1480,0,2007,0,98125,47.728,-122.292,1480,5764,7,11,2014,N,0,-4042
3342100569,8/13/2014,950000.0,3,2.5,2700,6947,2.0,0.0,3.0,3,9,2700,0,2013,0,98056,47.5172,-122.208,2500,6947,8,13,2014,N,200,0
7237501380,5/7/2015,1270000.0,4,3.5,4640,13404,2.0,0.0,0.0,3,10,4640,0,2007,0,98059,47.53100000000001,-122.134,4690,13590,5,7,2015,N,-50,-186
2325300093,7/7/2014,378000.0,3,2.5,1601,2491,3.0,0.0,0.0,3,7,1536,65,2007,0,98125,47.718999999999994,-122.31700000000001,1420,1156,7,7,2014,N,181,1335
9808100150,4/2/2015,3350000.0,5,3.75,5350,15360,1.0,0.0,1.0,3,11,3040,2310,2008,0,98004,47.648,-122.21799999999999,3740,15940,4,2,2015,N,1610,-580
3332500085,10/27/2014,489950.0,3,2.5,2540,5237,2.0,0.0,0.0,3,8,2540,0,2011,0,98118,47.5492,-122.27600000000001,1800,4097,10,27,2014,N,740,1140
3869900150,4/27/2015,345000.0,2,1.75,1030,1106,2.0,0.0,0.0,3,7,765,265,2006,0,98136,47.5397,-122.387,1030,1066,4,27,2015,N,0,40
2011400401,2/26/2015,510000.0,3,2.5,2730,7136,2.0,0.0,0.0,3,8,2730,0,2012,0,98198,47.3938,-122.321,2130,8932,2,26,2015,N,600,-1796
9578501030,7/29/2014,432500.0,4,2.5,3172,5033,2.0,0.0,0.0,3,8,3172,0,2014,0,98023,47.2961,-122.348,2704,5232,7,29,2014,N,468,-199
8029770410,4/20/2015,650000.0,4,2.5,3160,8530,2.0,0.0,0.0,3,9,3160,0,2006,0,98059,47.5075,-122.148,3160,6460,4,20,2015,N,0,2070
6639900242,10/3/2014,750000.0,4,2.5,2850,12429,2.0,0.0,0.0,3,9,2850,0,2008,0,98033,47.6915,-122.177,2540,12000,10,3,2014,N,310,429
2919700735,4/27/2015,870000.0,4,3.5,2780,3100,2.0,0.0,0.0,3,8,2120,660,2014,0,98117,47.6886,-122.36399999999999,1740,3600,4,27,2015,N,1040,-500
8691440410,12/15/2014,900000.0,4,3.5,3860,6543,2.0,0.0,0.0,3,10,3860,0,2014,0,98075,47.5934,-121.97399999999999,3760,6888,12,15,2014,N,100,-345
2902201301,12/16/2014,664950.0,2,1.75,1180,900,2.0,0.0,0.0,3,10,780,400,2014,0,98102,47.6395,-122.329,1380,3610,12,16,2014,N,-200,-2710
291310150,6/2/2014,391000.0,3,2.25,1410,1290,2.0,0.0,0.0,3,7,1290,120,2004,0,98027,47.5345,-122.069,1490,1380,6,2,2014,N,-80,-90
323079101,1/23/2015,1800000.0,4,3.5,6370,205603,2.0,0.0,0.0,3,12,6370,0,2008,0,98027,47.5016,-121.905,1490,33580,1,23,2015,N,4880,172023
5057100110,5/14/2015,479349.0,5,3.0,3223,6371,2.0,0.0,0.0,3,9,3223,0,2014,0,98042,47.3584,-122.163,1979,9008,5,14,2015,N,1244,-2637
9268850940,12/23/2014,661000.0,4,3.25,2600,2074,2.0,0.0,0.0,3,8,2150,450,2011,0,98027,47.5402,-122.02799999999999,2510,2074,12,23,2014,N,90,0
993000315,10/2/2014,379000.0,3,3.25,1380,1234,3.0,0.0,0.0,3,8,1380,0,2006,0,98103,47.6935,-122.34200000000001,1370,1282,10,2,2014,N,10,-48
9268851800,5/5/2014,415000.0,3,2.25,1620,998,2.5,0.0,0.0,3,8,1540,80,2010,0,98027,47.5401,-122.027,1620,1299,5,5,2014,N,0,-301
4310702837,12/1/2014,375000.0,3,3.25,1370,1227,3.0,0.0,0.0,3,8,1370,0,2007,0,98103,47.6964,-122.34100000000001,1370,1236,12,1,2014,N,0,-9
4310703083,5/23/2014,355000.0,3,2.0,1220,1186,3.0,0.0,0.0,3,8,1220,0,2007,0,98103,47.6972,-122.34100000000001,1280,1251,5,23,2014,N,-60,-65
1890000166,9/5/2014,540000.0,3,2.5,1280,1889,3.0,0.0,0.0,3,8,1280,0,2009,0,98105,47.6619,-122.324,1450,1889,9,5,2014,N,-170,0
7904700146,7/24/2014,290000.0,2,1.5,770,850,2.0,0.0,0.0,3,7,770,0,2006,0,98116,47.5644,-122.38799999999999,1350,915,7,24,2014,N,-580,-65
1931300308,5/20/2014,500000.0,3,2.5,1210,1200,3.0,0.0,0.0,3,8,1210,0,2008,0,98103,47.6543,-122.345,1210,1200,5,20,2014,N,0,0
8091670730,9/2/2014,416000.0,4,2.5,2890,6322,2.0,0.0,0.0,3,8,2890,0,2011,0,98038,47.3494,-122.044,2380,5738,9,2,2014,N,510,584
3278612370,8/11/2014,349900.0,3,2.5,1580,2765,2.0,0.0,0.0,3,8,1580,0,2011,0,98126,47.5444,-122.369,1580,1820,8,11,2014,N,0,945
7600065,6/5/2014,465000.0,3,2.25,1530,1245,2.0,0.0,0.0,3,9,1050,480,2014,0,98122,47.6018,-122.29700000000001,1530,2307,6,5,2014,N,0,-1062
3630200900,6/30/2014,950000.0,4,2.5,3670,7680,2.5,0.0,0.0,3,10,3670,0,2007,0,98029,47.5401,-121.993,3130,6112,6,30,2014,N,540,1568
3278611450,3/26/2015,496800.0,4,2.25,1850,2340,2.5,0.0,0.0,3,8,1850,0,2014,0,98126,47.543,-122.37200000000001,1850,2340,3,26,2015,N,0,0
2026049184,3/20/2015,680000.0,4,2.5,2440,6581,2.0,0.0,0.0,3,8,2440,0,2014,0,98133,47.7321,-122.334,1480,7432,3,20,2015,N,960,-851
9103000455,4/24/2015,920000.0,4,3.25,2190,4265,2.0,0.0,0.0,3,9,1540,650,2015,0,98122,47.6178,-122.29,1730,4265,4,24,2015,N,460,0
8691440220,2/2/2015,1290000.0,5,4.0,4360,8030,2.0,0.0,0.0,3,10,4360,0,2015,0,98075,47.5923,-121.973,3570,6185,2,2,2015,N,790,1845
7202300540,7/1/2014,825000.0,4,2.75,3990,6637,2.0,0.0,0.0,3,9,3990,0,2003,0,98053,47.6835,-122.045,3500,7074,7,1,2014,UNK,490,-437
1453601038,10/2/2014,292000.0,3,2.5,1270,1283,3.0,0.0,0.0,3,7,1270,0,2007,0,98125,47.7209,-122.291,1270,1512,10,2,2014,N,0,-229
9211010330,4/9/2015,576000.0,4,2.5,3340,6924,2.0,0.0,0.0,3,8,3340,0,2009,0,98059,47.495,-122.149,3030,6119,4,9,2015,N,310,805
1972201773,3/13/2015,670000.0,2,2.0,1500,761,3.0,0.0,3.0,3,8,1500,0,2008,0,98103,47.6522,-122.346,1360,1527,3,13,2015,N,140,-766
7974200948,5/20/2014,953007.0,4,3.5,3120,5086,2.0,0.0,0.0,3,9,2480,640,2008,0,98115,47.6762,-122.288,1880,5092,5,20,2014,N,1240,-6
2700200040,2/23/2015,399000.0,4,2.5,2480,4334,2.0,0.0,0.0,3,8,2480,0,2012,0,98038,47.3826,-122.036,2480,5632,2,23,2015,N,0,-1298
7625702264,4/27/2015,399000.0,2,2.0,1110,1155,3.0,0.0,0.0,3,7,980,130,2008,0,98136,47.5496,-122.38799999999999,1110,1089,4,27,2015,N,0,66
2428100100,11/17/2014,847093.0,4,2.75,2760,5670,2.0,0.0,0.0,3,10,2760,0,2014,0,98075,47.5819,-122.04700000000001,2760,6600,11,17,2014,N,0,-930
1176001123,2/6/2015,599950.0,3,2.5,1510,1493,3.0,0.0,0.0,3,8,1510,0,2014,0,98107,47.669,-122.402,1530,1357,2,6,2015,N,-20,136
3052700472,8/13/2014,499000.0,3,2.5,1460,1614,2.0,0.0,0.0,3,8,1180,280,2007,0,98117,47.6781,-122.374,1380,1402,8,13,2014,N,80,212
1623089086,10/15/2014,760000.0,4,2.75,3980,285318,2.0,0.0,2.0,3,9,3980,0,2006,0,98045,47.4803,-121.795,2100,105415,10,15,2014,N,1880,179903
2311400145,10/29/2014,1700000.0,4,3.75,3320,8234,2.0,0.0,0.0,3,10,3320,0,2014,0,98004,47.5963,-122.2,1560,8240,10,29,2014,N,1760,-6
8895800090,5/12/2014,1030000.0,4,3.25,3270,5187,2.0,0.0,0.0,3,9,3110,160,2014,0,98052,47.6966,-122.133,3600,5825,5,12,2014,N,-330,-638
847100021,5/20/2014,515000.0,4,2.5,2670,8765,2.0,0.0,0.0,3,9,2670,0,2006,0,98059,47.4876,-122.146,2880,8765,5,20,2014,N,-210,0
291310120,12/9/2014,355000.0,3,2.25,1410,1332,2.0,0.0,0.0,3,7,1290,120,2004,0,98027,47.5345,-122.069,1445,1290,12,9,2014,N,-35,42
301401390,8/5/2014,319900.0,4,2.75,2475,4000,2.0,0.0,0.0,3,7,2475,0,2014,0,98002,47.3452,-122.21,2166,4000,8,5,2014,N,309,0
7519001068,5/27/2014,460000.0,3,3.5,1600,1431,2.0,0.0,0.0,3,8,1240,360,2006,0,98117,47.6865,-122.363,1500,4120,5,27,2014,N,100,-2689
7203101590,1/8/2015,305000.0,2,1.0,1290,3383,2.0,0.0,0.0,3,7,1290,0,2008,0,98053,47.6968,-122.025,1290,2828,1,8,2015,N,0,555
7299600530,3/17/2015,280000.0,3,2.5,1608,4818,2.0,0.0,0.0,3,8,1608,0,2012,0,98092,47.2583,-122.20299999999999,2009,5200,3,17,2015,N,-401,-382
7625703357,2/27/2015,394950.0,2,2.25,1300,2104,2.0,0.0,0.0,3,8,1010,290,2011,0,98136,47.5477,-122.38799999999999,1430,1850,2,27,2015,N,-130,254
7889601270,8/21/2014,382000.0,4,3.5,2530,3000,2.0,0.0,0.0,3,8,1850,680,2014,0,98146,47.4919,-122.336,1470,6000,8,21,2014,N,1060,-3000
4083306553,4/22/2015,560000.0,3,2.5,1390,1411,3.0,0.0,0.0,3,8,1390,0,2008,0,98103,47.6485,-122.334,1350,1266,4,22,2015,N,40,145
9828701508,5/20/2014,772000.0,3,2.25,1640,1204,3.0,0.0,0.0,3,8,1640,0,2014,0,98112,47.6196,-122.29700000000001,1630,3136,5,20,2014,N,10,-1932
8946390150,7/22/2014,324950.0,4,2.5,2229,5723,2.0,0.0,0.0,3,7,2229,0,2012,0,98032,47.3693,-122.286,2738,5742,7,22,2014,N,-509,-19
8648900040,7/9/2014,530000.0,3,2.5,1790,3078,2.0,0.0,0.0,3,8,1790,0,2010,0,98027,47.5638,-122.094,1890,3078,7,9,2014,N,-100,0
4092300211,10/24/2014,384000.0,3,2.25,990,736,2.5,0.0,0.0,3,8,880,110,2009,0,98105,47.6605,-122.319,1030,1201,10,24,2014,N,-40,-465
3343902510,6/11/2014,719950.0,5,2.75,3240,6863,2.0,0.0,0.0,3,10,3240,0,2013,0,98056,47.5033,-122.193,2360,6002,6,11,2014,N,880,861
2919700107,8/11/2014,319950.0,2,2.5,1280,819,2.0,0.0,0.0,3,8,1060,220,2006,0,98103,47.6905,-122.36399999999999,1290,2900,8,11,2014,N,-10,-2081
2781280230,1/28/2015,292000.0,3,2.5,1610,3848,2.0,0.0,0.0,3,8,1610,0,2006,0,98055,47.4497,-122.18799999999999,1610,3049,1,28,2015,N,0,799
3232200085,4/28/2015,1500000.0,6,3.5,3670,3959,2.0,0.0,0.0,3,10,2410,1260,2008,0,98119,47.6356,-122.37299999999999,2060,3625,4,28,2015,N,1610,334
1972200259,5/7/2014,425000.0,2,2.5,1150,1027,3.0,0.0,0.0,3,8,1150,0,2008,0,98103,47.6534,-122.35600000000001,1360,1210,5,7,2014,N,-210,-183
1926059236,10/10/2014,799950.0,5,3.75,3760,4702,2.0,0.0,0.0,3,9,2780,980,2014,0,98034,47.7202,-122.223,2950,5981,10,10,2014,N,810,-1279
2768200210,8/25/2014,499000.0,2,2.5,1320,1157,2.0,0.0,0.0,3,8,990,330,2014,0,98107,47.6689,-122.363,1550,1519,8,25,2014,N,-230,-362
3304300210,3/27/2015,572000.0,4,2.75,2700,7992,2.0,0.0,0.0,3,9,2700,0,2012,0,98059,47.4831,-122.135,2840,7992,3,27,2015,N,-140,0
9826700930,7/22/2014,459000.0,2,2.0,1480,804,3.0,0.0,0.0,3,8,1480,0,2008,0,98122,47.602,-122.30799999999999,1380,1751,7,22,2014,N,100,-947
9385200042,3/18/2015,529500.0,3,2.25,1410,905,3.0,0.0,0.0,3,9,1410,0,2014,0,98116,47.5818,-122.402,1510,1352,3,18,2015,N,-100,-447
3876590090,9/9/2014,374500.0,4,2.5,3135,5811,2.0,0.0,0.0,3,9,3135,0,2005,0,98092,47.3263,-122.18,3008,5799,9,9,2014,N,127,12
2902200142,6/5/2014,584000.0,3,2.5,1480,1485,2.0,0.0,0.0,3,8,1280,0,2007,0,98102,47.6376,-122.32600000000001,1470,1277,6,5,2014,N,10,208
8085400401,1/15/2015,1900000.0,4,4.5,4020,9656,2.0,0.0,0.0,3,10,4020,0,2007,0,98004,47.6358,-122.20700000000001,1960,9520,1,15,2015,N,2060,136
2902200237,7/7/2014,505000.0,2,2.25,1060,1209,2.0,0.0,0.0,3,8,940,120,2006,0,98102,47.6369,-122.32700000000001,1300,1169,7,7,2014,N,-240,40
7658600082,11/14/2014,565000.0,2,2.5,1950,2457,3.0,0.0,0.0,3,8,1950,0,2009,0,98144,47.5925,-122.302,1650,1639,11,14,2014,N,300,818
6891100330,3/25/2015,799000.0,4,2.75,3340,5677,2.0,0.0,0.0,3,9,3340,0,2011,0,98052,47.708999999999996,-122.118,3240,5643,3,25,2015,N,100,34
6821102367,4/29/2015,547000.0,3,2.5,1570,1452,2.5,0.0,0.0,3,9,1240,330,2007,0,98199,47.648,-122.396,1670,1596,4,29,2015,N,-100,-144
1900600015,2/27/2015,550000.0,3,2.5,1930,6604,2.0,0.0,0.0,3,7,1930,0,2014,0,98166,47.4692,-122.351,910,6604,2,27,2015,N,1020,0
1545808120,9/18/2014,250000.0,3,2.0,1590,8100,1.0,0.0,0.0,3,7,1060,530,1996,0,98038,47.3611,-122.04700000000001,1590,8100,9,18,2014,UNK,0,0
2126059294,1/5/2015,960000.0,4,4.5,3720,7746,2.0,0.0,0.0,3,10,3720,0,2014,0,98034,47.7323,-122.165,3080,11067,1,5,2015,N,640,-3321
1370800515,10/30/2014,2950000.0,4,4.25,4470,5884,2.0,0.0,1.0,3,11,3230,1240,2010,0,98199,47.6387,-122.405,2570,6000,10,30,2014,N,1900,-116
3319500334,3/27/2015,441000.0,2,1.0,1290,1289,2.0,0.0,0.0,3,7,1030,260,2005,0,98144,47.6006,-122.305,1290,1332,3,27,2015,N,0,-43
301400940,4/7/2015,265000.0,3,2.25,1489,2800,2.0,0.0,0.0,3,7,1489,0,2012,0,98002,47.3454,-122.214,1584,2800,4,7,2015,N,-95,0
2722069077,4/9/2015,430000.0,3,2.5,2075,39553,1.0,0.0,0.0,3,7,2075,0,2012,0,98038,47.3601,-122.03200000000001,1960,9047,4,9,2015,N,115,30506
8943600720,6/17/2014,286800.0,3,2.5,1413,3600,2.0,0.0,0.0,3,8,1413,0,2011,0,98031,47.4222,-122.193,2150,3869,6,17,2014,N,-737,-269
7660100236,4/16/2015,375000.0,3,2.5,1300,1362,2.0,0.0,0.0,3,8,880,420,2008,0,98144,47.5893,-122.31700000000001,1300,1251,4,16,2015,N,0,111
1773100921,12/15/2014,312500.0,3,3.25,1480,983,2.0,0.0,0.0,3,8,1180,300,2013,0,98106,47.5555,-122.363,1330,1062,12,15,2014,N,150,-79
8679200100,1/7/2015,850000.0,4,2.75,3320,5559,2.0,0.0,0.0,3,9,3320,0,2012,0,98075,47.5607,-122.031,3400,6854,1,7,2015,N,-80,-1295
3654200039,3/25/2015,390500.0,3,2.25,1530,1279,2.0,0.0,0.0,3,7,1116,414,2007,0,98177,47.7035,-122.35700000000001,1320,1427,3,25,2015,N,210,-148
2771602428,10/29/2014,455000.0,3,2.5,1180,932,3.0,0.0,0.0,3,8,1180,0,2010,0,98119,47.63800000000001,-122.375,1180,2632,10,29,2014,N,0,-1700
1225039067,4/6/2015,455000.0,2,2.0,1190,1303,2.0,0.0,0.0,3,8,800,390,2009,0,98107,47.6675,-122.368,1670,2425,4,6,2015,N,-480,-1122
625049359,12/3/2014,515000.0,3,2.25,1300,1180,3.0,0.0,0.0,3,8,1300,0,2008,0,98103,47.6871,-122.339,1300,1174,12,3,2014,N,0,6
3278606050,4/1/2015,362500.0,3,3.5,1710,2212,2.0,0.0,0.0,3,7,1400,310,2013,0,98126,47.5459,-122.368,1580,2212,4,1,2015,N,130,0
5112800291,9/24/2014,460000.0,3,2.5,2390,47480,2.0,0.0,0.0,3,9,2390,0,2007,0,98058,47.4517,-122.084,1720,44866,9,24,2014,N,670,2614
7853360300,9/4/2014,540000.0,4,3.5,3510,6005,2.0,0.0,0.0,3,8,2750,760,2010,0,98065,47.5168,-121.87,3090,5866,9,4,2014,N,420,139
6056111063,7/31/2014,230000.0,3,1.75,1140,1165,2.0,0.0,0.0,3,8,1140,0,2014,0,98108,47.5638,-122.295,1150,1552,7,31,2014,N,-10,-387
2767704649,9/29/2014,425000.0,2,2.5,1320,1329,2.0,0.0,0.0,3,8,1180,140,2007,0,98107,47.6728,-122.374,1490,5000,9,29,2014,N,-170,-3671
7683800205,5/19/2014,298450.0,5,3.0,2100,9752,1.0,0.0,0.0,3,8,1200,900,2007,0,98003,47.3341,-122.304,1270,10200,5,19,2014,N,830,-448
9406530150,12/22/2014,344000.0,4,2.5,2400,4848,2.0,0.0,0.0,3,8,2400,0,2004,0,98038,47.3626,-122.04,1980,5199,12,22,2014,N,420,-351
2979800409,5/5/2014,416286.0,3,2.5,1408,989,3.0,0.0,0.0,3,8,1408,0,2005,0,98115,47.6856,-122.315,1408,1342,5,5,2014,N,0,-353
1085622540,2/23/2015,379500.0,4,2.5,2560,5102,2.0,0.0,0.0,3,8,2560,0,2013,0,98092,47.3404,-122.181,2586,5059,2,23,2015,N,-26,43
4310701421,6/17/2014,350000.0,2,2.5,1260,1347,3.0,0.0,0.0,3,8,1260,0,2005,0,98103,47.6994,-122.34100000000001,1260,1356,6,17,2014,N,0,-9
2895800770,4/8/2015,258800.0,2,1.75,1290,1624,2.0,0.0,0.0,3,8,1290,0,2014,0,98106,47.5171,-122.34700000000001,1410,1963,4,8,2015,N,-120,-339
3034200067,12/18/2014,620000.0,4,2.5,2730,9260,2.0,0.0,0.0,3,8,2730,0,2008,0,98133,47.7222,-122.331,2730,7357,12,18,2014,N,0,1903
3438501320,5/2/2014,295000.0,2,2.5,1630,1368,2.0,0.0,0.0,3,7,1280,350,2009,0,98106,47.5489,-122.363,1590,2306,5,2,2014,N,40,-938
8691450120,2/27/2015,908990.0,4,2.75,3530,6844,2.0,0.0,0.0,3,10,3530,0,2014,0,98075,47.5975,-121.985,3530,10038,2,27,2015,N,0,-3194
6306810110,11/17/2014,485230.0,4,2.5,2714,12558,2.0,0.0,0.0,3,9,2714,0,2014,0,98031,47.3522,-122.20100000000001,2873,8269,11,17,2014,N,-159,4289
3629990110,6/11/2014,475000.0,3,2.25,1630,2520,2.0,0.0,0.0,3,7,1630,0,2005,0,98029,47.5493,-121.99799999999999,1630,3131,6,11,2014,N,0,-611
715010110,8/4/2014,1240000.0,5,3.25,5790,13726,2.0,0.0,3.0,3,10,4430,1360,2014,0,98006,47.5388,-122.11399999999999,5790,13726,8,4,2014,N,0,0
3629700090,8/19/2014,635000.0,3,3.0,2230,1407,2.5,0.0,0.0,3,8,1850,380,2013,0,98027,47.5446,-122.01700000000001,2290,1407,8,19,2014,N,-60,0
3277801411,11/5/2014,350000.0,3,2.5,1380,1590,2.0,0.0,0.0,3,9,1160,220,2012,0,98126,47.5444,-122.375,1380,1590,11,5,2014,N,0,0
8822901175,12/29/2014,345000.0,3,3.5,1320,1161,3.0,0.0,0.0,3,8,1320,0,2010,0,98125,47.7162,-122.294,1320,1161,12,29,2014,N,0,0
6926700654,9/21/2014,700000.0,2,2.0,1490,713,3.0,0.0,0.0,3,9,1490,0,2014,0,98109,47.6356,-122.346,1490,1110,9,21,2014,N,0,-397
2768301482,8/21/2014,490000.0,3,2.25,1280,1520,2.0,0.0,0.0,3,8,1080,200,2008,0,98107,47.6651,-122.368,1280,1681,8,21,2014,N,0,-161
8895800110,8/5/2014,1300000.0,5,4.0,3870,5929,2.0,0.0,0.0,3,10,3870,0,2014,0,98052,47.6965,-122.134,3600,5625,8,5,2014,N,270,304
3879900750,9/10/2014,579000.0,2,2.5,1280,1051,2.0,0.0,0.0,3,8,1080,0,2009,0,98119,47.6273,-122.359,1580,1279,9,10,2014,N,-300,-228
7234600820,3/27/2015,552500.0,3,1.5,1300,1435,2.0,0.0,0.0,3,8,1120,180,2007,0,98122,47.6114,-122.31,1320,1652,3,27,2015,N,-20,-217
1946000100,2/4/2015,467000.0,4,2.75,2170,5024,2.0,0.0,0.0,3,8,2170,0,2012,0,98059,47.495,-122.145,2460,5024,2,4,2015,N,-290,0
8943600870,11/13/2014,305000.0,4,2.25,1763,3717,2.0,0.0,0.0,3,8,1763,0,2012,0,98031,47.4213,-122.194,1763,3666,11,13,2014,N,0,51
6145600557,5/9/2014,212000.0,2,1.5,1020,1525,2.0,0.0,0.0,3,7,1020,0,2004,0,98133,47.70399999999999,-122.34700000000001,1020,3844,5,9,2014,N,0,-2319
7203140180,8/21/2014,429000.0,4,2.5,1840,4593,2.0,0.0,0.0,3,7,1840,0,2010,0,98053,47.6866,-122.01299999999999,1740,3600,8,21,2014,N,100,993
3277801592,9/25/2014,479950.0,3,2.0,1820,1358,3.0,0.0,0.0,3,9,1820,0,2014,0,98126,47.5433,-122.376,1710,1367,9,25,2014,N,110,-9
461003835,12/18/2014,825000.0,3,3.5,2670,3000,2.0,0.0,0.0,3,9,1870,800,2014,0,98117,47.6813,-122.37200000000001,1750,5000,12,18,2014,N,920,-2000
424069279,3/28/2015,1180000.0,6,6.5,6260,10955,2.0,0.0,0.0,3,11,4840,1420,2007,0,98075,47.5947,-122.039,2710,12550,3,28,2015,N,3550,-1595
1760651000,6/13/2014,250000.0,3,2.25,1400,3814,2.0,0.0,0.0,3,7,1400,0,2012,0,98042,47.3584,-122.083,1610,3814,6,13,2014,N,-210,0
3057000070,10/27/2014,289000.0,2,1.5,1160,2158,2.0,0.0,0.0,3,7,1160,0,1982,0,98034,47.7178,-122.19,1150,2158,10,27,2014,UNK,10,0
2895810200,10/2/2014,265000.0,3,2.5,1400,3368,2.0,0.0,0.0,3,7,1400,0,2013,0,98146,47.5134,-122.34200000000001,1400,4316,10,2,2014,N,0,-948
2325300060,5/15/2014,344000.0,3,2.5,1232,1130,3.0,0.0,0.0,3,7,1232,0,2007,0,98125,47.7185,-122.31700000000001,1232,1202,5,15,2014,N,0,-72
9151600055,7/9/2014,749000.0,4,2.75,2700,6000,2.0,0.0,0.0,4,8,2100,600,1910,0,98116,47.58600000000001,-122.383,2050,5400,7,9,2014,UNK,650,600
7853321260,9/8/2014,492000.0,4,2.5,2550,6382,2.0,0.0,0.0,3,7,2550,0,2007,0,98065,47.5202,-121.87,2430,5900,9,8,2014,N,120,482
4219610320,1/19/2015,552500.0,4,2.5,3260,6902,2.0,0.0,0.0,3,8,3260,0,2008,0,98059,47.4829,-122.156,3130,6588,1,19,2015,N,130,314
2902200016,11/12/2014,653500.0,2,2.5,1680,1240,2.0,0.0,0.0,3,8,1120,560,2014,0,98102,47.6372,-122.324,2060,3630,11,12,2014,N,-380,-2390
7518507055,4/2/2015,855000.0,4,3.25,2630,2550,2.0,0.0,0.0,3,10,2030,600,2006,0,98117,47.6775,-122.385,1810,2600,4,2,2015,N,820,-50
7502700060,11/19/2014,333000.0,3,1.5,1260,5758,2.0,0.0,0.0,3,7,1260,0,1999,0,98006,47.5524,-122.139,3090,10142,11,19,2014,UNK,-1830,-4384
3448740160,6/11/2014,415000.0,4,2.5,2550,4500,2.0,0.0,0.0,3,7,2550,0,2009,0,98059,47.4916,-122.15299999999999,2340,4526,6,11,2014,N,210,-26
179001455,11/7/2014,445000.0,4,3.25,3450,5000,2.0,0.0,0.0,3,8,3450,0,2008,0,98178,47.4925,-122.273,1420,5000,11,7,2014,N,2030,0
8669160270,7/10/2014,273500.0,3,2.5,1550,3402,2.0,0.0,0.0,3,7,1550,0,2009,0,98002,47.3523,-122.212,2095,3402,7,10,2014,N,-545,0
4215270070,6/6/2014,969990.0,4,2.5,4150,8436,2.0,0.0,0.0,3,10,4150,0,2014,0,98075,47.5802,-122.039,4070,8438,6,6,2014,N,80,-2
170000060,10/8/2014,1200000.0,5,3.5,3900,4400,2.0,0.0,0.0,3,9,2650,1250,2014,0,98107,47.6607,-122.36200000000001,1190,4400,10,8,2014,N,2710,0
7410200431,8/6/2014,430000.0,3,3.25,1550,1444,3.0,0.0,0.0,3,8,1550,0,2006,0,98115,47.6767,-122.291,1550,1444,8,6,2014,N,0,0
6600060140,3/23/2015,392000.0,4,2.5,2130,4000,2.0,0.0,0.0,3,8,2130,0,2014,0,98146,47.5108,-122.36200000000001,1830,7217,3,23,2015,N,300,-3217
2324059314,7/2/2014,795000.0,4,2.5,2890,7798,2.0,0.0,0.0,3,9,2890,0,2005,0,98006,47.5456,-122.12899999999999,3300,30950,7,2,2014,N,-410,-23152
9376301111,6/30/2014,457000.0,3,2.5,1220,1330,2.0,0.0,0.0,3,8,1010,210,2008,0,98117,47.6904,-122.37,1360,3750,6,30,2014,N,-140,-2420
8956200560,3/20/2015,453000.0,4,2.5,2502,8306,2.0,0.0,0.0,3,9,2502,0,2013,0,98001,47.2953,-122.265,2597,6983,3,20,2015,N,-95,1323
6749700002,5/9/2014,376000.0,3,2.0,1340,1384,3.0,0.0,0.0,3,8,1340,0,2008,0,98103,47.6973,-122.35,1110,1384,5,9,2014,N,230,0
1438000390,8/4/2014,469995.0,4,2.5,2350,3800,2.0,0.0,0.0,3,8,2350,0,2014,0,98059,47.4783,-122.12299999999999,2670,4180,8,4,2014,N,-320,-380
8682301600,5/4/2015,540000.0,3,2.5,1810,3930,2.0,0.0,0.0,3,8,1810,0,2008,0,98053,47.7169,-122.02,1560,5100,5,4,2015,N,250,-1170
7853361370,5/2/2014,555000.0,4,2.5,3310,6500,2.0,0.0,0.0,3,8,3310,0,2012,0,98065,47.515,-121.87,2380,5000,5,2,2014,N,930,1500
3333001997,7/25/2014,445000.0,3,2.0,1620,5101,1.0,0.0,0.0,3,7,590,1030,2006,0,98118,47.5448,-122.288,1700,7750,7,25,2014,N,-80,-2649
7899800857,12/15/2014,256950.0,2,2.0,1070,635,2.0,0.0,0.0,3,9,720,350,2008,0,98106,47.5212,-122.35700000000001,1070,928,12,15,2014,N,0,-293
7338220370,10/6/2014,297000.0,4,2.5,2230,4952,2.0,0.0,0.0,3,8,2230,0,2011,0,98002,47.3363,-122.211,2030,3721,10,6,2014,N,200,1231
9406530160,10/17/2014,320000.0,4,2.5,1970,4558,2.0,0.0,0.0,3,8,1970,0,2005,0,98038,47.3627,-122.04,1980,5123,10,17,2014,N,-10,-565
7853280370,11/14/2014,805000.0,5,4.5,4600,7810,2.0,0.0,0.0,3,9,3200,1400,2006,0,98065,47.5381,-121.86,4480,6324,11,14,2014,N,120,1486
2937300520,8/1/2014,799990.0,4,2.75,3110,6050,2.0,0.0,0.0,3,9,3110,0,2014,0,98052,47.705,-122.126,3590,6054,8,1,2014,N,-480,-4
2738640310,4/9/2015,680000.0,4,2.5,3490,3677,2.0,0.0,0.0,3,9,2850,640,2007,0,98072,47.773999999999994,-122.162,3440,3600,4,9,2015,N,50,77
6056100312,6/24/2014,395000.0,3,2.5,1600,1936,2.0,0.0,0.0,3,7,1600,0,2007,0,98108,47.5629,-122.29700000000001,1600,1936,6,24,2014,N,0,0
2856100260,12/2/2014,732000.0,3,2.5,1960,3060,2.0,0.0,0.0,3,8,1960,0,2010,0,98117,47.6764,-122.389,1220,3060,12,2,2014,N,740,0
2724049222,8/2/2014,163800.0,2,2.5,1000,1092,2.0,0.0,0.0,3,7,990,10,2004,0,98118,47.5419,-122.271,1330,1466,8,2,2014,N,-330,-374
2724049222,12/1/2014,220000.0,2,2.5,1000,1092,2.0,0.0,0.0,3,7,990,10,2004,0,98118,47.5419,-122.271,1330,1466,12,1,2014,N,-330,-374
6149700197,11/6/2014,308625.0,2,2.0,1500,1408,3.0,0.0,0.0,3,7,1500,0,1999,0,98133,47.7293,-122.34299999999999,1500,1245,11,6,2014,UNK,0,163
3166900200,3/31/2015,375000.0,3,2.5,2424,5931,2.0,0.0,0.0,3,9,2424,0,2014,0,98042,47.3515,-122.134,2424,6036,3,31,2015,N,0,-105
5137800030,7/1/2014,300000.0,4,2.5,2303,3826,2.0,0.0,0.0,3,8,2303,0,2006,0,98092,47.3258,-122.165,2516,4500,7,1,2014,N,-213,-674
3832080070,6/16/2014,284000.0,3,2.5,1880,6008,2.0,0.0,0.0,3,7,1880,0,2009,0,98042,47.3366,-122.052,2180,5185,6,16,2014,N,-300,823
9828702336,2/20/2015,610000.0,2,2.0,1210,740,2.0,0.0,0.0,3,8,780,430,2014,0,98112,47.6206,-122.3,1480,1171,2,20,2015,N,-270,-431
7203180370,3/24/2015,955000.0,4,3.25,3720,6765,2.0,0.0,0.0,3,9,3720,0,2012,0,98053,47.688,-122.01799999999999,3100,6790,3,24,2015,N,620,-25
3901100030,6/27/2014,982000.0,4,2.75,3610,8580,2.0,0.0,0.0,3,9,3610,0,2014,0,98033,47.6706,-122.17299999999999,2360,8580,6,27,2014,N,1250,0
3126049500,5/22/2014,359000.0,3,1.5,1360,885,3.0,0.0,0.0,3,8,1360,0,2008,0,98103,47.6961,-122.34899999999999,1360,1167,5,22,2014,N,0,-282
6666830390,7/18/2014,779380.0,5,2.5,2590,7084,2.0,0.0,0.0,3,8,2590,0,2014,0,98052,47.7053,-122.113,3010,4823,7,18,2014,N,-420,2261
1832100055,6/30/2014,1510000.0,5,3.25,4390,11250,2.0,0.0,0.0,3,10,4390,0,2007,0,98040,47.5785,-122.225,2160,9249,6,30,2014,N,2230,2001
3629700030,2/23/2015,635000.0,3,3.0,2290,1407,2.5,0.0,0.0,3,8,1890,400,2014,0,98027,47.5446,-122.01700000000001,2230,1407,2,23,2015,N,60,0
3630200960,8/26/2014,1060000.0,4,3.75,3880,9979,2.5,0.0,0.0,3,10,3880,0,2007,0,98029,47.5408,-121.992,3130,6112,8,26,2014,N,750,3867
7625702431,7/16/2014,389500.0,3,2.5,1350,874,3.0,0.0,0.0,3,8,1270,80,2006,0,98136,47.549,-122.387,1350,886,7,16,2014,N,0,-12
2895800390,8/7/2014,359800.0,5,2.5,2170,2752,2.0,0.0,0.0,3,8,2170,0,2014,0,98106,47.5165,-122.346,1800,2752,8,7,2014,N,370,0
3753000030,5/27/2014,399950.0,3,3.0,1296,1051,3.0,0.0,0.0,3,8,1296,0,2009,0,98125,47.7175,-122.28399999999999,1520,1939,5,27,2014,N,-224,-888
1773100926,6/3/2014,320000.0,3,3.25,1530,1602,2.0,0.0,0.0,3,8,1140,390,2013,0,98106,47.5555,-122.36200000000001,1450,1198,6,3,2014,N,80,404
301400320,7/25/2014,255900.0,3,2.5,1489,3266,2.0,0.0,0.0,3,7,1489,0,2014,0,98002,47.3452,-122.21700000000001,1537,3273,7,25,2014,N,-48,-7
6600060160,2/9/2015,380000.0,4,2.5,2130,4467,2.0,0.0,0.0,3,8,2130,0,2014,0,98146,47.5108,-122.363,1830,8160,2,9,2015,N,300,-3693
1861100267,9/18/2014,580000.0,3,2.75,1430,1521,2.0,0.0,0.0,3,9,1130,300,2009,0,98119,47.6353,-122.37100000000001,1930,2700,9,18,2014,N,-500,-1179
3438500036,4/29/2015,545000.0,5,3.75,2380,7268,1.0,0.0,0.0,3,8,1430,950,2008,0,98106,47.5571,-122.35700000000001,2040,10810,4,29,2015,N,340,-3542
3869900036,7/25/2014,451300.0,3,2.5,1420,814,2.0,0.0,0.0,3,8,1140,280,2008,0,98136,47.5429,-122.387,1340,1382,7,25,2014,N,80,-568
1042700270,6/16/2014,852880.0,4,3.25,3450,6184,2.0,0.0,0.0,3,9,3450,0,2014,0,98074,47.6072,-122.054,3020,5369,6,16,2014,N,430,815
6817750340,9/19/2014,305000.0,4,2.5,1914,3150,2.0,0.0,0.0,3,8,1914,0,2009,0,98055,47.43,-122.18799999999999,1714,3164,9,19,2014,N,200,-14
3448001412,4/30/2015,295000.0,2,1.5,988,1080,3.0,0.0,0.0,3,7,988,0,2007,0,98125,47.7123,-122.301,1128,1080,4,30,2015,N,-140,0
301400800,10/16/2014,261000.0,3,2.25,1584,2800,2.0,0.0,0.0,3,7,1584,0,2012,0,98002,47.3451,-122.214,1584,2800,10,16,2014,N,0,0
7852090570,3/17/2015,560000.0,4,2.5,2630,5710,2.0,0.0,0.0,3,8,2630,0,2001,0,98065,47.5342,-121.876,2550,5500,3,17,2015,UNK,80,210
7203180070,9/19/2014,795000.0,4,3.25,3520,5250,2.0,0.0,0.0,3,9,3520,0,2012,0,98053,47.6869,-122.01899999999999,3220,5781,9,19,2014,N,300,-531
5416510200,9/29/2014,384950.0,4,2.5,2380,4913,2.0,0.0,0.0,3,8,2380,0,2006,0,98038,47.3607,-122.038,2580,5311,9,29,2014,N,-200,-398
1931300977,5/8/2014,500000.0,3,1.75,1410,1197,3.0,0.0,0.0,3,8,1410,0,2012,0,98103,47.6558,-122.348,1350,2512,5,8,2014,N,60,-1315
7853390260,2/5/2015,640000.0,4,3.5,3220,5741,2.0,0.0,0.0,3,9,3220,0,2013,0,98065,47.5169,-121.88600000000001,2960,6534,2,5,2015,N,260,-793
9578500810,11/21/2014,418000.0,4,3.25,3266,5969,2.0,0.0,0.0,3,8,3266,0,2014,0,98023,47.2975,-122.35,3087,5169,11,21,2014,N,179,800
6844700575,10/10/2014,799000.0,3,2.0,2550,4794,2.0,0.0,0.0,3,9,2550,0,2007,0,98115,47.6955,-122.29,1630,5100,10,10,2014,N,920,-306
3751601877,3/20/2015,552900.0,4,3.5,3828,18900,2.5,0.0,0.0,3,9,3828,0,2014,0,98001,47.2851,-122.277,2120,18900,3,20,2015,N,1708,0
3869900136,12/19/2014,539950.0,3,2.25,1670,1596,3.0,0.0,0.0,3,8,1670,0,2014,0,98136,47.5402,-122.387,1640,1310,12,19,2014,N,30,286
8956200960,1/20/2015,524225.0,4,2.5,3056,11385,2.0,0.0,0.0,3,9,3056,0,2014,0,98001,47.2905,-122.264,2849,8607,1,20,2015,N,207,2778
2883200083,2/2/2015,424950.0,2,1.5,1000,1188,3.0,0.0,0.0,3,8,1000,0,2005,0,98115,47.6823,-122.32700000000001,2300,3500,2,2,2015,N,-1300,-2312
2028700570,11/25/2014,560000.0,3,3.25,1530,1786,2.0,0.0,0.0,3,8,1200,330,2007,0,98117,47.6783,-122.366,1390,2900,11,25,2014,N,140,-1114
4188300030,4/29/2015,715000.0,5,3.0,3490,6091,2.0,0.0,0.0,3,9,3490,0,2009,0,98011,47.7744,-122.225,2870,5932,4,29,2015,N,620,159
7883603648,5/22/2014,300000.0,5,2.5,2760,6000,2.0,0.0,0.0,3,8,2760,0,2006,0,98108,47.5289,-122.321,1360,6000,5,22,2014,N,1400,0
3630080030,2/24/2015,405000.0,3,2.5,1440,2163,2.0,0.0,0.0,3,7,1440,0,2005,0,98029,47.553999999999995,-121.99799999999999,1440,2207,2,24,2015,N,0,-44
173000036,10/7/2014,327000.0,3,3.0,1370,1001,3.0,0.0,0.0,3,8,1370,0,2009,0,98133,47.7302,-122.355,1399,1151,10,7,2014,N,-29,-150
2862500070,12/9/2014,859950.0,6,4.0,3180,6551,2.0,0.0,0.0,3,9,3180,0,2014,0,98074,47.6236,-122.023,3230,7602,12,9,2014,N,-50,-1051
7017200055,1/13/2015,560000.0,4,3.0,2720,7570,2.0,0.0,0.0,3,9,2720,0,2008,0,98133,47.7113,-122.34899999999999,1770,5705,1,13,2015,N,950,1865
3278611610,9/7/2014,379900.0,3,2.5,1800,2792,2.0,0.0,0.0,3,8,1800,0,2011,0,98126,47.5442,-122.37100000000001,1580,2617,9,7,2014,N,220,175
4305500030,5/1/2015,625000.0,3,2.5,3220,6409,2.0,0.0,0.0,3,9,3220,0,2008,0,98059,47.4815,-122.12700000000001,3330,6231,5,1,2015,N,-110,178
255460240,4/23/2015,398096.0,3,2.5,2370,5321,2.0,0.0,0.0,3,8,2370,0,2014,0,98038,47.37,-122.01899999999999,2370,4357,4,23,2015,N,0,964
1773100416,11/20/2014,315000.0,3,2.5,1410,1325,2.0,0.0,0.0,3,7,1180,230,2007,0,98106,47.5582,-122.363,1270,1282,11,20,2014,N,140,43
2937300560,12/12/2014,939000.0,4,3.5,3640,6049,2.0,0.0,0.0,3,9,3640,0,2014,0,98052,47.7049,-122.125,3590,6104,12,12,2014,N,50,-55
9510860560,7/25/2014,674000.0,3,2.5,1920,3624,2.0,0.0,0.0,3,9,1920,0,2003,0,98052,47.6647,-122.087,1930,3533,7,25,2014,UNK,-10,91
1085621740,8/14/2014,306000.0,4,2.5,2267,3577,2.0,0.0,0.0,3,7,2267,0,2014,0,98092,47.3384,-122.18,2056,3577,8,14,2014,N,211,0
4139300135,7/9/2014,2320000.0,5,4.75,5780,17004,2.0,0.0,0.0,3,11,4260,1520,2006,0,98040,47.5802,-122.212,3460,10855,7,9,2014,N,2320,6149
5100400241,2/2/2015,394950.0,2,1.0,1131,1304,3.0,0.0,0.0,3,7,1131,0,2011,0,98115,47.6912,-122.31299999999999,1131,1992,2,2,2015,N,0,-688
2428100070,9/18/2014,914154.0,3,3.5,2940,6431,2.0,0.0,0.0,3,10,2940,0,2014,0,98075,47.5818,-122.04700000000001,2760,6695,9,18,2014,N,180,-264
726059485,11/17/2014,496000.0,3,2.5,2180,4533,2.0,0.0,0.0,3,7,2180,0,2010,0,98011,47.754,-122.215,2180,7347,11,17,2014,N,0,-2814
9834201370,4/17/2015,430100.0,3,2.25,1400,1078,2.0,0.0,0.0,3,8,940,460,2009,0,98144,47.5701,-122.288,1420,1230,4,17,2015,N,-20,-152
8564860270,7/8/2014,449990.0,4,2.5,2680,5539,2.0,0.0,0.0,3,8,2680,0,2013,0,98045,47.4759,-121.734,2680,5992,7,8,2014,N,0,-453
8564860270,3/30/2015,502000.0,4,2.5,2680,5539,2.0,0.0,0.0,3,8,2680,0,2013,0,98045,47.4759,-121.734,2680,5992,3,30,2015,N,0,-453
3395071580,3/11/2015,310000.0,3,2.5,1300,3612,2.0,0.0,0.0,3,7,1300,0,2005,0,98118,47.5328,-122.28200000000001,1390,2943,3,11,2015,N,-90,669
3682000060,3/23/2015,349950.0,4,3.5,2796,3520,2.5,0.0,0.0,3,8,2796,0,2013,0,98001,47.3427,-122.27799999999999,2040,5195,3,23,2015,N,756,-1675
1646500810,9/19/2014,625000.0,2,1.75,1460,1500,2.0,0.0,0.0,3,8,1000,460,2008,0,98103,47.6853,-122.35600000000001,1440,4120,9,19,2014,N,20,-2620
7768800160,8/27/2014,1050000.0,4,3.5,4210,6481,2.0,0.0,3.0,3,9,3260,950,2014,0,98075,47.5765,-122.072,3920,5331,8,27,2014,N,290,1150
3629980860,7/7/2014,680000.0,4,2.75,2330,3920,2.0,0.0,0.0,3,9,2330,0,2005,0,98029,47.5525,-121.99,2410,4063,7,7,2014,N,-80,-143
629890070,5/15/2014,828950.0,4,3.5,3930,5680,2.0,0.0,1.0,3,9,2820,1110,2013,0,98027,47.5528,-122.07600000000001,3700,5816,5,15,2014,N,230,-136
7299600140,4/3/2015,274950.0,3,2.5,1608,4000,2.0,0.0,0.0,3,8,1608,0,2014,0,98092,47.2582,-122.198,2009,4983,4,3,2015,N,-401,-983
1332700030,3/12/2015,293000.0,2,2.25,1610,1968,2.0,0.0,0.0,4,7,1610,0,1979,0,98056,47.5184,-122.196,1950,1968,3,12,2015,UNK,-340,0
3630220140,6/13/2014,795000.0,4,3.5,3200,3250,2.0,0.0,0.0,3,9,2670,530,2007,0,98029,47.5515,-122.0,3400,3663,6,13,2014,N,-200,-413
301400240,9/22/2014,282900.0,4,2.5,1710,3500,2.0,0.0,0.0,3,7,1710,0,2014,0,98002,47.3448,-122.21700000000001,1710,3500,9,22,2014,N,0,0
1233100710,4/16/2015,909950.0,5,3.75,3050,8972,2.0,0.0,0.0,3,9,3050,0,2014,0,98033,47.6819,-122.17200000000001,2750,8979,4,16,2015,N,300,-7
293070270,11/4/2014,922755.0,4,3.5,3560,4951,2.0,0.0,0.0,3,9,3560,0,2014,0,98074,47.6178,-122.055,3540,5500,11,4,2014,N,20,-549
3304030140,4/16/2015,424000.0,4,2.5,2650,8685,2.0,0.0,0.0,3,9,2650,0,2006,0,98001,47.343999999999994,-122.26899999999999,2650,7932,4,16,2015,N,0,753
5095401070,4/23/2015,630000.0,3,2.5,3490,12410,2.0,0.0,0.0,3,8,2590,900,2009,0,98059,47.4714,-122.071,1740,14448,4,23,2015,N,1750,-2038
6358900070,12/22/2014,810000.0,4,3.25,4140,46173,2.0,0.0,0.0,3,9,4140,0,2007,0,98011,47.7647,-122.213,2060,43103,12,22,2014,N,2080,3070
8141310030,7/30/2014,256703.0,3,2.0,1670,4441,1.0,0.0,0.0,3,7,1670,0,2014,0,98022,47.1948,-121.975,1670,4622,7,30,2014,N,0,-181
7203140270,5/15/2014,386380.0,3,2.5,1720,3600,2.0,0.0,0.0,3,7,1720,0,2010,0,98053,47.6856,-122.01299999999999,1720,3600,5,15,2014,N,0,0
8682320320,9/16/2014,485000.0,2,2.0,1510,3961,1.0,0.0,0.0,3,8,1510,0,2010,0,98053,47.708999999999996,-122.01799999999999,1510,3962,9,16,2014,N,0,-1
9542840340,2/11/2015,275000.0,3,2.25,1450,4040,2.0,0.0,0.0,3,7,1450,0,2010,0,98038,47.3665,-122.022,1610,4040,2,11,2015,N,-160,0
3943600140,3/2/2015,370000.0,4,2.5,1812,5026,2.0,0.0,0.0,3,8,1812,0,2011,0,98055,47.4513,-122.20200000000001,2440,6007,3,2,2015,N,-628,-981
2902200240,6/10/2014,499950.0,2,2.25,1060,1208,2.0,0.0,0.0,3,8,940,120,2005,0,98102,47.6371,-122.32700000000001,1300,1169,6,10,2014,N,-240,39
3274800505,4/24/2015,502000.0,3,2.5,1600,3073,3.0,0.0,0.0,3,8,1600,0,2009,0,98144,47.5934,-122.29799999999999,1130,2921,4,24,2015,N,470,152
8080400136,6/20/2014,654000.0,3,3.25,1530,1565,2.0,0.0,0.0,3,8,1280,250,2005,0,98122,47.6179,-122.31200000000001,1530,1381,6,20,2014,N,0,184
6371000079,7/14/2014,575000.0,4,2.25,2070,1230,3.0,0.0,0.0,3,9,1500,570,2013,0,98116,47.5775,-122.41,1569,4802,7,14,2014,N,501,-3572
5379801920,4/15/2015,500000.0,4,2.5,3630,7482,2.0,0.0,0.0,3,10,3630,0,2008,0,98188,47.4565,-122.287,1600,15716,4,15,2015,N,2030,-8234
8562770320,1/14/2015,554000.0,3,2.5,2140,4126,2.0,0.0,0.0,3,8,1960,180,2005,0,98027,47.5368,-122.073,2280,2615,1,14,2015,N,-140,1511
3449000200,5/8/2015,360000.0,4,1.75,2010,12188,1.0,0.0,0.0,4,7,1150,860,1960,0,98059,47.5013,-122.147,1720,8475,5,8,2015,UNK,290,3713
255470030,4/29/2015,619990.0,4,2.75,2630,4501,2.0,0.0,0.0,3,8,2630,0,2015,0,98028,47.7748,-122.244,2380,4599,4,29,2015,N,250,-98
629650030,3/12/2015,317500.0,4,2.5,2233,6025,2.0,0.0,0.0,3,7,2233,0,2012,0,98001,47.2599,-122.256,1544,6036,3,12,2015,N,689,-11
3574770030,8/28/2014,564950.0,4,2.75,2990,4521,2.0,0.0,0.0,3,7,2990,0,2014,0,98028,47.7401,-122.226,2580,7539,8,28,2014,N,410,-3018
7589700055,6/11/2014,545000.0,2,1.25,1240,2150,2.0,0.0,0.0,3,8,1240,0,2014,0,98117,47.6884,-122.374,1340,5289,6,11,2014,N,-100,-3139
3832050570,5/1/2015,333700.0,3,2.5,2230,5050,2.0,0.0,0.0,3,7,2230,0,2006,0,98042,47.3359,-122.055,2260,5050,5,1,2015,N,-30,0
5167000140,7/11/2014,1480000.0,3,3.25,3700,2264,2.0,0.0,0.0,3,11,2280,1420,1998,0,98033,47.6653,-122.205,3930,2567,7,11,2014,UNK,-230,-303
9578060370,4/8/2015,530000.0,4,3.0,2290,5105,2.0,0.0,0.0,3,8,2290,0,2012,0,98028,47.7727,-122.23700000000001,2450,5105,4,8,2015,N,-160,0
2767604253,4/13/2015,396000.0,2,1.5,950,865,3.0,0.0,0.0,3,8,950,0,2006,0,98107,47.6714,-122.382,1290,1189,4,13,2015,N,-340,-324
8562780800,10/16/2014,305000.0,2,1.75,1120,758,2.0,0.0,0.0,3,7,1120,0,2012,0,98027,47.5325,-122.072,1150,758,10,16,2014,N,-30,0
603000926,5/22/2014,380000.0,5,3.5,2420,4670,2.0,0.0,0.0,3,7,2420,0,2013,0,98118,47.5241,-122.285,1430,4468,5,22,2014,N,990,202
6817750510,3/3/2015,305000.0,4,2.5,1714,3250,2.0,0.0,0.0,3,8,1714,0,2010,0,98055,47.428999999999995,-122.189,1714,3250,3,3,2015,N,0,0
423059409,9/28/2014,440000.0,4,2.5,2230,5650,2.0,0.0,0.0,3,7,2230,0,2011,0,98056,47.5073,-122.16799999999999,1590,7241,9,28,2014,N,640,-1591
522049074,6/27/2014,459000.0,4,3.0,2530,10000,2.0,0.0,0.0,3,7,2530,0,2013,0,98148,47.431000000000004,-122.335,1420,9898,6,27,2014,N,1110,102
1934800193,3/6/2015,530000.0,3,3.5,1550,1233,2.0,0.0,0.0,3,8,1160,390,2005,0,98122,47.6034,-122.309,1490,1539,3,6,2015,N,60,-306
847100046,4/16/2015,600000.0,4,2.75,3110,11225,2.0,0.0,0.0,3,8,3110,0,2012,0,98059,47.4865,-122.14299999999999,2610,8535,4,16,2015,N,500,2690
1250200693,7/18/2014,515000.0,3,3.0,2100,2409,2.0,0.0,0.0,3,8,1660,440,2008,0,98144,47.5973,-122.29799999999999,1900,2400,7,18,2014,N,200,9
7338220200,4/8/2015,275000.0,4,2.5,2150,3721,2.0,0.0,0.0,3,8,2150,0,2007,0,98002,47.3363,-122.215,2150,3721,4,8,2015,N,0,0
1982201596,1/12/2015,540000.0,3,1.75,1630,1404,2.0,0.0,0.0,3,8,1020,610,2014,0,98107,47.6646,-122.367,1420,1670,1,12,2015,N,210,-266
7853270830,8/5/2014,445000.0,3,2.5,2230,7934,2.0,0.0,0.0,3,7,2230,0,2005,0,98065,47.5439,-121.88,2310,4818,8,5,2014,N,-80,3116
9352900200,4/7/2015,285000.0,3,2.5,1320,955,3.0,0.0,0.0,3,7,1320,0,2009,0,98106,47.5202,-122.35700000000001,1300,1003,4,7,2015,N,20,-48
8850000517,7/31/2014,480000.0,3,2.5,1590,1431,2.0,0.0,0.0,3,8,1060,0,2010,0,98144,47.5893,-122.309,1620,1548,7,31,2014,N,-30,-117
3395070560,1/20/2015,440000.0,5,3.25,2610,3642,2.0,0.0,0.0,3,8,2080,530,2005,0,98118,47.535,-122.28399999999999,1750,3118,1,20,2015,N,860,524
7211400576,2/11/2015,287450.0,3,2.5,1440,2500,2.0,0.0,0.0,3,7,1440,0,2008,0,98146,47.5123,-122.35799999999999,1440,5000,2,11,2015,N,0,-2500
5169700132,4/1/2015,507950.0,4,2.5,2630,6283,2.0,0.0,0.0,3,9,2630,0,2006,0,98059,47.5079,-122.15799999999999,2630,7210,4,1,2015,N,0,-927
3204960200,6/19/2014,750000.0,3,3.5,3390,10078,2.0,0.0,0.0,3,10,3040,350,2012,0,98056,47.537,-122.185,3290,12332,6,19,2014,N,100,-2254
8024200681,7/3/2014,425000.0,3,1.5,1400,1022,3.0,0.0,0.0,3,8,1400,0,2007,0,98115,47.6989,-122.31700000000001,1270,1205,7,3,2014,N,130,-183
9358000550,12/2/2014,420000.0,3,3.5,1900,2133,2.0,0.0,0.0,3,8,1520,380,2009,0,98126,47.5675,-122.369,1530,3264,12,2,2014,N,370,-1131
7625702444,5/10/2014,394950.0,3,2.5,1350,1250,3.0,0.0,0.0,3,8,1270,80,2006,0,98136,47.5491,-122.387,1350,886,5,10,2014,N,0,364
7853370260,7/11/2014,635000.0,4,3.25,3420,6752,2.0,0.0,2.0,3,9,3030,390,2012,0,98065,47.516999999999996,-121.876,3010,5172,7,11,2014,N,410,1580
522079068,5/6/2015,513000.0,3,2.5,2150,161607,2.0,0.0,0.0,3,7,1330,820,1995,0,98038,47.4178,-121.93700000000001,2400,207781,5,6,2015,UNK,-250,-46174
3023000200,5/5/2015,380000.0,4,2.5,2110,5306,2.0,0.0,0.0,3,8,2110,0,2012,0,98038,47.356,-122.057,2250,5306,5,5,2015,N,-140,0
3758900023,5/21/2014,1130000.0,4,3.25,3810,8519,1.0,0.0,1.0,3,10,2680,1130,2007,0,98033,47.699,-122.20700000000001,3240,10748,5,21,2014,N,570,-2229
6204050160,6/8/2014,540000.0,5,3.0,2870,4369,2.0,0.0,0.0,3,8,2090,780,2007,0,98011,47.7449,-122.19200000000001,2640,4610,6,8,2014,N,230,-241
8562780200,4/27/2015,352499.0,2,2.25,1240,705,2.0,0.0,0.0,3,7,1150,90,2009,0,98027,47.5321,-122.073,1240,750,4,27,2015,N,0,-45
7702600949,5/5/2015,603000.0,4,3.5,3610,6345,2.0,0.0,0.0,3,9,2370,1240,2008,0,98058,47.4283,-122.102,3010,29279,5,5,2015,N,600,-22934
3442000127,5/30/2014,685000.0,4,2.5,2310,5100,2.0,0.0,0.0,3,9,2310,0,2013,0,98177,47.7039,-122.36,1260,5100,5,30,2014,N,1050,0
255550070,6/26/2014,330675.0,4,3.0,1930,3031,1.0,0.0,0.0,3,7,1200,730,2006,0,98019,47.7457,-121.985,1930,2611,6,26,2014,N,0,420
7165700200,6/5/2014,275000.0,3,3.0,1390,1080,2.0,0.0,0.0,3,7,1140,250,2006,0,98118,47.5323,-122.281,1450,1081,6,5,2014,N,-60,-1
8096800270,7/16/2014,259950.0,3,2.5,1578,7340,2.0,0.0,0.0,3,7,1578,0,2010,0,98030,47.3771,-122.186,1850,7200,7,16,2014,N,-272,140
4046500160,7/29/2014,441000.0,3,2.0,1720,15000,1.0,0.0,0.0,3,9,1720,0,2011,0,98014,47.6927,-121.92,1900,15337,7,29,2014,N,-180,-337
7882600326,12/3/2014,1140000.0,5,3.75,4700,11237,2.0,0.0,0.0,3,10,2930,1770,2006,0,98033,47.6624,-122.197,3180,13140,12,3,2014,N,1520,-1903
9122001230,12/5/2014,590000.0,3,3.5,1970,5079,2.0,0.0,0.0,3,8,1680,290,2007,0,98144,47.5816,-122.296,1940,6000,12,5,2014,N,30,-921
6373000187,9/18/2014,497000.0,3,2.25,1460,1353,2.0,0.0,0.0,3,8,1050,410,2012,0,98116,47.5774,-122.412,1690,3776,9,18,2014,N,-230,-2423
7967000200,11/21/2014,345500.0,3,2.5,1930,4000,2.0,0.0,0.0,3,8,1930,0,2014,0,98001,47.3518,-122.275,2050,4000,11,21,2014,N,-120,0
2902200241,6/23/2014,562500.0,3,2.25,1300,907,2.0,0.0,0.0,3,8,1000,300,2006,0,98102,47.6371,-122.32700000000001,1300,1169,6,23,2014,N,0,-262
291310390,9/4/2014,355000.0,3,2.25,1445,1087,2.0,0.0,0.0,3,7,1300,145,2005,0,98027,47.5339,-122.06700000000001,1410,1336,9,4,2014,N,35,-249
1604601572,9/5/2014,345000.0,2,2.25,860,696,2.0,0.0,0.0,3,9,860,0,2009,0,98118,47.5663,-122.29,1100,3000,9,5,2014,N,-240,-2304
259500270,5/5/2014,478000.0,3,2.5,3040,4535,2.0,0.0,0.0,3,9,3040,0,2007,0,98056,47.51,-122.185,2670,4666,5,5,2014,N,370,-131
3166900270,4/2/2015,391500.0,3,2.5,2424,6143,2.0,0.0,0.0,3,9,2424,0,2014,0,98030,47.3512,-122.135,2381,6036,4,2,2015,N,43,107
2926049582,4/12/2015,265000.0,2,1.5,1084,3427,2.0,0.0,0.0,3,7,1084,0,1976,0,98125,47.7117,-122.32600000000001,1084,6250,4,12,2015,UNK,0,-2823
3438503230,10/30/2014,395000.0,3,2.5,2510,5320,2.0,0.0,0.0,3,8,2510,0,2005,0,98106,47.5374,-122.35700000000001,1820,5736,10,30,2014,N,690,-416
2827100075,7/27/2014,286308.0,2,1.5,1220,1036,3.0,0.0,0.0,3,7,1220,0,2006,0,98133,47.7348,-122.34700000000001,1210,659,7,27,2014,N,10,377
1702900624,5/27/2014,370000.0,2,2.25,1280,835,2.0,0.0,0.0,3,7,1080,200,2009,0,98118,47.5592,-122.28399999999999,1280,1246,5,27,2014,N,0,-411
2856100935,9/23/2014,1080000.0,5,3.5,3740,5610,2.0,0.0,0.0,3,9,2860,880,2014,0,98117,47.6764,-122.39200000000001,1520,4590,9,23,2014,N,2220,1020
301401620,10/15/2014,298900.0,3,2.5,1852,4000,2.0,0.0,0.0,3,7,1852,0,2014,0,98002,47.3451,-122.209,2475,4000,10,15,2014,N,-623,0
3630200520,4/21/2015,775000.0,4,2.5,2580,5787,2.0,0.0,0.0,3,9,2580,0,2007,0,98029,47.5416,-121.994,2580,4410,4,21,2015,N,0,1377
323079065,6/24/2014,790000.0,4,3.5,3190,31450,2.0,0.0,0.0,3,9,3190,0,2010,0,98027,47.50100000000001,-121.902,3000,72745,6,24,2014,N,190,-41295
7172200125,8/27/2014,1050000.0,3,2.5,3400,5119,2.0,0.0,0.0,3,8,2300,1100,2014,0,98115,47.6843,-122.305,1740,5969,8,27,2014,N,1660,-850
3057000400,7/8/2014,249000.0,2,1.5,1090,2686,2.0,0.0,0.0,3,7,1090,0,1982,0,98034,47.717,-122.19,1160,2158,7,8,2014,UNK,-70,528
3022900070,9/29/2014,348000.0,3,2.0,2360,6145,1.0,0.0,0.0,3,8,2360,0,2011,0,98030,47.3564,-122.198,2304,5880,9,29,2014,N,56,265
9406710060,11/14/2014,358000.0,5,2.5,2460,5604,2.0,0.0,0.0,3,8,2460,0,2011,0,98038,47.3658,-122.037,2210,6395,11,14,2014,N,250,-791
3353401070,6/25/2014,260000.0,5,2.5,2025,7760,2.0,0.0,0.0,3,7,2025,0,2007,0,98001,47.2671,-122.256,1664,9000,6,25,2014,N,361,-1240
7853280570,6/4/2014,765000.0,4,3.0,4410,5104,2.0,0.0,0.0,3,9,3400,1010,2006,0,98065,47.5392,-121.861,4390,5537,6,4,2014,N,20,-433
6192410550,5/28/2014,739000.0,3,2.5,2810,5400,2.0,0.0,0.0,3,9,2810,0,2005,0,98052,47.7065,-122.118,2870,5400,5,28,2014,N,-60,0
8562710520,5/5/2014,890000.0,5,3.5,4490,6000,2.0,0.0,0.0,3,10,3200,1290,2006,0,98027,47.5396,-122.073,4530,6000,5,5,2014,N,-40,0
1543000060,6/7/2014,462000.0,4,2.5,3070,6432,2.0,0.0,0.0,3,9,3070,0,2006,0,98055,47.4487,-122.205,2910,5106,6,7,2014,N,160,1326
9536600810,7/8/2014,380000.0,4,2.5,1984,32400,1.0,0.0,0.0,3,8,1564,420,1962,0,98198,47.36,-122.318,1390,9152,7,8,2014,UNK,594,23248
5428000070,5/11/2015,770000.0,5,3.5,4750,8234,2.0,0.0,2.0,3,10,3350,1400,2013,0,98198,47.3574,-122.318,2160,14496,5,11,2015,N,2590,-6262
2309000060,8/18/2014,641000.0,4,3.25,2760,4104,2.0,0.0,0.0,3,8,1900,860,2014,0,98056,47.5286,-122.18700000000001,2760,5186,8,18,2014,N,0,-1082
8043700105,4/17/2015,2300000.0,4,4.0,4360,8175,2.5,1.0,4.0,3,10,3940,420,2007,0,98008,47.5724,-122.104,2670,8525,4,17,2015,N,1690,-350
7792000140,5/4/2015,369000.0,4,2.5,3060,27251,1.5,0.0,0.0,3,8,3060,0,2008,0,98022,47.1967,-121.96600000000001,1760,27251,5,4,2015,N,1300,0
5244801550,9/16/2014,1110000.0,4,3.0,2770,2650,2.0,0.0,0.0,3,9,2180,590,2014,0,98109,47.6435,-122.354,1820,2960,9,16,2014,N,950,-310
9310300160,8/28/2014,357000.0,5,2.5,2990,9240,2.0,0.0,0.0,3,8,2990,0,2015,0,98133,47.7384,-122.348,1970,18110,8,28,2014,N,1020,-8870
6762700376,11/26/2014,650000.0,3,2.75,1540,1251,2.0,0.0,0.0,3,8,1230,310,2002,0,98102,47.6298,-122.321,1540,1287,11,26,2014,UNK,0,-36
1972200428,6/25/2014,563500.0,3,2.5,1400,1312,3.5,0.0,0.0,3,8,1400,0,2007,0,98103,47.6534,-122.355,1350,1312,6,25,2014,N,50,0
7304301231,6/17/2014,345000.0,3,2.5,1680,2229,2.0,0.0,0.0,3,7,1680,0,2007,0,98155,47.7484,-122.322,1230,9300,6,17,2014,N,450,-7071
9512200140,7/25/2014,479950.0,3,2.0,2260,7163,1.0,0.0,0.0,3,9,2260,0,2012,0,98058,47.4593,-122.13600000000001,2340,6730,7,25,2014,N,-80,433
7853400260,5/13/2014,660000.0,4,3.5,3400,5196,2.0,0.0,0.0,3,9,3400,0,2012,0,98065,47.5169,-121.884,3170,5260,5,13,2014,N,230,-64
97600140,7/29/2014,800000.0,4,2.5,2930,5000,2.0,0.0,0.0,3,9,2760,170,2007,0,98006,47.5424,-122.12,3230,5778,7,29,2014,N,-300,-778
2822059360,7/24/2014,253101.0,3,2.0,1239,6036,1.0,0.0,0.0,3,7,1239,0,2009,0,98030,47.3689,-122.175,2060,5746,7,24,2014,N,-821,290
6056110200,9/29/2014,555000.0,3,3.5,2100,2479,2.0,0.0,0.0,3,9,1450,650,2011,0,98118,47.562,-122.292,1800,2457,9,29,2014,N,300,22
6300000226,6/26/2014,240000.0,4,1.0,1200,2171,1.5,0.0,0.0,3,7,1200,0,1933,0,98133,47.7076,-122.34200000000001,1130,1598,6,26,2014,UNK,70,573
6300000226,5/4/2015,380000.0,4,1.0,1200,2171,1.5,0.0,0.0,3,7,1200,0,1933,0,98133,47.7076,-122.34200000000001,1130,1598,5,4,2015,UNK,70,573
9524100196,11/17/2014,239000.0,2,1.5,680,772,2.0,0.0,0.0,3,7,680,0,2005,0,98103,47.695,-122.34299999999999,690,1059,11,17,2014,N,-10,-287
3013300685,3/18/2015,760000.0,4,3.25,2690,3995,2.0,0.0,0.0,3,9,2060,0,2014,0,98136,47.532,-122.384,1810,4590,3,18,2015,N,880,-595
2619950070,8/26/2014,430000.0,4,2.5,2750,7200,2.0,0.0,0.0,3,8,2750,0,2011,0,98019,47.7327,-121.96600000000001,2750,7200,8,26,2014,N,0,0
7203110240,5/22/2014,660000.0,3,2.5,2450,4332,2.0,0.0,0.0,3,8,2450,0,2010,0,98053,47.6942,-122.016,2450,4154,5,22,2014,N,0,178
7694200350,8/20/2014,399963.0,4,2.5,2620,4050,2.0,0.0,0.0,3,8,2620,0,2014,0,98146,47.5017,-122.34,2030,3944,8,20,2014,N,590,106
7600136,7/18/2014,411000.0,2,2.0,1130,1148,2.0,0.0,0.0,3,9,800,330,2007,0,98122,47.6023,-122.314,1350,1201,7,18,2014,N,-220,-53
1442880160,6/27/2014,483453.0,4,2.75,2790,5527,2.0,0.0,0.0,3,8,2790,0,2014,0,98045,47.4827,-121.773,2620,5509,6,27,2014,N,170,18
3277801580,11/10/2014,469950.0,3,2.0,1820,1357,3.0,0.0,0.0,3,9,1820,0,2014,0,98126,47.5432,-122.376,1710,1372,11,10,2014,N,110,-15
1442880640,7/15/2014,504058.0,4,2.75,2910,7467,2.0,0.0,0.0,3,8,2910,0,2013,0,98045,47.4841,-121.772,2790,7868,7,15,2014,N,120,-401
3845101070,4/28/2015,425996.0,4,2.5,2568,5000,2.0,0.0,0.0,3,9,2568,0,2014,0,98092,47.2596,-122.194,2547,4500,4,28,2015,N,21,500
6791900260,7/8/2014,760005.0,4,2.75,3090,5859,2.0,0.0,0.0,3,9,3090,0,2010,0,98074,47.6057,-122.04700000000001,2960,5250,7,8,2014,N,130,609
9828702339,4/20/2015,699999.0,2,2.0,1460,1085,2.0,0.0,0.0,3,8,950,510,2014,0,98112,47.6205,-122.29899999999999,1580,1202,4,20,2015,N,-120,-117
2255500125,7/16/2014,749950.0,3,2.5,2010,2263,2.0,0.0,0.0,3,8,1340,670,2014,0,98122,47.6088,-122.311,1500,2670,7,16,2014,N,510,-407
5541300135,7/8/2014,674600.0,4,2.5,2610,5140,2.0,0.0,0.0,3,8,2610,0,2006,0,98103,47.6951,-122.346,1190,5101,7,8,2014,N,1420,39
4083306616,2/24/2015,450000.0,2,1.5,960,1000,2.0,0.0,0.0,3,8,920,40,2008,0,98103,47.6489,-122.335,1200,1297,2,24,2015,N,-240,-297
8096800260,4/7/2015,272000.0,3,2.5,1528,7616,2.0,0.0,0.0,3,7,1528,0,2011,0,98030,47.3774,-122.186,1850,7340,4,7,2015,N,-322,276
2997800024,7/14/2014,450000.0,2,1.5,1310,1264,2.0,0.0,0.0,3,8,1120,190,2006,0,98106,47.5772,-122.40899999999999,1330,1265,7,14,2014,N,-20,-1
952005863,5/5/2015,643950.0,3,2.25,1760,2122,3.0,0.0,0.0,3,9,1760,0,2015,0,98116,47.5633,-122.385,1420,1618,5,5,2015,N,340,504
7772850060,11/10/2014,290000.0,3,2.5,1420,3542,2.0,0.0,0.0,3,8,1310,110,2007,0,98133,47.7731,-122.34299999999999,1180,1622,11,10,2014,N,240,1920
6130500070,10/8/2014,378000.0,3,2.5,1650,2082,3.0,0.0,0.0,3,8,1650,0,2007,0,98133,47.7108,-122.33200000000001,1650,1965,10,8,2014,N,0,117
8682300400,6/19/2014,728050.0,3,2.5,2320,6775,1.0,0.0,0.0,3,8,2320,0,2008,0,98053,47.7158,-122.016,1680,4750,6,19,2014,N,640,2025
8956200990,4/26/2015,499160.0,4,2.5,2628,11466,2.0,0.0,0.0,3,9,2628,0,2014,0,98001,47.2904,-122.264,2849,10909,4,26,2015,N,-221,557
9532000070,12/1/2014,536000.0,4,2.5,2520,4831,2.0,0.0,0.0,3,8,2520,0,2009,0,98072,47.7711,-122.16799999999999,2430,3937,12,1,2014,N,90,894
7570050070,2/5/2015,419900.0,5,3.5,2880,5000,2.0,0.0,0.0,3,8,2260,620,2012,0,98038,47.3455,-122.023,2590,4800,2,5,2015,N,290,200
946000295,12/10/2014,469000.0,3,2.25,1440,1362,3.0,0.0,0.0,3,7,1440,0,2014,0,98117,47.6908,-122.365,1180,2603,12,10,2014,N,260,-1241
3831250350,4/8/2015,374000.0,3,2.5,2185,6042,2.0,0.0,0.0,3,9,2185,0,2009,0,98030,47.3573,-122.20200000000001,2297,5876,4,8,2015,N,-112,166
6056100160,7/28/2014,182568.0,4,1.5,1500,2106,2.0,0.0,0.0,3,7,1500,0,2014,0,98108,47.5669,-122.29700000000001,1490,2175,7,28,2014,N,10,-69
1402970070,6/26/2014,334888.0,3,2.5,1769,7324,2.0,0.0,0.0,3,9,1769,0,2012,0,98092,47.3307,-122.18799999999999,2502,6017,6,26,2014,N,-733,1307
2524059267,9/17/2014,799900.0,4,4.0,3650,18223,2.0,0.0,3.0,3,9,3330,320,2013,0,98006,47.5442,-122.116,3220,11022,9,17,2014,N,430,7201
8091670030,5/12/2014,383000.0,4,2.5,2160,6223,2.0,0.0,0.0,3,8,2160,0,2010,0,98038,47.3494,-122.042,2160,5555,5,12,2014,N,0,668
1825079046,12/18/2014,580000.0,3,2.5,1820,374616,2.0,0.0,0.0,3,7,1820,0,1999,0,98014,47.6539,-121.959,1870,220654,12,18,2014,UNK,-50,153962
255450390,7/7/2014,351999.0,3,2.5,2370,4200,2.0,0.0,0.0,3,8,2370,0,2014,0,98038,47.3706,-122.01700000000001,2370,4200,7,7,2014,N,0,0
9301300270,2/23/2015,1330000.0,3,3.0,3180,2758,2.0,0.0,2.0,3,11,2240,940,2008,0,98109,47.6377,-122.34200000000001,2420,2758,2,23,2015,N,760,0
9347300160,1/25/2015,312000.0,3,2.5,1780,4077,2.0,0.0,0.0,3,8,1780,0,2011,0,98038,47.3568,-122.056,1970,4077,1,25,2015,N,-190,0
710600070,9/12/2014,674950.0,4,3.5,2650,3127,2.0,0.0,0.0,3,8,2230,420,2011,0,98027,47.5381,-122.046,2330,3137,9,12,2014,N,320,-10
5556300116,12/29/2014,1110000.0,5,2.75,3300,7560,2.0,0.0,0.0,3,10,3300,0,2007,0,98052,47.6467,-122.118,3150,8580,12,29,2014,N,150,-1020
1324300126,3/13/2015,415000.0,2,2.5,1160,1219,3.0,0.0,0.0,3,8,1160,0,2007,0,98107,47.6543,-122.35799999999999,1320,2800,3,13,2015,N,-160,-1581
9279700013,7/10/2014,1250000.0,3,3.0,3460,5353,2.0,0.0,0.0,3,10,2850,610,2007,0,98116,47.5858,-122.39299999999999,2460,6325,7,10,2014,N,1000,-972
3336500140,9/19/2014,208800.0,3,2.5,1390,2450,2.0,0.0,0.0,3,7,1390,0,2009,0,98118,47.5298,-122.26899999999999,1390,2450,9,19,2014,N,0,0
2767604212,10/29/2014,452000.0,2,2.5,1260,1131,3.0,0.0,0.0,3,8,1260,0,2006,0,98107,47.6715,-122.384,1490,2500,10,29,2014,N,-230,-1369
6719600030,4/22/2015,837000.0,5,2.75,2940,5225,2.0,0.0,0.0,3,8,2760,180,2010,0,98052,47.6879,-122.10700000000001,3090,6261,4,22,2015,N,-150,-1036
3204930510,2/24/2015,780000.0,5,3.5,3190,4247,2.0,0.0,0.0,3,8,2430,760,2013,0,98052,47.7016,-122.103,2580,3989,2,24,2015,N,610,258
7582700075,10/2/2014,1490000.0,4,3.5,3930,6120,2.0,0.0,0.0,3,10,3310,620,2007,0,98105,47.6646,-122.28,3390,6120,10,2,2014,N,540,0
191100435,9/26/2014,1600000.0,5,3.75,3570,10125,2.0,0.0,0.0,3,10,3570,0,2014,0,98040,47.5639,-122.223,1760,10125,9,26,2014,N,1810,0
255450030,9/18/2014,369946.0,3,2.5,2420,4725,2.0,0.0,0.0,3,8,2420,0,2014,0,98038,47.371,-122.01799999999999,2370,4200,9,18,2014,N,50,525
9476200710,6/8/2014,530000.0,3,2.75,3400,7200,2.0,0.0,2.0,3,9,2470,930,2009,0,98056,47.4878,-122.191,1580,8676,6,8,2014,N,1820,-1476
1329300070,3/20/2015,386000.0,4,2.5,2478,6079,2.0,0.0,0.0,3,8,2478,0,2012,0,98030,47.3524,-122.175,2279,6079,3,20,2015,N,199,0
357000135,2/18/2015,1900000.0,4,2.5,3070,7830,2.0,0.0,2.0,3,11,1970,1100,2009,0,98144,47.593,-122.291,2440,4682,2,18,2015,N,630,3148
7203600560,9/11/2014,735000.0,4,3.5,3200,7605,2.0,0.0,2.0,3,9,2500,700,2013,0,98198,47.3443,-122.32700000000001,2240,4416,9,11,2014,N,960,3189
715010140,10/2/2014,1750000.0,5,3.25,5790,12739,2.0,0.0,3.0,3,10,4430,1360,2014,0,98006,47.538000000000004,-122.11399999999999,5790,13928,10,2,2014,N,0,-1189
3869900138,2/23/2015,489950.0,3,2.25,1590,926,3.0,0.0,0.0,3,8,1590,0,2014,0,98136,47.5402,-122.387,1640,1321,2,23,2015,N,-50,-395
2114700374,4/13/2015,357500.0,3,3.0,1730,1442,2.0,0.0,0.0,3,8,1440,290,2008,0,98106,47.5344,-122.348,1370,1524,4,13,2015,N,360,-82
9264450550,5/20/2014,329995.0,4,2.5,2303,3680,2.0,0.0,0.0,3,8,2303,0,2013,0,98001,47.2599,-122.28299999999999,2303,3760,5,20,2014,N,0,-80
3862710200,9/25/2014,414000.0,3,2.5,1790,3754,2.0,0.0,0.0,3,8,1790,0,2013,0,98065,47.534,-121.84100000000001,1800,3393,9,25,2014,N,-10,361
291310310,12/10/2014,533500.0,3,3.5,2490,3517,2.0,0.0,0.0,3,8,1720,770,2005,0,98027,47.5341,-122.06700000000001,1600,2378,12,10,2014,N,890,1139
3814900260,3/5/2015,402395.0,4,2.5,2669,5385,2.0,0.0,0.0,3,9,2669,0,2014,0,98092,47.3262,-122.165,2669,4645,3,5,2015,N,0,740
8562790710,4/10/2015,725000.0,4,3.25,2610,2552,2.0,0.0,0.0,3,10,2160,450,2008,0,98027,47.5322,-122.07600000000001,2610,2664,4,10,2015,N,0,-112
3425069117,8/28/2014,1280000.0,6,5.25,6160,27490,2.0,0.0,0.0,3,11,4040,2120,2007,0,98074,47.6094,-122.023,4225,9100,8,28,2014,N,1935,18390
2895800640,9/17/2014,239800.0,2,1.75,1290,1493,2.0,0.0,0.0,3,8,1290,0,2014,0,98106,47.5171,-122.346,1410,1875,9,17,2014,N,-120,-382
3438500253,9/4/2014,616950.0,5,3.5,3560,5008,2.0,0.0,0.0,3,8,2810,750,2013,0,98106,47.5542,-122.359,2910,5026,9,4,2014,N,650,-18
3630200340,10/1/2014,1260000.0,4,3.25,4360,6000,2.0,0.0,3.0,3,11,3400,960,2007,0,98027,47.5408,-121.994,4310,6000,10,1,2014,N,50,0
2770601769,6/17/2014,435000.0,3,2.25,1230,1238,2.0,0.0,0.0,3,8,1080,150,2009,0,98199,47.6519,-122.384,1230,953,6,17,2014,N,0,285
2225069036,8/15/2014,925000.0,4,3.25,3640,60086,2.0,0.0,0.0,3,10,3640,0,2005,0,98074,47.6328,-122.016,2900,51721,8,15,2014,N,740,8365
9525600030,4/28/2015,631500.0,2,2.5,1780,2493,3.0,0.0,0.0,3,8,1780,0,1981,0,98107,47.6704,-122.35799999999999,2050,4400,4,28,2015,UNK,-270,-1907
993002108,3/30/2015,399995.0,3,1.5,1140,1069,3.0,0.0,0.0,3,8,1140,0,2005,0,98103,47.6907,-122.34200000000001,1230,1276,3,30,2015,N,-90,-207
993000327,5/6/2014,369950.0,3,2.0,1270,1320,3.0,0.0,0.0,3,8,1270,0,2006,0,98103,47.6937,-122.34200000000001,1370,1320,5,6,2014,N,-100,0
1523059239,4/23/2015,475000.0,5,3.5,2780,3583,2.0,0.0,0.0,3,8,2180,600,2005,0,98059,47.4879,-122.152,2640,3850,4,23,2015,N,140,-267
7967000270,11/25/2014,353000.0,4,2.5,1912,5000,2.0,0.0,0.0,3,8,1912,0,2012,0,98001,47.3511,-122.275,2020,5000,11,25,2014,N,-108,0
7137800310,2/25/2015,329950.0,4,2.5,2300,9690,2.0,0.0,0.0,3,8,2300,0,2006,0,98023,47.2793,-122.352,1200,9085,2,25,2015,N,1100,605
2211300260,3/13/2015,367000.0,3,2.5,2828,4050,2.0,0.0,0.0,3,8,2828,0,2013,0,98030,47.382,-122.197,2513,4507,3,13,2015,N,315,-457
8956200070,9/5/2014,447500.0,4,2.5,2425,9017,2.0,0.0,0.0,3,9,2425,0,2013,0,98001,47.3003,-122.26299999999999,2725,7019,9,5,2014,N,-300,1998
1257201420,7/9/2014,595000.0,4,3.25,3730,4560,2.0,0.0,0.0,3,9,2760,970,2015,0,98103,47.6725,-122.33,1800,4560,7,9,2014,N,1930,0
1523300140,9/4/2014,325000.0,1,1.0,730,1942,1.0,0.0,0.0,3,7,730,0,2009,0,98144,47.5943,-122.29899999999999,1020,2044,9,4,2014,N,-290,-102
9831200186,2/3/2015,690000.0,2,2.5,1990,1756,3.0,0.0,0.0,3,9,1780,210,2005,0,98102,47.6264,-122.323,1955,1438,2,3,2015,N,35,318
7660100238,11/11/2014,329950.0,3,2.5,1300,812,2.0,0.0,0.0,3,8,880,420,2008,0,98144,47.5893,-122.31700000000001,1300,824,11,11,2014,N,0,-12
5381000477,1/28/2015,399500.0,4,2.5,2560,7492,2.0,0.0,0.0,3,8,2560,0,2014,0,98188,47.4467,-122.287,1260,11541,1,28,2015,N,1300,-4049
207700180,1/21/2015,555000.0,5,2.5,2450,5047,2.0,0.0,0.0,3,8,2450,0,2007,0,98011,47.7724,-122.16799999999999,2450,4478,1,21,2015,N,0,569
5288200072,10/1/2014,427000.0,2,1.5,1440,725,2.0,0.0,0.0,3,8,1100,340,2011,0,98126,47.5607,-122.37799999999999,1440,4255,10,1,2014,N,0,-3530
9524100322,10/20/2014,375000.0,3,2.25,1140,1557,3.0,0.0,0.0,3,8,1140,0,2007,0,98103,47.6947,-122.34200000000001,1140,1245,10,20,2014,N,0,312
1732800184,5/8/2014,499000.0,2,1.5,1110,957,2.0,0.0,0.0,3,8,930,180,2005,0,98119,47.6319,-122.36200000000001,1680,1104,5,8,2014,N,-570,-147
1425069103,7/18/2014,750000.0,3,2.5,2620,43832,2.0,0.0,0.0,3,8,2620,0,2013,0,98053,47.655,-122.009,2620,120686,7,18,2014,N,0,-76854
8165500790,12/29/2014,336900.0,3,2.5,1690,1200,2.0,0.0,0.0,3,8,1410,280,2014,0,98106,47.5388,-122.367,1740,1664,12,29,2014,N,-50,-464
7658600081,9/19/2014,555000.0,2,2.75,1950,1610,3.0,0.0,0.0,3,8,1950,0,2009,0,98144,47.5925,-122.302,910,1745,9,19,2014,N,1040,-135
1245003268,11/6/2014,1280000.0,4,3.5,3530,8126,2.0,0.0,0.0,3,10,3530,0,2007,0,98033,47.6847,-122.2,2660,8126,11,6,2014,N,870,0
8010100220,10/14/2014,999950.0,4,3.5,3310,4684,2.0,0.0,0.0,3,9,2290,1020,2014,0,98116,47.57899999999999,-122.389,1850,4750,10,14,2014,N,1460,-66
7974200452,6/25/2014,975000.0,5,3.0,2620,5477,2.0,0.0,0.0,3,10,2620,0,2009,0,98115,47.6804,-122.288,1680,5217,6,25,2014,N,940,260
8943600360,2/19/2015,299000.0,3,2.25,1350,3582,2.0,0.0,0.0,3,8,1350,0,2010,0,98031,47.4214,-122.191,1940,3860,2,19,2015,N,-590,-278
3026059361,4/17/2015,479000.0,2,2.5,1741,1439,2.0,0.0,0.0,3,8,1446,295,2007,0,98034,47.7043,-122.209,2090,10454,4,17,2015,N,-349,-9015
6130500120,4/17/2015,428000.0,3,2.5,1650,2201,3.0,0.0,0.0,3,8,1650,0,2007,0,98133,47.7108,-122.333,1650,1965,4,17,2015,N,0,236
3575305485,8/29/2014,409000.0,3,2.5,1890,6500,2.0,0.0,0.0,3,7,1890,0,2012,0,98074,47.6225,-122.05799999999999,2340,7500,8,29,2014,N,-450,-1000
666000142,3/26/2015,798500.0,3,3.0,1950,1833,3.0,0.0,0.0,3,9,1610,340,2009,0,98004,47.6078,-122.20200000000001,2040,2131,3,26,2015,N,-90,-298
7853280620,12/12/2014,689000.0,4,3.5,4490,5805,2.0,0.0,0.0,3,9,3390,1100,2006,0,98065,47.5389,-121.86,4410,6299,12,12,2014,N,80,-494
8946390040,5/8/2014,375000.0,6,2.25,3206,5793,2.0,0.0,0.0,3,7,3206,0,2012,0,98032,47.369,-122.287,2527,5804,5,8,2014,N,679,-11
5416300230,7/17/2014,775000.0,4,3.5,4130,77832,2.0,0.0,2.0,3,10,4130,0,2011,0,98042,47.3229,-122.045,4130,87476,7,17,2014,N,0,-9644
1604730150,10/14/2014,639983.0,5,3.0,2800,5700,2.0,0.0,0.0,3,8,2800,0,2014,0,98059,47.4969,-122.145,2910,5349,10,14,2014,N,-110,351
8669180150,3/26/2015,300000.0,4,3.0,1984,4419,2.0,0.0,0.0,3,7,1984,0,2010,0,98002,47.3514,-122.213,2440,4418,3,26,2015,N,-456,1
1081330180,12/22/2014,627000.0,4,2.5,2750,11830,2.0,0.0,0.0,3,9,2750,0,2014,0,98059,47.4698,-122.12100000000001,2310,11830,12,22,2014,N,440,0
2309710230,4/15/2015,275000.0,3,2.75,1740,5757,1.0,0.0,0.0,3,7,1740,0,2010,0,98022,47.1941,-121.979,2380,5647,4,15,2015,N,-640,110
2895800610,9/26/2014,352800.0,4,2.25,1800,2752,2.0,0.0,0.0,3,8,1800,0,2014,0,98106,47.5167,-122.346,1650,2752,9,26,2014,N,150,0
3362400092,3/12/2015,565000.0,3,2.25,1540,1005,3.0,0.0,0.0,3,8,1540,0,2008,0,98103,47.6828,-122.346,1510,1501,3,12,2015,N,30,-496
3052700385,4/14/2015,765000.0,4,2.25,2030,2222,2.0,0.0,0.0,3,9,1610,420,2015,0,98117,47.678999999999995,-122.375,1420,2222,4,14,2015,N,610,0
2738640040,4/9/2015,644000.0,4,2.5,3310,4839,2.0,0.0,0.0,3,9,3310,0,2007,0,98072,47.773,-122.161,3240,5280,4,9,2015,N,70,-441
8024200674,2/23/2015,461000.0,3,1.5,1270,1416,3.0,0.0,0.0,3,8,1270,0,2007,0,98115,47.6988,-122.31700000000001,1270,1413,2,23,2015,N,0,3
3353400092,12/23/2014,270500.0,5,2.5,2406,7093,2.0,0.0,0.0,3,8,2406,0,2006,0,98001,47.2615,-122.25200000000001,1767,7093,12,23,2014,N,639,0
6003500749,7/1/2014,640000.0,2,2.25,1540,965,3.0,0.0,0.0,3,9,1540,0,2007,0,98122,47.6181,-122.318,1410,964,7,1,2014,N,130,1
8956200530,8/5/2014,457000.0,4,2.5,2820,6983,2.0,0.0,0.0,3,9,2820,0,2013,0,98001,47.2958,-122.265,2597,7222,8,5,2014,N,223,-239
133000271,12/1/2014,355000.0,5,2.5,2540,5100,2.0,0.0,0.0,3,7,2540,0,2014,0,98168,47.5123,-122.316,1400,9440,12,1,2014,N,1140,-4340
6749700063,12/15/2014,356000.0,2,2.25,1230,989,3.0,0.0,0.0,3,8,1230,0,2007,0,98103,47.6975,-122.348,1230,1223,12,15,2014,N,0,-234
3278613060,8/5/2014,425000.0,4,2.5,1900,2766,2.0,0.0,0.0,3,8,1900,0,2014,0,98106,47.543,-122.368,1900,2604,8,5,2014,N,0,162
7708200880,9/23/2014,562500.0,5,2.75,2920,6327,2.0,0.0,0.0,3,8,2920,0,2007,0,98059,47.4935,-122.145,2520,5026,9,23,2014,N,400,1301
2767600673,7/1/2014,460000.0,3,2.5,1450,1053,2.0,0.0,0.0,3,8,940,510,2008,0,98107,47.6754,-122.374,1410,1080,7,1,2014,N,40,-27
7299810040,4/6/2015,790000.0,4,3.0,5370,69848,2.0,0.0,0.0,3,10,3500,1870,2005,0,98042,47.3166,-122.046,4443,94403,4,6,2015,N,927,-24555
993000308,3/18/2015,401000.0,3,2.0,1270,1333,3.0,0.0,0.0,3,8,1270,0,2006,0,98103,47.6933,-122.34200000000001,1330,1333,3,18,2015,N,-60,0
3364900040,8/28/2014,1100000.0,3,2.5,2550,5100,2.0,0.0,0.0,3,9,2550,0,2014,0,98115,47.6757,-122.32600000000001,1250,4080,8,28,2014,N,1300,1020
9578090180,4/3/2015,850000.0,4,3.0,3070,7150,2.0,0.0,0.0,3,9,3070,0,2007,0,98052,47.7079,-122.10700000000001,3200,6984,4,3,2015,N,-130,166
9542840120,7/2/2014,274500.0,3,2.25,1450,4050,2.0,0.0,0.0,3,7,1450,0,2010,0,98038,47.367,-122.01899999999999,1660,3800,7,2,2014,N,-210,250
3860900035,4/15/2015,1940000.0,5,3.5,4230,16526,2.0,0.0,0.0,3,10,4230,0,2008,0,98004,47.5933,-122.199,3000,12362,4,15,2015,N,1230,4164
7202300040,8/4/2014,808000.0,4,2.5,3480,6262,2.0,0.0,0.0,3,9,3480,0,2003,0,98053,47.6857,-122.045,3490,6629,8,4,2014,UNK,-10,-367
1773100972,5/15/2014,312000.0,3,2.25,1490,974,2.0,0.0,0.0,3,7,1220,270,2009,0,98106,47.5567,-122.363,1490,1283,5,15,2014,N,0,-309
3626039424,6/16/2014,320000.0,3,2.25,1200,1400,3.0,0.0,0.0,3,8,1200,0,2005,0,98133,47.7046,-122.35700000000001,1370,6552,6,16,2014,N,-170,-5152
3175200220,1/13/2015,410000.0,3,2.5,2150,4332,2.0,0.0,0.0,3,8,2150,0,2013,0,98019,47.7373,-121.969,2140,4332,1,13,2015,N,10,0
7852120120,6/20/2014,725000.0,3,3.5,3690,8837,2.0,0.0,0.0,3,10,3690,0,2001,0,98065,47.5402,-121.876,3690,9585,6,20,2014,UNK,0,-748
7813500040,10/15/2014,335000.0,4,2.5,1900,3301,2.0,0.0,0.0,3,7,1900,0,2007,0,98178,47.489,-122.249,1960,3379,10,15,2014,N,-60,-78
7242800040,1/20/2015,519990.0,4,3.25,1690,1321,2.0,0.0,0.0,3,8,1320,370,2014,0,98052,47.678000000000004,-122.117,3080,4558,1,20,2015,N,-1390,-3237
1442880650,6/10/2014,533112.0,4,2.75,2790,8853,2.0,0.0,0.0,3,8,2790,0,2013,0,98045,47.4842,-121.772,2790,8092,6,10,2014,N,0,761
3355400242,10/28/2014,274900.0,3,2.0,1936,6612,2.0,0.0,0.0,3,7,1936,0,2014,0,98001,47.2602,-122.24600000000001,1620,21600,10,28,2014,N,316,-14988
8562780540,12/22/2014,325000.0,2,2.25,1150,711,2.0,0.0,0.0,3,7,1150,0,2013,0,98027,47.5323,-122.07,1150,748,12,22,2014,N,0,-37
923049203,5/29/2014,350000.0,4,2.5,2040,22653,2.0,0.0,0.0,3,7,2040,0,2011,0,98168,47.4991,-122.29899999999999,2020,20502,5,29,2014,N,20,2151
3578600141,9/23/2014,550000.0,4,2.5,2470,7539,2.0,0.0,0.0,3,9,2470,0,2006,0,98028,47.7407,-122.226,2580,7539,9,23,2014,N,-110,0
53500450,3/9/2015,311850.0,4,2.5,1890,4158,2.0,0.0,0.0,3,8,1890,0,2014,0,98042,47.343,-122.056,2720,4549,3,9,2015,N,-830,-391
1934800180,2/10/2015,526000.0,3,2.5,1626,1583,2.5,0.0,0.0,3,8,1419,207,2007,0,98122,47.6031,-122.309,1400,1583,2,10,2015,N,226,0
3023000210,10/1/2014,375000.0,4,2.5,2250,5306,2.0,0.0,0.0,3,8,2250,0,2012,0,98038,47.356,-122.057,2250,5306,10,1,2014,N,0,0
1773100967,2/23/2015,299999.0,3,2.25,1350,1234,2.0,0.0,0.0,3,7,1160,190,2007,0,98106,47.5565,-122.363,1420,1234,2,23,2015,N,-70,0
2767704777,9/19/2014,436000.0,3,2.5,1460,1238,2.0,0.0,0.0,3,8,1200,260,2008,0,98107,47.6719,-122.374,1280,1257,9,19,2014,N,180,-19
1085621960,12/12/2014,303000.0,3,2.5,2056,3564,2.0,0.0,0.0,3,7,2056,0,2014,0,98092,47.338,-122.181,2056,3577,12,12,2014,N,0,-13
2771602174,7/1/2014,525000.0,2,2.5,1160,1458,2.0,0.0,0.0,3,8,1040,120,2012,0,98119,47.6384,-122.37299999999999,1650,2311,7,1,2014,N,-490,-853
6762700452,6/13/2014,575000.0,3,3.0,1384,1287,2.0,0.0,0.0,3,8,1144,240,2006,0,98102,47.6295,-122.32,1570,1288,6,13,2014,N,-186,-1
5695000142,10/24/2014,420000.0,2,1.5,1100,1107,3.0,0.0,0.0,3,8,1100,0,2008,0,98103,47.6584,-122.35,1110,2750,10,24,2014,N,-10,-1643
9578140180,6/11/2014,329950.0,3,2.5,2456,7566,2.0,0.0,0.0,3,8,2456,0,2012,0,98023,47.297,-122.351,2478,7212,6,11,2014,N,-22,354
2124069115,10/21/2014,1830000.0,4,4.25,4500,215186,2.0,0.0,3.0,3,11,2630,1870,2009,0,98029,47.559,-122.045,3030,25447,10,21,2014,N,1470,189739
3864000120,4/8/2015,1180000.0,4,3.25,3780,10099,1.0,0.0,1.0,3,11,2240,1540,2006,0,98006,47.5508,-122.19200000000001,3120,10669,4,8,2015,N,660,-570
2768200212,9/11/2014,499950.0,2,2.5,1320,1157,2.0,0.0,0.0,3,8,990,330,2014,0,98107,47.6689,-122.363,1550,1519,9,11,2014,N,-230,-362
7852070210,5/27/2014,1150000.0,4,3.0,5940,11533,2.0,0.0,4.0,3,11,4950,990,2004,0,98065,47.5443,-121.87,4240,12813,5,27,2014,N,1700,-1280
7853361210,2/18/2015,400000.0,3,2.0,1650,5027,1.5,0.0,0.0,3,7,1650,0,2009,0,98065,47.515,-121.874,2430,6000,2,18,2015,N,-780,-973
8141310040,6/27/2014,246950.0,3,3.0,1670,4440,1.0,0.0,0.0,3,7,1670,0,2014,0,98022,47.1948,-121.975,1670,4622,6,27,2014,N,0,-182
6852700097,8/6/2014,630000.0,3,3.25,1610,1275,2.0,0.0,0.0,3,8,1220,390,2005,0,98102,47.6236,-122.318,1750,3000,8,6,2014,N,-140,-1725
7708210040,9/12/2014,561000.0,5,2.75,3370,10315,2.0,0.0,0.0,3,9,3370,0,2006,0,98059,47.4893,-122.146,3010,8296,9,12,2014,N,360,2019
53500760,12/8/2014,287000.0,4,2.5,2660,4082,2.0,0.0,0.0,3,7,2660,0,2010,0,98042,47.3414,-122.055,2390,4876,12,8,2014,N,270,-794
3528900771,3/31/2015,600000.0,3,3.25,1690,1473,2.0,0.0,0.0,3,8,1380,310,2008,0,98109,47.6397,-122.345,1670,2594,3,31,2015,N,20,-1121
9126100813,8/28/2014,490000.0,3,2.25,1620,1062,3.0,0.0,0.0,3,8,1620,0,2014,0,98122,47.6051,-122.304,1560,1728,8,28,2014,N,60,-666
3679400503,3/30/2015,330000.0,3,1.75,1300,958,2.0,0.0,0.0,3,7,840,460,2011,0,98108,47.5677,-122.314,1340,1254,3,30,2015,N,-40,-296
1760650210,12/1/2014,286950.0,4,2.5,1610,4052,2.0,0.0,0.0,3,7,1610,0,2013,0,98042,47.3603,-122.081,2110,4034,12,1,2014,N,-500,18
2652501565,4/23/2015,1550000.0,3,3.25,3530,4920,2.0,0.0,0.0,3,9,2660,870,2015,0,98109,47.64100000000001,-122.35700000000001,1900,4200,4,23,2015,N,1630,720
1237500577,2/12/2015,880000.0,4,2.5,3550,8618,2.0,0.0,0.0,3,10,3550,0,2007,0,98052,47.6776,-122.161,1310,9746,2,12,2015,N,2240,-1128
6382500084,10/13/2014,577450.0,3,3.0,1730,1755,3.0,0.0,0.0,3,8,1730,0,2014,0,98117,47.6944,-122.37700000000001,1830,1804,10,13,2014,N,-100,-49
3023000410,4/30/2015,405000.0,5,2.75,2400,4900,2.0,0.0,0.0,3,8,2400,0,2011,0,98038,47.355,-122.057,2110,5696,4,30,2015,N,290,-796
2767601752,7/7/2014,510000.0,3,2.5,1420,1237,3.0,0.0,0.0,3,8,1420,0,2014,0,98107,47.674,-122.387,1510,2501,7,7,2014,N,-90,-1264
2771604196,8/12/2014,465000.0,2,1.5,1220,1120,2.5,0.0,0.0,3,8,1110,110,2008,0,98199,47.6374,-122.38799999999999,2010,3175,8,12,2014,N,-790,-2055
1778500620,7/7/2014,1300000.0,4,2.25,2360,4000,2.0,0.0,0.0,3,9,2360,0,2013,0,98112,47.6198,-122.289,3040,4400,7,7,2014,N,-680,-400
1823059241,4/8/2015,609000.0,4,3.5,3990,11270,2.0,0.0,3.0,3,9,2930,1060,2007,0,98055,47.488,-122.225,1980,11328,4,8,2015,N,2010,-58
9267200062,9/11/2014,336000.0,3,2.5,1260,1211,3.0,0.0,0.0,3,8,1260,0,2004,0,98103,47.6969,-122.34299999999999,1270,1211,9,11,2014,N,-10,0
3278606110,1/8/2015,375000.0,3,2.5,1580,2407,2.0,0.0,0.0,3,8,1580,0,2013,0,98126,47.5455,-122.368,1580,2212,1,8,2015,N,0,195
1657530180,12/4/2014,294500.0,3,2.5,1760,2688,2.0,0.0,0.0,3,7,1760,0,2005,0,98059,47.4903,-122.166,1760,2329,12,4,2014,N,0,359
2754700035,11/25/2014,925000.0,5,3.5,3420,4216,2.0,0.0,0.0,3,9,2520,900,2008,0,98115,47.6799,-122.304,1420,4500,11,25,2014,N,2000,-284
2568200120,12/15/2014,730000.0,5,2.75,2870,6593,2.0,0.0,0.0,3,9,2870,0,2006,0,98052,47.7075,-122.102,3150,6593,12,15,2014,N,-280,0
6601200040,9/19/2014,280000.0,4,2.5,1934,5677,2.0,0.0,0.0,3,8,1934,0,2013,0,98001,47.2602,-122.25200000000001,1919,5049,9,19,2014,N,15,628
2767601750,8/15/2014,500000.0,3,1.5,1220,962,3.0,0.0,0.0,3,8,1220,0,2014,0,98107,47.674,-122.387,1510,2501,8,15,2014,N,-290,-1539
7853350220,3/24/2015,605000.0,3,2.75,2450,5750,2.0,0.0,0.0,3,9,2450,0,2013,0,98065,47.5439,-121.86200000000001,3200,8036,3,24,2015,N,-750,-2286
6163900628,5/16/2014,379950.0,3,3.25,1860,1787,3.0,0.0,0.0,3,8,1860,0,2007,0,98155,47.7563,-122.316,1830,1787,5,16,2014,N,30,0
1689401526,3/23/2015,605000.0,3,2.5,1500,1119,3.0,0.0,2.0,3,7,1110,0,2008,0,98109,47.6327,-122.346,1500,1057,3,23,2015,N,0,62
8725950360,5/1/2015,720000.0,2,1.75,1570,1108,3.0,0.0,0.0,3,9,1570,0,2007,0,98004,47.6215,-122.2,1940,1160,5,1,2015,N,-370,-52
9826700697,11/3/2014,549900.0,3,2.0,1280,960,2.0,0.0,0.0,3,9,1040,240,2014,0,98122,47.602,-122.311,1280,1173,11,3,2014,N,0,-213
9578500180,1/21/2015,427000.0,3,2.5,3192,5653,2.0,0.0,0.0,3,8,3192,0,2014,0,98023,47.2956,-122.35,3000,5134,1,21,2015,N,192,519
9826700707,10/28/2014,492000.0,3,2.5,1690,1479,3.0,0.0,0.0,3,8,1420,270,2005,0,98122,47.6022,-122.311,1280,1253,10,28,2014,N,410,226
8138870530,5/5/2014,419190.0,2,2.5,1590,1426,2.0,0.0,0.0,3,8,1590,0,2014,0,98029,47.5441,-122.01299999999999,1590,1426,5,5,2014,N,0,0
4188300180,11/12/2014,650000.0,3,2.5,2870,7288,2.0,0.0,0.0,3,9,2870,0,2012,0,98011,47.7745,-122.225,2870,5998,11,12,2014,N,0,1290
5416510530,11/24/2014,379950.0,4,2.5,2580,4818,2.0,0.0,0.0,3,8,2580,0,2005,0,98038,47.3607,-122.038,2570,5386,11,24,2014,N,10,-568
4181200540,7/28/2014,269800.0,4,2.75,1830,3420,2.0,0.0,0.0,3,8,1830,0,2012,0,98198,47.36600000000001,-122.30799999999999,1813,3420,7,28,2014,N,17,0
2222059154,8/13/2014,407000.0,4,2.5,2927,6000,2.0,0.0,0.0,3,7,2927,0,2011,0,98042,47.3737,-122.16,2533,6000,8,13,2014,N,394,0
8032700072,4/15/2015,580000.0,3,1.5,1320,1250,3.0,0.0,0.0,3,8,1320,0,2008,0,98103,47.6536,-122.34100000000001,1560,1694,4,15,2015,N,-240,-444
7203140220,1/16/2015,389700.0,3,2.5,1720,3581,2.0,0.0,0.0,3,7,1720,0,2011,0,98053,47.6861,-122.01299999999999,1720,3600,1,16,2015,N,0,-19
1278000210,3/11/2015,110000.0,2,1.0,828,4524,1.0,0.0,0.0,3,6,828,0,1968,2007,98001,47.2655,-122.244,828,5402,3,11,2015,Y,0,-878
6058600220,7/31/2014,230000.0,3,1.5,1040,1264,2.0,0.0,0.0,3,9,900,140,2015,0,98144,47.5951,-122.301,1350,3000,7,31,2014,N,-310,-1736
1442880610,8/29/2014,533380.0,4,2.75,2790,6685,2.0,0.0,0.0,3,8,2790,0,2014,0,98045,47.4838,-121.773,2790,6444,8,29,2014,N,0,241
3679400484,9/18/2014,295500.0,3,2.5,1410,1332,2.0,0.0,0.0,3,7,960,450,2014,0,98108,47.5683,-122.314,1410,1343,9,18,2014,N,0,-11
3825310180,10/7/2014,860000.0,4,4.5,4040,8400,2.0,0.0,0.0,3,9,3220,820,2006,0,98052,47.7067,-122.131,3940,8400,10,7,2014,N,100,0
3630220180,7/8/2014,812000.0,4,3.5,3370,3634,2.0,0.0,0.0,3,9,2750,620,2007,0,98029,47.5519,-122.001,3200,3650,7,8,2014,N,170,-16
3336500180,6/5/2014,324500.0,3,2.5,1660,3990,2.0,0.0,0.0,3,7,1660,0,2009,0,98118,47.5298,-122.26799999999999,1670,4050,6,5,2014,N,-10,-60
2781270530,3/26/2015,193000.0,2,1.75,910,2550,1.0,0.0,0.0,3,6,910,0,2004,0,98038,47.3494,-122.022,1310,2550,3,26,2015,N,-400,0
993001563,5/22/2014,355000.0,3,2.25,1280,959,3.0,0.0,0.0,3,8,1280,0,2005,0,98103,47.6914,-122.34299999999999,1130,1126,5,22,2014,N,150,-167
9578060540,6/14/2014,525000.0,4,2.75,2360,4924,2.0,0.0,0.0,3,8,2360,0,2008,0,98028,47.7737,-122.235,2360,4670,6,14,2014,N,0,254
2222059052,2/27/2015,370950.0,3,2.5,2529,9653,2.0,0.0,0.0,3,7,2529,0,2012,0,98042,47.3738,-122.161,2533,6125,2,27,2015,N,-4,3528
1239400650,11/7/2014,1240000.0,4,3.5,4700,10183,1.0,0.0,2.0,3,11,2660,2040,2002,0,98033,47.6728,-122.189,3770,9000,11,7,2014,UNK,930,1183
8835800450,5/4/2015,950000.0,3,2.5,2780,275033,1.0,0.0,0.0,3,10,2780,0,2006,0,98045,47.4496,-121.766,1680,16340,5,4,2015,N,1100,258693
293070120,9/18/2014,888990.0,4,2.75,3540,5500,2.0,0.0,0.0,3,9,3540,0,2014,0,98074,47.6181,-122.056,3540,5500,9,18,2014,N,0,0
1176001117,3/19/2015,705000.0,3,2.5,1580,1321,2.0,0.0,2.0,3,8,1080,500,2014,0,98107,47.6688,-122.402,1530,1357,3,19,2015,N,50,-36
7889601165,8/26/2014,268000.0,3,2.5,1700,2250,2.0,0.0,0.0,3,7,1700,0,2014,0,98168,47.4914,-122.334,1520,4500,8,26,2014,N,180,-2250
7227801581,5/7/2014,305450.0,3,2.5,1600,3573,2.0,0.0,0.0,3,7,1600,0,2013,0,98056,47.507,-122.181,1500,11089,5,7,2014,N,100,-7516
9895000040,7/3/2014,399900.0,2,1.75,1410,1005,1.5,0.0,0.0,3,9,900,510,2011,0,98027,47.5446,-122.01799999999999,1440,1188,7,3,2014,N,-30,-183
9528102993,12/29/2014,495000.0,3,1.5,1580,1228,3.0,0.0,0.0,3,8,1580,0,2014,0,98115,47.6765,-122.32,1580,3605,12,29,2014,N,0,-2377
3746700120,11/4/2014,857326.0,3,3.5,3940,11632,2.0,0.0,0.0,3,10,3940,0,2014,0,98166,47.438,-122.344,2015,11632,11,4,2014,N,1925,0
745530040,9/11/2014,845950.0,5,2.75,4450,9600,2.0,0.0,0.0,3,9,3650,800,2014,0,98011,47.7336,-122.21,4000,9750,9,11,2014,N,450,-150
7299600180,6/10/2014,303210.0,4,2.5,2009,5000,2.0,0.0,0.0,3,8,2009,0,2014,0,98092,47.2577,-122.198,2009,5182,6,10,2014,N,0,-182
2149800278,10/15/2014,343000.0,6,5.0,2732,7655,2.0,0.0,0.0,3,7,2732,0,2009,0,98002,47.3045,-122.211,3078,69993,10,15,2014,N,-346,-62338
2517000650,7/16/2014,300000.0,3,2.5,2090,4590,2.0,0.0,0.0,3,7,2090,0,2005,0,98042,47.3992,-122.163,2190,4060,7,16,2014,N,-100,530
6021503708,11/22/2014,334900.0,2,2.5,980,1013,3.0,0.0,0.0,3,8,980,0,2008,0,98117,47.6844,-122.387,980,1023,11,22,2014,N,0,-10
8559300120,4/16/2015,477500.0,5,3.5,2815,5619,2.0,0.0,0.0,3,9,2815,0,2012,0,98055,47.4299,-122.20700000000001,2583,5295,4,16,2015,N,232,324
3305100230,6/18/2014,820000.0,4,2.5,3170,8523,2.0,0.0,0.0,3,9,3170,0,2008,0,98033,47.6854,-122.184,3230,8523,6,18,2014,N,-60,0
2135200155,8/5/2014,580000.0,5,3.25,3030,7410,2.0,0.0,0.0,3,8,2150,880,2014,0,98106,47.553000000000004,-122.354,2020,7410,8,5,2014,N,1010,0
2919700109,7/22/2014,350000.0,2,2.5,1280,940,2.0,0.0,0.0,3,8,1060,220,2006,0,98103,47.6904,-122.36399999999999,1290,2900,7,22,2014,N,-10,-1960
8725950220,2/26/2015,910000.0,3,2.5,2030,1160,3.0,0.0,0.0,3,9,1970,60,2007,0,98004,47.6213,-122.2,1950,1160,2,26,2015,N,80,0
1776230220,6/26/2014,414000.0,3,2.5,2490,4540,2.5,0.0,0.0,3,8,2490,0,2012,0,98059,47.5051,-122.155,2640,3844,6,26,2014,N,-150,696
9211010230,3/30/2015,525000.0,3,2.5,3030,4500,2.0,0.0,0.0,3,8,3030,0,2009,0,98059,47.4944,-122.15,3030,4501,3,30,2015,N,0,-1
1972201772,4/9/2015,650000.0,2,2.5,1470,690,3.0,0.0,3.0,3,8,1470,0,2008,0,98103,47.6523,-122.346,1480,1284,4,9,2015,N,-10,-594
9268851320,12/10/2014,450000.0,3,2.25,1620,997,2.5,0.0,0.0,3,8,1540,80,2012,0,98027,47.5394,-122.027,1620,1068,12,10,2014,N,0,-71
1424059154,5/16/2014,1270000.0,4,3.0,5520,8313,2.0,0.0,3.0,3,9,3570,1950,2008,0,98006,47.5655,-122.12899999999999,3770,8278,5,16,2014,N,1750,35
626059365,4/12/2015,699000.0,3,3.5,3200,10344,2.0,0.0,0.0,3,10,3200,0,2007,0,98011,47.7636,-122.21600000000001,2550,20152,4,12,2015,N,650,-9808
3885802136,7/23/2014,899000.0,4,2.5,2580,3943,2.0,0.0,0.0,3,8,2580,0,2013,0,98033,47.6853,-122.21,1700,5772,7,23,2014,N,880,-1829
7967000150,8/8/2014,353500.0,4,3.0,2050,4000,2.0,0.0,0.0,3,8,2050,0,2014,0,98001,47.3523,-122.275,2050,4000,8,8,2014,N,0,0
7853360720,9/8/2014,485000.0,3,2.5,2430,5867,2.0,0.0,0.0,3,7,2430,0,2011,0,98065,47.5162,-121.87200000000001,2620,5866,9,8,2014,N,-190,1
8562790150,6/26/2014,782900.0,4,3.25,3060,3898,2.0,0.0,0.0,3,10,2300,760,2014,0,98027,47.5311,-122.073,2920,3448,6,26,2014,N,140,450
1226039124,4/28/2015,529000.0,2,2.0,1540,9714,2.0,0.0,0.0,3,8,1540,0,2008,0,98177,47.7628,-122.359,1840,8179,4,28,2015,N,-300,1535
2767704251,4/16/2015,514700.0,3,3.25,1310,1072,2.0,0.0,0.0,3,8,1060,250,2008,0,98107,47.6744,-122.374,1160,1266,4,16,2015,N,150,-194
3862710210,5/20/2014,409316.0,3,2.5,1800,3168,2.0,0.0,0.0,3,8,1800,0,2014,0,98065,47.5342,-121.84100000000001,1800,3393,5,20,2014,N,0,-225
255460330,5/6/2015,388598.0,3,2.5,2370,4200,2.0,0.0,0.0,3,8,2370,0,2014,0,98038,47.3699,-122.01899999999999,2370,4370,5,6,2015,N,0,-170
291310610,2/27/2015,415000.0,3,2.25,1445,1512,2.0,0.0,0.0,3,7,1300,145,2004,0,98027,47.5341,-122.069,1445,1082,2,27,2015,N,0,430
9126101121,4/7/2015,521500.0,3,2.25,1450,1619,2.0,0.0,0.0,3,8,1140,310,2006,0,98122,47.6076,-122.304,1580,3472,4,7,2015,N,-130,-1853
9274200322,8/20/2014,580000.0,3,2.5,1740,1236,3.0,0.0,2.0,3,8,1740,0,2008,0,98116,47.5891,-122.387,1740,1280,8,20,2014,N,0,-44
6666830230,6/30/2014,882566.0,4,2.5,3560,5265,3.0,0.0,0.0,3,8,3560,0,2014,0,98052,47.7047,-122.113,3220,4892,6,30,2014,N,340,373
1604601803,4/8/2015,525000.0,3,2.75,2130,1400,2.0,0.0,0.0,3,9,1080,1050,2010,0,98118,47.5661,-122.29,1880,3132,4,8,2015,N,250,-1732
7702080150,12/1/2014,515000.0,5,2.75,2980,4502,2.0,0.0,0.0,3,9,2980,0,2007,0,98028,47.7698,-122.235,2850,4501,12,1,2014,N,130,1
7853400220,9/26/2014,589410.0,3,3.0,2840,7201,2.0,0.0,0.0,3,9,2840,0,2014,0,98065,47.5165,-121.883,2540,5260,9,26,2014,N,300,1941
3895100039,3/24/2015,757500.0,4,2.5,3420,6845,2.0,0.0,0.0,3,9,3420,0,2009,0,98052,47.6777,-122.156,2800,5715,3,24,2015,N,620,1130
7697000150,10/2/2014,284000.0,3,2.5,1660,4083,2.0,0.0,0.0,3,7,1660,0,2013,0,98038,47.3595,-122.045,1800,4087,10,2,2014,N,-140,-4
8562780530,3/28/2015,338500.0,2,2.25,1150,711,2.0,0.0,0.0,3,7,1150,0,2013,0,98027,47.5323,-122.071,1150,748,3,28,2015,N,0,-37
291310180,6/13/2014,379500.0,3,2.25,1410,1287,2.0,0.0,0.0,3,7,1290,0,2005,0,98027,47.5344,-122.068,1490,1435,6,13,2014,N,-80,-148
1972205633,7/23/2014,550000.0,3,2.0,1420,1369,2.5,0.0,0.0,3,9,1340,80,2007,0,98109,47.6472,-122.35700000000001,1540,2168,7,23,2014,N,-120,-799
3023000120,9/2/2014,294900.0,3,2.5,1860,5025,2.0,0.0,0.0,3,8,1860,0,2010,0,98038,47.3557,-122.059,2000,5550,9,2,2014,N,-140,-525
7548301056,6/9/2014,345000.0,2,1.5,1340,1210,2.0,0.0,0.0,3,8,1120,220,2008,0,98144,47.588,-122.305,1340,1213,6,9,2014,N,0,-3
9826701201,2/9/2015,450000.0,2,1.5,1530,1012,2.0,0.0,0.0,3,8,1200,330,2005,0,98122,47.602,-122.306,1530,1425,2,9,2015,N,0,-413
6300500476,4/15/2015,420000.0,3,2.5,1509,1114,3.0,0.0,0.0,3,8,1509,0,2014,0,98133,47.7049,-122.34,1509,2431,4,15,2015,N,0,-1317
2597490410,4/2/2015,740000.0,3,2.5,2350,3798,2.0,0.0,0.0,3,8,2350,0,2013,0,98029,47.543,-122.01,2020,3532,4,2,2015,N,330,266
3448001411,2/20/2015,286000.0,2,1.5,1010,825,3.0,0.0,0.0,3,7,1010,0,2007,0,98125,47.7124,-122.301,1128,1080,2,20,2015,N,-118,-255
745530180,3/17/2015,870000.0,5,3.5,4495,10079,2.0,0.0,0.0,3,9,3580,915,2013,0,98011,47.7339,-122.209,4495,10079,3,17,2015,N,0,0
3879900753,11/14/2014,727000.0,3,2.5,1580,991,3.0,0.0,0.0,3,9,1580,0,2009,0,98119,47.6276,-122.359,1610,1297,11,14,2014,N,-30,-306
2781230230,2/4/2015,395000.0,4,3.0,2750,7965,2.0,0.0,0.0,3,9,2750,0,2012,0,98038,47.3479,-122.02799999999999,2750,6000,2,4,2015,N,0,1965
3629990180,8/5/2014,535000.0,4,2.25,1890,3615,2.0,0.0,0.0,3,7,1890,0,2005,0,98029,47.5493,-121.999,1630,3280,8,5,2014,N,260,335
9352900222,12/29/2014,255000.0,3,2.25,1320,963,2.0,0.0,0.0,3,7,1040,280,2007,0,98106,47.5199,-122.35700000000001,1300,1285,12,29,2014,N,20,-322
7338220120,10/15/2014,260000.0,4,2.5,2150,3721,2.0,0.0,0.0,3,8,2150,0,2006,0,98002,47.3363,-122.21700000000001,2150,3721,10,15,2014,N,0,0
325059287,9/10/2014,810000.0,4,2.5,3340,8384,2.0,0.0,0.0,3,9,3340,0,2014,0,98052,47.6761,-122.152,1560,9429,9,10,2014,N,1780,-1045
7203140360,12/1/2014,359782.0,3,2.5,1850,3400,2.0,0.0,0.0,3,7,1850,0,2010,0,98053,47.6871,-122.014,1850,3400,12,1,2014,N,0,0
6056110150,3/20/2015,500000.0,2,2.5,1950,2162,2.0,0.0,0.0,3,9,1500,450,2012,0,98118,47.5622,-122.292,1800,2457,3,20,2015,N,150,-295
7203230040,10/27/2014,1050000.0,5,3.25,4240,9588,2.0,0.0,0.0,3,9,4240,0,2014,0,98053,47.6901,-122.01799999999999,4080,8425,10,27,2014,N,160,1163
8121100155,2/25/2015,810000.0,4,3.5,2700,2868,2.0,0.0,0.0,3,11,1920,780,2006,0,98118,47.5685,-122.286,1430,3858,2,25,2015,N,1270,-990
7853370620,2/6/2015,605000.0,5,4.0,3040,6000,2.0,0.0,0.0,3,8,2280,760,2011,0,98065,47.5189,-121.876,3070,5558,2,6,2015,N,-30,442
6400700264,3/17/2015,730000.0,4,2.5,2460,7930,2.0,0.0,0.0,3,8,2460,0,2005,0,98033,47.6684,-122.175,1850,9000,3,17,2015,N,610,-1070
1760650880,3/17/2015,327000.0,4,2.5,2110,3825,2.0,0.0,0.0,3,7,2110,0,2013,0,98042,47.358999999999995,-122.08200000000001,1950,3825,3,17,2015,N,160,0
567000382,11/10/2014,370000.0,2,1.0,780,1133,2.0,0.0,0.0,3,7,780,0,2009,0,98144,47.5924,-122.295,1130,1270,11,10,2014,N,-350,-137
7852100150,6/25/2014,459000.0,5,3.5,2640,6895,2.0,0.0,0.0,3,7,2640,0,2001,0,98065,47.5298,-121.87899999999999,2640,5267,6,25,2014,UNK,0,1628
6447300365,11/13/2014,2900000.0,5,4.0,5190,14600,2.0,0.0,1.0,3,11,5190,0,2013,0,98039,47.6102,-122.225,3840,19250,11,13,2014,N,1350,-4650
2622059197,12/10/2014,365000.0,4,2.5,2420,8404,2.0,0.0,0.0,3,8,2420,0,2013,0,98042,47.372,-122.13,2440,4822,12,10,2014,N,-20,3582
1389600040,12/26/2014,255000.0,4,2.5,1987,6000,2.0,0.0,0.0,3,7,1987,0,2011,0,98001,47.2679,-122.255,1880,9589,12,26,2014,N,107,-3589
9276200220,7/17/2014,375000.0,1,1.0,720,3166,1.0,0.0,0.0,3,6,720,0,1920,0,98116,47.5811,-122.389,1140,6250,7,17,2014,UNK,-420,-3084
7904700032,10/2/2014,375000.0,2,1.5,1130,912,2.0,0.0,0.0,3,8,1000,130,2006,0,98116,47.5638,-122.38799999999999,1500,1474,10,2,2014,N,-370,-562
3744000040,7/22/2014,518380.0,4,2.5,2810,4500,2.0,0.0,0.0,3,9,2810,0,2014,0,98038,47.3552,-122.023,2980,5046,7,22,2014,N,-170,-546
1773100604,7/21/2014,346000.0,3,3.25,1500,1442,2.0,0.0,0.0,3,8,1150,350,2007,0,98106,47.5592,-122.36200000000001,1500,1533,7,21,2014,N,0,-91
9268850360,2/23/2015,302059.0,4,2.0,1390,745,3.0,0.0,0.0,3,7,1390,0,2008,0,98027,47.5393,-122.02600000000001,1390,942,2,23,2015,N,0,-197
7853420450,5/19/2014,575000.0,4,2.5,2500,4945,2.0,0.0,0.0,3,9,2500,0,2013,0,98065,47.5185,-121.885,2760,6000,5,19,2014,N,-260,-1055
8956200770,7/23/2014,549950.0,4,3.5,3906,9674,2.0,0.0,2.0,3,9,3906,0,2014,0,98001,47.2931,-122.264,2673,6500,7,23,2014,N,1233,3174
2424059170,2/19/2015,900000.0,5,6.0,7120,40806,2.0,0.0,4.0,3,12,5480,1640,2007,0,98006,47.5451,-122.11399999999999,3440,36859,2,19,2015,N,3680,3947
1934800133,7/11/2014,397500.0,3,2.5,1470,1256,2.0,0.0,0.0,3,8,930,540,2006,0,98122,47.6033,-122.309,1510,1797,7,11,2014,N,-40,-541
5556300109,11/21/2014,1080000.0,5,3.5,3230,7560,2.0,0.0,0.0,3,10,3230,0,2007,0,98052,47.6467,-122.118,3230,8580,11,21,2014,N,0,-1020
2326600150,4/22/2015,775900.0,3,2.5,2700,5764,2.0,0.0,0.0,3,9,2700,0,2014,0,98075,47.5618,-122.027,3270,14700,4,22,2015,N,-570,-8936
3751600409,5/8/2015,510000.0,4,2.5,4073,17334,2.0,0.0,0.0,3,8,4073,0,2008,0,98001,47.2949,-122.27,1780,9625,5,8,2015,N,2293,7709
3814900210,8/29/2014,471275.0,4,2.5,3361,5038,2.0,0.0,0.0,3,9,3361,0,2014,0,98092,47.3269,-122.165,2316,4105,8,29,2014,N,1045,933
9542840730,9/11/2014,288000.0,4,2.25,1610,3560,2.0,0.0,0.0,3,7,1610,0,2010,0,98038,47.3669,-122.02,1760,3692,9,11,2014,N,-150,-132
2937300540,10/16/2014,989990.0,4,3.5,3830,7150,2.0,0.0,0.0,3,9,3830,0,2014,0,98052,47.7049,-122.126,3640,6055,10,16,2014,N,190,1095
7549800543,6/12/2014,300000.0,3,3.25,1470,1235,2.0,0.0,0.0,3,7,1180,290,2008,0,98108,47.5537,-122.31299999999999,1470,1243,6,12,2014,N,0,-8
4058800439,6/23/2014,664950.0,5,3.0,3190,7081,1.0,0.0,2.0,3,9,1890,1300,2013,0,98178,47.50899999999999,-122.24,2270,7623,6,23,2014,N,920,-542
7853430180,7/16/2014,699188.0,4,3.25,3250,5478,2.0,0.0,0.0,3,9,3250,0,2014,0,98065,47.5178,-121.887,3250,5482,7,16,2014,N,0,-4
982850120,3/3/2015,390000.0,3,2.25,1490,4539,2.0,0.0,0.0,3,7,1490,0,2009,0,98028,47.7607,-122.23299999999999,1750,4667,3,3,2015,N,-260,-128
9476010120,3/21/2015,670000.0,5,2.75,2900,5155,2.0,0.0,0.0,3,8,2900,0,2008,0,98075,47.5977,-122.008,2900,6176,3,21,2015,N,0,-1021
5200087,7/9/2014,487000.0,4,2.5,2540,5001,2.0,0.0,0.0,3,9,2540,0,2005,0,98108,47.5423,-122.302,2360,6834,7,9,2014,N,180,-1833
7308600040,7/23/2014,769995.0,5,2.75,3360,12080,2.0,0.0,0.0,3,9,3360,0,2014,0,98011,47.7757,-122.17299999999999,3360,9724,7,23,2014,N,0,2356
1498301048,5/8/2014,321950.0,2,1.25,860,1277,2.0,0.0,0.0,3,7,860,0,2007,0,98144,47.5842,-122.314,1280,1265,5,8,2014,N,-420,12
2738630040,4/27/2015,613500.0,4,2.5,3020,6068,2.0,0.0,0.0,3,9,3020,0,2006,0,98072,47.773,-122.16,3240,5757,4,27,2015,N,-220,311
6300500081,8/6/2014,300000.0,3,2.5,1330,1200,3.0,0.0,0.0,3,7,1330,0,2002,0,98133,47.7034,-122.344,1330,1206,8,6,2014,UNK,0,-6
3845100620,11/25/2014,400950.0,4,2.5,2578,4554,2.0,0.0,0.0,3,9,2578,0,2014,0,98092,47.2603,-122.194,2647,4554,11,25,2014,N,-69,0
255450040,9/18/2014,389517.0,4,2.5,2640,4725,2.0,0.0,0.0,3,8,2640,0,2014,0,98038,47.371,-122.01700000000001,2370,4725,9,18,2014,N,270,0
880000211,8/21/2014,255000.0,3,1.75,1260,1133,2.0,0.0,0.0,3,7,810,450,2011,0,98106,47.5261,-122.361,1260,1172,8,21,2014,N,0,-39
2163900081,2/20/2015,1080000.0,3,2.5,1990,1891,3.0,0.0,0.0,3,9,1990,0,2012,0,98102,47.6271,-122.324,1990,3600,2,20,2015,N,0,-1709
7853370440,11/21/2014,637850.0,5,3.25,3340,4900,2.0,0.0,2.0,3,9,2500,840,2014,0,98065,47.5193,-121.87700000000001,3220,5200,11,21,2014,N,120,-300
3448900290,8/28/2014,636230.0,4,2.5,2840,6284,2.0,0.0,0.0,3,9,2840,0,2013,0,98056,47.5135,-122.169,2790,7168,8,28,2014,N,50,-884
263000006,12/16/2014,375000.0,3,2.5,1530,1131,3.0,0.0,0.0,3,8,1530,0,2009,0,98103,47.6993,-122.346,1530,1445,12,16,2014,N,0,-314
1972200882,6/4/2014,586500.0,3,2.5,1780,1487,3.0,0.0,0.0,3,8,1600,180,2006,0,98107,47.6539,-122.351,1780,1300,6,4,2014,N,0,187
7853270630,1/20/2015,544000.0,4,2.5,2340,6973,2.0,0.0,0.0,3,8,1930,410,2005,0,98065,47.5451,-121.882,2950,6908,1,20,2015,N,-610,65
7852130430,8/6/2014,425000.0,4,2.5,2390,5021,2.0,0.0,0.0,3,7,2390,0,2002,0,98065,47.5353,-121.87899999999999,2520,5333,8,6,2014,UNK,-130,-312
7383450250,3/11/2015,374950.0,4,2.5,2090,3777,2.0,0.0,0.0,3,8,2090,0,2012,0,98038,47.3595,-122.042,2160,3993,3,11,2015,N,-70,-216
3449000010,3/12/2015,294570.0,3,1.0,1140,8400,1.0,0.0,0.0,4,7,1140,0,1960,0,98059,47.5022,-122.14399999999999,1400,9000,3,12,2015,UNK,-260,-600
2690100170,10/13/2014,300000.0,3,2.5,1960,1477,2.0,0.0,0.0,3,7,1670,290,2012,0,98059,47.4873,-122.166,1980,1467,10,13,2014,N,-20,10
9578500920,9/10/2014,395950.0,5,3.5,2738,6031,2.0,0.0,0.0,3,8,2738,0,2014,0,98023,47.2962,-122.35,2738,5201,9,10,2014,N,0,830
8562900430,7/18/2014,800000.0,4,2.5,3691,11088,2.0,0.0,1.0,3,8,3691,0,2013,0,98074,47.6122,-122.059,3190,11270,7,18,2014,N,501,-182
1442880380,7/30/2014,439990.0,3,2.5,2340,5171,2.0,0.0,0.0,3,8,2340,0,2013,0,98045,47.4832,-121.772,2790,5684,7,30,2014,N,-450,-513
3204930170,11/6/2014,680000.0,4,3.5,2510,3763,2.0,0.0,0.0,3,8,1990,520,2013,0,98052,47.7002,-122.103,2560,3820,11,6,2014,N,-50,-57
4449800480,3/18/2015,677790.0,6,3.0,2800,4213,2.0,0.0,0.0,3,8,2800,0,1998,0,98117,47.6892,-122.389,1440,3960,3,18,2015,UNK,1360,253
3862710010,5/1/2015,424950.0,3,2.5,1650,4777,2.0,0.0,0.0,3,8,1650,0,2013,0,98065,47.5336,-121.84100000000001,1800,3331,5,1,2015,N,-150,1446
301402280,3/31/2015,223990.0,2,2.25,1061,2884,2.0,0.0,0.0,3,7,1061,0,2013,0,98002,47.346000000000004,-122.21799999999999,1481,2887,3,31,2015,N,-420,-3
2867300170,5/13/2015,498000.0,4,2.5,3402,14355,2.0,0.0,0.0,3,10,2846,556,2014,0,98023,47.3009,-122.385,3402,8487,5,13,2015,N,0,5868
5635100080,10/31/2014,359950.0,4,2.5,2542,6120,2.0,0.0,0.0,3,8,2542,0,2014,0,98030,47.3751,-122.18799999999999,2419,8984,10,31,2014,N,123,-2864
1624079024,5/15/2014,720000.0,3,2.5,3150,151588,2.0,0.0,0.0,3,9,3150,0,2007,0,98024,47.571999999999996,-121.926,2410,208652,5,15,2014,N,740,-57064
9211010840,11/12/2014,530000.0,4,2.5,3010,9000,2.0,0.0,0.0,3,8,3010,0,2008,0,98059,47.4987,-122.147,3250,5531,11,12,2014,N,-240,3469
7697000020,10/7/2014,295000.0,3,2.5,1660,4898,2.0,0.0,0.0,3,7,1660,0,2011,0,98038,47.3588,-122.044,1810,4462,10,7,2014,N,-150,436
3832050130,10/21/2014,255500.0,3,2.5,1770,5000,2.0,0.0,0.0,3,7,1770,0,2009,0,98042,47.3358,-122.051,2230,5200,10,21,2014,N,-460,-200
3630240020,5/21/2014,556000.0,3,3.0,1960,1168,2.0,0.0,0.0,3,9,1600,360,2007,0,98027,47.5445,-122.014,2080,1423,5,21,2014,N,-120,-255
1389600080,7/10/2014,277950.0,4,2.5,1889,6000,2.0,0.0,0.0,3,7,1889,0,2012,0,98001,47.2676,-122.256,1990,6350,7,10,2014,N,-101,-350
2781230080,4/8/2015,431000.0,4,2.5,3040,6000,2.0,0.0,0.0,3,9,3040,0,2007,0,98038,47.3473,-122.03,2640,6000,4,8,2015,N,400,0
7203100660,11/17/2014,780000.0,4,2.75,3420,6787,2.0,0.0,0.0,3,9,3420,0,2010,0,98053,47.6962,-122.023,3450,6137,11,17,2014,N,-30,650
1806900502,10/14/2014,649000.0,3,3.25,1720,936,2.0,0.0,0.0,3,8,1030,690,2004,0,98112,47.6201,-122.309,1720,1527,10,14,2014,N,0,-591
3022800010,7/14/2014,447000.0,3,2.5,1740,3043,2.0,0.0,0.0,3,7,1740,0,2012,0,98011,47.744,-122.181,1920,2869,7,14,2014,N,-180,174
6666830250,5/5/2014,712198.0,4,2.5,2450,4247,2.0,0.0,0.0,3,8,2450,0,2013,0,98052,47.7048,-122.113,2970,4685,5,5,2014,N,-520,-438
7242800020,8/15/2014,277140.0,3,1.5,1190,785,2.0,0.0,0.0,3,8,920,270,2014,0,98052,47.6781,-122.117,2820,5626,8,15,2014,N,-1630,-4841
2867300190,5/28/2014,363000.0,4,2.5,3753,7204,2.0,0.0,0.0,3,10,3336,417,2008,0,98023,47.3011,-122.385,3494,9375,5,28,2014,N,259,-2171
8564860130,2/2/2015,598992.0,5,3.5,3440,6037,2.0,0.0,0.0,3,9,3440,0,2014,0,98045,47.4765,-121.734,3270,6037,2,2,2015,N,170,0
2770603522,12/11/2014,585000.0,3,2.5,2160,1250,3.0,0.0,0.0,3,8,1830,330,2010,0,98119,47.6515,-122.375,1870,2825,12,11,2014,N,290,-1575
9544200422,7/31/2014,1270000.0,4,2.75,3820,8850,2.0,0.0,0.0,3,10,3820,0,2014,0,98033,47.6506,-122.195,2330,12000,7,31,2014,N,1490,-3150
4253400104,2/12/2015,380950.0,2,2.0,1120,1039,2.0,0.0,0.0,3,7,840,280,2007,0,98144,47.5788,-122.315,1130,5400,2,12,2015,N,-10,-4361
1085622890,7/8/2014,333490.0,4,2.5,2250,3916,2.0,0.0,0.0,3,8,2250,0,2014,0,98003,47.3413,-122.18,2156,3920,7,8,2014,N,94,-4
9268851630,6/4/2014,520000.0,3,3.25,1540,1487,2.0,0.0,0.0,3,8,1540,0,2011,0,98027,47.5397,-122.027,1620,1104,6,4,2014,N,-80,383
8562780190,10/7/2014,315000.0,2,2.25,1240,705,2.0,0.0,0.0,3,7,1150,90,2009,0,98027,47.5321,-122.073,1240,750,10,7,2014,N,0,-45
2767600686,3/31/2015,487000.0,2,1.5,1160,1118,2.0,0.0,0.0,3,8,1020,140,2007,0,98117,47.6754,-122.375,1210,1118,3,31,2015,N,-50,0
7207900080,8/8/2014,424950.0,5,3.5,2760,3865,2.5,0.0,0.0,3,8,2760,0,2013,0,98056,47.5049,-122.17,2590,4587,8,8,2014,N,170,-722
2770601457,2/10/2015,542300.0,3,2.25,1580,1487,3.0,0.0,0.0,3,9,1580,0,2013,0,98199,47.6514,-122.38600000000001,1600,1525,2,10,2015,N,-20,-38
1773100920,12/11/2014,320000.0,3,3.25,1480,1192,2.0,0.0,0.0,3,8,1180,300,2013,0,98106,47.5556,-122.363,1330,1094,12,11,2014,N,150,98
1024069027,7/23/2014,1140000.0,4,3.25,3740,11467,2.0,0.0,0.0,3,10,3740,0,2014,0,98029,47.581,-122.022,2510,27520,7,23,2014,N,1230,-16053
7853361310,12/15/2014,425000.0,4,2.5,1950,5000,2.0,0.0,0.0,3,8,1950,0,2012,0,98065,47.515,-121.87200000000001,2710,5000,12,15,2014,N,-760,0
6824100029,10/31/2014,474950.0,3,3.0,1530,1568,3.0,0.0,0.0,3,8,1530,0,2012,0,98117,47.6998,-122.367,1460,1224,10,31,2014,N,70,344
255450250,8/4/2014,307635.0,3,2.5,1820,4200,2.0,0.0,0.0,3,8,1820,0,2014,0,98038,47.3693,-122.01700000000001,2370,4200,8,4,2014,N,-550,0
2428100130,12/10/2014,834538.0,3,2.5,2760,6187,2.0,0.0,0.0,3,10,2760,0,2014,0,98075,47.5821,-122.04700000000001,2760,6600,12,10,2014,N,0,-413
1042700050,7/23/2014,769995.0,5,2.75,3010,5398,2.0,0.0,0.0,3,9,3010,0,2014,0,98074,47.6067,-122.053,3360,5407,7,23,2014,N,-350,-9
7853280250,4/24/2015,820875.0,5,3.25,3860,9387,2.0,0.0,2.0,3,9,3860,0,2006,0,98065,47.538000000000004,-121.85799999999999,3860,8979,4,24,2015,N,0,408
7853410170,3/16/2015,595500.0,4,2.5,2490,6537,2.0,0.0,0.0,3,8,2490,0,2013,0,98065,47.5185,-121.884,2520,5848,3,16,2015,N,-30,689
2708450020,9/12/2014,450000.0,4,2.5,3236,9608,2.0,0.0,0.0,3,10,3236,0,2005,0,98030,47.3838,-122.195,3236,9660,9,12,2014,N,0,-52
7852140170,4/21/2015,695000.0,4,2.5,2830,14538,2.0,0.0,0.0,3,8,2830,0,2003,0,98065,47.5405,-121.882,2270,6939,4,21,2015,UNK,560,7599
1459920010,3/23/2015,300000.0,3,2.0,1451,7159,1.0,0.0,0.0,3,7,1451,0,2010,0,98042,47.3754,-122.163,2303,6126,3,23,2015,N,-852,1033
3438500250,6/23/2014,515000.0,5,3.25,2910,5027,2.0,0.0,0.0,3,8,2040,0,2013,0,98106,47.5543,-122.359,2910,5027,6,23,2014,N,0,0
1890000169,9/3/2014,545000.0,3,2.5,1280,1845,3.0,0.0,0.0,3,8,1280,0,2009,0,98105,47.662,-122.324,1450,1889,9,3,2014,N,-170,-44
1250200414,2/18/2015,365000.0,3,2.25,1110,979,2.0,0.0,0.0,3,7,960,150,2008,0,98144,47.5999,-122.3,1170,1400,2,18,2015,N,-60,-421
2564900470,7/14/2014,718500.0,4,2.75,2840,8800,2.0,0.0,0.0,3,9,2840,0,2008,0,98033,47.7029,-122.171,1840,7700,7,14,2014,N,1000,1100
2895800780,4/1/2015,279800.0,3,1.75,1410,2052,2.0,0.0,0.0,3,8,1410,0,2014,0,98106,47.5171,-122.34700000000001,1410,1988,4,1,2015,N,0,64
6306800050,9/25/2014,486940.0,4,2.5,3250,13360,2.0,0.0,0.0,3,9,3250,0,2014,0,98030,47.3524,-122.198,2612,14448,9,25,2014,N,638,-1088
6928000605,6/26/2014,525000.0,4,2.75,3030,6625,2.0,0.0,0.0,3,8,3030,0,2011,0,98059,47.4815,-122.152,3030,9620,6,26,2014,N,0,-2995
3814900950,7/25/2014,345000.0,4,2.5,1983,6002,2.0,0.0,0.0,3,9,1983,0,2012,0,98092,47.3281,-122.164,2502,4750,7,25,2014,N,-519,1252
8562770080,10/30/2014,613000.0,3,3.25,2440,2812,2.0,0.0,0.0,3,8,1710,730,2005,0,98027,47.5362,-122.072,2440,2836,10,30,2014,N,0,-24
3831250130,8/25/2014,370000.0,3,2.5,2313,5700,2.0,0.0,0.0,3,9,2313,0,2011,0,98030,47.3572,-122.20200000000001,2323,5701,8,25,2014,N,-10,-1
3629990020,10/2/2014,449500.0,3,2.25,1260,2556,2.0,0.0,0.0,3,7,1260,0,2005,0,98029,47.5482,-121.99799999999999,1630,2844,10,2,2014,N,-370,-288
9532000010,4/16/2015,515000.0,3,2.5,2000,3837,2.0,0.0,0.0,3,8,2000,0,2011,0,98072,47.7713,-122.167,2210,4075,4,16,2015,N,-210,-238
8562780430,5/4/2015,346100.0,2,1.75,1150,698,2.0,0.0,0.0,3,7,1150,0,2013,0,98027,47.5323,-122.071,1150,757,5,4,2015,N,0,-59
2781230020,12/9/2014,398500.0,4,2.5,2820,6666,2.0,0.0,0.0,3,9,2820,0,2007,0,98038,47.3473,-122.031,1880,7200,12,9,2014,N,940,-534
8658301060,8/20/2014,310000.0,2,1.75,1160,2500,2.0,0.0,0.0,3,7,1160,0,2008,0,98014,47.6489,-121.911,970,7500,8,20,2014,N,190,-5000
301402140,2/26/2015,250000.0,3,2.25,1481,2820,2.0,0.0,0.0,3,7,1481,0,2012,0,98002,47.3457,-122.21700000000001,1481,2889,2,26,2015,N,0,-69
8923600020,8/6/2014,1880000.0,5,3.5,4390,6220,2.0,0.0,3.0,3,9,3170,1220,2013,0,98115,47.6789,-122.273,2740,6448,8,6,2014,N,1650,-228
8725950020,8/27/2014,695000.0,2,1.75,1570,1207,3.0,0.0,0.0,3,9,1570,0,2007,0,98004,47.6215,-122.20100000000001,1570,1206,8,27,2014,N,0,1
1121000357,8/27/2014,1090000.0,4,3.0,3410,6541,2.0,0.0,2.0,3,9,2680,730,2007,0,98126,47.5416,-122.38,2300,6345,8,27,2014,N,1110,196
1042700290,8/4/2014,864327.0,5,3.25,3480,6507,2.0,0.0,0.0,3,9,3480,0,2014,0,98074,47.607,-122.053,3360,5398,8,4,2014,N,120,1109
7308600010,6/16/2014,749995.0,4,3.25,3430,9870,2.0,0.0,0.0,3,9,3430,0,2014,0,98011,47.776,-122.17299999999999,3360,9724,6,16,2014,N,70,146
7708210050,6/10/2014,525000.0,5,2.75,2880,8364,2.0,0.0,0.0,3,9,2880,0,2006,0,98059,47.4893,-122.147,3010,8296,6,10,2014,N,-130,68
5631500285,11/21/2014,659950.0,3,2.5,2990,9413,2.0,0.0,0.0,3,10,2990,0,2006,0,98028,47.7341,-122.234,1940,9600,11,21,2014,N,1050,-187
524059063,5/6/2014,1800000.0,5,5.0,4490,10279,2.0,0.0,0.0,3,10,3930,560,2013,0,98004,47.5974,-122.20200000000001,2490,10279,5,6,2014,N,2000,0
7203160190,10/29/2014,950000.0,5,4.0,4100,8120,2.0,0.0,0.0,3,9,4100,0,2011,0,98053,47.6917,-122.02,4100,7625,10,29,2014,N,0,495
1692900095,6/18/2014,1400000.0,4,2.75,3870,10046,2.0,0.0,0.0,3,11,3870,0,2005,0,98033,47.6651,-122.191,3560,10046,6,18,2014,N,310,0
3438500346,7/2/2014,265050.0,2,1.5,800,2119,2.0,0.0,0.0,3,7,800,0,2008,0,98106,47.553999999999995,-122.36200000000001,1020,4800,7,2,2014,N,-220,-2681
9268850290,3/6/2015,450000.0,3,2.25,1620,1057,3.0,0.0,0.0,3,8,1540,80,2009,0,98027,47.5396,-122.02600000000001,1390,942,3,6,2015,N,230,115
2419700080,5/5/2015,915000.0,4,2.5,2910,4356,3.0,0.0,0.0,3,8,2910,0,2010,0,98034,47.6705,-122.146,2840,4181,5,5,2015,N,70,175
1235700052,6/30/2014,963000.0,4,3.25,3530,8589,2.0,0.0,0.0,3,10,3530,0,2007,0,98033,47.6975,-122.195,2470,9019,6,30,2014,N,1060,-430
4233800020,10/8/2014,270000.0,4,2.5,2701,5821,2.0,0.0,0.0,3,7,2701,0,2013,0,98092,47.2873,-122.177,2566,5843,10,8,2014,N,135,-22
3278612570,7/24/2014,294000.0,2,2.5,1380,889,2.0,0.0,0.0,3,7,1140,240,2012,0,98126,47.5441,-122.369,1580,1397,7,24,2014,N,-200,-508
6638900461,6/5/2014,700000.0,3,2.5,2050,4185,2.0,0.0,0.0,3,9,2050,0,2011,0,98117,47.6922,-122.37100000000001,1150,5000,6,5,2014,N,900,-815
4233600190,3/16/2015,1070000.0,3,4.0,3370,8252,2.0,0.0,0.0,3,10,3370,0,2014,0,98075,47.5965,-122.01299999999999,3710,8252,3,16,2015,N,-340,0
7987400285,4/29/2015,494900.0,3,2.5,2040,2500,2.0,0.0,0.0,3,7,1470,570,2008,0,98126,47.573,-122.37200000000001,1410,2500,4,29,2015,N,630,0
9532000500,8/1/2014,415000.0,3,2.5,1610,3600,2.0,0.0,0.0,3,8,1610,0,2010,0,98072,47.771,-122.169,2210,3600,8,1,2014,N,-600,0
8564860280,5/2/2014,459990.0,3,2.5,2680,5539,2.0,0.0,0.0,3,8,2680,0,2013,0,98045,47.4761,-121.734,2990,6037,5,2,2014,N,-310,-498
8691440440,10/3/2014,882990.0,4,3.5,3560,6562,2.0,0.0,0.0,3,10,3560,0,2014,0,98075,47.5929,-121.97399999999999,3710,6562,10,3,2014,N,-150,0
1099950050,12/29/2014,620000.0,4,3.5,3880,8244,2.0,0.0,0.0,3,10,3060,820,2007,0,98019,47.7426,-121.976,3180,10947,12,29,2014,N,700,-2703
3304040130,2/12/2015,375900.0,3,2.0,1824,7120,1.0,0.0,0.0,3,9,1824,0,2010,0,98001,47.3457,-122.27,2409,6264,2,12,2015,N,-585,856
8562790480,10/6/2014,654000.0,3,2.5,2220,2873,2.0,0.0,0.0,3,10,2010,210,2012,0,98027,47.5311,-122.074,2290,3213,10,6,2014,N,-70,-340
4457300005,3/25/2015,1840000.0,4,3.25,4140,11007,2.0,0.0,0.0,3,10,4140,0,2013,0,98040,47.5707,-122.21700000000001,2150,9663,3,25,2015,N,1990,1344
8856003839,12/10/2014,215000.0,3,2.5,1322,6006,2.0,0.0,0.0,3,7,1322,0,2009,0,98001,47.2706,-122.25399999999999,1440,6796,12,10,2014,N,-118,-790
1972200728,11/24/2014,630500.0,3,2.5,1909,1300,3.0,0.0,0.0,3,8,1766,143,2006,0,98103,47.6538,-122.352,1780,1248,11,24,2014,N,129,52
8691420050,11/7/2014,855000.0,4,3.5,3460,7702,2.0,0.0,0.0,3,10,3460,0,2010,0,98075,47.5942,-121.977,3380,7464,11,7,2014,N,80,238
6601200020,1/27/2015,235245.0,4,2.5,1954,5075,2.0,0.0,0.0,3,8,1954,0,2007,0,98001,47.2606,-122.25299999999999,1934,5000,1,27,2015,N,20,75
200480020,7/10/2014,770000.0,5,2.5,3000,7912,1.0,0.0,0.0,3,9,1610,1390,2007,0,98033,47.6765,-122.175,2700,7205,7,10,2014,N,300,707
7203170190,6/19/2014,734990.0,4,2.5,2650,6884,2.0,0.0,0.0,3,8,2650,0,2012,0,98053,47.6901,-122.015,2520,5866,6,19,2014,N,130,1018
3885802134,1/9/2015,880000.0,4,2.5,2580,3436,2.0,0.0,0.0,3,8,2580,0,2013,0,98033,47.6853,-122.21,1780,5772,1,9,2015,N,800,-2336
9578060420,1/14/2015,525000.0,4,3.0,2650,4924,2.0,0.0,0.0,3,8,2650,0,2011,0,98028,47.7734,-122.238,2380,4733,1,14,2015,N,270,191
3630200080,8/7/2014,775000.0,4,3.5,3390,3960,2.0,0.0,0.0,3,10,3390,0,2008,0,98027,47.5406,-121.995,2990,3400,8,7,2014,N,400,560
3876900089,4/30/2015,687015.0,3,1.75,1470,873,3.0,0.0,0.0,3,10,1470,0,2009,0,98119,47.6256,-122.36200000000001,1410,967,4,30,2015,N,60,-94
3630130130,11/12/2014,663000.0,3,2.5,1910,5125,2.0,0.0,0.0,3,9,1910,0,2006,0,98029,47.5481,-121.995,1910,3215,11,12,2014,N,0,1910
3326059253,3/30/2015,815000.0,4,2.5,3030,7187,2.0,0.0,0.0,3,9,3030,0,2005,0,98033,47.6934,-122.166,3030,7187,3,30,2015,N,0,0
2224069109,4/27/2015,1050000.0,4,3.25,2930,25020,2.0,0.0,0.0,3,9,2930,0,2013,0,98029,47.5514,-122.023,2400,32374,4,27,2015,N,530,-7354
3862700020,4/23/2015,433190.0,3,2.5,1650,2787,2.0,0.0,0.0,3,8,1650,0,2014,0,98065,47.5336,-121.838,1760,2787,4,23,2015,N,-110,0
3629980080,12/10/2014,725000.0,4,2.5,2870,5118,2.0,0.0,0.0,3,9,2870,0,2006,0,98029,47.5544,-121.99,2940,4800,12,10,2014,N,-70,318
7299600950,4/8/2015,279950.0,3,2.5,1608,4800,2.0,0.0,0.0,3,8,1608,0,2013,0,98092,47.2585,-122.20100000000001,2009,4800,4,8,2015,N,-401,0
5528600005,3/27/2015,272167.0,2,2.5,1620,3795,2.0,0.0,0.0,3,7,1620,0,2014,0,98027,47.5321,-122.03399999999999,1620,6000,3,27,2015,N,0,-2205
3052700419,6/16/2014,468500.0,3,2.5,1350,1186,2.0,0.0,0.0,3,8,1120,230,2007,0,98117,47.6786,-122.375,1500,1605,6,16,2014,N,-150,-419
9542840630,6/2/2014,298000.0,3,2.5,1950,3600,2.0,0.0,0.0,3,7,1950,0,2010,0,98038,47.3658,-122.021,1870,4184,6,2,2014,N,80,-584
7896300592,1/14/2015,303500.0,6,4.5,3390,7200,2.0,0.0,0.0,3,8,2440,950,2007,0,98118,47.5205,-122.288,2040,7214,1,14,2015,N,1350,-14
9268850480,4/10/2015,308000.0,3,1.75,1300,1237,2.0,0.0,0.0,3,7,1060,240,2008,0,98027,47.538999999999994,-122.02600000000001,1350,942,4,10,2015,N,-50,295
3629700020,4/15/2015,646800.0,3,3.0,2230,1407,2.5,0.0,0.0,3,8,1850,380,2014,0,98027,47.5446,-122.01700000000001,2230,1407,4,15,2015,N,0,0
8648900010,1/2/2015,530200.0,4,2.5,1880,3853,2.0,0.0,0.0,3,8,1880,0,2010,0,98027,47.5636,-122.094,1890,3078,1,2,2015,N,-10,775
5422950170,11/12/2014,405000.0,5,2.5,3370,5092,2.0,0.0,0.0,3,7,3370,0,2006,0,98038,47.3594,-122.036,2910,5092,11,12,2014,N,460,0
2768200213,7/24/2014,529000.0,2,2.5,1320,1395,2.0,0.0,0.0,3,8,990,330,2014,0,98107,47.6689,-122.36200000000001,1550,1519,7,24,2014,N,-230,-124
642150080,9/8/2014,675900.0,3,2.5,2920,9096,2.0,0.0,0.0,3,9,2920,0,2013,0,98059,47.4855,-122.149,2930,7995,9,8,2014,N,-10,1101
2770601912,4/2/2015,570000.0,3,3.25,1550,1280,2.0,0.0,0.0,3,9,1220,330,2013,0,98199,47.6493,-122.384,1550,1579,4,2,2015,N,0,-299
3304040020,12/26/2014,375500.0,4,2.5,2301,6452,2.0,0.0,0.0,3,9,2301,0,2010,0,98001,47.346000000000004,-122.26899999999999,2650,6054,12,26,2014,N,-349,398
3629960170,10/21/2014,445000.0,3,3.25,1710,1960,2.0,0.0,0.0,3,8,1360,350,2004,0,98029,47.5479,-122.00299999999999,1420,955,10,21,2014,N,290,1005
1238900130,1/5/2015,1100000.0,4,3.75,2890,4164,2.0,0.0,0.0,3,9,2240,650,2013,0,98033,47.676,-122.197,2354,3207,1,5,2015,N,536,957
6056100114,8/25/2014,477000.0,3,2.5,2100,5060,2.0,0.0,0.0,3,7,2100,0,2006,0,98108,47.563,-122.29799999999999,1520,2468,8,25,2014,N,580,2592
4140940130,11/21/2014,450000.0,3,2.75,2240,3360,2.0,0.0,0.0,3,8,2100,140,2014,0,98178,47.4999,-122.23200000000001,1790,5873,11,21,2014,N,450,-2513
6824100007,3/26/2015,427005.0,3,3.0,1460,1200,3.0,0.0,0.0,3,8,1460,0,2006,0,98117,47.7,-122.367,1460,1245,3,26,2015,N,0,-45
1959700225,2/24/2015,720000.0,3,1.75,1370,1990,3.0,0.0,0.0,3,9,1370,0,2014,0,98102,47.6434,-122.324,1730,1990,2,24,2015,N,-360,0
518500460,10/8/2014,2230000.0,3,3.5,3760,5634,2.0,1.0,4.0,3,11,2830,930,2014,0,98056,47.5285,-122.205,3560,5762,10,8,2014,N,200,-128
923059252,5/27/2014,450800.0,4,3.25,2510,5311,2.0,0.0,0.0,3,9,2510,0,2009,0,98056,47.5028,-122.17,1590,9583,5,27,2014,N,920,-4272
3052700213,8/29/2014,461100.0,2,2.25,1210,1267,2.0,0.0,0.0,3,8,1120,90,2010,0,98117,47.6783,-122.376,1360,1349,8,29,2014,N,-150,-82
2428100080,10/1/2014,1060000.0,4,3.0,2990,6695,2.0,0.0,0.0,3,10,2990,0,2014,0,98075,47.5817,-122.04700000000001,2760,6600,10,1,2014,N,230,95
9276202130,4/8/2015,590000.0,3,2.5,1710,2875,2.0,0.0,0.0,3,8,1710,0,2006,0,98116,47.5787,-122.39200000000001,1640,5750,4,8,2015,N,70,-2875
3845100670,7/16/2014,478830.0,4,2.5,3274,4950,2.0,0.0,0.0,3,9,3274,0,2014,0,98092,47.2603,-122.195,2578,4200,7,16,2014,N,696,750
4319200675,7/9/2014,760000.0,4,2.25,3300,8365,3.0,0.0,0.0,3,9,3300,0,2014,0,98126,47.5363,-122.37700000000001,1290,8369,7,9,2014,N,2010,-4
323059327,7/3/2014,1030000.0,4,3.5,4370,10860,2.0,0.0,0.0,3,11,4370,0,2008,0,98059,47.5066,-122.148,3560,8070,7,3,2014,N,810,2790
3448720020,6/13/2014,385000.0,4,2.5,2050,5276,2.0,0.0,0.0,3,7,2050,0,2006,0,98059,47.49100000000001,-122.15,2480,5447,6,13,2014,N,-430,-171
7234600832,5/16/2014,500000.0,2,2.5,1310,1500,2.0,0.0,0.0,3,8,1160,150,2006,0,98122,47.6112,-122.309,1320,1581,5,16,2014,N,-10,-81
4045500950,4/15/2015,425000.0,3,1.5,1680,8000,1.5,0.0,0.0,3,7,1680,0,2012,0,98014,47.6923,-121.869,1990,26336,4,15,2015,N,-310,-18336
7234600098,9/5/2014,552100.0,3,3.0,1330,1379,2.0,0.0,0.0,4,8,1120,210,2005,0,98122,47.6126,-122.31299999999999,1810,1770,9,5,2014,N,-480,-391
666000143,12/29/2014,785000.0,3,3.0,1950,1983,3.0,0.0,0.0,3,9,1610,340,2009,0,98004,47.6078,-122.20200000000001,2040,2131,12,29,2014,N,-90,-148
3343903611,3/23/2015,615000.0,5,3.25,3090,7069,2.0,0.0,0.0,3,9,3090,0,2012,0,98056,47.5114,-122.196,2480,8000,3,23,2015,N,610,-931
1760650950,4/23/2015,309000.0,3,2.5,1950,3825,2.0,0.0,0.0,3,7,1950,0,2013,0,98042,47.3588,-122.08200000000001,1950,3825,4,23,2015,N,0,0
5100403818,2/20/2015,369500.0,3,2.0,1108,1128,3.0,0.0,0.0,3,7,1108,0,2009,0,98115,47.6961,-122.318,1285,1253,2,20,2015,N,-177,-125
2325400170,2/11/2015,391000.0,4,2.25,2190,3850,2.0,0.0,0.0,3,7,2190,0,2006,0,98059,47.4861,-122.161,2190,3980,2,11,2015,N,0,-130
5700000446,10/29/2014,465000.0,3,1.75,1590,1322,2.0,0.0,0.0,3,8,1060,530,2014,0,98144,47.5753,-122.294,1530,5400,10,29,2014,N,60,-4078
9492500010,6/6/2014,879950.0,4,2.75,3010,7215,2.0,0.0,0.0,3,9,3010,0,2014,0,98033,47.6952,-122.178,3010,7215,6,6,2014,N,0,0
2461900446,10/23/2014,372000.0,3,2.0,1330,1042,2.0,0.0,0.0,3,8,1060,270,2014,0,98136,47.5522,-122.382,1440,2428,10,23,2014,N,-110,-1386
8669160170,5/22/2014,259000.0,3,2.5,1550,3569,2.0,0.0,0.0,3,7,1550,0,2011,0,98002,47.3528,-122.211,2095,3402,5,22,2014,N,-545,167
3644100101,7/7/2014,374000.0,2,1.5,1260,1575,2.0,0.0,0.0,3,7,1260,0,2001,0,98144,47.5914,-122.295,1220,1740,7,7,2014,UNK,40,-165
7852090680,3/5/2015,561000.0,4,2.5,2550,5395,2.0,0.0,0.0,3,8,2550,0,2001,0,98065,47.5355,-121.874,2850,6109,3,5,2015,UNK,-300,-714
5693501028,4/3/2015,610000.0,3,2.5,1300,1331,3.0,0.0,0.0,3,8,1300,0,2007,0,98103,47.6607,-122.352,1450,5270,4,3,2015,N,-150,-3939
3629700080,1/8/2015,635000.0,3,3.0,2230,1407,2.5,0.0,0.0,3,8,1850,380,2014,0,98027,47.5446,-122.01700000000001,2290,1407,1,8,2015,N,-60,0
3278600680,6/27/2014,235000.0,1,1.5,1170,1456,2.0,0.0,0.0,3,8,1070,0,2007,0,98126,47.5493,-122.37200000000001,1360,1730,6,27,2014,N,-190,-274
2738640470,7/16/2014,623300.0,4,3.5,4170,4524,2.0,0.0,0.0,3,9,3500,670,2007,0,98072,47.7726,-122.162,3510,5001,7,16,2014,N,660,-477
7853320950,10/23/2014,412500.0,3,2.0,1680,5246,1.0,0.0,0.0,3,7,1680,0,2007,0,98065,47.5206,-121.868,2430,6883,10,23,2014,N,-750,-1637
5635100050,11/21/2014,380000.0,4,3.25,2864,8035,3.0,0.0,0.0,3,8,2864,0,2014,0,98030,47.3746,-122.189,2419,8984,11,21,2014,N,445,-949
3629990280,6/23/2014,497000.0,3,2.25,1630,3817,2.0,0.0,0.0,3,7,1630,0,2005,0,98029,47.5485,-121.999,1630,3348,6,23,2014,N,0,469
6306800020,11/11/2014,452000.0,4,2.5,2716,7850,2.0,0.0,0.0,3,9,2716,0,2014,0,98030,47.352,-122.197,2580,14448,11,11,2014,N,136,-6598
7697000170,10/25/2014,312000.0,3,2.5,1750,4076,2.0,0.0,0.0,3,7,1750,0,2013,0,98038,47.3597,-122.045,1810,4090,10,25,2014,N,-60,-14
5057100080,9/19/2014,469950.0,5,3.0,3223,6371,2.0,0.0,0.0,3,9,3223,0,2014,0,98042,47.3588,-122.163,1979,19030,9,19,2014,N,1244,-12659
5276200020,8/5/2014,775000.0,5,2.5,2600,4284,2.0,0.0,0.0,3,9,2600,0,2014,0,98136,47.5409,-122.39,1620,5000,8,5,2014,N,980,-716
5727500006,4/27/2015,679990.0,4,2.75,3320,8653,2.0,0.0,0.0,3,8,3320,0,2014,0,98133,47.7521,-122.334,2140,8727,4,27,2015,N,1180,-74
9268850130,6/27/2014,288790.0,4,2.0,1350,942,3.0,0.0,0.0,3,7,1350,0,2008,0,98027,47.5401,-122.02600000000001,1390,942,6,27,2014,N,-40,0
9293000170,4/8/2015,800000.0,5,2.5,3410,4726,2.0,0.0,0.0,3,9,3410,0,2007,0,98006,47.5459,-122.184,2810,5129,4,8,2015,N,600,-403
7299601870,4/27/2015,299000.0,3,2.5,1572,4000,2.0,0.0,0.0,3,8,1572,0,2013,0,98092,47.2615,-122.198,1608,5175,4,27,2015,N,-36,-1175
1760650500,1/29/2015,332000.0,4,2.5,2300,4482,2.0,0.0,0.0,3,7,2300,0,2013,0,98042,47.3599,-122.08200000000001,2300,3825,1,29,2015,N,0,657
7174800094,4/20/2015,525000.0,1,1.5,1030,5923,1.0,0.0,0.0,3,8,1030,0,1940,0,98105,47.6653,-122.305,2650,5000,4,20,2015,UNK,-1620,923
6909200007,9/3/2014,620000.0,3,1.75,1458,858,2.0,0.0,0.0,3,8,950,508,2014,0,98144,47.592,-122.29299999999999,1458,3000,9,3,2014,N,0,-2142
7853321150,11/3/2014,452000.0,4,2.5,2190,6896,2.0,0.0,0.0,3,7,2190,0,2007,0,98065,47.5191,-121.869,2190,5900,11,3,2014,N,0,996
1105000402,10/28/2014,630000.0,4,3.0,3640,5096,2.0,0.0,0.0,3,8,2740,900,2010,0,98118,47.5428,-122.27,1910,9189,10,28,2014,N,1730,-4093
1442870420,7/24/2014,485000.0,4,2.75,2790,7803,2.0,0.0,0.0,3,8,2790,0,2013,0,98045,47.4823,-121.772,2620,6178,7,24,2014,N,170,1625
3682000050,10/13/2014,349950.0,4,2.5,2632,4117,2.0,0.0,0.0,3,8,2632,0,2013,0,98001,47.3428,-122.27799999999999,2040,5195,10,13,2014,N,592,-1078
1442880080,7/1/2014,499990.0,4,2.75,2910,6334,2.0,0.0,0.0,3,8,2910,0,2013,0,98045,47.4826,-121.771,2790,6352,7,1,2014,N,120,-18
7169500020,12/5/2014,510000.0,2,2.25,1470,1101,2.0,0.0,0.0,3,8,1340,130,2005,0,98115,47.6768,-122.301,1470,1582,12,5,2014,N,0,-481
2911700010,3/3/2015,1080000.0,3,2.5,2240,21477,2.0,0.0,2.0,3,8,2240,0,1995,0,98006,47.5745,-122.18,2930,21569,3,3,2015,UNK,-690,-92
9578060470,5/8/2014,494000.0,3,2.5,2310,4729,2.0,0.0,0.0,3,8,2310,0,2011,0,98028,47.7734,-122.23700000000001,2440,4711,5,8,2014,N,-130,18
1776460190,6/26/2014,429900.0,3,2.5,2370,5353,2.0,0.0,0.0,3,8,2370,0,2009,0,98019,47.7333,-121.975,2130,6850,6,26,2014,N,240,-1497
3449500050,10/15/2014,505000.0,4,2.75,2980,9825,1.0,0.0,0.0,3,8,1910,1070,2007,0,98056,47.5073,-122.17200000000001,2580,12231,10,15,2014,N,400,-2406
2309710130,7/15/2014,272000.0,4,2.0,1870,6551,1.0,0.0,3.0,3,7,1870,0,2009,0,98022,47.1934,-121.977,2280,5331,7,15,2014,N,-410,1220
1972201511,2/10/2015,671500.0,3,2.5,1770,1714,3.0,0.0,0.0,3,8,1770,0,2012,0,98103,47.6532,-122.348,1720,3360,2,10,2015,N,50,-1646
7852120050,3/11/2015,729950.0,4,3.5,3510,10010,2.0,0.0,0.0,3,10,3510,0,2001,0,98065,47.5412,-121.876,4200,9935,3,11,2015,UNK,-690,75
3814900660,7/21/2014,471835.0,4,2.5,3281,5354,2.0,0.0,0.0,3,9,3281,0,2014,0,98092,47.3273,-122.163,2598,4815,7,21,2014,N,683,539
8141310080,11/3/2014,249950.0,3,2.0,1670,4438,1.0,0.0,0.0,3,7,1670,0,2014,0,98022,47.1948,-121.97399999999999,1670,4558,11,3,2014,N,0,-120
7207900050,8/8/2014,424950.0,5,3.5,2760,3846,2.5,0.0,0.0,3,8,2760,0,2013,0,98056,47.5047,-122.17,2760,4587,8,8,2014,N,0,-741
2424059163,7/9/2014,1240000.0,5,3.5,5430,10327,2.0,0.0,2.0,3,10,4010,1420,2007,0,98006,47.5476,-122.116,4340,10324,7,9,2014,N,1090,3
2140950130,9/11/2014,440000.0,4,2.5,2990,7928,2.0,0.0,0.0,3,9,2990,0,2011,0,98010,47.3139,-122.024,2810,7401,9,11,2014,N,180,527
1776230190,4/8/2015,495000.0,4,3.5,3170,3858,2.0,0.0,0.0,3,8,2530,640,2008,0,98059,47.5049,-122.155,2640,3844,4,8,2015,N,530,14
3524039224,5/13/2014,870000.0,4,2.5,3520,6773,2.5,0.0,0.0,3,9,2650,870,2006,0,98136,47.5317,-122.391,2930,6458,5,13,2014,N,590,315
5694500840,11/25/2014,559000.0,2,3.0,1650,960,3.0,0.0,0.0,3,8,1350,300,2015,0,98103,47.6611,-122.346,1650,3000,11,25,2014,N,0,-2040
4014400381,5/7/2014,495000.0,4,2.75,2656,21195,2.0,0.0,0.0,3,9,2656,0,2014,0,98001,47.3162,-122.272,1860,16510,5,7,2014,N,796,4685
2838000130,2/13/2015,722000.0,3,2.5,2230,4850,2.0,0.0,0.0,3,8,2230,0,2014,0,98133,47.7295,-122.334,2230,4513,2,13,2015,N,0,337
8562770430,7/2/2014,567500.0,3,2.5,2280,2502,2.0,0.0,0.0,3,8,1880,400,2006,0,98027,47.5364,-122.073,2280,2812,7,2,2014,N,0,-310
1402970020,12/17/2014,440000.0,4,2.5,2798,5085,2.0,0.0,0.0,3,9,2798,0,2011,0,98092,47.3308,-122.18700000000001,2502,5707,12,17,2014,N,296,-622
3943600020,8/29/2014,400000.0,4,2.5,2398,5988,2.0,0.0,0.0,3,8,2398,0,2008,0,98055,47.452,-122.204,2370,5988,8,29,2014,N,28,0
1438000430,10/6/2014,459995.0,4,2.5,2350,3760,2.0,0.0,0.0,3,8,2350,0,2014,0,98059,47.4786,-122.12299999999999,2590,4136,10,6,2014,N,-240,-376
1601600167,5/7/2014,365000.0,5,2.75,2410,5003,1.0,0.0,0.0,3,7,1410,1000,2008,0,98118,47.5298,-122.274,1590,5003,5,7,2014,N,820,0
1773100541,4/17/2015,389950.0,3,2.25,1580,920,3.0,0.0,0.0,3,8,1580,0,2015,0,98106,47.5578,-122.363,1250,1150,4,17,2015,N,330,-230
1773100924,7/8/2014,320000.0,3,3.25,1450,1387,2.0,0.0,0.0,3,8,1180,270,2013,0,98106,47.5556,-122.36200000000001,1450,1198,7,8,2014,N,0,189
982850080,6/13/2014,415500.0,4,2.5,1750,4779,2.0,0.0,0.0,3,7,1750,0,2009,0,98028,47.7608,-122.23200000000001,1580,4687,6,13,2014,N,170,92
7628700050,3/9/2015,775000.0,3,2.5,3020,4120,2.0,0.0,0.0,3,9,2360,660,2008,0,98126,47.5714,-122.37299999999999,2280,4120,3,9,2015,N,740,0
8673400020,3/11/2015,590000.0,3,3.0,1740,1100,3.0,0.0,0.0,3,8,1740,0,2007,0,98107,47.67,-122.391,1370,1180,3,11,2015,N,370,-80
8725950170,1/23/2015,950000.0,2,2.25,2200,2043,2.0,0.0,0.0,3,9,1760,440,2007,0,98004,47.6213,-122.2,2020,1957,1,23,2015,N,180,86
6306800080,8/6/2014,378950.0,4,2.5,1867,15314,2.0,0.0,0.0,3,9,1867,0,2013,0,98030,47.3524,-122.198,2616,8048,8,6,2014,N,-749,7266
3362401763,5/8/2014,441750.0,2,1.5,1020,1060,3.0,0.0,0.0,3,8,1020,0,2008,0,98103,47.6801,-122.348,1340,1415,5,8,2014,N,-320,-355
301401630,10/31/2014,335900.0,4,2.75,2475,4000,2.0,0.0,0.0,3,7,2475,0,2014,0,98002,47.345,-122.209,2475,4000,10,31,2014,N,0,0
6056110780,6/27/2014,229800.0,2,1.75,1110,1773,2.0,0.0,0.0,3,8,1110,0,2014,0,98108,47.5647,-122.29299999999999,1420,2855,6,27,2014,N,-310,-1082
6819100352,3/10/2015,645000.0,3,2.5,1900,1258,2.5,0.0,0.0,3,7,1700,200,2007,0,98119,47.6465,-122.35799999999999,1780,1877,3,10,2015,N,120,-619
9297302031,4/23/2015,448000.0,3,3.25,1560,1345,2.0,0.0,0.0,3,8,1260,300,2009,0,98126,47.5637,-122.375,1560,4800,4,23,2015,N,0,-3455
7203150080,12/16/2014,706000.0,4,2.5,2510,5436,2.0,0.0,0.0,3,8,2510,0,2011,0,98053,47.6894,-122.016,2520,5436,12,16,2014,N,-10,0
2937300050,2/27/2015,988990.0,4,4.75,4150,6303,3.0,0.0,0.0,3,9,4150,0,2014,0,98052,47.7047,-122.12299999999999,3570,6285,2,27,2015,N,580,18
9521100029,7/16/2014,716000.0,3,3.0,1660,1849,3.0,0.0,0.0,3,9,1660,0,2013,0,98103,47.6649,-122.353,1660,3300,7,16,2014,N,0,-1451
832700170,4/21/2015,319000.0,2,1.5,1090,847,3.0,0.0,0.0,3,8,1090,0,2009,0,98133,47.7235,-122.352,1090,1118,4,21,2015,N,0,-271
6817750440,10/14/2014,300000.0,4,2.5,1914,3272,2.0,0.0,0.0,3,8,1914,0,2009,0,98055,47.4297,-122.189,1714,3250,10,14,2014,N,200,22
123059127,5/2/2014,625000.0,4,3.25,2730,54014,1.0,0.0,0.0,3,9,1560,1170,2007,0,98059,47.5133,-122.11,2730,111274,5,2,2014,N,0,-57260
3630200430,5/14/2014,773000.0,3,2.75,2470,3600,2.0,0.0,0.0,3,9,2470,0,2007,0,98029,47.5406,-121.994,2570,3600,5,14,2014,N,-100,0
3448740430,9/25/2014,392000.0,5,2.5,2340,5670,2.0,0.0,0.0,3,7,2340,0,2009,0,98059,47.4913,-122.152,2190,4869,9,25,2014,N,150,801
1438000190,9/11/2014,549995.0,4,3.5,2660,5690,2.0,0.0,0.0,3,8,1920,740,2014,0,98059,47.4775,-122.12200000000001,2970,5690,9,11,2014,N,-310,0
7853320250,9/20/2014,480000.0,3,2.5,2410,4656,2.0,0.0,0.0,3,7,2410,0,2009,0,98065,47.5203,-121.874,2410,4840,9,20,2014,N,0,-184
100300280,10/20/2014,355000.0,3,2.25,1430,4777,2.0,0.0,0.0,3,7,1430,0,2010,0,98059,47.4867,-122.152,1639,3854,10,20,2014,N,-209,923
8862500280,12/30/2014,208400.0,2,2.5,1570,1268,3.0,0.0,0.0,3,7,1570,0,2007,0,98106,47.534,-122.365,1570,1300,12,30,2014,N,0,-32
1042700080,8/22/2014,831548.0,5,2.75,3010,4919,2.0,0.0,0.0,3,9,3010,0,2014,0,98074,47.6067,-122.052,3230,5415,8,22,2014,N,-220,-496
4051150080,11/17/2014,279500.0,4,2.5,1613,4338,2.0,0.0,0.0,3,7,1613,0,2009,0,98042,47.3859,-122.162,1427,4341,11,17,2014,N,186,-3
5592200010,2/27/2015,445000.0,3,2.5,2380,5269,2.0,0.0,0.0,3,8,2380,0,2008,0,98056,47.5066,-122.19200000000001,2150,7600,2,27,2015,N,230,-2331
7787920080,6/16/2014,492500.0,5,2.5,2570,9962,2.0,0.0,0.0,3,8,2570,0,2006,0,98019,47.7275,-121.95700000000001,2890,9075,6,16,2014,N,-320,887
3448740190,7/9/2014,435000.0,4,2.5,2550,5200,2.0,0.0,0.0,3,7,2550,0,2009,0,98059,47.4919,-122.15299999999999,2550,4660,7,9,2014,N,0,540
8822900122,5/12/2015,325000.0,3,2.25,1330,969,3.0,0.0,0.0,3,7,1330,0,2007,0,98125,47.7177,-122.292,1310,1941,5,12,2015,N,20,-972
4083300098,11/17/2014,453000.0,2,1.5,1160,1269,2.0,0.0,0.0,3,7,970,190,2005,0,98103,47.6608,-122.335,1700,3150,11,17,2014,N,-540,-1881
1438000170,8/22/2014,612995.0,5,3.5,3240,6919,2.0,0.0,0.0,3,8,2760,480,2014,0,98059,47.4779,-122.12200000000001,2970,5690,8,22,2014,N,270,1229
7853360480,9/4/2014,540000.0,4,2.5,2710,9248,2.0,0.0,0.0,3,7,2710,0,2011,0,98065,47.5164,-121.875,2710,5000,9,4,2014,N,0,4248
522059130,4/29/2015,465000.0,3,1.0,1150,18200,1.0,0.0,0.0,5,7,1150,0,1959,0,98058,47.4262,-122.18700000000001,1714,18200,4,29,2015,UNK,-564,0
4385700185,8/12/2014,799950.0,3,2.25,1860,1386,3.0,0.0,0.0,3,9,1860,0,2014,0,98112,47.6368,-122.279,1680,3080,8,12,2014,N,180,-1694
2768301476,11/24/2014,495000.0,3,2.25,1280,1517,2.0,0.0,0.0,3,8,1080,200,2008,0,98107,47.6651,-122.368,1280,1681,11,24,2014,N,0,-164
1862400541,2/28/2015,579950.0,3,2.5,1810,1585,3.0,0.0,0.0,3,7,1810,0,2014,0,98117,47.6957,-122.376,1560,1586,2,28,2015,N,250,-1
8562780280,2/20/2015,331000.0,2,2.25,1240,720,2.0,0.0,0.0,3,7,1150,90,2008,0,98027,47.5322,-122.072,1260,810,2,20,2015,N,-20,-90
9528101061,8/25/2014,580000.0,4,3.5,1460,951,3.0,0.0,0.0,3,8,1460,0,2008,0,98115,47.6821,-122.32600000000001,1430,1282,8,25,2014,N,30,-331
6056110460,4/14/2015,669000.0,2,2.5,1640,1953,2.0,0.0,0.0,3,10,1640,0,2014,0,98118,47.5639,-122.292,1820,2653,4,14,2015,N,-180,-700
2154970020,7/3/2014,2350000.0,4,4.25,5010,19412,2.0,0.0,1.0,3,11,4000,1010,2014,0,98040,47.5455,-122.211,3820,17064,7,3,2014,N,1190,2348
5694500497,1/16/2015,539900.0,3,3.25,1300,1325,2.0,0.0,0.0,3,8,1080,220,2005,0,98103,47.6584,-122.346,1290,1323,1,16,2015,N,10,2
7708200670,7/23/2014,490000.0,4,2.5,2510,4349,2.0,0.0,0.0,3,8,2510,0,2010,0,98059,47.4927,-122.147,2510,4314,7,23,2014,N,0,35
8562770050,5/27/2014,627000.0,3,3.5,2710,3475,2.0,0.0,0.0,3,8,1650,1060,2005,0,98027,47.5359,-122.072,2440,2867,5,27,2014,N,270,608
1441000470,7/28/2014,458000.0,4,3.5,3217,4000,2.0,0.0,0.0,3,8,2587,630,2008,0,98055,47.4483,-122.20299999999999,2996,5418,7,28,2014,N,221,-1418
6056100293,11/10/2014,440000.0,3,2.5,1650,4929,2.0,0.0,0.0,3,7,1520,130,2007,0,98108,47.5634,-122.29799999999999,1520,2287,11,10,2014,N,130,2642
6600000050,3/10/2015,1700000.0,4,3.5,3950,6240,2.0,0.0,0.0,3,11,3950,0,2015,0,98112,47.6221,-122.29,2040,6240,3,10,2015,N,1910,0
1732800199,5/11/2015,935000.0,2,2.5,1680,977,3.0,0.0,0.0,3,9,1680,0,2009,0,98119,47.632,-122.361,1680,977,5,11,2015,N,0,0
7853360470,4/17/2015,641000.0,5,3.5,3420,6403,2.0,0.0,2.0,3,8,2700,720,2013,0,98065,47.5162,-121.874,2710,6038,4,17,2015,N,710,365
3438501583,9/11/2014,452000.0,3,2.75,2300,5090,2.0,0.0,0.0,3,8,1700,600,2007,0,98106,47.545,-122.36,1530,9100,9,11,2014,N,770,-4010
7853370250,12/23/2014,625000.0,4,2.75,3010,6854,2.0,0.0,2.0,3,9,2570,440,2012,0,98065,47.5171,-121.876,1830,2952,12,23,2014,N,1180,3902
2387600010,3/3/2015,1350000.0,4,3.5,4680,12495,2.0,0.0,0.0,3,10,3040,1640,2008,0,98033,47.6984,-122.206,3240,10749,3,3,2015,N,1440,1746
8946780080,9/8/2014,834950.0,5,3.5,3630,4911,2.0,0.0,0.0,3,9,2790,840,2014,0,98034,47.718,-122.156,3600,4992,9,8,2014,N,30,-81
9402800005,10/28/2014,1500000.0,3,3.5,3530,3610,2.0,0.0,0.0,3,10,2370,1160,2008,0,98103,47.6857,-122.339,1780,3610,10,28,2014,N,1750,0
5422950080,8/25/2014,305000.0,4,2.5,2280,3800,2.0,0.0,0.0,3,7,2280,0,2006,0,98038,47.3586,-122.036,2630,4045,8,25,2014,N,-350,-245
2826079027,11/12/2014,659000.0,3,2.5,3090,384634,2.0,0.0,0.0,3,8,3090,0,2007,0,98019,47.7072,-121.927,2200,292645,11,12,2014,N,890,91989
6003000851,5/22/2014,353000.0,1,1.0,550,1279,2.0,0.0,0.0,3,7,550,0,2008,0,98122,47.61600000000001,-122.314,1460,1385,5,22,2014,N,-910,-106
7394400080,3/4/2015,535000.0,4,3.25,2840,4000,2.0,0.0,3.0,3,9,2330,510,2014,0,98108,47.5529,-122.29299999999999,2160,4867,3,4,2015,N,680,-867
1238501184,7/8/2014,999000.0,4,2.5,3130,10849,2.0,0.0,0.0,3,10,3130,0,2013,0,98033,47.6828,-122.186,2470,9131,7,8,2014,N,660,1718
263000009,1/29/2015,375000.0,3,2.5,1440,1102,3.0,0.0,0.0,3,8,1440,0,2009,0,98103,47.6995,-122.346,1440,1434,1,29,2015,N,0,-332
5101408889,6/16/2014,685000.0,4,3.5,2840,4637,3.0,0.0,0.0,3,8,2840,0,2008,0,98125,47.7033,-122.321,1730,5279,6,16,2014,N,1110,-642
7299601410,8/8/2014,333000.0,4,2.5,2623,7184,2.0,0.0,0.0,3,8,2623,0,2012,0,98092,47.25899999999999,-122.20200000000001,2010,4939,8,8,2014,N,613,2245
9266700190,5/11/2015,245000.0,1,1.0,390,2000,1.0,0.0,0.0,4,6,390,0,1920,0,98103,47.6938,-122.34700000000001,1340,5100,5,11,2015,UNK,-950,-3100
2424059174,5/8/2015,2000000.0,4,3.25,5640,35006,2.0,0.0,2.0,3,11,4900,740,2015,0,98006,47.5491,-122.104,4920,35033,5,8,2015,N,720,-27
8562780290,10/15/2014,329950.0,2,2.25,1260,1032,2.0,0.0,0.0,3,7,1170,90,2008,0,98027,47.5323,-122.072,1240,809,10,15,2014,N,20,223
5100400244,4/20/2015,403000.0,2,1.0,894,1552,2.0,0.0,0.0,3,7,894,0,2011,0,98115,47.6911,-122.31299999999999,1131,1992,4,20,2015,N,-237,-440
3744000130,11/11/2014,559630.0,4,2.5,3370,4934,2.0,0.0,0.0,3,9,3370,0,2014,0,98038,47.3562,-122.022,2980,5046,11,11,2014,N,390,-112
993001976,8/18/2014,344000.0,3,2.25,1250,871,3.0,0.0,0.0,3,8,1250,0,2007,0,98103,47.6907,-122.34299999999999,1250,1158,8,18,2014,N,0,-287
525049174,4/2/2015,435000.0,3,1.5,1180,1231,3.0,0.0,0.0,3,7,1180,0,2008,0,98115,47.6845,-122.315,1280,3360,4,2,2015,N,-100,-2129
5393600562,5/22/2014,430000.0,2,2.5,1520,1588,2.0,0.0,0.0,3,8,1240,280,2007,0,98144,47.5825,-122.31299999999999,1660,6000,5,22,2014,N,-140,-4412
4187000190,11/17/2014,417000.0,3,2.5,2000,4500,2.0,0.0,0.0,3,7,2000,0,2010,0,98059,47.4937,-122.149,2230,4501,11,17,2014,N,-230,-1
2862500190,4/9/2015,895950.0,5,2.75,3180,9255,2.0,0.0,0.0,3,9,3180,0,2014,0,98074,47.6232,-122.023,3180,7782,4,9,2015,N,0,1473
5045700470,3/19/2015,563950.0,4,2.75,3050,4750,2.0,0.0,0.0,3,8,3050,0,2014,0,98059,47.4857,-122.15299999999999,2730,5480,3,19,2015,N,320,-730
2924079034,9/25/2014,332220.0,3,1.5,2580,47480,1.0,0.0,0.0,3,7,1360,1220,1953,0,98024,47.5333,-121.93299999999999,1760,48181,9,25,2014,UNK,820,-701
8835770170,8/22/2014,1490000.0,5,6.0,6880,279968,2.0,0.0,3.0,3,12,4070,2810,2007,0,98045,47.4624,-121.779,4690,256803,8,22,2014,N,2190,23165
3630200480,6/12/2014,680000.0,3,2.5,2570,3600,2.5,0.0,0.0,3,9,2570,0,2007,0,98027,47.5412,-121.994,2570,3600,6,12,2014,N,0,0
8562790080,2/9/2015,825750.0,4,3.5,2950,3737,2.0,0.0,0.0,3,10,2270,680,2012,0,98027,47.5313,-122.074,2580,3581,2,9,2015,N,370,156
8165500780,12/9/2014,338000.0,3,2.5,1690,1760,2.0,0.0,0.0,3,8,1410,280,2014,0,98106,47.5387,-122.367,1740,1760,12,9,2014,N,-50,0
1442870050,7/18/2014,535365.0,4,2.75,2790,6969,2.0,0.0,0.0,3,8,2790,0,2012,0,98045,47.4836,-121.76899999999999,2620,6307,7,18,2014,N,170,662
1704900303,12/11/2014,608000.0,3,2.25,1720,5234,2.0,0.0,0.0,3,9,1240,480,2011,0,98118,47.5547,-122.27799999999999,1720,5825,12,11,2014,N,0,-591
6132600655,10/16/2014,930000.0,3,2.25,2890,5000,3.0,0.0,0.0,3,9,2890,0,2014,0,98117,47.6983,-122.389,2020,5000,10,16,2014,N,870,0
3421069049,10/21/2014,565000.0,2,1.75,1130,276170,1.0,0.0,0.0,3,8,1130,0,2006,0,98022,47.2673,-122.027,2092,217800,10,21,2014,N,-962,58370
7169500130,12/19/2014,495000.0,2,2.25,1460,1623,2.0,0.0,0.0,3,8,1260,200,2005,0,98115,47.6764,-122.301,1460,1137,12,19,2014,N,0,486
8732900840,7/22/2014,667000.0,3,2.5,2510,3819,2.0,0.0,0.0,3,8,2510,0,2007,0,98052,47.6987,-122.096,2520,3990,7,22,2014,N,-10,-171
5379803372,11/12/2014,495000.0,4,2.5,3390,7870,2.0,0.0,0.0,3,8,3390,0,2014,0,98188,47.4536,-122.274,1960,10069,11,12,2014,N,1430,-2199
2937300430,9/29/2014,928990.0,4,2.5,3570,6054,2.0,0.0,0.0,3,9,3570,0,2014,0,98052,47.7053,-122.126,3600,6050,9,29,2014,N,-30,4
5422950020,6/30/2014,345000.0,4,2.5,2280,5000,2.0,0.0,0.0,3,7,2280,0,2006,0,98038,47.3593,-122.037,2910,5000,6,30,2014,N,-630,0
3797001702,12/16/2014,1070000.0,5,3.5,2920,3000,2.0,0.0,0.0,3,9,2260,660,2014,0,98103,47.6846,-122.34899999999999,1580,4000,12,16,2014,N,1340,-1000
1438000130,7/3/2014,519995.0,4,3.0,2590,6160,2.0,0.0,0.0,3,8,2590,0,2014,0,98059,47.4784,-122.12200000000001,2670,5600,7,3,2014,N,-80,560
1853080130,11/5/2014,924000.0,5,2.75,3210,8001,2.0,0.0,0.0,3,9,3210,0,2014,0,98074,47.5935,-122.061,3190,6624,11,5,2014,N,20,1377
741500010,4/24/2015,295000.0,3,2.0,1230,3405,1.0,0.0,0.0,3,7,1230,0,2010,0,98058,47.438,-122.179,1440,4066,4,24,2015,N,-210,-661
3123089027,7/21/2014,472000.0,3,2.5,3800,104979,2.0,0.0,0.0,3,8,3210,590,2005,0,98045,47.4304,-121.84100000000001,2040,109771,7,21,2014,N,1760,-4792
3630080190,8/1/2014,405000.0,3,2.5,1500,2314,2.0,0.0,0.0,3,7,1500,0,2005,0,98029,47.5537,-121.99799999999999,1440,2170,8,1,2014,N,60,144
3782760080,7/18/2014,410000.0,4,2.25,2510,4090,2.0,0.0,0.0,3,8,1840,670,2012,0,98019,47.7345,-121.96700000000001,2070,4090,7,18,2014,N,440,0
8024200684,11/25/2014,419500.0,3,1.5,1400,1091,3.0,0.0,0.0,3,8,1400,0,2007,0,98115,47.6989,-122.31700000000001,1270,1413,11,25,2014,N,130,-322
982850020,9/3/2014,382000.0,3,2.25,1450,4667,2.0,0.0,0.0,3,7,1450,0,2009,0,98028,47.7611,-122.23299999999999,1490,4667,9,3,2014,N,-40,0
5649600462,2/24/2015,370000.0,2,2.5,1390,1821,2.0,0.0,0.0,3,7,1180,210,2007,0,98118,47.5537,-122.28200000000001,1350,1821,2,24,2015,N,40,0
3449820430,10/6/2014,553000.0,3,2.75,3160,9072,2.0,0.0,0.0,3,9,3160,0,2005,0,98056,47.5147,-122.177,3160,9072,10,6,2014,N,0,0
9533100285,6/30/2014,2070000.0,4,3.75,4350,7965,2.0,0.0,0.0,3,10,4350,0,2013,0,98004,47.6289,-122.205,2190,8557,6,30,2014,N,2160,-592
923059259,4/1/2015,455950.0,4,2.5,2720,5771,2.0,0.0,0.0,3,8,2720,0,2015,0,98056,47.4917,-122.17,1940,4184,4,1,2015,N,780,1587
6431000748,10/27/2014,331000.0,3,3.25,1290,1153,3.0,0.0,0.0,3,7,1290,0,2008,0,98103,47.6904,-122.346,1290,1200,10,27,2014,N,0,-47
3753000010,5/7/2014,417250.0,3,2.25,1606,1452,3.0,0.0,0.0,3,8,1606,0,2009,0,98125,47.7175,-122.28399999999999,1516,1939,5,7,2014,N,90,-487
6169901185,5/20/2014,490000.0,5,3.5,4460,2975,3.0,0.0,2.0,3,10,3280,0,2015,0,98119,47.6313,-122.37,2490,4231,5,20,2014,N,1970,-1256
2309710150,8/4/2014,325000.0,4,3.25,2800,5291,2.0,0.0,0.0,3,7,2800,0,2011,0,98022,47.1937,-121.977,2380,5291,8,4,2014,N,420,0
1773600264,2/23/2015,705000.0,5,3.5,3250,4800,2.0,0.0,0.0,3,9,2410,840,2010,0,98106,47.5618,-122.36200000000001,1330,4920,2,23,2015,N,1920,-120
6061500100,7/17/2014,1170000.0,6,3.5,4310,7760,2.0,0.0,0.0,3,10,3260,1050,2013,0,98059,47.5297,-122.155,4620,10217,7,17,2014,N,-310,-2457
1282300995,2/22/2015,365000.0,3,2.25,1310,915,2.0,0.0,0.0,3,7,1060,250,2007,0,98144,47.5738,-122.29299999999999,1500,1215,2,22,2015,N,-190,-300
597000593,11/17/2014,403000.0,2,1.5,1240,1101,2.0,0.0,0.0,3,8,1080,160,2009,0,98144,47.5758,-122.309,1530,1209,11,17,2014,N,-290,-108
7853321110,8/13/2014,409000.0,3,2.5,1950,7263,2.0,0.0,0.0,3,7,1950,0,2007,0,98065,47.5194,-121.869,2190,5900,8,13,2014,N,-240,1363
3278612450,4/7/2015,391000.0,3,2.5,1800,1120,2.0,0.0,0.0,3,8,1800,0,2011,0,98126,47.5436,-122.369,1800,2380,4,7,2015,N,0,-1260
1438000120,6/16/2014,542525.0,4,2.5,2650,5600,2.0,0.0,0.0,3,8,2650,0,2014,0,98059,47.4786,-122.12200000000001,2650,5600,6,16,2014,N,0,0
9521100301,5/7/2014,339950.0,2,1.0,820,681,3.0,0.0,0.0,3,8,820,0,2006,0,98103,47.6619,-122.352,820,1156,5,7,2014,N,0,-475
1442870040,8/19/2014,499990.0,4,2.75,2620,7001,2.0,0.0,0.0,3,8,2620,0,2012,0,98045,47.4838,-121.76899999999999,2620,6543,8,19,2014,N,0,458
644000115,9/23/2014,1770000.0,4,3.25,3980,10249,2.0,0.0,0.0,3,10,3980,0,2011,0,98004,47.5873,-122.196,2450,10912,9,23,2014,N,1530,-663
6372000297,3/23/2015,608000.0,3,3.5,1660,2298,2.0,0.0,0.0,3,8,1260,400,2009,0,98116,47.5809,-122.40299999999999,1500,2198,3,23,2015,N,160,100
6600060150,3/12/2015,392000.0,4,2.5,2130,4028,2.0,0.0,0.0,3,8,2130,0,2014,0,98146,47.5108,-122.363,1830,7817,3,12,2015,N,300,-3789
774101755,4/17/2015,320000.0,3,1.75,1790,66250,1.5,0.0,0.0,3,7,1790,0,2003,0,98014,47.7179,-121.40299999999999,1440,59346,4,17,2015,UNK,350,6904
2895800750,4/17/2015,274800.0,3,1.75,1410,1988,2.0,0.0,0.0,3,8,1410,0,2014,0,98106,47.5171,-122.34700000000001,1410,1899,4,17,2015,N,0,89
2424039029,4/27/2015,325000.0,3,2.25,1330,1198,2.0,0.0,0.0,3,8,1080,250,2007,0,98106,47.555,-122.36200000000001,1260,1062,4,27,2015,N,70,136
3448740360,4/29/2015,418500.0,4,2.5,2190,4866,2.0,0.0,0.0,3,7,2190,0,2009,0,98059,47.4907,-122.152,2190,5670,4,29,2015,N,0,-804
3832050580,5/2/2014,300000.0,3,2.5,2540,5050,2.0,0.0,0.0,3,7,2540,0,2006,0,98042,47.3358,-122.055,2280,5050,5,2,2014,N,260,0
3094000210,1/5/2015,269950.0,3,2.5,2244,4079,2.0,0.0,0.0,3,7,2244,0,2012,0,98001,47.2606,-122.25399999999999,2077,4078,1,5,2015,N,167,1
321030150,5/6/2015,358000.0,3,2.5,2026,7611,2.0,0.0,0.0,3,8,2026,0,2010,0,98042,47.3733,-122.162,2270,7611,5,6,2015,N,-244,0
7694200090,5/4/2015,350000.0,3,2.5,1730,4086,2.0,0.0,0.0,3,8,1730,0,2013,0,98146,47.5016,-122.34100000000001,2030,4086,5,4,2015,N,-300,0
3299710110,5/28/2014,782000.0,4,3.5,3910,8095,2.0,0.0,0.0,3,9,3130,780,2007,0,98029,47.5588,-122.036,3770,7021,5,28,2014,N,140,1074
3879900754,9/15/2014,779000.0,3,2.5,1580,1487,3.0,0.0,1.0,3,9,1580,0,2009,0,98119,47.6276,-122.359,1610,1297,9,15,2014,N,-30,190
8732900300,12/17/2014,685000.0,4,2.5,2510,3479,2.0,0.0,0.0,3,8,2510,0,2007,0,98052,47.6981,-122.09899999999999,2540,4171,12,17,2014,N,-30,-692
6021503698,5/29/2014,305000.0,2,2.25,1000,905,3.0,0.0,0.0,3,8,1000,0,2006,0,98117,47.6842,-122.387,980,1023,5,29,2014,N,20,-118
3333000745,4/17/2015,350000.0,4,2.5,1660,2500,2.0,0.0,0.0,3,7,1660,0,2007,0,98118,47.5437,-122.28299999999999,1030,5000,4,17,2015,N,630,-2500
3630220220,9/23/2014,775000.0,4,3.5,3060,4573,2.0,0.0,0.0,3,9,2410,650,2012,0,98029,47.5522,-122.001,3170,3634,9,23,2014,N,-110,939
9478500180,8/28/2014,317750.0,3,2.5,1980,4500,2.0,0.0,0.0,3,7,1980,0,2012,0,98042,47.3682,-122.117,1980,4500,8,28,2014,N,0,0
2771602427,5/8/2014,438000.0,2,1.0,980,1179,2.0,0.0,0.0,3,8,980,0,2010,0,98119,47.6381,-122.375,1190,1600,5,8,2014,N,-210,-421
1498301168,5/28/2014,325000.0,2,2.5,1050,1609,2.0,0.0,0.0,3,7,1050,0,2005,0,98144,47.5854,-122.31299999999999,1120,1693,5,28,2014,N,-70,-84
8562790580,4/28/2015,830000.0,4,3.25,3080,4287,2.0,0.0,0.0,3,10,2230,850,2012,0,98027,47.5313,-122.07600000000001,2250,2520,4,28,2015,N,830,1767
2325400040,9/22/2014,353000.0,3,2.25,1900,3800,2.0,0.0,0.0,3,7,1900,0,2006,0,98059,47.4866,-122.16,1950,3800,9,22,2014,N,-50,0
5045700330,7/25/2014,460000.0,4,2.5,2200,6400,2.0,0.0,0.0,3,8,2200,0,2010,0,98059,47.4856,-122.156,2600,5870,7,25,2014,N,-400,530
3126049498,3/16/2015,370000.0,3,1.5,1360,1167,3.0,0.0,0.0,3,8,1360,0,2008,0,98103,47.6962,-122.34899999999999,1360,1167,3,16,2015,N,0,0
9578140360,6/19/2014,330000.0,3,2.5,2238,7209,2.0,0.0,0.0,3,8,2238,0,2011,0,98023,47.2966,-122.353,2456,7212,6,19,2014,N,-218,-3
3343901408,1/28/2015,569888.0,4,2.5,2590,6474,2.0,0.0,0.0,3,8,2590,0,2014,0,98056,47.5164,-122.19,1960,8679,1,28,2015,N,630,-2205
7859910110,9/18/2014,353900.0,3,2.5,2517,3900,2.0,0.0,0.0,3,8,2517,0,2014,0,98092,47.3211,-122.182,2390,7108,9,18,2014,N,127,-3208
7852120180,3/4/2015,695000.0,4,3.5,3510,9084,2.0,0.0,0.0,3,10,3510,0,2001,0,98065,47.5402,-121.875,3690,9568,3,4,2015,UNK,-180,-484
9268850180,7/18/2014,288790.0,3,1.75,1290,1237,2.0,0.0,0.0,3,7,1060,230,2008,0,98027,47.54,-122.02600000000001,1370,942,7,18,2014,N,-80,295
6031400092,2/13/2015,334950.0,5,3.0,2230,8642,1.0,0.0,0.0,3,7,1330,900,2014,0,98168,47.486999999999995,-122.32,2100,11056,2,13,2015,N,130,-2414
1853080790,12/15/2014,869950.0,4,2.75,3140,7928,2.0,0.0,0.0,3,9,3140,0,2013,0,98074,47.5923,-122.05799999999999,3500,7055,12,15,2014,N,-360,873
1624049291,10/8/2014,557500.0,3,3.5,3350,5025,2.0,0.0,2.0,3,8,2670,680,2014,0,98144,47.5699,-122.296,2030,5117,10,8,2014,N,1320,-92
7237450100,9/19/2014,389990.0,4,2.5,2245,4330,2.0,0.0,0.0,3,8,2245,0,2014,0,98038,47.3557,-122.06299999999999,2530,4478,9,19,2014,N,-285,-148
9521100214,6/4/2014,455000.0,3,1.75,1420,1189,3.0,0.0,0.0,3,8,1420,0,2006,0,98103,47.6625,-122.352,1380,1196,6,4,2014,N,40,-7
5693501102,10/30/2014,598500.0,3,3.0,1560,2091,3.0,0.0,0.0,3,8,1560,0,2006,0,98103,47.6604,-122.352,1530,2091,10,30,2014,N,30,0
6891100590,3/2/2015,750000.0,4,2.75,2810,5497,2.0,0.0,0.0,3,9,2810,0,2011,0,98052,47.7081,-122.116,2990,5842,3,2,2015,N,-180,-345
2254501095,11/13/2014,729999.0,2,2.25,1630,1686,2.0,0.0,0.0,3,10,1330,300,2014,0,98122,47.6113,-122.314,1570,2580,11,13,2014,N,60,-894
9478550110,3/3/2015,299950.0,3,2.5,1740,4497,2.0,0.0,0.0,3,7,1740,0,2012,0,98042,47.3697,-122.117,1950,4486,3,3,2015,N,-210,11
993001961,7/9/2014,374950.0,3,2.25,1390,1484,3.0,0.0,0.0,3,8,1390,0,2007,0,98103,47.6912,-122.34299999999999,1250,1087,7,9,2014,N,140,397
9274200028,2/19/2015,386950.0,3,2.5,1070,1089,2.0,0.0,0.0,3,7,900,170,2009,0,98116,47.5902,-122.387,1450,1437,2,19,2015,N,-380,-348
7708200180,7/10/2014,535000.0,5,3.25,2850,4551,2.0,0.0,0.0,3,8,2370,480,2006,0,98059,47.4916,-122.14399999999999,2850,4849,7,10,2014,N,0,-298
8691430330,8/31/2014,890000.0,5,3.25,4100,7578,2.0,0.0,2.0,3,10,4100,0,2011,0,98075,47.5955,-121.97399999999999,3710,8156,8,31,2014,N,390,-578
8924100308,2/3/2015,1050000.0,4,2.5,3260,5974,2.0,0.0,1.0,3,9,2820,440,2007,0,98115,47.6772,-122.26700000000001,2260,6780,2,3,2015,N,1000,-806
1070000180,10/15/2014,1110000.0,4,3.5,3660,4760,2.0,0.0,0.0,3,9,2840,820,2014,0,98199,47.6482,-122.40899999999999,3210,4640,10,15,2014,N,450,120
1085623630,10/3/2014,436952.0,4,2.5,2708,4772,2.0,0.0,0.0,3,9,2708,0,2014,0,98092,47.3413,-122.178,2502,4900,10,3,2014,N,206,-128
3278605550,6/9/2014,365000.0,3,2.5,1800,2700,2.0,0.0,0.0,3,8,1800,0,2011,0,98126,47.5458,-122.369,1580,2036,6,9,2014,N,220,664
1139000062,6/25/2014,288000.0,3,2.5,1150,887,3.0,0.0,0.0,3,7,1150,0,2007,0,98133,47.7072,-122.35600000000001,1180,915,6,25,2014,N,-30,-28
2838000180,2/20/2015,700000.0,3,2.5,2230,4006,2.0,0.0,0.0,3,8,2230,0,2014,0,98133,47.73,-122.335,2230,4180,2,20,2015,N,0,-174
2725079018,5/9/2014,800000.0,4,3.25,3540,159430,2.0,0.0,0.0,3,9,3540,0,2007,0,98014,47.6285,-121.899,1940,392040,5,9,2014,N,1600,-232610
7104100110,5/11/2015,899000.0,4,3.5,2490,5500,2.0,0.0,0.0,3,9,1780,710,2015,0,98136,47.5499,-122.39299999999999,1710,5500,5,11,2015,N,780,0
259500230,12/18/2014,465750.0,3,2.5,2670,4534,2.0,0.0,0.0,3,9,2670,0,2007,0,98056,47.51,-122.184,3040,5079,12,18,2014,N,-370,-545
9523100712,6/18/2014,485000.0,2,2.5,1430,923,3.0,0.0,0.0,3,8,1410,20,2008,0,98103,47.6683,-122.355,1620,1505,6,18,2014,N,-190,-582
1438000360,6/3/2014,494995.0,5,2.75,2670,3800,2.0,0.0,0.0,3,8,2670,0,2014,0,98059,47.4783,-122.12299999999999,2670,3800,6,3,2014,N,0,0
1608000120,2/2/2015,255000.0,3,2.5,2555,5720,2.0,0.0,0.0,3,8,2555,0,2006,0,98031,47.386,-122.184,2844,5769,2,2,2015,N,-289,-49
7853361120,7/29/2014,530000.0,3,2.5,1970,6295,2.0,0.0,0.0,3,7,1970,0,2011,0,98065,47.5158,-121.874,2710,6009,7,29,2014,N,-740,286
2461900448,6/16/2014,435000.0,3,2.0,1980,2674,3.0,0.0,0.0,3,8,1980,0,2007,0,98136,47.5524,-122.382,1440,2674,6,16,2014,N,540,0
1703400910,8/11/2014,639000.0,3,2.5,2010,3300,2.0,0.0,0.0,3,9,1610,400,2014,0,98118,47.5573,-122.287,1660,4950,8,11,2014,N,350,-1650
8024200683,7/9/2014,440000.0,3,1.5,1270,1413,3.0,0.0,0.0,3,8,1270,0,2007,0,98115,47.6989,-122.31700000000001,1270,1413,7,9,2014,N,0,0
9544700730,5/15/2014,914500.0,4,2.5,3950,10856,3.0,0.0,0.0,3,10,3950,0,2013,0,98075,47.5818,-121.99600000000001,3200,10856,5,15,2014,N,750,0
8682320900,11/5/2014,580000.0,3,2.0,1870,5300,1.0,0.0,0.0,3,8,1870,0,2009,0,98053,47.7106,-122.02,1870,5050,11,5,2014,N,0,250
3278600750,4/7/2015,250000.0,1,1.5,1180,1688,2.0,0.0,0.0,3,8,1070,110,2007,0,98126,47.549,-122.37200000000001,1380,2059,4,7,2015,N,-200,-371
5676000008,3/16/2015,410000.0,3,2.5,1420,1269,3.0,0.0,0.0,3,7,1420,0,2007,0,98103,47.6904,-122.34200000000001,1420,1300,3,16,2015,N,0,-31
3744000150,9/28/2014,531155.0,4,2.75,2810,5046,2.0,0.0,0.0,3,9,2810,0,2014,0,98038,47.3559,-122.022,3060,4934,9,28,2014,N,-250,112
3630080120,9/19/2014,358000.0,3,2.5,1400,1529,2.0,0.0,0.0,3,7,1400,0,2005,0,98029,47.5535,-121.99700000000001,1440,1536,9,19,2014,N,-40,-7
7853360620,7/1/2014,425000.0,3,2.5,1950,5689,2.0,0.0,0.0,3,7,1950,0,2009,0,98065,47.5158,-121.87299999999999,2190,5653,7,1,2014,N,-240,36
255550100,7/11/2014,326000.0,3,2.25,1930,3462,2.0,0.0,0.0,3,7,1930,0,2004,0,98019,47.7453,-121.985,1930,2952,7,11,2014,N,0,510
9268200484,5/13/2014,650000.0,4,2.5,2210,4861,2.0,0.0,0.0,3,9,2210,0,2013,0,98117,47.6959,-122.36399999999999,1590,5080,5,13,2014,N,620,-219
8562790720,5/14/2015,749950.0,4,3.5,2630,3757,2.0,0.0,0.0,3,10,2200,430,2008,0,98027,47.5322,-122.075,2620,2699,5,14,2015,N,10,1058
7140700690,3/12/2015,239950.0,3,1.75,1600,4888,1.0,0.0,0.0,3,6,1600,0,2014,0,98042,47.383,-122.09700000000001,2520,5700,3,12,2015,N,-920,-812
3624039183,6/9/2014,315000.0,3,2.5,1480,1590,2.0,0.0,0.0,3,8,1150,330,2010,0,98106,47.5302,-122.36200000000001,1480,5761,6,9,2014,N,0,-4171
2254502071,5/23/2014,375000.0,2,2.5,750,1430,2.0,0.0,0.0,3,8,750,0,2006,0,98122,47.6093,-122.31,1320,2790,5,23,2014,N,-570,-1360
4310702838,4/27/2015,375000.0,3,1.5,1290,1213,3.0,0.0,0.0,3,8,1290,0,2007,0,98103,47.6965,-122.34,1360,1227,4,27,2015,N,-70,-14
6431000749,9/22/2014,349000.0,3,3.25,1340,1151,3.0,0.0,0.0,3,7,1340,0,2008,0,98103,47.6904,-122.346,1290,1200,9,22,2014,N,50,-49
3362401761,2/25/2015,450000.0,2,1.5,1020,1049,3.0,0.0,0.0,3,8,1020,0,2008,0,98103,47.68,-122.348,1350,1395,2,25,2015,N,-330,-346
3629700120,10/14/2014,669950.0,3,3.0,2330,1944,2.5,0.0,0.0,3,8,1950,380,2014,0,98027,47.5446,-122.016,2290,1407,10,14,2014,N,40,537
3226049565,7/11/2014,504600.0,5,3.0,2360,5000,1.0,0.0,0.0,3,7,1390,0,2008,0,98103,47.6931,-122.33,2180,5009,7,11,2014,N,180,-9
567000408,6/2/2014,400000.0,3,2.5,1495,936,3.0,0.0,0.0,3,8,1405,90,2006,0,98144,47.593,-122.295,1495,1186,6,2,2014,N,0,-250
825059349,7/1/2014,1020000.0,4,3.5,3770,8501,2.0,0.0,0.0,3,10,3770,0,2008,0,98033,47.6744,-122.196,1520,9660,7,1,2014,N,2250,-1159
7787920230,4/8/2015,518000.0,5,2.5,2890,13104,2.0,0.0,0.0,3,8,2890,0,2006,0,98019,47.7277,-121.958,3020,9300,4,8,2015,N,-130,3804
5694000706,8/13/2014,535000.0,3,2.75,1320,1125,3.0,0.0,0.0,3,8,1320,0,2008,0,98103,47.6598,-122.348,1320,1266,8,13,2014,N,0,-141
1760650900,7/21/2014,337500.0,4,2.5,2330,4907,2.0,0.0,0.0,3,7,2330,0,2013,0,98042,47.358999999999995,-122.081,2300,3836,7,21,2014,N,30,1071
2021000180,3/10/2015,380000.0,4,2.5,3120,5001,2.0,0.0,0.0,3,9,3120,0,2005,0,98023,47.2779,-122.34899999999999,3120,5244,3,10,2015,N,0,-243
6400700389,7/10/2014,875000.0,5,3.0,2960,15152,2.0,0.0,0.0,3,9,2960,0,2004,0,98033,47.6689,-122.179,1850,9453,7,10,2014,N,1110,5699
6431000987,9/2/2014,385000.0,3,2.25,1630,1598,3.0,0.0,0.0,3,8,1630,0,2008,0,98103,47.6904,-122.34700000000001,1320,1605,9,2,2014,N,310,-7
2311400056,12/1/2014,1990000.0,5,3.5,5230,8960,2.0,0.0,0.0,3,11,4450,780,2014,0,98004,47.5964,-122.20100000000001,2310,9603,12,1,2014,N,2920,-643
3224059107,5/8/2015,649500.0,4,3.0,3150,6599,2.0,0.0,0.0,3,9,3150,0,2008,0,98056,47.5279,-122.199,2680,9430,5,8,2015,N,470,-2831
1245002281,5/12/2014,1050000.0,4,3.75,3280,11000,2.0,0.0,0.0,3,10,2320,960,2008,0,98033,47.6855,-122.20100000000001,2400,8351,5,12,2014,N,880,2649
121039156,1/9/2015,249000.0,3,1.0,1030,24750,1.0,0.0,2.0,3,5,1030,0,1943,0,98023,47.3343,-122.36200000000001,2810,28800,1,9,2015,UNK,-1780,-4050
9211000110,10/3/2014,525000.0,4,2.5,3130,5795,2.0,0.0,0.0,3,9,3130,0,2008,0,98059,47.4997,-122.15100000000001,2950,5259,10,3,2014,N,180,536
7625702263,6/12/2014,402000.0,3,3.5,1240,1666,2.0,0.0,0.0,3,7,1000,240,2008,0,98136,47.5496,-122.38799999999999,1110,1027,6,12,2014,N,130,639
8085400586,11/1/2014,1750000.0,4,2.75,3560,8975,2.0,0.0,0.0,3,10,3560,0,2014,0,98004,47.6322,-122.209,3440,12825,11,1,2014,N,120,-3850
2895800590,10/20/2014,359800.0,5,2.5,2170,2752,2.0,0.0,0.0,3,8,2170,0,2014,0,98106,47.5167,-122.34700000000001,1800,2752,10,20,2014,N,370,0
100300530,9/25/2014,330000.0,3,2.5,1520,3003,2.0,0.0,0.0,3,7,1520,0,2009,0,98059,47.4876,-122.15299999999999,1820,3030,9,25,2014,N,-300,-27
4092302096,3/25/2015,433000.0,3,2.5,1270,1062,2.0,0.0,0.0,3,8,1060,210,2008,0,98105,47.6568,-122.321,1260,1112,3,25,2015,N,10,-50
7010700308,11/12/2014,1010000.0,4,3.25,3610,4000,2.0,0.0,0.0,3,9,2640,970,2007,0,98199,47.658,-122.396,1980,4000,11,12,2014,N,1630,0
7853370100,4/6/2015,599832.0,3,2.75,3230,5200,2.0,0.0,0.0,3,9,2680,550,2014,0,98065,47.519,-121.87799999999999,3100,4900,4,6,2015,N,130,300
6181500120,6/23/2014,312891.0,5,3.0,2300,8214,2.0,0.0,0.0,3,8,2300,0,2013,0,98001,47.3052,-122.27600000000001,2594,4950,6,23,2014,N,-294,3264
567000775,9/12/2014,449000.0,2,2.5,1460,1296,2.0,0.0,0.0,3,8,1160,300,2008,0,98144,47.5923,-122.296,1460,1296,9,12,2014,N,0,0
3331000035,5/27/2014,495000.0,3,2.5,1750,1548,3.0,0.0,0.0,3,9,1750,0,2013,0,98118,47.5532,-122.28200000000001,1750,3960,5,27,2014,N,0,-2412
4216500110,5/15/2014,819995.0,5,2.75,3030,10335,2.0,0.0,0.0,3,9,3030,0,2013,0,98056,47.5305,-122.184,2720,11213,5,15,2014,N,310,-878
2776600082,11/13/2014,407500.0,3,3.5,1522,1465,2.0,0.0,0.0,3,8,1248,274,2006,0,98117,47.6922,-122.375,1522,1341,11,13,2014,N,0,124
323079058,1/5/2015,850000.0,4,3.75,3890,22000,2.0,0.0,0.0,3,10,3890,0,2007,0,98027,47.5052,-121.906,1610,23142,1,5,2015,N,2280,-1142
1088100450,7/25/2014,1720000.0,5,4.0,4590,35046,2.0,0.0,0.0,3,10,4590,0,2008,0,98033,47.6647,-122.16,3350,35857,7,25,2014,N,1240,-811
98300230,4/28/2015,1460000.0,4,4.0,4620,130208,2.0,0.0,0.0,3,10,4620,0,2014,0,98024,47.5885,-121.939,4620,131007,4,28,2015,N,0,-799
847100047,9/17/2014,579000.0,4,2.75,3220,9825,2.0,0.0,0.0,3,8,3220,0,2012,0,98059,47.4863,-122.14299999999999,2820,8566,9,17,2014,N,400,1259
1853080150,8/11/2014,890776.0,5,2.75,3170,8093,2.0,0.0,0.0,3,9,3170,0,2014,0,98075,47.5933,-122.06,3210,7062,8,11,2014,N,-40,1031
6021503707,1/20/2015,352500.0,2,2.5,980,1010,3.0,0.0,0.0,3,8,980,0,2008,0,98117,47.6844,-122.387,980,1023,1,20,2015,N,0,-13
9512200090,5/1/2015,529000.0,3,1.75,2340,7724,1.0,0.0,0.0,3,10,2340,0,2010,0,98058,47.4593,-122.134,3040,5787,5,1,2015,N,-700,1937
9268850040,3/27/2015,484000.0,3,2.25,1620,1425,3.0,0.0,0.0,3,8,1540,80,2009,0,98027,47.5405,-122.02600000000001,1620,1237,3,27,2015,N,0,188
7283900306,4/17/2015,400000.0,3,2.5,1910,4408,3.0,0.0,0.0,3,8,1910,0,2007,0,98133,47.7634,-122.35,1910,8154,4,17,2015,N,0,-3746
1980200236,4/17/2015,649950.0,3,2.5,2420,6847,2.0,0.0,0.0,3,9,2420,0,2009,0,98133,47.7329,-122.35600000000001,1180,8100,4,17,2015,N,1240,-1253
2413910120,7/2/2014,915000.0,3,4.5,3850,62726,2.0,0.0,0.0,3,10,3120,730,2013,0,98053,47.6735,-122.05799999999999,2630,46609,7,2,2014,N,1220,16117
7787920180,5/4/2015,534950.0,5,2.5,3220,10572,2.0,0.0,0.0,3,8,3220,0,2006,0,98019,47.7268,-121.95700000000001,2890,9090,5,4,2015,N,330,1482
1283800110,5/6/2014,776000.0,4,2.5,3040,6425,2.0,0.0,0.0,3,8,3040,0,2008,0,98052,47.6788,-122.117,3040,7800,5,6,2014,N,0,-1375
6140100028,5/1/2015,370000.0,3,1.75,1496,1423,2.0,0.0,0.0,3,8,1248,248,2006,0,98133,47.715,-122.355,1460,1423,5,1,2015,N,36,0
1972200555,7/14/2014,610000.0,3,1.75,1630,1500,3.0,0.0,0.0,3,8,1630,0,2014,0,98103,47.6536,-122.354,1570,1335,7,14,2014,N,60,165
6891100090,10/14/2014,850000.0,5,3.5,4200,5400,2.0,0.0,0.0,3,9,3140,1060,2012,0,98052,47.7077,-122.12,3300,5564,10,14,2014,N,900,-164
3438503021,11/5/2014,443000.0,3,2.5,2430,7049,2.0,0.0,0.0,3,8,2430,0,2007,0,98106,47.5399,-122.352,1770,7049,11,5,2014,N,660,0
4233600150,2/3/2015,1150000.0,5,4.25,4010,8252,2.0,0.0,0.0,3,10,4010,0,2015,0,98075,47.5974,-122.01299999999999,3370,8252,2,3,2015,N,640,0
2770601782,8/1/2014,453000.0,3,2.5,1510,1618,2.5,0.0,0.0,3,8,1330,180,2011,0,98199,47.6515,-122.384,1350,1397,8,1,2014,N,160,221
9268851020,4/10/2015,735000.0,4,3.5,2340,2810,2.0,0.0,2.0,3,8,1730,610,2011,0,98027,47.5403,-122.02799999999999,2600,2843,4,10,2015,N,-260,-33
8682291050,7/8/2014,810000.0,2,2.75,2700,8572,1.0,0.0,0.0,3,9,2700,0,2007,0,98053,47.7236,-122.03299999999999,2680,8569,7,8,2014,N,20,3
9468200109,6/17/2014,1560000.0,3,3.5,4360,6240,2.0,0.0,3.0,3,10,2960,1400,2008,0,98103,47.6791,-122.354,1920,3910,6,17,2014,N,2440,2330
2524069097,5/9/2014,2240000.0,5,6.5,7270,130017,2.0,0.0,0.0,3,12,6420,850,2010,0,98027,47.5371,-121.98200000000001,1800,44890,5,9,2014,N,5470,85127
7625702441,8/8/2014,377500.0,3,2.5,1350,886,3.0,0.0,0.0,3,8,1270,80,2006,0,98136,47.5491,-122.387,1350,886,8,8,2014,N,0,0
9521100866,6/18/2014,482000.0,3,3.25,1380,1120,3.0,0.0,0.0,3,8,1380,0,2008,0,98103,47.6617,-122.34899999999999,1310,1405,6,18,2014,N,70,-285
148000072,8/18/2014,600000.0,2,2.5,1830,1988,2.0,0.0,0.0,3,9,1530,300,2011,0,98116,47.5779,-122.40899999999999,1800,2467,8,18,2014,N,30,-479
1493300057,8/7/2014,420000.0,3,2.5,1470,1571,2.0,0.0,0.0,3,8,1180,290,2007,0,98116,47.5722,-122.387,1580,4329,8,7,2014,N,-110,-2758
3304030220,4/21/2015,480000.0,4,2.5,2940,9172,2.0,0.0,0.0,3,9,2940,0,2006,0,98001,47.3444,-122.26899999999999,2660,7955,4,21,2015,N,280,1217
7625702277,3/31/2015,406000.0,2,2.0,1110,1095,3.0,0.0,0.0,3,7,980,130,2008,0,98136,47.5494,-122.38799999999999,1110,1083,3,31,2015,N,0,12
1023059465,5/13/2014,505000.0,4,2.5,2790,5602,2.0,0.0,0.0,3,8,2790,0,2009,0,98059,47.4959,-122.15,2790,5309,5,13,2014,N,0,293
3262300818,2/27/2015,1870000.0,4,3.75,3790,8797,2.0,0.0,0.0,3,11,3290,500,2006,0,98039,47.6351,-122.236,2660,12150,2,27,2015,N,1130,-3353
2937300040,12/15/2014,942990.0,4,2.5,3570,6218,2.0,0.0,0.0,3,9,3570,0,2014,0,98052,47.7046,-122.12299999999999,3230,5972,12,15,2014,N,340,246
2768100206,10/1/2014,440000.0,3,2.25,1230,1097,3.0,0.0,0.0,3,8,1230,0,2009,0,98107,47.6697,-122.37200000000001,1420,1437,10,1,2014,N,-190,-340
7904700134,6/26/2014,390000.0,3,3.25,1370,913,2.0,0.0,0.0,3,8,1100,270,2006,0,98116,47.5636,-122.38799999999999,1370,915,6,26,2014,N,0,-2
9521100867,7/11/2014,475000.0,3,3.25,1380,1121,3.0,0.0,0.0,3,8,1380,0,2008,0,98103,47.6617,-122.34899999999999,1310,1405,7,11,2014,N,70,-284
1702901618,4/7/2015,420000.0,1,2.0,1070,675,2.0,0.0,0.0,3,8,880,190,2007,0,98118,47.5574,-122.28399999999999,1220,788,4,7,2015,N,-150,-113
7237550100,8/25/2014,1410000.0,4,4.0,4920,50621,2.0,0.0,0.0,3,10,4280,640,2012,0,98053,47.6575,-122.006,4920,74052,8,25,2014,N,0,-23431
7430500110,12/9/2014,1380000.0,5,3.5,5150,12230,2.0,0.0,2.0,3,10,3700,1450,2007,0,98008,47.6249,-122.09,2940,13462,12,9,2014,N,2210,-1232
603000555,3/2/2015,462500.0,6,3.0,2390,4000,2.0,0.0,0.0,3,7,2390,0,2014,0,98118,47.5173,-122.286,1680,5000,3,2,2015,N,710,-1000
3304300300,5/7/2015,579950.0,4,2.75,2460,8643,2.0,0.0,0.0,3,9,2460,0,2011,0,98059,47.4828,-122.133,3110,8626,5,7,2015,N,-650,17
6453550090,5/5/2015,861111.0,4,2.5,3650,7090,2.0,0.0,0.0,3,10,3650,0,2008,0,98074,47.606,-122.052,3860,7272,5,5,2015,N,-210,-182
2625069038,11/24/2014,1450000.0,4,3.5,4300,108865,2.0,0.0,0.0,3,11,4300,0,2014,0,98074,47.6258,-122.005,4650,107498,11,24,2014,N,-350,1367
1760650820,4/28/2015,290000.0,3,2.25,1610,3764,2.0,0.0,0.0,3,7,1610,0,2012,0,98042,47.3589,-122.083,1610,3825,4,28,2015,N,0,-61
9578060230,6/18/2014,535000.0,4,2.5,2610,4595,2.0,0.0,0.0,3,8,2610,0,2008,0,98028,47.7728,-122.235,2440,4588,6,18,2014,N,170,7
3416600750,2/17/2015,585000.0,3,2.5,1750,1381,3.0,0.0,0.0,3,8,1750,0,2008,0,98122,47.6021,-122.294,1940,4800,2,17,2015,N,-190,-3419
2487200490,6/23/2014,670000.0,3,2.5,3310,5300,2.0,0.0,2.0,3,8,2440,870,2008,0,98136,47.5178,-122.389,2140,7500,6,23,2014,N,1170,-2200
8964800330,4/7/2015,3000000.0,4,3.75,5090,14823,1.0,0.0,0.0,3,11,4180,910,2013,0,98004,47.62,-122.20700000000001,3030,12752,4,7,2015,N,2060,2071
5637500082,12/3/2014,346000.0,3,2.0,1060,1184,2.0,0.0,0.0,3,7,730,330,2006,0,98136,47.5443,-122.385,1270,1601,12,3,2014,N,-210,-417
324069112,6/17/2014,1330000.0,4,4.0,4420,16526,2.0,0.0,0.0,3,11,4420,0,2013,0,98075,47.5914,-122.027,3510,50447,6,17,2014,N,910,-33921
524059322,2/26/2015,999999.0,3,2.5,2100,4097,2.0,0.0,0.0,3,9,2100,0,2008,0,98004,47.5983,-122.2,1780,4764,2,26,2015,N,320,-667
889000025,8/11/2014,599000.0,3,1.75,1650,1180,3.0,0.0,0.0,3,8,1650,0,2014,0,98105,47.6636,-122.319,1720,1960,8,11,2014,N,-70,-780
2909310100,10/15/2014,332000.0,4,2.5,2380,5737,2.0,0.0,0.0,3,7,2380,0,2010,0,98023,47.2815,-122.35600000000001,2380,5396,10,15,2014,N,0,341
8562780180,6/12/2014,336750.0,2,2.25,1170,1011,2.0,0.0,0.0,3,7,1170,0,2009,0,98027,47.5321,-122.073,1240,750,6,12,2014,N,-70,261
1043000100,12/11/2014,370000.0,4,2.5,2531,6843,2.0,0.0,0.0,3,8,2531,0,2013,0,98030,47.385,-122.189,2604,6238,12,11,2014,N,-73,605
1865400076,5/9/2014,324000.0,3,2.25,998,904,2.0,0.0,0.0,3,7,798,200,2007,0,98117,47.6983,-122.367,998,1110,5,9,2014,N,0,-206
8902000201,2/19/2015,338500.0,3,2.25,1333,1470,3.0,0.0,3.0,3,7,1333,0,2009,0,98125,47.7058,-122.302,1360,1680,2,19,2015,N,-27,-210
715010530,1/13/2015,1880000.0,5,3.5,4410,13000,2.0,0.0,3.0,3,10,2920,1490,2014,0,98006,47.5382,-122.111,5790,12969,1,13,2015,N,-1380,31
4253400100,4/10/2015,402723.0,3,2.75,1160,1073,2.0,0.0,0.0,3,7,880,280,2007,0,98144,47.5788,-122.315,1250,5400,4,10,2015,N,-90,-4327
3874900085,2/27/2015,715000.0,4,3.25,2630,7770,2.0,0.0,0.0,3,9,2630,0,2014,0,98126,47.5459,-122.37700000000001,1370,7770,2,27,2015,N,1260,0
1972200227,10/7/2014,459000.0,3,1.5,1160,1031,3.0,0.0,0.0,3,8,1160,0,2008,0,98103,47.6538,-122.35700000000001,1268,1688,10,7,2014,N,-108,-657
8562770720,4/23/2015,589999.0,3,2.5,2140,3628,2.0,0.0,0.0,3,8,1960,180,2006,0,98027,47.537,-122.074,2280,2812,4,23,2015,N,-140,816
6669080120,12/15/2014,405000.0,4,2.5,1980,5020,2.0,0.0,0.0,3,7,1980,0,2007,0,98056,47.5147,-122.19,1980,5064,12,15,2014,N,0,-44
9211010300,7/7/2014,509900.0,3,2.5,3030,9053,2.0,0.0,0.0,3,8,3030,0,2009,0,98059,47.4945,-122.149,3010,6026,7,7,2014,N,20,3027
3277800823,8/20/2014,327000.0,2,2.0,1490,1627,2.0,0.0,0.0,3,8,1190,300,2009,0,98126,47.5455,-122.375,1400,1498,8,20,2014,N,90,129
8835770330,8/19/2014,1060000.0,2,1.5,2370,184231,2.0,0.0,0.0,3,11,2370,0,2005,0,98045,47.4543,-121.77799999999999,3860,151081,8,19,2014,N,-1490,33150
1220000371,12/31/2014,327500.0,3,2.5,1820,1866,2.0,0.0,0.0,3,8,1570,250,2008,0,98166,47.4643,-122.346,1660,6900,12,31,2014,N,160,-5034
880000205,7/29/2014,249000.0,3,2.0,1260,1125,2.0,0.0,0.0,3,7,810,450,2011,0,98106,47.5262,-122.361,1260,1172,7,29,2014,N,0,-47
1561750040,12/24/2014,1380000.0,5,4.5,4350,13405,2.0,0.0,0.0,3,11,4350,0,2014,0,98074,47.6018,-122.06,3990,7208,12,24,2014,N,360,6197
688000017,6/27/2014,516500.0,1,1.25,1100,638,3.0,0.0,0.0,3,9,1100,0,2014,0,98112,47.6228,-122.307,1110,1933,6,27,2014,N,-10,-1295
2522059251,4/9/2015,465000.0,3,2.5,2050,15035,2.0,0.0,0.0,3,9,2050,0,2006,0,98042,47.3619,-122.12200000000001,1300,15836,4,9,2015,N,750,-801
2855000110,8/8/2014,388000.0,3,2.5,2198,6222,2.0,0.0,2.0,3,8,2198,0,2010,0,98198,47.3906,-122.304,2198,7621,8,8,2014,N,0,-1399
6821101731,9/30/2014,549000.0,3,2.25,1230,1380,3.0,0.0,0.0,3,8,1230,0,2013,0,98199,47.6521,-122.4,1760,5664,9,30,2014,N,-530,-4284
476000017,10/3/2014,553000.0,2,2.0,1400,1512,2.0,0.0,0.0,3,8,940,460,2006,0,98107,47.6719,-122.39200000000001,1400,3500,10,3,2014,N,0,-1988
2770603523,4/22/2015,530000.0,3,2.5,1410,1250,2.0,0.0,0.0,3,8,1140,270,2010,0,98119,47.6515,-122.375,1720,2825,4,22,2015,N,-310,-1575
2255500123,8/20/2014,747450.0,3,2.5,2110,1339,2.0,0.0,0.0,3,8,1410,700,2014,0,98122,47.6088,-122.311,1630,2670,8,20,2014,N,480,-1331
3438501329,5/20/2014,305000.0,2,2.5,1590,2656,2.0,0.0,0.0,3,7,1220,370,2009,0,98106,47.5489,-122.36399999999999,1590,2306,5,20,2014,N,0,350
423059387,11/18/2014,540000.0,5,2.5,3370,4850,2.0,0.0,0.0,3,9,3370,0,2007,0,98056,47.5078,-122.169,2900,5570,11,18,2014,N,470,-720
6664500090,1/15/2015,750000.0,5,4.0,4500,8130,2.0,0.0,0.0,3,10,4500,0,2007,0,98059,47.4832,-122.145,2840,8402,1,15,2015,N,1660,-272
2122059216,4/14/2015,422000.0,4,2.5,2930,5973,2.0,0.0,0.0,3,10,2930,0,2008,0,98030,47.3846,-122.186,3038,7095,4,14,2015,N,-108,-1122
9406530090,10/20/2014,337000.0,4,2.5,2470,5100,2.0,0.0,0.0,3,8,2470,0,2005,0,98038,47.3622,-122.041,2240,5123,10,20,2014,N,230,-23
7168100015,10/9/2014,579950.0,5,2.75,3080,5752,2.0,0.0,0.0,3,9,3080,0,2014,0,98059,47.4922,-122.15299999999999,3000,4650,10,9,2014,N,80,1102
5007500120,2/26/2015,341780.0,4,2.75,2260,4440,2.0,0.0,0.0,3,7,2260,0,2014,0,98001,47.3507,-122.291,2260,4563,2,26,2015,N,0,-123
3528900770,4/23/2015,710200.0,4,3.0,1670,2642,2.0,0.0,0.0,3,8,1350,320,2008,0,98109,47.6397,-122.345,1670,2594,4,23,2015,N,0,48
9521100031,6/18/2014,690000.0,3,3.25,1540,1428,3.0,0.0,0.0,3,9,1540,0,2013,0,98103,47.6648,-122.353,1660,3300,6,18,2014,N,-120,-1872
524059330,1/30/2015,1700000.0,4,3.5,3830,8963,2.0,0.0,0.0,3,10,3120,710,2014,0,98004,47.599,-122.197,2190,10777,1,30,2015,N,1640,-1814
6021503705,10/15/2014,329000.0,2,2.5,980,1020,3.0,0.0,0.0,3,8,980,0,2008,0,98117,47.6844,-122.387,980,1023,10,15,2014,N,0,-3
3438501862,5/13/2014,330000.0,3,2.5,1450,5008,1.0,0.0,0.0,3,7,840,610,2007,0,98106,47.5435,-122.35700000000001,2120,5019,5,13,2014,N,-670,-11
3345700207,5/2/2015,608500.0,4,3.5,2850,5577,2.0,0.0,0.0,3,8,1950,900,2014,0,98056,47.5252,-122.19200000000001,2850,5708,5,2,2015,N,0,-131
6056111067,7/7/2014,230000.0,3,1.75,1140,1201,2.0,0.0,0.0,3,8,1140,0,2014,0,98108,47.5637,-122.295,1210,1552,7,7,2014,N,-70,-351
8562790760,5/20/2014,785000.0,4,3.5,3070,4684,2.0,0.0,0.0,3,10,2190,880,2009,0,98027,47.5316,-122.07600000000001,2290,2664,5,20,2014,N,780,2020
1931300090,5/7/2014,610950.0,3,3.0,1680,1570,3.0,0.0,0.0,3,8,1680,0,2014,0,98103,47.6572,-122.346,1640,4800,5,7,2014,N,40,-3230
9578500790,11/11/2014,399950.0,3,2.5,3087,5002,2.0,0.0,0.0,3,8,3087,0,2014,0,98023,47.2974,-122.34899999999999,2927,5183,11,11,2014,N,160,-181
9253900271,1/7/2015,3570000.0,5,4.5,4850,10584,2.0,1.0,4.0,3,10,3540,1310,2007,0,98008,47.5943,-122.11,3470,18270,1,7,2015,N,1380,-7686
3881900317,1/23/2015,579000.0,4,3.25,1900,2631,2.0,0.0,0.0,3,9,1250,650,2014,0,98144,47.5869,-122.311,1710,4502,1,23,2015,N,190,-1871
567000385,6/23/2014,362500.0,2,1.5,940,1768,2.0,0.0,0.0,3,7,940,0,2009,0,98144,47.5925,-122.295,1130,1159,6,23,2014,N,-190,609
7011201004,5/29/2014,645000.0,3,3.25,1730,1229,2.0,0.0,2.0,3,9,1320,410,2008,0,98119,47.6374,-122.369,1710,1686,5,29,2014,N,20,-457
7853420110,10/3/2014,594866.0,3,3.0,2780,6000,2.0,0.0,0.0,3,9,2780,0,2013,0,98065,47.5184,-121.88600000000001,2850,6000,10,3,2014,N,-70,0
7853420110,5/4/2015,625000.0,3,3.0,2780,6000,2.0,0.0,0.0,3,9,2780,0,2013,0,98065,47.5184,-121.88600000000001,2850,6000,5,4,2015,N,-70,0
3052700432,11/12/2014,490000.0,3,2.25,1500,1290,2.0,0.0,0.0,3,8,1220,280,2006,0,98117,47.6785,-122.375,1460,1375,11,12,2014,N,40,-85
2025049203,6/10/2014,399950.0,2,1.0,710,1157,2.0,0.0,0.0,4,7,710,0,1943,0,98102,47.6413,-122.329,1370,1173,6,10,2014,UNK,-660,-16
952006823,12/2/2014,380000.0,3,2.5,1260,900,2.0,0.0,0.0,3,7,940,320,2007,0,98116,47.5621,-122.384,1310,1415,12,2,2014,N,-50,-515
3832050760,8/28/2014,270000.0,3,2.5,1870,5000,2.0,0.0,0.0,3,7,1870,0,2009,0,98042,47.3339,-122.055,2170,5399,8,28,2014,N,-300,-399
2767604724,10/15/2014,505000.0,2,2.5,1430,1201,3.0,0.0,0.0,3,8,1430,0,2009,0,98107,47.6707,-122.381,1430,1249,10,15,2014,N,0,-48
6632300207,3/5/2015,385000.0,3,2.5,1520,1488,3.0,0.0,0.0,3,8,1520,0,2006,0,98125,47.7337,-122.309,1520,1497,3,5,2015,N,0,-9
2767600688,11/13/2014,414500.0,2,1.5,1210,1278,2.0,0.0,0.0,3,8,1020,190,2007,0,98117,47.6756,-122.375,1210,1118,11,13,2014,N,0,160
7570050450,9/10/2014,347500.0,3,2.5,2540,4760,2.0,0.0,0.0,3,8,2540,0,2010,0,98038,47.3452,-122.022,2540,4571,9,10,2014,N,0,189
7430200100,5/14/2014,1220000.0,4,3.5,4910,9444,1.5,0.0,0.0,3,11,3110,1800,2007,0,98074,47.6502,-122.066,4560,11063,5,14,2014,N,350,-1619
4140940150,10/2/2014,572000.0,4,2.75,2770,3852,2.0,0.0,0.0,3,8,2770,0,2014,0,98178,47.5001,-122.23200000000001,1810,5641,10,2,2014,N,960,-1789
1931300412,4/16/2015,475000.0,3,2.25,1190,1200,3.0,0.0,0.0,3,8,1190,0,2008,0,98103,47.6542,-122.346,1180,1224,4,16,2015,N,10,-24
8672200110,3/17/2015,1090000.0,5,3.75,4170,8142,2.0,0.0,2.0,3,10,4170,0,2006,0,98056,47.5354,-122.181,3030,7980,3,17,2015,N,1140,162
5087900040,10/17/2014,350000.0,4,2.75,2500,5995,2.0,0.0,0.0,3,8,2500,0,2008,0,98042,47.3749,-122.10700000000001,2530,5988,10,17,2014,N,-30,7
1972201967,10/31/2014,520000.0,2,2.25,1530,981,3.0,0.0,0.0,3,8,1480,50,2006,0,98103,47.6533,-122.346,1530,1282,10,31,2014,N,0,-301
7502800100,8/13/2014,679950.0,5,2.75,3600,9437,2.0,0.0,0.0,3,9,3600,0,2014,0,98059,47.4822,-122.131,3550,9421,8,13,2014,N,50,16
191100405,4/21/2015,1580000.0,4,3.25,3410,10125,2.0,0.0,0.0,3,10,3410,0,2007,0,98040,47.5653,-122.223,2290,10125,4,21,2015,N,1120,0
8956200760,10/13/2014,541800.0,4,2.5,3118,7866,2.0,0.0,2.0,3,9,3118,0,2014,0,98001,47.2931,-122.264,2673,6500,10,13,2014,N,445,1366
7202300110,9/15/2014,810000.0,4,3.0,3990,7838,2.0,0.0,0.0,3,9,3990,0,2003,0,98053,47.6857,-122.046,3370,6814,9,15,2014,UNK,620,1024
249000205,10/15/2014,1540000.0,5,3.75,4470,8088,2.0,0.0,0.0,3,11,4470,0,2008,0,98004,47.6321,-122.2,2780,8964,10,15,2014,N,1690,-876
5100403806,4/7/2015,467000.0,3,2.5,1425,1179,3.0,0.0,0.0,3,8,1425,0,2008,0,98125,47.6963,-122.318,1285,1253,4,7,2015,N,140,-74
844000965,6/26/2014,224000.0,3,1.75,1500,11968,1.0,0.0,0.0,3,6,1500,0,2014,0,98010,47.3095,-122.00200000000001,1320,11303,6,26,2014,N,180,665
7852140040,8/25/2014,507250.0,3,2.5,2270,5536,2.0,0.0,0.0,3,8,2270,0,2003,0,98065,47.5389,-121.881,2270,5731,8,25,2014,UNK,0,-195
9834201367,1/26/2015,429000.0,3,2.0,1490,1126,3.0,0.0,0.0,3,8,1490,0,2014,0,98144,47.5699,-122.288,1400,1230,1,26,2015,N,90,-104
3448900210,10/14/2014,610685.0,4,2.5,2520,6023,2.0,0.0,0.0,3,9,2520,0,2014,0,98056,47.5137,-122.167,2520,6023,10,14,2014,N,0,0
7936000429,3/26/2015,1010000.0,4,3.5,3510,7200,2.0,0.0,0.0,3,9,2600,910,2009,0,98136,47.5537,-122.398,2050,6200,3,26,2015,N,1460,1000
2997800021,2/19/2015,475000.0,3,2.5,1310,1294,2.0,0.0,0.0,3,8,1180,130,2008,0,98116,47.5773,-122.40899999999999,1330,1265,2,19,2015,N,-20,29
263000018,5/21/2014,360000.0,3,2.5,1530,1131,3.0,0.0,0.0,3,8,1530,0,2009,0,98103,47.6993,-122.346,1530,1509,5,21,2014,N,0,-378
6600060120,2/23/2015,400000.0,4,2.5,2310,5813,2.0,0.0,0.0,3,8,2310,0,2014,0,98146,47.5107,-122.36200000000001,1830,7200,2,23,2015,N,480,-1387
1523300141,6/23/2014,402101.0,2,0.75,1020,1350,2.0,0.0,0.0,3,7,1020,0,2009,0,98144,47.5944,-122.29899999999999,1020,2007,6,23,2014,N,0,-657
291310100,1/16/2015,400000.0,3,2.5,1600,2388,2.0,0.0,0.0,3,8,1600,0,2004,0,98027,47.5345,-122.069,1410,1287,1,16,2015,N,190,1101
1523300157,10/15/2014,325000.0,2,0.75,1020,1076,2.0,0.0,0.0,3,7,1020,0,2008,0,98144,47.5941,-122.29899999999999,1020,1357,10,15,2014,N,0,-281
